date_stat,nom_pays,continent,population,nouveaux_cas,cas_totaux
2020-03-12,albania,Europe,2871945,8,23
2020-03-13,albania,Europe,2871945,10,33
2020-03-14,albania,Europe,2871945,5,38
2020-03-15,albania,Europe,2871945,4,42
2020-03-16,albania,Europe,2871945,9,51
2020-03-17,albania,Europe,2871945,4,55
2020-03-18,albania,Europe,2871945,4,59
2020-03-19,albania,Europe,2871945,5,64
2020-03-20,albania,Europe,2871945,6,70
2020-03-21,albania,Europe,2871945,6,76
2020-03-22,albania,Europe,2871945,13,89
2020-03-23,albania,Europe,2871945,15,104
2020-03-24,albania,Europe,2871945,19,123
2020-03-25,albania,Europe,2871945,23,146
2020-03-26,albania,Europe,2871945,28,174
2020-03-27,albania,Europe,2871945,12,186
2020-03-28,albania,Europe,2871945,11,197
2020-03-29,albania,Europe,2871945,15,212
2020-03-30,albania,Europe,2871945,11,223
2020-03-31,albania,Europe,2871945,20,243
2020-04-01,albania,Europe,2871945,16,259
2020-04-02,albania,Europe,2871945,18,277
2020-04-03,albania,Europe,2871945,27,304
2020-04-04,albania,Europe,2871945,29,333
2020-04-05,albania,Europe,2871945,28,361
2020-04-06,albania,Europe,2871945,16,377
2020-04-07,albania,Europe,2871945,6,383
2020-04-08,albania,Europe,2871945,17,400
2020-04-09,albania,Europe,2871945,9,409
2020-04-10,albania,Europe,2871945,7,416
2020-04-11,albania,Europe,2871945,17,433
2020-04-12,albania,Europe,2871945,13,446
2020-04-13,albania,Europe,2871945,21,467
2020-04-14,albania,Europe,2871945,8,475
2020-04-15,albania,Europe,2871945,19,494
2020-04-16,albania,Europe,2871945,24,518
2020-04-17,albania,Europe,2871945,21,539
2020-04-18,albania,Europe,2871945,9,548
2020-04-19,albania,Europe,2871945,14,562
2020-04-20,albania,Europe,2871945,22,584
2020-04-21,albania,Europe,2871945,25,609
2020-04-22,albania,Europe,2871945,25,634
2020-04-23,albania,Europe,2871945,29,663
2020-04-24,albania,Europe,2871945,15,678
2020-04-25,albania,Europe,2871945,34,712
2020-04-26,albania,Europe,2871945,14,726
2020-04-27,albania,Europe,2871945,10,736
2020-04-28,albania,Europe,2871945,14,750
2020-04-29,albania,Europe,2871945,16,766
2020-04-30,albania,Europe,2871945,7,773
2020-05-01,albania,Europe,2871945,9,782
2020-05-02,albania,Europe,2871945,7,789
2020-05-03,albania,Europe,2871945,6,795
2020-05-04,albania,Europe,2871945,8,803
2020-05-05,albania,Europe,2871945,17,820
2020-05-06,albania,Europe,2871945,12,832
2020-05-07,albania,Europe,2871945,10,842
2020-05-08,albania,Europe,2871945,8,850
2020-05-09,albania,Europe,2871945,6,856
2020-05-10,albania,Europe,2871945,12,868
2020-05-11,albania,Europe,2871945,4,872
2020-05-12,albania,Europe,2871945,4,876
2020-05-13,albania,Europe,2871945,4,880
2020-05-14,albania,Europe,2871945,18,898
2020-05-15,albania,Europe,2871945,18,916
2020-05-16,albania,Europe,2871945,17,933
2020-05-17,albania,Europe,2871945,13,946
2020-05-18,albania,Europe,2871945,2,948
2020-05-19,albania,Europe,2871945,1,949
2020-05-20,albania,Europe,2871945,15,964
2020-05-21,albania,Europe,2871945,5,969
2020-05-22,albania,Europe,2871945,12,981
2020-05-23,albania,Europe,2871945,8,989
2020-05-24,albania,Europe,2871945,9,998
2020-05-25,albania,Europe,2871945,6,1004
2020-05-26,albania,Europe,2871945,25,1029
2020-05-27,albania,Europe,2871945,21,1050
2020-05-28,albania,Europe,2871945,26,1076
2020-05-29,albania,Europe,2871945,23,1099
2020-05-30,albania,Europe,2871945,23,1122
2020-05-31,albania,Europe,2871945,15,1137
2020-06-01,albania,Europe,2871945,6,1143
2020-06-02,albania,Europe,2871945,21,1164
2020-06-03,albania,Europe,2871945,20,1184
2020-06-04,albania,Europe,2871945,13,1197
2020-06-05,albania,Europe,2871945,15,1212
2020-06-06,albania,Europe,2871945,20,1232
2020-06-07,albania,Europe,2871945,14,1246
2020-06-08,albania,Europe,2871945,17,1263
2020-06-09,albania,Europe,2871945,36,1299
2020-06-10,albania,Europe,2871945,42,1341
2020-06-11,albania,Europe,2871945,44,1385
2020-06-12,albania,Europe,2871945,31,1416
2020-06-13,albania,Europe,2871945,48,1464
2020-06-14,albania,Europe,2871945,57,1521
2020-06-15,albania,Europe,2871945,69,1590
2020-06-16,albania,Europe,2871945,82,1672
2020-06-17,albania,Europe,2871945,50,1722
2020-06-18,albania,Europe,2871945,66,1788
2020-06-19,albania,Europe,2871945,50,1838
2020-06-20,albania,Europe,2871945,53,1891
2020-06-21,albania,Europe,2871945,71,1962
2020-06-22,albania,Europe,2871945,33,1995
2020-06-23,albania,Europe,2871945,52,2047
2020-06-24,albania,Europe,2871945,67,2114
2020-06-25,albania,Europe,2871945,78,2192
2020-06-26,albania,Europe,2871945,77,2269
2020-06-27,albania,Europe,2871945,61,2330
2020-06-28,albania,Europe,2871945,72,2402
2020-06-29,albania,Europe,2871945,64,2466
2020-06-30,albania,Europe,2871945,69,2535
2020-07-01,albania,Europe,2871945,45,2580
2020-07-02,albania,Europe,2871945,82,2662
2020-07-03,albania,Europe,2871945,90,2752
2020-07-04,albania,Europe,2871945,67,2819
2020-07-05,albania,Europe,2871945,74,2893
2020-07-06,albania,Europe,2871945,71,2964
2020-07-07,albania,Europe,2871945,74,3038
2020-07-08,albania,Europe,2871945,68,3106
2020-07-09,albania,Europe,2871945,82,3188
2020-07-10,albania,Europe,2871945,90,3278
2020-07-11,albania,Europe,2871945,93,3371
2020-07-12,albania,Europe,2871945,83,3454
2020-07-13,albania,Europe,2871945,117,3571
2020-07-14,albania,Europe,2871945,96,3667
2020-07-15,albania,Europe,2871945,85,3752
2020-07-16,albania,Europe,2871945,99,3851
2020-07-17,albania,Europe,2871945,55,3906
2020-07-18,albania,Europe,2871945,102,4008
2020-07-19,albania,Europe,2871945,82,4090
2020-07-20,albania,Europe,2871945,81,4171
2020-07-21,albania,Europe,2871945,119,4290
2020-07-22,albania,Europe,2871945,68,4358
2020-07-23,albania,Europe,2871945,108,4466
2020-07-24,albania,Europe,2871945,104,4570
2020-07-25,albania,Europe,2871945,67,4637
2020-07-26,albania,Europe,2871945,126,4763
2020-07-27,albania,Europe,2871945,117,4880
2020-07-28,albania,Europe,2871945,117,4997
2020-07-29,albania,Europe,2871945,108,5105
2020-07-30,albania,Europe,2871945,92,5197
2020-07-31,albania,Europe,2871945,79,5276
2020-08-01,albania,Europe,2871945,120,5396
2020-08-02,albania,Europe,2871945,123,5519
2020-08-03,albania,Europe,2871945,101,5620
2020-08-04,albania,Europe,2871945,130,5750
2020-08-05,albania,Europe,2871945,139,5889
2020-08-06,albania,Europe,2871945,127,6016
2020-08-07,albania,Europe,2871945,135,6151
2020-08-08,albania,Europe,2871945,124,6275
2020-08-09,albania,Europe,2871945,136,6411
2020-08-10,albania,Europe,2871945,125,6536
2020-08-11,albania,Europe,2871945,140,6676
2020-08-12,albania,Europe,2871945,141,6817
2020-08-13,albania,Europe,2871945,154,6971
2020-08-14,albania,Europe,2871945,146,7117
2020-08-15,albania,Europe,2871945,143,7260
2020-08-16,albania,Europe,2871945,120,7380
2020-08-17,albania,Europe,2871945,119,7499
2020-08-18,albania,Europe,2871945,155,7654
2020-08-19,albania,Europe,2871945,158,7812
2020-08-20,albania,Europe,2871945,155,7967
2020-08-21,albania,Europe,2871945,152,8119
2020-08-22,albania,Europe,2871945,156,8275
2020-08-23,albania,Europe,2871945,152,8427
2020-08-24,albania,Europe,2871945,178,8605
2020-08-25,albania,Europe,2871945,154,8759
2020-08-26,albania,Europe,2871945,168,8927
2020-08-27,albania,Europe,2871945,156,9083
2020-08-28,albania,Europe,2871945,112,9195
2020-08-29,albania,Europe,2871945,84,9279
2020-08-30,albania,Europe,2871945,101,9380
2020-08-31,albania,Europe,2871945,133,9513
2020-09-01,albania,Europe,2871945,93,9606
2020-09-02,albania,Europe,2871945,122,9728
2020-09-03,albania,Europe,2871945,116,9844
2020-09-04,albania,Europe,2871945,123,9967
2020-09-05,albania,Europe,2871945,135,10102
2020-09-06,albania,Europe,2871945,153,10255
2020-09-07,albania,Europe,2871945,151,10406
2020-09-08,albania,Europe,2871945,147,10553
2020-09-09,albania,Europe,2871945,151,10704
2020-09-10,albania,Europe,2871945,156,10860
2020-09-11,albania,Europe,2871945,161,11021
2020-09-12,albania,Europe,2871945,164,11185
2020-09-13,albania,Europe,2871945,168,11353
2020-09-14,albania,Europe,2871945,167,11520
2020-09-15,albania,Europe,2871945,152,11672
2020-09-16,albania,Europe,2871945,144,11816
2020-09-17,albania,Europe,2871945,132,11948
2020-02-26,algeria,Africa,45325517,0,1
2020-02-27,algeria,Africa,45325517,0,1
2020-02-28,algeria,Africa,45325517,0,1
2020-02-29,algeria,Africa,45325517,0,1
2020-03-01,algeria,Africa,45325517,2,3
2020-03-02,algeria,Africa,45325517,2,5
2020-03-03,algeria,Africa,45325517,3,8
2020-03-04,algeria,Africa,45325517,9,17
2020-03-05,algeria,Africa,45325517,0,17
2020-03-06,algeria,Africa,45325517,0,17
2020-03-07,algeria,Africa,45325517,2,19
2020-03-08,algeria,Africa,45325517,1,20
2020-03-09,algeria,Africa,45325517,0,20
2020-03-10,algeria,Africa,45325517,0,20
2020-03-11,algeria,Africa,45325517,0,20
2020-03-12,algeria,Africa,45325517,6,26
2020-03-13,algeria,Africa,45325517,0,26
2020-03-14,algeria,Africa,45325517,13,39
2020-03-15,algeria,Africa,45325517,15,54
2020-03-16,algeria,Africa,45325517,6,60
2020-03-17,algeria,Africa,45325517,1,61
2020-03-18,algeria,Africa,45325517,14,75
2020-03-19,algeria,Africa,45325517,15,90
2020-03-20,algeria,Africa,45325517,4,94
2020-03-21,algeria,Africa,45325517,45,139
2020-03-22,algeria,Africa,45325517,62,201
2020-03-23,algeria,Africa,45325517,29,230
2020-03-24,algeria,Africa,45325517,34,264
2020-03-25,algeria,Africa,45325517,38,302
2020-03-26,algeria,Africa,45325517,65,367
2020-03-27,algeria,Africa,45325517,42,409
2020-03-28,algeria,Africa,45325517,45,454
2020-03-29,algeria,Africa,45325517,57,511
2020-03-30,algeria,Africa,45325517,73,584
2020-03-31,algeria,Africa,45325517,132,716
2020-04-01,algeria,Africa,45325517,131,847
2020-04-02,algeria,Africa,45325517,139,986
2020-04-03,algeria,Africa,45325517,185,1171
2020-04-04,algeria,Africa,45325517,80,1251
2020-04-05,algeria,Africa,45325517,69,1320
2020-04-06,algeria,Africa,45325517,103,1423
2020-04-07,algeria,Africa,45325517,45,1468
2020-04-08,algeria,Africa,45325517,104,1572
2020-04-09,algeria,Africa,45325517,94,1666
2020-04-10,algeria,Africa,45325517,95,1761
2020-04-11,algeria,Africa,45325517,64,1825
2020-04-12,algeria,Africa,45325517,89,1914
2020-04-13,algeria,Africa,45325517,69,1983
2020-04-14,algeria,Africa,45325517,87,2070
2020-04-15,algeria,Africa,45325517,90,2160
2020-04-16,algeria,Africa,45325517,108,2268
2020-04-17,algeria,Africa,45325517,150,2418
2020-04-18,algeria,Africa,45325517,116,2534
2020-04-19,algeria,Africa,45325517,95,2629
2020-04-20,algeria,Africa,45325517,89,2718
2020-04-21,algeria,Africa,45325517,93,2811
2020-04-22,algeria,Africa,45325517,99,2910
2020-04-23,algeria,Africa,45325517,97,3007
2020-04-24,algeria,Africa,45325517,120,3127
2020-04-25,algeria,Africa,45325517,129,3256
2020-04-26,algeria,Africa,45325517,126,3382
2020-04-27,algeria,Africa,45325517,135,3517
2020-04-28,algeria,Africa,45325517,132,3649
2020-04-29,algeria,Africa,45325517,199,3848
2020-04-30,algeria,Africa,45325517,158,4006
2020-05-01,algeria,Africa,45325517,148,4154
2020-05-02,algeria,Africa,45325517,141,4295
2020-05-03,algeria,Africa,45325517,179,4474
2020-05-04,algeria,Africa,45325517,174,4648
2020-05-05,algeria,Africa,45325517,190,4838
2020-05-06,algeria,Africa,45325517,159,4997
2020-05-07,algeria,Africa,45325517,185,5182
2020-05-08,algeria,Africa,45325517,187,5369
2020-05-09,algeria,Africa,45325517,189,5558
2020-05-10,algeria,Africa,45325517,165,5723
2020-05-11,algeria,Africa,45325517,168,5891
2020-05-12,algeria,Africa,45325517,176,6067
2020-05-13,algeria,Africa,45325517,186,6253
2020-05-14,algeria,Africa,45325517,189,6442
2020-05-15,algeria,Africa,45325517,187,6629
2020-05-16,algeria,Africa,45325517,192,6821
2020-05-17,algeria,Africa,45325517,198,7019
2020-05-18,algeria,Africa,45325517,182,7201
2020-05-19,algeria,Africa,45325517,176,7377
2020-05-20,algeria,Africa,45325517,165,7542
2020-05-21,algeria,Africa,45325517,186,7728
2020-05-22,algeria,Africa,45325517,190,7918
2020-05-23,algeria,Africa,45325517,195,8113
2020-05-24,algeria,Africa,45325517,193,8306
2020-05-25,algeria,Africa,45325517,197,8503
2020-05-26,algeria,Africa,45325517,194,8697
2020-05-27,algeria,Africa,45325517,160,8857
2020-05-28,algeria,Africa,45325517,140,8997
2020-05-29,algeria,Africa,45325517,137,9134
2020-05-30,algeria,Africa,45325517,133,9267
2020-05-31,algeria,Africa,45325517,127,9394
2020-06-01,algeria,Africa,45325517,119,9513
2020-06-02,algeria,Africa,45325517,113,9626
2020-06-03,algeria,Africa,45325517,107,9733
2020-06-04,algeria,Africa,45325517,98,9831
2020-06-05,algeria,Africa,45325517,104,9935
2020-06-06,algeria,Africa,45325517,115,10050
2020-06-07,algeria,Africa,45325517,104,10154
2020-06-08,algeria,Africa,45325517,111,10265
2020-06-09,algeria,Africa,45325517,117,10382
2020-06-10,algeria,Africa,45325517,102,10484
2020-06-11,algeria,Africa,45325517,105,10589
2020-06-12,algeria,Africa,45325517,109,10698
2020-06-13,algeria,Africa,45325517,112,10810
2020-06-14,algeria,Africa,45325517,109,10919
2020-06-15,algeria,Africa,45325517,112,11031
2020-06-16,algeria,Africa,45325517,116,11147
2020-06-17,algeria,Africa,45325517,121,11268
2020-06-18,algeria,Africa,45325517,117,11385
2020-06-19,algeria,Africa,45325517,119,11504
2020-06-20,algeria,Africa,45325517,127,11631
2020-06-21,algeria,Africa,45325517,140,11771
2020-06-22,algeria,Africa,45325517,149,11920
2020-06-23,algeria,Africa,45325517,156,12076
2020-06-24,algeria,Africa,45325517,172,12248
2020-06-25,algeria,Africa,45325517,197,12445
2020-06-26,algeria,Africa,45325517,240,12685
2020-06-27,algeria,Africa,45325517,283,12968
2020-06-28,algeria,Africa,45325517,305,13273
2020-06-29,algeria,Africa,45325517,298,13571
2020-06-30,algeria,Africa,45325517,336,13907
2020-07-01,algeria,Africa,45325517,365,14272
2020-07-02,algeria,Africa,45325517,385,14657
2020-07-03,algeria,Africa,45325517,413,15070
2020-07-04,algeria,Africa,45325517,430,15500
2020-07-05,algeria,Africa,45325517,441,15941
2020-07-06,algeria,Africa,45325517,463,16404
2020-07-07,algeria,Africa,45325517,475,16879
2020-07-08,algeria,Africa,45325517,469,17348
2020-07-09,algeria,Africa,45325517,460,17808
2020-07-10,algeria,Africa,45325517,434,18242
2020-07-11,algeria,Africa,45325517,470,18712
2020-07-12,algeria,Africa,45325517,483,19195
2020-07-13,algeria,Africa,45325517,494,19689
2020-07-14,algeria,Africa,45325517,527,20216
2020-07-15,algeria,Africa,45325517,554,20770
2020-07-16,algeria,Africa,45325517,585,21355
2020-07-17,algeria,Africa,45325517,593,21948
2020-07-18,algeria,Africa,45325517,601,22549
2020-07-19,algeria,Africa,45325517,535,23084
2020-07-20,algeria,Africa,45325517,607,23691
2020-07-21,algeria,Africa,45325517,587,24278
2020-07-22,algeria,Africa,45325517,594,24872
2020-07-23,algeria,Africa,45325517,612,25484
2020-07-24,algeria,Africa,45325517,675,26159
2020-07-25,algeria,Africa,45325517,605,26764
2020-07-26,algeria,Africa,45325517,593,27357
2020-07-27,algeria,Africa,45325517,616,27973
2020-07-28,algeria,Africa,45325517,642,28615
2020-07-29,algeria,Africa,45325517,614,29229
2020-07-30,algeria,Africa,45325517,602,29831
2020-07-31,algeria,Africa,45325517,563,30394
2020-08-01,algeria,Africa,45325517,556,30950
2020-08-02,algeria,Africa,45325517,515,31465
2020-08-03,algeria,Africa,45325517,507,31972
2020-08-04,algeria,Africa,45325517,532,32504
2020-08-05,algeria,Africa,45325517,551,33055
2020-08-06,algeria,Africa,45325517,571,33626
2020-08-07,algeria,Africa,45325517,529,34155
2020-08-08,algeria,Africa,45325517,538,34693
2020-08-09,algeria,Africa,45325517,521,35214
2020-08-10,algeria,Africa,45325517,498,35712
2020-08-11,algeria,Africa,45325517,492,36204
2020-08-12,algeria,Africa,45325517,495,36699
2020-08-13,algeria,Africa,45325517,488,37187
2020-08-14,algeria,Africa,45325517,477,37664
2020-08-15,algeria,Africa,45325517,469,38133
2020-08-16,algeria,Africa,45325517,450,38583
2020-08-17,algeria,Africa,45325517,442,39025
2020-08-18,algeria,Africa,45325517,419,39444
2020-08-19,algeria,Africa,45325517,403,39847
2020-08-20,algeria,Africa,45325517,411,40258
2020-08-21,algeria,Africa,45325517,409,40667
2020-08-22,algeria,Africa,45325517,401,41068
2020-08-23,algeria,Africa,45325517,392,41460
2020-08-24,algeria,Africa,45325517,398,41858
2020-08-25,algeria,Africa,45325517,370,42228
2020-08-26,algeria,Africa,45325517,391,42619
2020-08-27,algeria,Africa,45325517,397,43016
2020-08-28,algeria,Africa,45325517,387,43403
2020-08-29,algeria,Africa,45325517,378,43781
2020-08-30,algeria,Africa,45325517,365,44146
2020-08-31,algeria,Africa,45325517,348,44494
2020-09-01,algeria,Africa,45325517,339,44833
2020-09-02,algeria,Africa,45325517,325,45158
2020-09-03,algeria,Africa,45325517,311,45469
2020-09-04,algeria,Africa,45325517,304,45773
2020-09-05,algeria,Africa,45325517,298,46071
2020-09-06,algeria,Africa,45325517,293,46364
2020-09-07,algeria,Africa,45325517,289,46653
2020-09-08,algeria,Africa,45325517,285,46938
2020-09-09,algeria,Africa,45325517,278,47216
2020-09-10,algeria,Africa,45325517,272,47488
2020-09-11,algeria,Africa,45325517,264,47752
2020-09-12,algeria,Africa,45325517,255,48007
2020-09-13,algeria,Africa,45325517,247,48254
2020-09-14,algeria,Africa,45325517,242,48496
2020-09-15,algeria,Africa,45325517,238,48734
2020-09-16,algeria,Africa,45325517,232,48966
2020-09-17,algeria,Africa,45325517,228,49194
2020-09-18,algeria,Africa,45325517,219,49413
2020-09-19,algeria,Africa,45325517,210,49623
2020-09-20,algeria,Africa,45325517,203,49826
2020-09-21,algeria,Africa,45325517,197,50023
2020-09-22,algeria,Africa,45325517,191,50214
2020-09-23,algeria,Africa,45325517,186,50400
2020-09-24,algeria,Africa,45325517,179,50579
2020-09-25,algeria,Africa,45325517,175,50754
2020-09-26,algeria,Africa,45325517,160,50914
2020-09-27,algeria,Africa,45325517,153,51067
2020-09-28,algeria,Africa,45325517,146,51213
2020-09-29,algeria,Africa,45325517,155,51368
2020-09-30,algeria,Africa,45325517,162,51530
2020-10-01,algeria,Africa,45325517,160,51690
2020-10-02,algeria,Africa,45325517,157,51847
2020-10-03,algeria,Africa,45325517,148,51995
2020-10-04,algeria,Africa,45325517,141,52136
2020-10-05,algeria,Africa,45325517,134,52270
2020-10-06,algeria,Africa,45325517,129,52399
2020-10-07,algeria,Africa,45325517,121,52520
2020-10-08,algeria,Africa,45325517,138,52658
2020-10-09,algeria,Africa,45325517,146,52804
2020-10-10,algeria,Africa,45325517,136,52940
2020-10-11,algeria,Africa,45325517,132,53072
2020-10-12,algeria,Africa,45325517,153,53225
2020-10-13,algeria,Africa,45325517,174,53399
2020-10-14,algeria,Africa,45325517,185,53584
2020-10-15,algeria,Africa,45325517,193,53777
2020-10-16,algeria,Africa,45325517,221,53998
2020-10-17,algeria,Africa,45325517,205,54203
2020-10-18,algeria,Africa,45325517,199,54402
2020-10-19,algeria,Africa,45325517,214,54616
2020-10-20,algeria,Africa,45325517,213,54829
2020-10-21,algeria,Africa,45325517,252,55081
2020-10-22,algeria,Africa,45325517,276,55357
2020-10-23,algeria,Africa,45325517,273,55630
2020-10-24,algeria,Africa,45325517,250,55880
2020-10-25,algeria,Africa,45325517,263,56143
2020-10-26,algeria,Africa,45325517,276,56419
2020-10-27,algeria,Africa,45325517,287,56706
2020-10-28,algeria,Africa,45325517,320,57026
2020-10-29,algeria,Africa,45325517,306,57332
2020-10-30,algeria,Africa,45325517,319,57651
2020-10-31,algeria,Africa,45325517,291,57942
2020-11-01,algeria,Africa,45325517,330,58272
2020-11-02,algeria,Africa,45325517,302,58574
2020-11-03,algeria,Africa,45325517,405,58979
2020-11-04,algeria,Africa,45325517,548,59527
2020-11-05,algeria,Africa,45325517,642,60169
2020-11-06,algeria,Africa,45325517,631,60800
2020-11-07,algeria,Africa,45325517,581,61381
2020-11-08,algeria,Africa,45325517,670,62051
2020-11-09,algeria,Africa,45325517,642,62693
2020-11-10,algeria,Africa,45325517,753,63446
2020-11-11,algeria,Africa,45325517,811,64257
2020-11-12,algeria,Africa,45325517,851,65108
2020-11-13,algeria,Africa,45325517,867,65975
2020-11-14,algeria,Africa,45325517,844,66819
2020-11-15,algeria,Africa,45325517,860,67679
2020-11-16,algeria,Africa,45325517,910,68589
2020-11-17,algeria,Africa,45325517,1002,69591
2020-11-18,algeria,Africa,45325517,1038,70629
2020-11-19,algeria,Africa,45325517,1023,71652
2020-11-20,algeria,Africa,45325517,1103,72755
2020-11-21,algeria,Africa,45325517,1019,73774
2020-11-22,algeria,Africa,45325517,1088,74862
2020-11-23,algeria,Africa,45325517,1005,75867
2020-11-24,algeria,Africa,45325517,1133,77000
2020-11-25,algeria,Africa,45325517,1025,78025
2020-11-26,algeria,Africa,45325517,1085,79110
2020-11-27,algeria,Africa,45325517,1058,80168
2020-11-28,algeria,Africa,45325517,1044,81212
2020-11-29,algeria,Africa,45325517,1009,82221
2020-11-30,algeria,Africa,45325517,978,83199
2020-12-01,algeria,Africa,45325517,953,84152
2020-12-02,algeria,Africa,45325517,932,85084
2020-12-03,algeria,Africa,45325517,843,85927
2020-12-04,algeria,Africa,45325517,803,86730
2020-12-05,algeria,Africa,45325517,772,87502
2020-12-06,algeria,Africa,45325517,750,88252
2020-12-07,algeria,Africa,45325517,573,88825
2020-12-08,algeria,Africa,45325517,591,89416
2020-12-09,algeria,Africa,45325517,598,90014
2020-12-10,algeria,Africa,45325517,565,90579
2020-12-11,algeria,Africa,45325517,542,91121
2020-12-12,algeria,Africa,45325517,517,91638
2020-12-13,algeria,Africa,45325517,464,92102
2020-12-14,algeria,Africa,45325517,495,92597
2020-12-15,algeria,Africa,45325517,468,93065
2020-12-16,algeria,Africa,45325517,442,93507
2020-12-17,algeria,Africa,45325517,426,93933
2020-12-18,algeria,Africa,45325517,438,94371
2020-12-19,algeria,Africa,45325517,410,94781
2020-12-20,algeria,Africa,45325517,422,95203
2020-12-21,algeria,Africa,45325517,456,95659
2020-12-22,algeria,Africa,45325517,410,96069
2020-12-23,algeria,Africa,45325517,480,96549
2020-12-24,algeria,Africa,45325517,458,97007
2020-12-25,algeria,Africa,45325517,434,97441
2020-12-26,algeria,Africa,45325517,416,97857
2020-12-27,algeria,Africa,45325517,392,98249
2020-12-28,algeria,Africa,45325517,382,98631
2020-12-29,algeria,Africa,45325517,357,98988
2020-12-30,algeria,Africa,45325517,323,99311
2020-12-31,algeria,Africa,45325517,299,99610
2021-01-01,algeria,Africa,45325517,287,99897
2021-01-02,algeria,Africa,45325517,262,100159
2021-01-03,algeria,Africa,45325517,249,100408
2021-01-04,algeria,Africa,45325517,237,100645
2021-01-05,algeria,Africa,45325517,228,100873
2021-01-06,algeria,Africa,45325517,247,101120
2021-01-07,algeria,Africa,45325517,262,101382
2021-01-08,algeria,Africa,45325517,275,101657
2021-01-09,algeria,Africa,45325517,256,101913
2021-01-10,algeria,Africa,45325517,231,102144
2021-01-11,algeria,Africa,45325517,225,102369
2021-01-12,algeria,Africa,45325517,272,102641
2021-01-13,algeria,Africa,45325517,219,102860
2021-01-14,algeria,Africa,45325517,267,103127
2021-01-15,algeria,Africa,45325517,254,103381
2021-01-16,algeria,Africa,45325517,230,103611
2021-01-17,algeria,Africa,45325517,222,103833
2021-01-18,algeria,Africa,45325517,259,104092
2021-01-19,algeria,Africa,45325517,249,104341
2021-01-20,algeria,Africa,45325517,265,104606
2021-01-21,algeria,Africa,45325517,246,104852
2021-01-22,algeria,Africa,45325517,272,105124
2021-01-23,algeria,Africa,45325517,245,105369
2021-01-24,algeria,Africa,45325517,227,105596
2021-01-25,algeria,Africa,45325517,258,105854
2021-01-26,algeria,Africa,45325517,243,106097
2021-01-27,algeria,Africa,45325517,262,106359
2021-01-28,algeria,Africa,45325517,251,106610
2021-01-29,algeria,Africa,45325517,277,106887
2021-01-30,algeria,Africa,45325517,235,107122
2021-01-31,algeria,Africa,45325517,217,107339
2021-02-01,algeria,Africa,45325517,239,107578
2021-02-02,algeria,Africa,45325517,263,107841
2021-02-03,algeria,Africa,45325517,275,108116
2021-02-04,algeria,Africa,45325517,265,108381
2021-02-05,algeria,Africa,45325517,248,108629
2021-02-06,algeria,Africa,45325517,223,108852
2021-02-07,algeria,Africa,45325517,236,109088
2021-02-08,algeria,Africa,45325517,225,109313
2021-02-09,algeria,Africa,45325517,246,109559
2021-02-10,algeria,Africa,45325517,223,109782
2021-02-11,algeria,Africa,45325517,267,110049
2021-02-12,algeria,Africa,45325517,254,110303
2021-02-13,algeria,Africa,45325517,210,110513
2021-02-14,algeria,Africa,45325517,198,110711
2021-02-15,algeria,Africa,45325517,183,110894
2021-02-16,algeria,Africa,45325517,175,111069
2021-02-17,algeria,Africa,45325517,178,111247
2021-02-18,algeria,Africa,45325517,171,111418
2021-02-19,algeria,Africa,45325517,182,111600
2021-02-20,algeria,Africa,45325517,164,111764
2021-02-21,algeria,Africa,45325517,153,111917
2021-02-22,algeria,Africa,45325517,177,112094
2021-02-23,algeria,Africa,45325517,185,112279
2021-02-24,algeria,Africa,45325517,182,112461
2021-02-25,algeria,Africa,45325517,161,112622
2021-02-26,algeria,Africa,45325517,183,112805
2021-02-27,algeria,Africa,45325517,155,112960
2021-02-28,algeria,Africa,45325517,132,113092
2021-03-01,algeria,Africa,45325517,163,113255
2021-03-02,algeria,Africa,45325517,175,113430
2021-03-03,algeria,Africa,45325517,163,113593
2021-03-04,algeria,Africa,45325517,168,113761
2021-03-05,algeria,Africa,45325517,187,113948
2021-03-06,algeria,Africa,45325517,156,114104
2021-03-07,algeria,Africa,45325517,130,114234
2021-03-08,algeria,Africa,45325517,148,114382
2021-03-09,algeria,Africa,45325517,161,114543
2021-03-10,algeria,Africa,45325517,138,114681
2021-03-11,algeria,Africa,45325517,170,114851
2021-03-12,algeria,Africa,45325517,157,115008
2021-03-13,algeria,Africa,45325517,135,115143
2021-03-14,algeria,Africa,45325517,122,115265
2021-03-15,algeria,Africa,45325517,145,115410
2021-03-16,algeria,Africa,45325517,130,115540
2021-03-17,algeria,Africa,45325517,148,115688
2021-03-18,algeria,Africa,45325517,154,115842
2021-03-19,algeria,Africa,45325517,128,115970
2021-03-20,algeria,Africa,45325517,96,116066
2021-03-21,algeria,Africa,45325517,91,116157
2021-03-22,algeria,Africa,45325517,98,116255
2021-03-23,algeria,Africa,45325517,94,116349
2021-03-24,algeria,Africa,45325517,89,116438
2021-03-25,algeria,Africa,45325517,105,116543
2021-03-26,algeria,Africa,45325517,114,116657
2021-03-27,algeria,Africa,45325517,93,116750
2020-03-03,andorra,Europe,77495,0,1
2020-03-04,andorra,Europe,77495,0,1
2020-03-05,andorra,Europe,77495,0,1
2020-03-06,andorra,Europe,77495,0,1
2020-03-07,andorra,Europe,77495,0,1
2020-03-08,andorra,Europe,77495,0,1
2020-03-09,andorra,Europe,77495,0,1
2020-03-10,andorra,Europe,77495,0,1
2020-03-11,andorra,Europe,77495,0,1
2020-03-12,andorra,Europe,77495,0,1
2020-03-13,andorra,Europe,77495,0,1
2020-03-14,andorra,Europe,77495,0,1
2020-03-15,andorra,Europe,77495,4,5
2020-03-16,andorra,Europe,77495,9,14
2020-03-17,andorra,Europe,77495,25,39
2020-03-18,andorra,Europe,77495,14,53
2020-03-19,andorra,Europe,77495,21,74
2020-03-20,andorra,Europe,77495,1,75
2020-03-21,andorra,Europe,77495,13,88
2020-03-22,andorra,Europe,77495,25,113
2020-03-23,andorra,Europe,77495,20,133
2020-03-24,andorra,Europe,77495,31,164
2020-03-25,andorra,Europe,77495,24,188
2020-03-26,andorra,Europe,77495,36,224
2020-03-27,andorra,Europe,77495,43,267
2020-03-28,andorra,Europe,77495,41,308
2020-03-29,andorra,Europe,77495,26,334
2020-03-30,andorra,Europe,77495,36,370
2020-03-31,andorra,Europe,77495,6,376
2020-04-01,andorra,Europe,77495,14,390
2020-04-02,andorra,Europe,77495,38,428
2020-04-03,andorra,Europe,77495,11,439
2020-04-04,andorra,Europe,77495,27,466
2020-04-05,andorra,Europe,77495,35,501
2020-04-06,andorra,Europe,77495,24,525
2020-04-07,andorra,Europe,77495,20,545
2020-04-08,andorra,Europe,77495,19,564
2020-04-09,andorra,Europe,77495,19,583
2020-04-10,andorra,Europe,77495,18,601
2020-04-11,andorra,Europe,77495,0,601
2020-04-12,andorra,Europe,77495,37,638
2020-04-13,andorra,Europe,77495,8,646
2020-04-14,andorra,Europe,77495,13,659
2020-04-15,andorra,Europe,77495,14,673
2020-04-16,andorra,Europe,77495,0,673
2020-04-17,andorra,Europe,77495,23,696
2020-04-18,andorra,Europe,77495,8,704
2020-04-19,andorra,Europe,77495,9,713
2020-04-20,andorra,Europe,77495,4,717
2020-04-21,andorra,Europe,77495,0,717
2020-04-22,andorra,Europe,77495,6,723
2020-04-23,andorra,Europe,77495,0,723
2020-04-24,andorra,Europe,77495,8,731
2020-04-25,andorra,Europe,77495,7,738
2020-04-26,andorra,Europe,77495,0,738
2020-04-27,andorra,Europe,77495,5,743
2020-04-28,andorra,Europe,77495,0,743
2020-04-29,andorra,Europe,77495,0,743
2020-04-30,andorra,Europe,77495,2,745
2020-05-01,andorra,Europe,77495,0,745
2020-05-02,andorra,Europe,77495,2,747
2020-05-03,andorra,Europe,77495,1,748
2020-05-04,andorra,Europe,77495,2,750
2020-05-05,andorra,Europe,77495,1,751
2020-05-06,andorra,Europe,77495,0,751
2020-05-07,andorra,Europe,77495,1,752
2020-05-08,andorra,Europe,77495,0,752
2020-05-09,andorra,Europe,77495,2,754
2020-05-10,andorra,Europe,77495,1,755
2020-05-11,andorra,Europe,77495,0,755
2020-05-12,andorra,Europe,77495,3,758
2020-05-13,andorra,Europe,77495,2,760
2020-05-14,andorra,Europe,77495,1,761
2020-05-15,andorra,Europe,77495,0,761
2020-05-16,andorra,Europe,77495,0,761
2020-05-17,andorra,Europe,77495,0,761
2020-05-18,andorra,Europe,77495,0,761
2020-05-19,andorra,Europe,77495,0,761
2020-05-20,andorra,Europe,77495,1,762
2020-05-21,andorra,Europe,77495,0,762
2020-05-22,andorra,Europe,77495,0,762
2020-05-23,andorra,Europe,77495,0,762
2020-05-24,andorra,Europe,77495,0,762
2020-05-25,andorra,Europe,77495,1,763
2020-05-26,andorra,Europe,77495,0,763
2020-05-27,andorra,Europe,77495,0,763
2020-05-28,andorra,Europe,77495,0,763
2020-05-29,andorra,Europe,77495,1,764
2020-05-30,andorra,Europe,77495,0,764
2020-05-31,andorra,Europe,77495,0,764
2020-06-01,andorra,Europe,77495,1,765
2020-06-02,andorra,Europe,77495,79,844
2020-06-03,andorra,Europe,77495,7,851
2020-06-04,andorra,Europe,77495,1,852
2020-06-05,andorra,Europe,77495,0,852
2020-06-06,andorra,Europe,77495,0,852
2020-06-07,andorra,Europe,77495,0,852
2020-06-08,andorra,Europe,77495,0,852
2020-06-09,andorra,Europe,77495,0,852
2020-06-10,andorra,Europe,77495,0,852
2020-06-11,andorra,Europe,77495,0,852
2020-06-12,andorra,Europe,77495,1,853
2020-06-13,andorra,Europe,77495,0,853
2020-06-14,andorra,Europe,77495,0,853
2020-06-15,andorra,Europe,77495,0,853
2020-06-16,andorra,Europe,77495,1,854
2020-06-17,andorra,Europe,77495,0,854
2020-06-18,andorra,Europe,77495,1,855
2020-06-19,andorra,Europe,77495,0,855
2020-06-20,andorra,Europe,77495,0,855
2020-06-21,andorra,Europe,77495,0,855
2020-06-22,andorra,Europe,77495,0,855
2020-06-23,andorra,Europe,77495,0,855
2020-06-24,andorra,Europe,77495,0,855
2020-06-25,andorra,Europe,77495,0,855
2020-06-26,andorra,Europe,77495,0,855
2020-06-27,andorra,Europe,77495,0,855
2020-06-28,andorra,Europe,77495,0,855
2020-06-29,andorra,Europe,77495,0,855
2020-06-30,andorra,Europe,77495,0,855
2020-07-01,andorra,Europe,77495,0,855
2020-07-02,andorra,Europe,77495,0,855
2020-07-03,andorra,Europe,77495,0,855
2020-07-04,andorra,Europe,77495,0,855
2020-07-05,andorra,Europe,77495,0,855
2020-07-06,andorra,Europe,77495,0,855
2020-07-07,andorra,Europe,77495,0,855
2020-07-08,andorra,Europe,77495,0,855
2020-07-09,andorra,Europe,77495,0,855
2020-07-10,andorra,Europe,77495,0,855
2020-07-11,andorra,Europe,77495,0,855
2020-07-12,andorra,Europe,77495,0,855
2020-07-13,andorra,Europe,77495,3,858
2020-07-14,andorra,Europe,77495,3,861
2020-07-15,andorra,Europe,77495,1,862
2020-07-16,andorra,Europe,77495,15,877
2020-07-17,andorra,Europe,77495,3,880
2020-07-18,andorra,Europe,77495,0,880
2020-07-19,andorra,Europe,77495,0,880
2020-07-20,andorra,Europe,77495,4,884
2020-07-21,andorra,Europe,77495,0,884
2020-07-22,andorra,Europe,77495,5,889
2020-07-23,andorra,Europe,77495,0,889
2020-07-24,andorra,Europe,77495,8,897
2020-07-25,andorra,Europe,77495,0,897
2020-07-26,andorra,Europe,77495,0,897
2020-07-27,andorra,Europe,77495,10,907
2020-07-28,andorra,Europe,77495,0,907
2020-07-29,andorra,Europe,77495,11,918
2020-07-30,andorra,Europe,77495,4,922
2020-07-31,andorra,Europe,77495,3,925
2020-08-01,andorra,Europe,77495,0,925
2020-08-02,andorra,Europe,77495,0,925
2020-08-03,andorra,Europe,77495,12,937
2020-08-04,andorra,Europe,77495,2,939
2020-08-05,andorra,Europe,77495,0,939
2020-08-06,andorra,Europe,77495,5,944
2020-08-07,andorra,Europe,77495,11,955
2020-08-08,andorra,Europe,77495,0,955
2020-08-09,andorra,Europe,77495,0,955
2020-08-10,andorra,Europe,77495,8,963
2020-08-11,andorra,Europe,77495,0,963
2020-08-12,andorra,Europe,77495,14,977
2020-08-13,andorra,Europe,77495,4,981
2020-08-14,andorra,Europe,77495,8,989
2020-08-15,andorra,Europe,77495,0,989
2020-08-16,andorra,Europe,77495,0,989
2020-08-17,andorra,Europe,77495,16,1005
2020-08-18,andorra,Europe,77495,0,1005
2020-08-19,andorra,Europe,77495,19,1024
2020-08-20,andorra,Europe,77495,0,1024
2020-08-21,andorra,Europe,77495,21,1045
2020-08-22,andorra,Europe,77495,0,1045
2020-08-23,andorra,Europe,77495,0,1045
2020-08-24,andorra,Europe,77495,15,1060
2020-08-25,andorra,Europe,77495,0,1060
2020-08-26,andorra,Europe,77495,38,1098
2020-08-27,andorra,Europe,77495,0,1098
2020-08-28,andorra,Europe,77495,26,1124
2020-08-29,andorra,Europe,77495,0,1124
2020-08-30,andorra,Europe,77495,0,1124
2020-08-31,andorra,Europe,77495,52,1176
2020-09-01,andorra,Europe,77495,8,1184
2020-09-02,andorra,Europe,77495,15,1199
2020-09-03,andorra,Europe,77495,0,1199
2020-09-04,andorra,Europe,77495,16,1215
2020-09-05,andorra,Europe,77495,0,1215
2020-09-06,andorra,Europe,77495,0,1215
2020-09-07,andorra,Europe,77495,46,1261
2020-09-08,andorra,Europe,77495,0,1261
2020-09-09,andorra,Europe,77495,40,1301
2020-09-10,andorra,Europe,77495,0,1301
2020-09-11,andorra,Europe,77495,43,1344
2020-09-12,andorra,Europe,77495,0,1344
2020-09-13,andorra,Europe,77495,0,1344
2020-09-14,andorra,Europe,77495,94,1438
2020-09-15,andorra,Europe,77495,0,1438
2020-09-16,andorra,Europe,77495,45,1483
2020-09-17,andorra,Europe,77495,0,1483
2020-09-18,andorra,Europe,77495,81,1564
2020-09-19,andorra,Europe,77495,0,1564
2020-09-20,andorra,Europe,77495,0,1564
2020-09-21,andorra,Europe,77495,117,1681
2020-09-22,andorra,Europe,77495,0,1681
2020-09-23,andorra,Europe,77495,72,1753
2020-09-24,andorra,Europe,77495,0,1753
2020-09-25,andorra,Europe,77495,83,1836
2020-09-26,andorra,Europe,77495,0,1836
2020-09-27,andorra,Europe,77495,0,1836
2020-09-28,andorra,Europe,77495,130,1966
2020-09-29,andorra,Europe,77495,0,1966
2020-09-30,andorra,Europe,77495,84,2050
2020-10-01,andorra,Europe,77495,0,2050
2020-10-02,andorra,Europe,77495,60,2110
2020-10-03,andorra,Europe,77495,0,2110
2020-10-04,andorra,Europe,77495,0,2110
2020-10-05,andorra,Europe,77495,260,2370
2020-10-06,andorra,Europe,77495,0,2370
2020-10-07,andorra,Europe,77495,198,2568
2020-10-08,andorra,Europe,77495,0,2568
2020-10-09,andorra,Europe,77495,128,2696
2020-10-10,andorra,Europe,77495,0,2696
2020-10-11,andorra,Europe,77495,0,2696
2020-10-12,andorra,Europe,77495,299,2995
2020-10-13,andorra,Europe,77495,0,2995
2020-10-14,andorra,Europe,77495,195,3190
2020-10-15,andorra,Europe,77495,0,3190
2020-10-16,andorra,Europe,77495,187,3377
2020-10-17,andorra,Europe,77495,0,3377
2020-10-18,andorra,Europe,77495,0,3377
2020-10-19,andorra,Europe,77495,246,3623
2020-10-20,andorra,Europe,77495,0,3623
2020-10-21,andorra,Europe,77495,188,3811
2020-10-22,andorra,Europe,77495,0,3811
2020-10-23,andorra,Europe,77495,227,4038
2020-10-24,andorra,Europe,77495,0,4038
2020-10-25,andorra,Europe,77495,0,4038
2020-10-26,andorra,Europe,77495,287,4325
2020-10-27,andorra,Europe,77495,85,4410
2020-10-28,andorra,Europe,77495,107,4517
2020-10-29,andorra,Europe,77495,50,4567
2020-10-30,andorra,Europe,77495,98,4665
2020-10-31,andorra,Europe,77495,91,4756
2020-11-01,andorra,Europe,77495,69,4825
2020-11-02,andorra,Europe,77495,63,4888
2020-11-03,andorra,Europe,77495,22,4910
2020-11-04,andorra,Europe,77495,135,5045
2020-11-05,andorra,Europe,77495,90,5135
2020-11-06,andorra,Europe,77495,0,5135
2020-11-07,andorra,Europe,77495,184,5319
2020-11-08,andorra,Europe,77495,64,5383
2020-11-09,andorra,Europe,77495,54,5437
2020-11-10,andorra,Europe,77495,40,5477
2020-11-11,andorra,Europe,77495,90,5567
2020-11-12,andorra,Europe,77495,49,5616
2020-11-13,andorra,Europe,77495,109,5725
2020-11-14,andorra,Europe,77495,0,5725
2020-11-15,andorra,Europe,77495,147,5872
2020-11-16,andorra,Europe,77495,42,5914
2020-11-17,andorra,Europe,77495,37,5951
2020-11-18,andorra,Europe,77495,67,6018
2020-11-19,andorra,Europe,77495,48,6066
2020-11-20,andorra,Europe,77495,76,6142
2020-11-21,andorra,Europe,77495,65,6207
2020-11-22,andorra,Europe,77495,49,6256
2020-11-23,andorra,Europe,77495,48,6304
2020-11-24,andorra,Europe,77495,47,6351
2020-11-25,andorra,Europe,77495,77,6428
2020-11-26,andorra,Europe,77495,106,6534
2020-11-27,andorra,Europe,77495,76,6610
2020-11-28,andorra,Europe,77495,0,6610
2020-11-29,andorra,Europe,77495,102,6712
2020-11-30,andorra,Europe,77495,33,6745
2020-12-01,andorra,Europe,77495,45,6790
2020-12-02,andorra,Europe,77495,52,6842
2020-12-03,andorra,Europe,77495,62,6904
2020-12-04,andorra,Europe,77495,51,6955
2020-12-05,andorra,Europe,77495,50,7005
2020-12-06,andorra,Europe,77495,45,7050
2020-12-07,andorra,Europe,77495,34,7084
2020-12-08,andorra,Europe,77495,43,7127
2020-12-09,andorra,Europe,77495,35,7162
2020-12-10,andorra,Europe,77495,28,7190
2020-12-11,andorra,Europe,77495,46,7236
2020-12-12,andorra,Europe,77495,52,7288
2020-12-13,andorra,Europe,77495,50,7338
2020-12-14,andorra,Europe,77495,44,7382
2020-12-15,andorra,Europe,77495,0,7382
2020-12-16,andorra,Europe,77495,64,7446
2020-12-17,andorra,Europe,77495,20,7466
2020-12-18,andorra,Europe,77495,53,7519
2020-12-19,andorra,Europe,77495,41,7560
2020-12-20,andorra,Europe,77495,17,7577
2020-12-21,andorra,Europe,77495,25,7602
2020-12-22,andorra,Europe,77495,31,7633
2020-12-23,andorra,Europe,77495,36,7669
2020-12-24,andorra,Europe,77495,30,7699
2020-12-25,andorra,Europe,77495,57,7756
2020-12-26,andorra,Europe,77495,50,7806
2020-12-27,andorra,Europe,77495,15,7821
2020-12-28,andorra,Europe,77495,54,7875
2020-12-29,andorra,Europe,77495,44,7919
2020-12-30,andorra,Europe,77495,64,7983
2020-12-31,andorra,Europe,77495,66,8049
2021-01-01,andorra,Europe,77495,68,8117
2021-01-02,andorra,Europe,77495,49,8166
2021-01-03,andorra,Europe,77495,26,8192
2021-01-04,andorra,Europe,77495,57,8249
2021-01-05,andorra,Europe,77495,59,8308
2021-01-06,andorra,Europe,77495,40,8348
2021-01-07,andorra,Europe,77495,0,8348
2021-01-08,andorra,Europe,77495,141,8489
2021-01-09,andorra,Europe,77495,97,8586
2021-01-10,andorra,Europe,77495,0,8586
2021-01-11,andorra,Europe,77495,0,8586
2021-01-12,andorra,Europe,77495,96,8682
2021-01-13,andorra,Europe,77495,136,8818
2021-01-14,andorra,Europe,77495,50,8868
2021-01-15,andorra,Europe,77495,78,8946
2021-01-16,andorra,Europe,77495,92,9038
2021-01-17,andorra,Europe,77495,45,9083
2021-01-18,andorra,Europe,77495,0,9083
2021-01-19,andorra,Europe,77495,111,9194
2021-01-20,andorra,Europe,77495,114,9308
2021-01-21,andorra,Europe,77495,71,9379
2021-01-22,andorra,Europe,77495,37,9416
2021-01-23,andorra,Europe,77495,83,9499
2021-01-24,andorra,Europe,77495,50,9549
2021-01-25,andorra,Europe,77495,47,9596
2021-01-26,andorra,Europe,77495,42,9638
2021-01-27,andorra,Europe,77495,78,9716
2021-01-28,andorra,Europe,77495,63,9779
2021-01-29,andorra,Europe,77495,58,9837
2021-01-30,andorra,Europe,77495,48,9885
2021-01-31,andorra,Europe,77495,52,9937
2021-02-01,andorra,Europe,77495,35,9972
2021-02-02,andorra,Europe,77495,45,10017
2021-02-03,andorra,Europe,77495,53,10070
2021-02-04,andorra,Europe,77495,67,10137
2021-02-05,andorra,Europe,77495,35,10172
2021-02-06,andorra,Europe,77495,34,10206
2021-02-07,andorra,Europe,77495,45,10251
2021-02-08,andorra,Europe,77495,24,10275
2021-02-09,andorra,Europe,77495,37,10312
2021-02-10,andorra,Europe,77495,40,10352
2021-02-11,andorra,Europe,77495,39,10391
2021-02-12,andorra,Europe,77495,36,10427
2021-02-13,andorra,Europe,77495,36,10463
2021-02-14,andorra,Europe,77495,40,10503
2021-02-15,andorra,Europe,77495,35,10538
2021-02-16,andorra,Europe,77495,17,10555
2021-02-17,andorra,Europe,77495,28,10583
2021-02-18,andorra,Europe,77495,27,10610
2021-02-19,andorra,Europe,77495,35,10645
2021-02-20,andorra,Europe,77495,27,10672
2021-02-21,andorra,Europe,77495,27,10699
2021-02-22,andorra,Europe,77495,13,10712
2021-02-23,andorra,Europe,77495,27,10739
2021-02-24,andorra,Europe,77495,36,10775
2021-02-25,andorra,Europe,77495,24,10799
2021-02-26,andorra,Europe,77495,23,10822
2021-02-27,andorra,Europe,77495,27,10849
2021-02-28,andorra,Europe,77495,17,10866
2021-03-01,andorra,Europe,77495,23,10889
2021-03-02,andorra,Europe,77495,19,10908
2021-03-03,andorra,Europe,77495,40,10948
2021-03-04,andorra,Europe,77495,28,10976
2021-03-05,andorra,Europe,77495,22,10998
2021-03-06,andorra,Europe,77495,21,11019
2021-03-07,andorra,Europe,77495,23,11042
2021-03-08,andorra,Europe,77495,27,11069
2021-03-09,andorra,Europe,77495,20,11089
2021-03-10,andorra,Europe,77495,41,11130
2021-03-11,andorra,Europe,77495,0,11130
2021-03-12,andorra,Europe,77495,69,11199
2021-03-13,andorra,Europe,77495,29,11228
2021-03-14,andorra,Europe,77495,38,11266
2021-03-15,andorra,Europe,77495,23,11289
2021-03-16,andorra,Europe,77495,30,11319
2021-03-17,andorra,Europe,77495,41,11360
2021-03-18,andorra,Europe,77495,33,11393
2021-03-19,andorra,Europe,77495,38,11431
2021-03-20,andorra,Europe,77495,50,11481
2021-03-21,andorra,Europe,77495,36,11517
2021-03-22,andorra,Europe,77495,28,11545
2021-03-23,andorra,Europe,77495,46,11591
2021-03-24,andorra,Europe,77495,47,11638
2021-03-25,andorra,Europe,77495,49,11687
2021-03-26,andorra,Europe,77495,45,11732
2021-03-27,andorra,Europe,77495,77,11809
2021-03-28,andorra,Europe,77495,41,11850
2021-03-29,andorra,Europe,77495,38,11888
2021-03-30,andorra,Europe,77495,56,11944
2021-03-31,andorra,Europe,77495,66,12010
2021-04-01,andorra,Europe,77495,43,12053
2021-04-02,andorra,Europe,77495,62,12115
2021-04-03,andorra,Europe,77495,59,12174
2021-04-04,andorra,Europe,77495,57,12231
2021-04-05,andorra,Europe,77495,55,12286
2021-04-06,andorra,Europe,77495,42,12328
2021-04-07,andorra,Europe,77495,35,12363
2021-04-08,andorra,Europe,77495,46,12409
2021-04-09,andorra,Europe,77495,47,12456
2021-04-10,andorra,Europe,77495,41,12497
2021-04-11,andorra,Europe,77495,48,12545
2021-04-12,andorra,Europe,77495,36,12581
2021-04-13,andorra,Europe,77495,33,12614
2021-04-14,andorra,Europe,77495,27,12641
2021-04-15,andorra,Europe,77495,0,12641
2021-04-16,andorra,Europe,77495,71,12712
2021-04-17,andorra,Europe,77495,59,12771
2021-04-18,andorra,Europe,77495,34,12805
2021-04-19,andorra,Europe,77495,0,12805
2021-04-20,andorra,Europe,77495,69,12874
2021-04-21,andorra,Europe,77495,43,12917
2021-04-22,andorra,Europe,77495,25,12942
2021-04-23,andorra,Europe,77495,65,13007
2021-04-24,andorra,Europe,77495,17,13024
2021-04-25,andorra,Europe,77495,36,13060
2021-04-26,andorra,Europe,77495,23,13083
2021-04-27,andorra,Europe,77495,38,13121
2021-04-28,andorra,Europe,77495,27,13148
2021-04-29,andorra,Europe,77495,50,13198
2021-04-30,andorra,Europe,77495,34,13232
2021-05-01,andorra,Europe,77495,0,13232
2021-05-02,andorra,Europe,77495,50,13282
2021-05-03,andorra,Europe,77495,13,13295
2021-05-04,andorra,Europe,77495,21,13316
2021-05-05,andorra,Europe,77495,24,13340
2021-05-06,andorra,Europe,77495,23,13363
2021-05-07,andorra,Europe,77495,27,13390
2021-05-08,andorra,Europe,77495,16,13406
2021-05-09,andorra,Europe,77495,17,13423
2021-05-10,andorra,Europe,77495,6,13429
2021-05-11,andorra,Europe,77495,18,13447
2021-05-12,andorra,Europe,77495,23,13470
2021-05-13,andorra,Europe,77495,0,13470
2021-05-14,andorra,Europe,77495,40,13510
2021-05-15,andorra,Europe,77495,0,13510
2021-05-16,andorra,Europe,77495,0,13510
2021-05-17,andorra,Europe,77495,45,13555
2021-05-18,andorra,Europe,77495,14,13569
2021-05-19,andorra,Europe,77495,0,13569
2021-05-20,andorra,Europe,77495,0,13569
2021-05-21,andorra,Europe,77495,0,13569
2021-05-22,andorra,Europe,77495,0,13569
2021-05-23,andorra,Europe,77495,0,13569
2021-05-24,andorra,Europe,77495,0,13569
2021-05-25,andorra,Europe,77495,95,13664
2021-05-26,andorra,Europe,77495,7,13671
2021-05-27,andorra,Europe,77495,11,13682
2021-05-28,andorra,Europe,77495,11,13693
2021-05-29,andorra,Europe,77495,0,13693
2021-05-30,andorra,Europe,77495,0,13693
2021-05-31,andorra,Europe,77495,34,13727
2021-06-01,andorra,Europe,77495,2,13729
2021-06-02,andorra,Europe,77495,15,13744
2021-06-03,andorra,Europe,77495,8,13752
2021-06-04,andorra,Europe,77495,6,13758
2021-06-05,andorra,Europe,77495,0,13758
2021-06-06,andorra,Europe,77495,0,13758
2021-06-07,andorra,Europe,77495,19,13777
2021-06-08,andorra,Europe,77495,4,13781
2021-06-09,andorra,Europe,77495,10,13791
2021-06-10,andorra,Europe,77495,14,13805
2021-06-11,andorra,Europe,77495,8,13813
2021-06-12,andorra,Europe,77495,0,13813
2021-06-13,andorra,Europe,77495,0,13813
2021-06-14,andorra,Europe,77495,13,13826
2021-06-15,andorra,Europe,77495,2,13828
2021-06-16,andorra,Europe,77495,8,13836
2021-06-17,andorra,Europe,77495,3,13839
2021-06-18,andorra,Europe,77495,3,13842
2021-06-19,andorra,Europe,77495,0,13842
2021-06-20,andorra,Europe,77495,0,13842
2021-06-21,andorra,Europe,77495,22,13864
2021-06-22,andorra,Europe,77495,0,13864
2021-06-23,andorra,Europe,77495,9,13873
2021-06-24,andorra,Europe,77495,4,13877
2021-06-25,andorra,Europe,77495,5,13882
2021-06-26,andorra,Europe,77495,0,13882
2021-06-27,andorra,Europe,77495,0,13882
2021-06-28,andorra,Europe,77495,0,13882
2021-06-29,andorra,Europe,77495,18,13900
2021-06-30,andorra,Europe,77495,11,13911
2021-07-01,andorra,Europe,77495,7,13918
2021-07-02,andorra,Europe,77495,0,13918
2021-07-03,andorra,Europe,77495,0,13918
2021-07-04,andorra,Europe,77495,0,13918
2021-07-05,andorra,Europe,77495,0,13918
2021-07-06,andorra,Europe,77495,73,13991
2021-07-07,andorra,Europe,77495,30,14021
2021-07-08,andorra,Europe,77495,29,14050
2021-07-09,andorra,Europe,77495,25,14075
2021-07-10,andorra,Europe,77495,0,14075
2021-07-11,andorra,Europe,77495,0,14075
2021-07-12,andorra,Europe,77495,80,14155
2021-07-13,andorra,Europe,77495,12,14167
2021-07-14,andorra,Europe,77495,0,14167
2021-07-15,andorra,Europe,77495,72,14239
2021-07-16,andorra,Europe,77495,34,14273
2021-07-17,andorra,Europe,77495,0,14273
2021-07-18,andorra,Europe,77495,0,14273
2021-07-19,andorra,Europe,77495,86,14359
2021-07-20,andorra,Europe,77495,20,14379
2021-07-21,andorra,Europe,77495,0,14379
2021-07-22,andorra,Europe,77495,85,14464
2021-07-23,andorra,Europe,77495,34,14498
2021-07-24,andorra,Europe,77495,0,14498
2021-07-25,andorra,Europe,77495,0,14498
2021-07-26,andorra,Europe,77495,79,14577
2021-07-27,andorra,Europe,77495,9,14586
2021-07-28,andorra,Europe,77495,0,14586
2021-07-29,andorra,Europe,77495,69,14655
2021-07-30,andorra,Europe,77495,23,14678
2021-07-31,andorra,Europe,77495,0,14678
2021-08-01,andorra,Europe,77495,0,14678
2021-08-02,andorra,Europe,77495,69,14747
2021-08-03,andorra,Europe,77495,19,14766
2021-08-04,andorra,Europe,77495,31,14797
2021-08-05,andorra,Europe,77495,12,14809
2021-08-06,andorra,Europe,77495,27,14836
2021-08-07,andorra,Europe,77495,0,14836
2021-08-08,andorra,Europe,77495,0,14836
2021-08-09,andorra,Europe,77495,0,14836
2021-08-10,andorra,Europe,77495,37,14873
2021-08-11,andorra,Europe,77495,18,14891
2021-08-12,andorra,Europe,77495,17,14908
2021-08-13,andorra,Europe,77495,16,14924
2021-08-14,andorra,Europe,77495,0,14924
2021-08-15,andorra,Europe,77495,0,14924
2021-08-16,andorra,Europe,77495,30,14954
2021-08-17,andorra,Europe,77495,6,14960
2021-08-18,andorra,Europe,77495,16,14976
2021-08-19,andorra,Europe,77495,5,14981
2021-08-20,andorra,Europe,77495,7,14988
2021-08-21,andorra,Europe,77495,0,14988
2021-08-22,andorra,Europe,77495,0,14988
2021-08-23,andorra,Europe,77495,14,15002
2021-08-24,andorra,Europe,77495,1,15003
2021-08-25,andorra,Europe,77495,11,15014
2021-08-26,andorra,Europe,77495,2,15016
2021-08-27,andorra,Europe,77495,9,15025
2021-08-28,andorra,Europe,77495,0,15025
2021-08-29,andorra,Europe,77495,0,15025
2021-08-30,andorra,Europe,77495,7,15032
2021-08-31,andorra,Europe,77495,1,15033
2021-09-01,andorra,Europe,77495,13,15046
2021-09-02,andorra,Europe,77495,6,15052
2021-09-03,andorra,Europe,77495,3,15055
2021-09-04,andorra,Europe,77495,0,15055
2021-09-05,andorra,Europe,77495,0,15055
2021-09-06,andorra,Europe,77495,14,15069
2021-09-07,andorra,Europe,77495,1,15070
2021-09-08,andorra,Europe,77495,0,15070
2021-09-09,andorra,Europe,77495,8,15078
2021-09-10,andorra,Europe,77495,5,15083
2021-09-11,andorra,Europe,77495,0,15083
2021-09-12,andorra,Europe,77495,0,15083
2021-09-13,andorra,Europe,77495,13,15096
2021-09-14,andorra,Europe,77495,3,15099
2021-09-15,andorra,Europe,77495,9,15108
2021-09-16,andorra,Europe,77495,5,15113
2021-09-17,andorra,Europe,77495,11,15124
2021-09-18,andorra,Europe,77495,0,15124
2021-09-19,andorra,Europe,77495,0,15124
2021-09-20,andorra,Europe,77495,16,15140
2021-09-21,andorra,Europe,77495,0,15140
2021-09-22,andorra,Europe,77495,13,15153
2021-09-23,andorra,Europe,77495,3,15156
2021-09-24,andorra,Europe,77495,11,15167
2021-09-25,andorra,Europe,77495,0,15167
2021-09-26,andorra,Europe,77495,0,15167
2021-09-27,andorra,Europe,77495,22,15189
2021-09-28,andorra,Europe,77495,3,15192
2021-09-29,andorra,Europe,77495,17,15209
2021-09-30,andorra,Europe,77495,13,15222
2021-10-01,andorra,Europe,77495,0,15222
2021-10-02,andorra,Europe,77495,0,15222
2021-10-03,andorra,Europe,77495,0,15222
2021-10-04,andorra,Europe,77495,45,15267
2021-10-05,andorra,Europe,77495,4,15271
2021-10-06,andorra,Europe,77495,13,15284
2021-10-07,andorra,Europe,77495,4,15288
2021-10-08,andorra,Europe,77495,3,15291
2021-10-09,andorra,Europe,77495,0,15291
2021-10-10,andorra,Europe,77495,0,15291
2021-09-22,anguilla,North America,15252,10,350
2021-09-23,anguilla,North America,15252,0,350
2021-09-24,anguilla,North America,15252,14,364
2021-09-25,anguilla,North America,15252,0,364
2021-09-26,anguilla,North America,15252,0,364
2021-09-27,anguilla,North America,15252,25,389
2021-09-28,anguilla,North America,15252,0,389
2021-09-29,anguilla,North America,15252,20,409
2020-03-08,argentina,South America,45968174,3,12
2020-03-09,argentina,South America,45968174,5,17
2020-03-10,argentina,South America,45968174,2,19
2020-03-11,argentina,South America,45968174,2,21
2020-03-12,argentina,South America,45968174,10,31
2020-03-13,argentina,South America,45968174,3,34
2020-03-02,armenia,Asia,2973558,0,1
2020-03-03,armenia,Asia,2973558,0,1
2020-03-04,armenia,Asia,2973558,0,1
2020-03-05,armenia,Asia,2973558,0,1
2020-03-06,armenia,Asia,2973558,0,1
2020-03-07,armenia,Asia,2973558,0,1
2020-03-08,armenia,Asia,2973558,0,1
2020-03-09,armenia,Asia,2973558,0,1
2020-03-10,armenia,Asia,2973558,0,1
2020-03-11,armenia,Asia,2973558,0,1
2020-03-12,armenia,Asia,2973558,5,6
2020-03-13,armenia,Asia,2973558,2,8
2020-03-14,armenia,Asia,2973558,12,20
2020-03-15,armenia,Asia,2973558,8,28
2020-03-16,armenia,Asia,2973558,24,52
2020-03-17,armenia,Asia,2973558,26,78
2020-03-18,armenia,Asia,2973558,32,110
2020-03-19,armenia,Asia,2973558,12,122
2020-03-20,armenia,Asia,2973558,14,136
2020-03-21,armenia,Asia,2973558,24,160
2020-03-22,armenia,Asia,2973558,34,194
2020-03-23,armenia,Asia,2973558,41,235
2020-03-24,armenia,Asia,2973558,14,249
2020-03-25,armenia,Asia,2973558,16,265
2020-03-26,armenia,Asia,2973558,25,290
2020-03-27,armenia,Asia,2973558,39,329
2020-03-28,armenia,Asia,2973558,78,407
2020-03-29,armenia,Asia,2973558,17,424
2020-03-30,armenia,Asia,2973558,58,482
2020-03-31,armenia,Asia,2973558,50,532
2020-04-01,armenia,Asia,2973558,39,571
2020-04-02,armenia,Asia,2973558,92,663
2020-04-03,armenia,Asia,2973558,73,736
2020-04-04,armenia,Asia,2973558,34,770
2020-04-05,armenia,Asia,2973558,52,822
2020-04-06,armenia,Asia,2973558,11,833
2020-04-07,armenia,Asia,2973558,20,853
2020-04-08,armenia,Asia,2973558,28,881
2020-04-09,armenia,Asia,2973558,40,921
2020-04-10,armenia,Asia,2973558,16,937
2020-04-11,armenia,Asia,2973558,30,967
2020-04-12,armenia,Asia,2973558,46,1013
2020-04-13,armenia,Asia,2973558,26,1039
2020-04-14,armenia,Asia,2973558,28,1067
2020-04-15,armenia,Asia,2973558,44,1111
2020-04-16,armenia,Asia,2973558,48,1159
2020-04-17,armenia,Asia,2973558,42,1201
2020-04-18,armenia,Asia,2973558,47,1248
2020-04-19,armenia,Asia,2973558,43,1291
2020-04-20,armenia,Asia,2973558,48,1339
2020-04-21,armenia,Asia,2973558,62,1401
2020-04-22,armenia,Asia,2973558,72,1473
2020-04-23,armenia,Asia,2973558,50,1523
2020-04-24,armenia,Asia,2973558,73,1596
2020-04-25,armenia,Asia,2973558,81,1677
2020-04-26,armenia,Asia,2973558,69,1746
2020-04-27,armenia,Asia,2973558,62,1808
2020-04-28,armenia,Asia,2973558,59,1867
2020-04-29,armenia,Asia,2973558,65,1932
2020-04-30,armenia,Asia,2973558,134,2066
2020-05-01,armenia,Asia,2973558,82,2148
2020-05-02,armenia,Asia,2973558,125,2273
2020-05-03,armenia,Asia,2973558,113,2386
2020-05-04,armenia,Asia,2973558,121,2507
2020-05-05,armenia,Asia,2973558,112,2619
2020-05-06,armenia,Asia,2973558,163,2782
2020-05-07,armenia,Asia,2973558,102,2884
2020-05-08,armenia,Asia,2973558,145,3029
2020-05-09,armenia,Asia,2973558,146,3175
2020-05-10,armenia,Asia,2973558,138,3313
2020-05-11,armenia,Asia,2973558,79,3392
2020-05-12,armenia,Asia,2973558,146,3538
2020-05-13,armenia,Asia,2973558,180,3718
2020-05-14,armenia,Asia,2973558,142,3860
2020-05-15,armenia,Asia,2973558,184,4044
2020-05-16,armenia,Asia,2973558,239,4283
2020-05-17,armenia,Asia,2973558,189,4472
2020-05-18,armenia,Asia,2973558,351,4823
2020-05-19,armenia,Asia,2973558,218,5041
2020-05-20,armenia,Asia,2973558,230,5271
2020-05-21,armenia,Asia,2973558,335,5606
2020-05-22,armenia,Asia,2973558,322,5928
2020-05-23,armenia,Asia,2973558,374,6302
2020-05-24,armenia,Asia,2973558,359,6661
2020-05-25,armenia,Asia,2973558,452,7113
2020-05-26,armenia,Asia,2973558,289,7402
2020-05-27,armenia,Asia,2973558,372,7774
2020-05-28,armenia,Asia,2973558,442,8216
2020-05-29,armenia,Asia,2973558,460,8676
2020-05-30,armenia,Asia,2973558,251,8927
2020-05-31,armenia,Asia,2973558,355,9282
2020-06-01,armenia,Asia,2973558,210,9492
2020-06-02,armenia,Asia,2973558,517,10009
2020-06-03,armenia,Asia,2973558,515,10524
2020-06-04,armenia,Asia,2973558,697,11221
2020-06-05,armenia,Asia,2973558,596,11817
2020-06-06,armenia,Asia,2973558,547,12364
2020-06-07,armenia,Asia,2973558,766,13130
2020-06-08,armenia,Asia,2973558,195,13325
2020-06-09,armenia,Asia,2973558,350,13675
2020-06-10,armenia,Asia,2973558,428,14103
2020-06-11,armenia,Asia,2973558,566,14669
2020-06-12,armenia,Asia,2973558,612,15281
2020-06-13,armenia,Asia,2973558,723,16004
2020-06-14,armenia,Asia,2973558,663,16667
2020-06-15,armenia,Asia,2973558,397,17064
2020-06-16,armenia,Asia,2973558,425,17489
2020-06-17,armenia,Asia,2973558,544,18033
2020-06-18,armenia,Asia,2973558,665,18698
2020-06-19,armenia,Asia,2973558,459,19157
2020-06-20,armenia,Asia,2973558,551,19708
2020-06-21,armenia,Asia,2973558,560,20268
2020-06-22,armenia,Asia,2973558,320,20588
2020-06-23,armenia,Asia,2973558,418,21006
2020-06-24,armenia,Asia,2973558,711,21717
2020-06-25,armenia,Asia,2973558,771,22488
2020-06-26,armenia,Asia,2973558,759,23247
2020-06-27,armenia,Asia,2973558,662,23909
2020-06-28,armenia,Asia,2973558,736,24645
2020-06-29,armenia,Asia,2973558,482,25127
2020-06-30,armenia,Asia,2973558,415,25542
2020-07-01,armenia,Asia,2973558,523,26065
2020-07-02,armenia,Asia,2973558,593,26658
2020-07-03,armenia,Asia,2973558,662,27320
2020-07-04,armenia,Asia,2973558,580,27900
2020-07-05,armenia,Asia,2973558,706,28606
2020-07-06,armenia,Asia,2973558,330,28936
2020-07-07,armenia,Asia,2973558,349,29285
2020-07-08,armenia,Asia,2973558,535,29820
2020-07-09,armenia,Asia,2973558,526,30346
2020-07-10,armenia,Asia,2973558,557,30903
2020-07-11,armenia,Asia,2973558,489,31392
2020-07-12,armenia,Asia,2973558,577,31969
2020-07-13,armenia,Asia,2973558,182,32151
2020-07-14,armenia,Asia,2973558,339,32490
2020-07-15,armenia,Asia,2973558,515,33005
2020-07-16,armenia,Asia,2973558,554,33559
2020-07-17,armenia,Asia,2973558,442,34001
2020-07-18,armenia,Asia,2973558,461,34462
2020-07-19,armenia,Asia,2973558,415,34877
2020-07-20,armenia,Asia,2973558,104,34981
2020-07-21,armenia,Asia,2973558,273,35254
2020-07-22,armenia,Asia,2973558,439,35693
2020-07-23,armenia,Asia,2973558,469,36162
2020-07-24,armenia,Asia,2973558,451,36613
2020-07-25,armenia,Asia,2973558,383,36996
2020-07-26,armenia,Asia,2973558,321,37317
2020-07-27,armenia,Asia,2973558,73,37390
2020-07-28,armenia,Asia,2973558,239,37629
2020-07-29,armenia,Asia,2973558,308,37937
2020-07-30,armenia,Asia,2973558,259,38196
2020-07-31,armenia,Asia,2973558,354,38550
2020-08-01,armenia,Asia,2973558,291,38841
2020-08-02,armenia,Asia,2973558,209,39050
2020-08-03,armenia,Asia,2973558,52,39102
2020-08-04,armenia,Asia,2973558,196,39298
2020-08-05,armenia,Asia,2973558,288,39586
2020-08-06,armenia,Asia,2973558,233,39819
2020-08-07,armenia,Asia,2973558,166,39985
2020-08-08,armenia,Asia,2973558,200,40185
2020-08-09,armenia,Asia,2973558,225,40410
2020-08-10,armenia,Asia,2973558,23,40433
2020-08-11,armenia,Asia,2973558,160,40593
2020-08-12,armenia,Asia,2973558,201,40794
2020-08-13,armenia,Asia,2973558,229,41023
2020-08-14,armenia,Asia,2973558,276,41299
2020-08-15,armenia,Asia,2973558,196,41495
2020-08-16,armenia,Asia,2973558,168,41663
2020-08-17,armenia,Asia,2973558,38,41701
2020-08-18,armenia,Asia,2973558,145,41846
2020-08-19,armenia,Asia,2973558,210,42056
2020-08-20,armenia,Asia,2973558,263,42319
2020-08-21,armenia,Asia,2973558,158,42477
2020-08-22,armenia,Asia,2973558,139,42616
2020-08-23,armenia,Asia,2973558,176,42792
2020-08-24,armenia,Asia,2973558,33,42825
2020-08-25,armenia,Asia,2973558,111,42936
2020-08-26,armenia,Asia,2973558,131,43067
2020-08-27,armenia,Asia,2973558,203,43270
2020-08-28,armenia,Asia,2973558,181,43451
2020-08-29,armenia,Asia,2973558,175,43626
2020-08-30,armenia,Asia,2973558,124,43750
2020-08-31,armenia,Asia,2973558,31,43781
2020-09-01,armenia,Asia,2973558,97,43878
2020-09-02,armenia,Asia,2973558,197,44075
2020-09-03,armenia,Asia,2973558,196,44271
2020-09-04,armenia,Asia,2973558,190,44461
2020-09-05,armenia,Asia,2973558,188,44649
2020-09-06,armenia,Asia,2973558,134,44783
2020-09-07,armenia,Asia,2973558,62,44845
2020-09-08,armenia,Asia,2973558,108,44953
2020-09-09,armenia,Asia,2973558,199,45152
2020-09-10,armenia,Asia,2973558,174,45326
2020-09-11,armenia,Asia,2973558,177,45503
2020-09-12,armenia,Asia,2973558,172,45675
2020-09-13,armenia,Asia,2973558,187,45862
2020-09-14,armenia,Asia,2973558,107,45969
2020-09-15,armenia,Asia,2973558,150,46119
2020-09-16,armenia,Asia,2973558,257,46376
2020-09-17,armenia,Asia,2973558,295,46671
2020-09-18,armenia,Asia,2973558,239,46910
2020-09-19,armenia,Asia,2973558,244,47154
2020-09-20,armenia,Asia,2973558,277,47431
2020-09-21,armenia,Asia,2973558,121,47552
2020-09-22,armenia,Asia,2973558,115,47667
2020-09-23,armenia,Asia,2973558,210,47877
2020-09-24,armenia,Asia,2973558,374,48251
2020-09-25,armenia,Asia,2973558,392,48643
2020-04-16,aruba,North America,107610,2,95
2020-04-17,aruba,North America,107610,1,96
2020-04-18,aruba,North America,107610,0,96
2020-04-19,aruba,North America,107610,1,97
2020-04-20,aruba,North America,107610,0,97
2020-04-21,aruba,North America,107610,0,97
2020-04-22,aruba,North America,107610,3,100
2020-04-23,aruba,North America,107610,0,100
2020-04-24,aruba,North America,107610,0,100
2020-04-25,aruba,North America,107610,0,100
2020-04-26,aruba,North America,107610,0,100
2020-04-27,aruba,North America,107610,0,100
2020-04-28,aruba,North America,107610,0,100
2020-04-29,aruba,North America,107610,0,100
2020-04-30,aruba,North America,107610,0,100
2020-05-01,aruba,North America,107610,0,100
2020-05-02,aruba,North America,107610,0,100
2020-05-03,aruba,North America,107610,0,100
2020-05-04,aruba,North America,107610,0,100
2020-05-05,aruba,North America,107610,1,101
2020-05-06,aruba,North America,107610,0,101
2020-05-07,aruba,North America,107610,0,101
2020-05-08,aruba,North America,107610,0,101
2020-05-09,aruba,North America,107610,0,101
2020-05-10,aruba,North America,107610,0,101
2020-05-11,aruba,North America,107610,0,101
2020-05-12,aruba,North America,107610,0,101
2020-05-13,aruba,North America,107610,0,101
2020-05-14,aruba,North America,107610,0,101
2020-05-15,aruba,North America,107610,0,101
2020-05-16,aruba,North America,107610,0,101
2020-05-17,aruba,North America,107610,0,101
2020-05-18,aruba,North America,107610,0,101
2020-05-19,aruba,North America,107610,0,101
2020-05-20,aruba,North America,107610,0,101
2020-05-21,aruba,North America,107610,0,101
2020-05-22,aruba,North America,107610,0,101
2020-05-23,aruba,North America,107610,0,101
2020-05-24,aruba,North America,107610,0,101
2020-05-25,aruba,North America,107610,0,101
2020-05-26,aruba,North America,107610,0,101
2020-05-27,aruba,North America,107610,0,101
2020-05-28,aruba,North America,107610,0,101
2020-05-29,aruba,North America,107610,0,101
2020-05-30,aruba,North America,107610,0,101
2020-05-31,aruba,North America,107610,0,101
2020-06-01,aruba,North America,107610,0,101
2020-06-02,aruba,North America,107610,0,101
2020-06-03,aruba,North America,107610,0,101
2020-06-04,aruba,North America,107610,0,101
2020-06-05,aruba,North America,107610,0,101
2020-06-06,aruba,North America,107610,0,101
2020-06-07,aruba,North America,107610,0,101
2020-06-08,aruba,North America,107610,0,101
2020-06-09,aruba,North America,107610,0,101
2020-06-10,aruba,North America,107610,0,101
2020-06-11,aruba,North America,107610,0,101
2020-06-12,aruba,North America,107610,0,101
2020-06-13,aruba,North America,107610,0,101
2020-06-14,aruba,North America,107610,0,101
2020-06-15,aruba,North America,107610,0,101
2020-06-16,aruba,North America,107610,0,101
2020-06-17,aruba,North America,107610,0,101
2020-06-18,aruba,North America,107610,0,101
2020-06-19,aruba,North America,107610,0,101
2020-06-20,aruba,North America,107610,0,101
2020-06-21,aruba,North America,107610,0,101
2020-06-22,aruba,North America,107610,0,101
2020-06-23,aruba,North America,107610,0,101
2020-06-24,aruba,North America,107610,0,101
2020-06-25,aruba,North America,107610,0,101
2020-06-26,aruba,North America,107610,0,101
2020-06-27,aruba,North America,107610,0,101
2020-06-28,aruba,North America,107610,0,101
2020-06-29,aruba,North America,107610,2,103
2020-06-30,aruba,North America,107610,0,103
2020-07-01,aruba,North America,107610,0,103
2020-07-02,aruba,North America,107610,1,104
2020-07-03,aruba,North America,107610,0,104
2020-07-04,aruba,North America,107610,1,105
2020-07-05,aruba,North America,107610,0,105
2020-07-06,aruba,North America,107610,0,105
2020-07-07,aruba,North America,107610,0,105
2020-07-08,aruba,North America,107610,0,105
2020-07-09,aruba,North America,107610,0,105
2020-07-10,aruba,North America,107610,0,105
2020-07-11,aruba,North America,107610,0,105
2020-07-12,aruba,North America,107610,0,105
2020-07-13,aruba,North America,107610,0,105
2020-07-14,aruba,North America,107610,1,106
2020-07-15,aruba,North America,107610,0,106
2020-07-16,aruba,North America,107610,2,108
2020-07-17,aruba,North America,107610,3,111
2020-07-18,aruba,North America,107610,0,111
2020-07-19,aruba,North America,107610,2,113
2020-07-20,aruba,North America,107610,2,115
2020-07-21,aruba,North America,107610,2,117
2020-07-22,aruba,North America,107610,0,117
2020-07-23,aruba,North America,107610,0,117
2020-07-24,aruba,North America,107610,1,118
2020-07-25,aruba,North America,107610,1,119
2020-07-26,aruba,North America,107610,0,119
2020-07-27,aruba,North America,107610,0,119
2020-07-28,aruba,North America,107610,0,119
2020-07-29,aruba,North America,107610,0,119
2020-07-30,aruba,North America,107610,1,120
2020-07-31,aruba,North America,107610,1,121
2020-08-01,aruba,North America,107610,0,121
2020-08-02,aruba,North America,107610,1,122
2020-08-03,aruba,North America,107610,2,124
2020-08-04,aruba,North America,107610,8,132
2020-08-05,aruba,North America,107610,39,171
2020-08-06,aruba,North America,107610,92,263
2020-08-07,aruba,North America,107610,133,396
2020-08-08,aruba,North America,107610,113,509
2020-08-09,aruba,North America,107610,54,563
2020-08-10,aruba,North America,107610,67,630
2020-08-11,aruba,North America,107610,87,717
2020-08-12,aruba,North America,107610,81,798
2020-08-13,aruba,North America,107610,96,894
2020-08-14,aruba,North America,107610,79,973
2020-08-15,aruba,North America,107610,75,1048
2020-08-16,aruba,North America,107610,54,1102
2020-08-17,aruba,North America,107610,19,1121
2020-08-18,aruba,North America,107610,84,1205
2020-08-19,aruba,North America,107610,91,1296
2020-08-20,aruba,North America,107610,91,1387
2020-08-21,aruba,North America,107610,77,1464
2020-08-22,aruba,North America,107610,70,1534
2020-08-23,aruba,North America,107610,34,1568
2020-08-24,aruba,North America,107610,60,1628
2020-08-25,aruba,North America,107610,42,1670
2020-08-26,aruba,North America,107610,90,1760
2020-08-27,aruba,North America,107610,88,1848
2020-08-28,aruba,North America,107610,58,1906
2020-08-29,aruba,North America,107610,69,1975
2020-08-30,aruba,North America,107610,22,1997
2020-08-31,aruba,North America,107610,9,2006
2020-09-01,aruba,North America,107610,98,2104
2020-09-02,aruba,North America,107610,107,2211
2020-09-03,aruba,North America,107610,81,2292
2020-09-04,aruba,North America,107610,66,2358
2020-09-05,aruba,North America,107610,70,2428
2020-09-06,aruba,North America,107610,21,2449
2020-09-07,aruba,North America,107610,33,2482
2020-09-08,aruba,North America,107610,107,2589
2020-09-09,aruba,North America,107610,141,2730
2020-09-10,aruba,North America,107610,89,2819
2020-09-11,aruba,North America,107610,79,2898
2020-09-12,aruba,North America,107610,96,2994
2020-09-13,aruba,North America,107610,52,3046
2020-09-14,aruba,North America,107610,14,3060
2020-09-15,aruba,North America,107610,92,3152
2020-09-16,aruba,North America,107610,176,3328
2020-09-17,aruba,North America,107610,54,3382
2020-09-18,aruba,North America,107610,78,3460
2020-09-19,aruba,North America,107610,0,3460
2020-09-20,aruba,North America,107610,91,3551
2020-09-21,aruba,North America,107610,36,3587
2020-09-22,aruba,North America,107610,78,3665
2020-09-23,aruba,North America,107610,56,3721
2020-09-24,aruba,North America,107610,35,3756
2020-09-25,aruba,North America,107610,43,3799
2020-09-26,aruba,North America,107610,33,3832
2020-09-27,aruba,North America,107610,12,3844
2020-09-28,aruba,North America,107610,28,3872
2020-09-29,aruba,North America,107610,62,3934
2020-09-30,aruba,North America,107610,29,3963
2020-10-01,aruba,North America,107610,35,3998
2020-10-02,aruba,North America,107610,40,4038
2020-10-03,aruba,North America,107610,36,4074
2020-10-04,aruba,North America,107610,5,4079
2020-10-05,aruba,North America,107610,15,4094
2020-10-06,aruba,North America,107610,14,4108
2020-10-07,aruba,North America,107610,25,4133
2020-10-08,aruba,North America,107610,17,4150
2020-10-09,aruba,North America,107610,17,4167
2020-10-10,aruba,North America,107610,21,4188
2020-10-11,aruba,North America,107610,6,4194
2020-10-12,aruba,North America,107610,3,4197
2020-10-13,aruba,North America,107610,32,4229
2020-10-14,aruba,North America,107610,26,4255
2020-10-15,aruba,North America,107610,30,4285
2020-10-16,aruba,North America,107610,4,4289
2020-10-17,aruba,North America,107610,15,4304
2020-10-18,aruba,North America,107610,18,4322
2020-10-19,aruba,North America,107610,12,4334
2020-10-20,aruba,North America,107610,21,4355
2020-10-21,aruba,North America,107610,14,4369
2020-10-22,aruba,North America,107610,20,4389
2020-10-23,aruba,North America,107610,12,4401
2020-10-24,aruba,North America,107610,9,4410
2020-10-25,aruba,North America,107610,10,4420
2020-10-26,aruba,North America,107610,2,4422
2020-10-27,aruba,North America,107610,15,4437
2020-10-28,aruba,North America,107610,18,4455
2020-10-29,aruba,North America,107610,17,4472
2020-10-30,aruba,North America,107610,22,4494
2020-10-31,aruba,North America,107610,19,4513
2020-11-01,aruba,North America,107610,6,4519
2020-11-02,aruba,North America,107610,5,4524
2020-11-03,aruba,North America,107610,14,4538
2020-11-04,aruba,North America,107610,15,4553
2020-11-05,aruba,North America,107610,11,4564
2020-11-06,aruba,North America,107610,14,4578
2020-11-07,aruba,North America,107610,11,4589
2020-11-08,aruba,North America,107610,11,4600
2020-11-09,aruba,North America,107610,6,4606
2020-11-10,aruba,North America,107610,16,4622
2020-11-11,aruba,North America,107610,9,4631
2020-11-12,aruba,North America,107610,8,4639
2020-11-13,aruba,North America,107610,11,4650
2020-11-14,aruba,North America,107610,8,4658
2020-11-15,aruba,North America,107610,4,4662
2020-11-16,aruba,North America,107610,6,4668
2020-11-17,aruba,North America,107610,8,4676
2020-11-18,aruba,North America,107610,9,4685
2020-11-19,aruba,North America,107610,8,4693
2020-11-20,aruba,North America,107610,5,4698
2020-11-21,aruba,North America,107610,26,4724
2020-11-22,aruba,North America,107610,7,4731
2020-11-23,aruba,North America,107610,6,4737
2020-11-24,aruba,North America,107610,14,4751
2020-11-25,aruba,North America,107610,27,4778
2020-11-26,aruba,North America,107610,13,4791
2020-11-27,aruba,North America,107610,17,4808
2020-11-28,aruba,North America,107610,25,4833
2020-11-29,aruba,North America,107610,5,4838
2020-11-30,aruba,North America,107610,7,4845
2020-12-01,aruba,North America,107610,27,4872
2020-12-02,aruba,North America,107610,30,4902
2020-12-03,aruba,North America,107610,21,4923
2020-12-04,aruba,North America,107610,19,4942
2020-12-05,aruba,North America,107610,15,4957
2020-12-06,aruba,North America,107610,8,4965
2020-12-07,aruba,North America,107610,1,4966
2020-12-08,aruba,North America,107610,18,4984
2020-12-09,aruba,North America,107610,12,4996
2020-12-10,aruba,North America,107610,15,5011
2020-12-11,aruba,North America,107610,20,5031
2020-12-12,aruba,North America,107610,13,5044
2020-12-13,aruba,North America,107610,5,5049
2020-12-14,aruba,North America,107610,7,5056
2020-12-15,aruba,North America,107610,23,5079
2020-12-16,aruba,North America,107610,27,5106
2020-12-17,aruba,North America,107610,18,5124
2020-12-18,aruba,North America,107610,14,5138
2020-12-19,aruba,North America,107610,17,5155
2020-12-20,aruba,North America,107610,8,5163
2020-12-21,aruba,North America,107610,13,5176
2020-12-22,aruba,North America,107610,23,5199
2020-12-23,aruba,North America,107610,29,5228
2020-12-24,aruba,North America,107610,29,5257
2020-12-25,aruba,North America,107610,11,5268
2020-12-26,aruba,North America,107610,19,5287
2020-12-27,aruba,North America,107610,18,5305
2020-12-28,aruba,North America,107610,18,5323
2020-12-29,aruba,North America,107610,50,5373
2020-12-30,aruba,North America,107610,69,5442
2020-12-31,aruba,North America,107610,47,5489
2021-01-01,aruba,North America,107610,20,5509
2021-01-02,aruba,North America,107610,23,5532
2021-01-03,aruba,North America,107610,32,5564
2021-01-04,aruba,North America,107610,42,5606
2021-01-05,aruba,North America,107610,110,5716
2021-01-06,aruba,North America,107610,95,5811
2021-01-07,aruba,North America,107610,72,5883
2021-01-08,aruba,North America,107610,94,5977
2021-01-09,aruba,North America,107610,36,6013
2021-01-10,aruba,North America,107610,29,6042
2021-01-11,aruba,North America,107610,26,6068
2021-01-12,aruba,North America,107610,86,6154
2021-01-13,aruba,North America,107610,74,6228
2021-01-14,aruba,North America,107610,68,6296
2021-01-15,aruba,North America,107610,54,6350
2021-01-16,aruba,North America,107610,55,6405
2021-01-17,aruba,North America,107610,30,6435
2021-01-18,aruba,North America,107610,16,6451
2021-01-19,aruba,North America,107610,72,6523
2021-01-20,aruba,North America,107610,39,6562
2021-01-21,aruba,North America,107610,61,6623
2021-01-22,aruba,North America,107610,33,6656
2021-01-23,aruba,North America,107610,52,6708
2021-01-24,aruba,North America,107610,15,6723
2021-01-25,aruba,North America,107610,19,6742
2021-01-26,aruba,North America,107610,26,6768
2021-01-27,aruba,North America,107610,41,6809
2021-01-28,aruba,North America,107610,49,6858
2021-01-29,aruba,North America,107610,38,6896
2021-01-30,aruba,North America,107610,48,6944
2021-01-31,aruba,North America,107610,22,6966
2021-02-01,aruba,North America,107610,20,6986
2021-02-02,aruba,North America,107610,42,7028
2021-02-03,aruba,North America,107610,55,7083
2021-02-04,aruba,North America,107610,51,7134
2021-02-05,aruba,North America,107610,34,7168
2021-02-06,aruba,North America,107610,34,7202
2021-02-07,aruba,North America,107610,21,7223
2021-02-08,aruba,North America,107610,15,7238
2021-02-09,aruba,North America,107610,48,7286
2021-02-10,aruba,North America,107610,33,7319
2021-02-11,aruba,North America,107610,19,7338
2021-02-12,aruba,North America,107610,30,7368
2021-02-13,aruba,North America,107610,32,7400
2021-02-14,aruba,North America,107610,13,7413
2021-02-15,aruba,North America,107610,25,7438
2021-02-16,aruba,North America,107610,23,7461
2021-02-17,aruba,North America,107610,52,7513
2021-02-18,aruba,North America,107610,40,7553
2021-02-19,aruba,North America,107610,46,7599
2021-02-20,aruba,North America,107610,48,7647
2021-02-21,aruba,North America,107610,27,7674
2021-02-22,aruba,North America,107610,18,7692
2021-02-23,aruba,North America,107610,43,7735
2021-02-24,aruba,North America,107610,40,7775
2021-02-25,aruba,North America,107610,29,7804
2021-02-26,aruba,North America,107610,45,7849
2021-02-27,aruba,North America,107610,27,7876
2021-02-28,aruba,North America,107610,15,7891
2021-03-01,aruba,North America,107610,17,7908
2021-03-02,aruba,North America,107610,30,7938
2021-03-03,aruba,North America,107610,35,7973
2021-03-04,aruba,North America,107610,36,8009
2021-03-05,aruba,North America,107610,45,8054
2021-03-06,aruba,North America,107610,35,8089
2021-03-07,aruba,North America,107610,21,8110
2021-03-08,aruba,North America,107610,0,8110
2021-03-09,aruba,North America,107610,67,8177
2021-03-10,aruba,North America,107610,50,8227
2021-03-11,aruba,North America,107610,45,8272
2021-03-12,aruba,North America,107610,48,8320
2021-03-13,aruba,North America,107610,56,8376
2021-03-14,aruba,North America,107610,19,8395
2021-03-15,aruba,North America,107610,26,8421
2021-03-16,aruba,North America,107610,61,8482
2021-03-17,aruba,North America,107610,69,8551
2021-03-18,aruba,North America,107610,73,8624
2021-03-19,aruba,North America,107610,40,8664
2021-03-20,aruba,North America,107610,67,8731
2021-03-21,aruba,North America,107610,40,8771
2021-03-22,aruba,North America,107610,29,8800
2021-03-23,aruba,North America,107610,102,8902
2021-03-24,aruba,North America,107610,83,8985
2021-03-25,aruba,North America,107610,88,9073
2021-03-26,aruba,North America,107610,69,9142
2021-03-27,aruba,North America,107610,72,9214
2021-03-28,aruba,North America,107610,45,9259
2021-03-29,aruba,North America,107610,35,9294
2021-03-30,aruba,North America,107610,80,9374
2021-03-31,aruba,North America,107610,69,9443
2021-04-01,aruba,North America,107610,60,9503
2021-04-02,aruba,North America,107610,57,9560
2021-04-03,aruba,North America,107610,47,9607
2021-04-04,aruba,North America,107610,31,9638
2021-04-05,aruba,North America,107610,43,9681
2021-04-06,aruba,North America,107610,79,9760
2021-04-07,aruba,North America,107610,74,9834
2021-04-08,aruba,North America,107610,62,9896
2021-04-09,aruba,North America,107610,62,9958
2021-04-10,aruba,North America,107610,58,10016
2021-04-11,aruba,North America,107610,34,10050
2021-04-12,aruba,North America,107610,26,10076
2021-04-13,aruba,North America,107610,46,10122
2021-04-14,aruba,North America,107610,37,10159
2021-04-15,aruba,North America,107610,60,10219
2021-04-16,aruba,North America,107610,45,10264
2021-04-17,aruba,North America,107610,41,10305
2021-04-18,aruba,North America,107610,19,10324
2021-04-19,aruba,North America,107610,21,10345
2021-04-20,aruba,North America,107610,54,10399
2021-04-21,aruba,North America,107610,38,10437
2021-04-22,aruba,North America,107610,32,10469
2021-04-23,aruba,North America,107610,36,10505
2021-04-24,aruba,North America,107610,17,10522
2021-04-25,aruba,North America,107610,16,10538
2021-04-26,aruba,North America,107610,17,10555
2021-04-27,aruba,North America,107610,15,10570
2021-04-28,aruba,North America,107610,15,10585
2021-04-29,aruba,North America,107610,23,10608
2021-04-30,aruba,North America,107610,30,10638
2021-05-01,aruba,North America,107610,12,10650
2021-05-02,aruba,North America,107610,20,10670
2021-05-03,aruba,North America,107610,9,10679
2021-05-04,aruba,North America,107610,25,10704
2021-05-05,aruba,North America,107610,17,10721
2021-05-06,aruba,North America,107610,0,10721
2021-05-07,aruba,North America,107610,15,10736
2021-05-08,aruba,North America,107610,21,10757
2021-05-09,aruba,North America,107610,13,10770
2021-05-10,aruba,North America,107610,11,10781
2021-05-11,aruba,North America,107610,14,10795
2021-05-12,aruba,North America,107610,19,10814
2021-05-13,aruba,North America,107610,12,10826
2021-05-14,aruba,North America,107610,12,10838
2021-05-15,aruba,North America,107610,11,10849
2021-05-16,aruba,North America,107610,5,10854
2021-05-17,aruba,North America,107610,3,10857
2021-05-18,aruba,North America,107610,12,10869
2021-05-19,aruba,North America,107610,10,10879
2021-05-20,aruba,North America,107610,13,10892
2021-05-21,aruba,North America,107610,10,10902
2021-05-22,aruba,North America,107610,13,10915
2021-05-23,aruba,North America,107610,2,10917
2021-05-24,aruba,North America,107610,5,10922
2020-02-20,australia,Australia/Oceania,26050899,2,17
2020-02-21,australia,Australia/Oceania,26050899,2,19
2020-02-22,australia,Australia/Oceania,26050899,2,21
2020-02-23,australia,Australia/Oceania,26050899,1,22
2020-02-24,australia,Australia/Oceania,26050899,0,22
2020-02-25,australia,Australia/Oceania,26050899,0,22
2020-02-26,australia,Australia/Oceania,26050899,1,23
2020-02-27,australia,Australia/Oceania,26050899,0,23
2020-02-28,australia,Australia/Oceania,26050899,2,25
2020-02-29,australia,Australia/Oceania,26050899,0,25
2020-03-01,australia,Australia/Oceania,26050899,4,29
2020-03-02,australia,Australia/Oceania,26050899,4,33
2020-03-03,australia,Australia/Oceania,26050899,6,39
2020-03-04,australia,Australia/Oceania,26050899,14,53
2020-03-05,australia,Australia/Oceania,26050899,7,60
2020-03-06,australia,Australia/Oceania,26050899,3,63
2020-03-07,australia,Australia/Oceania,26050899,11,74
2020-03-08,australia,Australia/Oceania,26050899,9,83
2020-03-09,australia,Australia/Oceania,26050899,10,93
2020-03-10,australia,Australia/Oceania,26050899,23,116
2020-03-11,australia,Australia/Oceania,26050899,12,128
2020-03-12,australia,Australia/Oceania,26050899,28,156
2020-03-13,australia,Australia/Oceania,26050899,43,199
2020-03-14,australia,Australia/Oceania,26050899,49,248
2020-03-15,australia,Australia/Oceania,26050899,52,300
2020-03-16,australia,Australia/Oceania,26050899,101,401
2020-03-17,australia,Australia/Oceania,26050899,54,455
2020-03-18,australia,Australia/Oceania,26050899,141,596
2020-03-19,australia,Australia/Oceania,26050899,160,756
2020-03-20,australia,Australia/Oceania,26050899,172,928
2020-03-21,australia,Australia/Oceania,26050899,144,1072
2020-03-22,australia,Australia/Oceania,26050899,537,1609
2020-03-23,australia,Australia/Oceania,26050899,278,1887
2020-03-24,australia,Australia/Oceania,26050899,430,2317
2020-03-25,australia,Australia/Oceania,26050899,359,2676
2020-03-26,australia,Australia/Oceania,26050899,374,3050
2020-03-27,australia,Australia/Oceania,26050899,328,3378
2020-03-28,australia,Australia/Oceania,26050899,257,3635
2020-03-29,australia,Australia/Oceania,26050899,528,4163
2020-03-30,australia,Australia/Oceania,26050899,297,4460
2020-03-31,australia,Australia/Oceania,26050899,303,4763
2020-04-01,australia,Australia/Oceania,26050899,285,5048
2020-04-02,australia,Australia/Oceania,26050899,266,5314
2020-04-03,australia,Australia/Oceania,26050899,140,5454
2020-04-04,australia,Australia/Oceania,26050899,96,5550
2020-04-05,australia,Australia/Oceania,26050899,200,5750
2020-04-06,australia,Australia/Oceania,26050899,145,5895
2020-04-07,australia,Australia/Oceania,26050899,93,5988
2020-04-08,australia,Australia/Oceania,26050899,64,6052
2020-04-09,australia,Australia/Oceania,26050899,100,6152
2020-04-10,australia,Australia/Oceania,26050899,86,6238
2020-04-11,australia,Australia/Oceania,26050899,65,6303
2020-04-12,australia,Australia/Oceania,26050899,10,6313
2020-04-13,australia,Australia/Oceania,26050899,46,6359
2020-04-14,australia,Australia/Oceania,26050899,41,6400
2020-04-15,australia,Australia/Oceania,26050899,47,6447
2020-04-16,australia,Australia/Oceania,26050899,21,6468
2020-04-17,australia,Australia/Oceania,26050899,65,6533
2020-04-18,australia,Australia/Oceania,26050899,53,6586
2020-04-19,australia,Australia/Oceania,26050899,26,6612
2020-04-20,australia,Australia/Oceania,26050899,13,6625
2020-04-21,australia,Australia/Oceania,26050899,20,6645
2020-04-22,australia,Australia/Oceania,26050899,4,6649
2020-04-23,australia,Australia/Oceania,26050899,18,6667
2020-04-24,australia,Australia/Oceania,26050899,8,6675
2020-04-25,australia,Australia/Oceania,26050899,20,6695
2020-04-26,australia,Australia/Oceania,26050899,21,6716
2020-04-27,australia,Australia/Oceania,26050899,4,6720
2020-04-28,australia,Australia/Oceania,26050899,18,6738
2020-04-29,australia,Australia/Oceania,26050899,8,6746
2020-04-30,australia,Australia/Oceania,26050899,8,6754
2020-05-01,australia,Australia/Oceania,26050899,13,6767
2020-05-02,australia,Australia/Oceania,26050899,14,6781
2020-05-03,australia,Australia/Oceania,26050899,20,6801
2020-05-04,australia,Australia/Oceania,26050899,24,6825
2020-05-05,australia,Australia/Oceania,26050899,24,6849
2020-05-06,australia,Australia/Oceania,26050899,26,6875
2020-05-07,australia,Australia/Oceania,26050899,21,6896
2020-05-08,australia,Australia/Oceania,26050899,18,6914
2020-05-09,australia,Australia/Oceania,26050899,15,6929
2020-05-10,australia,Australia/Oceania,26050899,12,6941
2020-05-11,australia,Australia/Oceania,26050899,7,6948
2020-05-12,australia,Australia/Oceania,26050899,16,6964
2020-05-13,australia,Australia/Oceania,26050899,16,6980
2020-05-14,australia,Australia/Oceania,26050899,9,6989
2020-05-15,australia,Australia/Oceania,26050899,30,7019
2020-05-16,australia,Australia/Oceania,26050899,17,7036
2020-05-17,australia,Australia/Oceania,26050899,9,7045
2020-05-18,australia,Australia/Oceania,26050899,15,7060
2020-05-19,australia,Australia/Oceania,26050899,8,7068
2020-05-20,australia,Australia/Oceania,26050899,11,7079
2020-05-21,australia,Australia/Oceania,26050899,2,7081
2020-05-22,australia,Australia/Oceania,26050899,14,7095
2020-05-23,australia,Australia/Oceania,26050899,16,7111
2020-05-24,australia,Australia/Oceania,26050899,3,7114
2020-05-25,australia,Australia/Oceania,26050899,4,7118
2020-05-26,australia,Australia/Oceania,26050899,15,7133
2020-05-27,australia,Australia/Oceania,26050899,6,7139
2020-05-28,australia,Australia/Oceania,26050899,11,7150
2020-05-29,australia,Australia/Oceania,26050899,23,7173
2020-05-30,australia,Australia/Oceania,26050899,12,7185
2020-05-31,australia,Australia/Oceania,26050899,10,7195
2020-06-01,australia,Australia/Oceania,26050899,9,7204
2020-06-02,australia,Australia/Oceania,26050899,17,7221
2020-06-03,australia,Australia/Oceania,26050899,8,7229
2020-06-04,australia,Australia/Oceania,26050899,11,7240
2020-06-05,australia,Australia/Oceania,26050899,11,7251
2020-06-06,australia,Australia/Oceania,26050899,4,7255
2020-06-07,australia,Australia/Oceania,26050899,5,7260
2020-06-08,australia,Australia/Oceania,26050899,5,7265
2020-06-09,australia,Australia/Oceania,26050899,2,7267
2020-06-10,australia,Australia/Oceania,26050899,9,7276
2020-06-11,australia,Australia/Oceania,26050899,9,7285
2020-06-12,australia,Australia/Oceania,26050899,5,7290
2020-06-13,australia,Australia/Oceania,26050899,12,7302
2020-06-14,australia,Australia/Oceania,26050899,18,7320
2020-06-15,australia,Australia/Oceania,26050899,15,7335
2020-06-16,australia,Australia/Oceania,26050899,12,7347
2020-06-17,australia,Australia/Oceania,26050899,23,7370
2020-06-18,australia,Australia/Oceania,26050899,21,7391
2020-06-19,australia,Australia/Oceania,26050899,18,7409
2020-06-20,australia,Australia/Oceania,26050899,27,7436
2020-06-21,australia,Australia/Oceania,26050899,25,7461
2020-06-22,australia,Australia/Oceania,26050899,13,7474
2020-06-23,australia,Australia/Oceania,26050899,18,7492
2020-06-24,australia,Australia/Oceania,26050899,29,7521
2020-06-25,australia,Australia/Oceania,26050899,37,7558
2020-06-26,australia,Australia/Oceania,26050899,37,7595
2020-06-27,australia,Australia/Oceania,26050899,46,7641
2020-06-28,australia,Australia/Oceania,26050899,45,7686
2020-06-29,australia,Australia/Oceania,26050899,81,7767
2020-06-30,australia,Australia/Oceania,26050899,69,7836
2020-07-01,australia,Australia/Oceania,26050899,84,7920
2020-07-02,australia,Australia/Oceania,26050899,81,8001
2020-07-03,australia,Australia/Oceania,26050899,254,8255
2020-07-04,australia,Australia/Oceania,26050899,107,8362
2020-07-05,australia,Australia/Oceania,26050899,87,8449
2020-07-06,australia,Australia/Oceania,26050899,137,8586
2020-07-07,australia,Australia/Oceania,26050899,169,8755
2020-07-08,australia,Australia/Oceania,26050899,131,8886
2020-07-09,australia,Australia/Oceania,26050899,173,9059
2020-07-10,australia,Australia/Oceania,26050899,300,9359
2020-07-11,australia,Australia/Oceania,26050899,194,9553
2020-07-12,australia,Australia/Oceania,26050899,243,9796
2020-07-13,australia,Australia/Oceania,26050899,184,9980
2020-07-14,australia,Australia/Oceania,26050899,270,10250
2020-07-15,australia,Australia/Oceania,26050899,237,10487
2020-07-16,australia,Australia/Oceania,26050899,323,10810
2020-07-17,australia,Australia/Oceania,26050899,425,11235
2020-07-18,australia,Australia/Oceania,26050899,206,11441
2020-07-19,australia,Australia/Oceania,26050899,361,11802
2020-07-20,australia,Australia/Oceania,26050899,267,12069
2020-07-21,australia,Australia/Oceania,26050899,359,12428
2020-07-22,australia,Australia/Oceania,26050899,468,12896
2020-07-23,australia,Australia/Oceania,26050899,410,13306
2020-07-24,australia,Australia/Oceania,26050899,289,13595
2020-07-25,australia,Australia/Oceania,26050899,355,13950
2020-07-26,australia,Australia/Oceania,26050899,453,14403
2020-07-27,australia,Australia/Oceania,26050899,532,14935
2020-07-28,australia,Australia/Oceania,26050899,369,15304
2020-07-29,australia,Australia/Oceania,26050899,278,15582
2020-07-30,australia,Australia/Oceania,26050899,721,16303
2020-07-31,australia,Australia/Oceania,26050899,602,16905
2020-08-01,australia,Australia/Oceania,26050899,377,17282
2020-08-02,australia,Australia/Oceania,26050899,641,17923
2020-08-03,australia,Australia/Oceania,26050899,395,18318
2020-08-04,australia,Australia/Oceania,26050899,412,18730
2020-08-05,australia,Australia/Oceania,26050899,714,19444
2020-08-06,australia,Australia/Oceania,26050899,418,19862
2020-08-07,australia,Australia/Oceania,26050899,410,20272
2020-08-08,australia,Australia/Oceania,26050899,426,20698
2020-08-09,australia,Australia/Oceania,26050899,386,21084
2020-08-10,australia,Australia/Oceania,26050899,313,21397
2020-08-11,australia,Australia/Oceania,26050899,316,21713
2020-08-12,australia,Australia/Oceania,26050899,414,22127
2020-08-13,australia,Australia/Oceania,26050899,231,22358
2020-08-14,australia,Australia/Oceania,26050899,385,22743
2020-08-15,australia,Australia/Oceania,26050899,292,23035
2020-08-16,australia,Australia/Oceania,26050899,253,23288
2020-08-17,australia,Australia/Oceania,26050899,271,23559
2020-08-18,australia,Australia/Oceania,26050899,214,23773
2020-08-19,australia,Australia/Oceania,26050899,220,23993
2020-08-20,australia,Australia/Oceania,26050899,243,24236
2020-08-21,australia,Australia/Oceania,26050899,171,24407
2020-08-22,australia,Australia/Oceania,26050899,195,24602
2020-08-23,australia,Australia/Oceania,26050899,210,24812
2020-08-24,australia,Australia/Oceania,26050899,104,24916
2020-08-25,australia,Australia/Oceania,26050899,137,25053
2020-08-26,australia,Australia/Oceania,26050899,151,25204
2020-08-27,australia,Australia/Oceania,26050899,118,25322
2020-08-28,australia,Australia/Oceania,26050899,126,25448
2020-08-29,australia,Australia/Oceania,26050899,99,25547
2020-08-30,australia,Australia/Oceania,26050899,123,25670
2020-08-31,australia,Australia/Oceania,26050899,76,25746
2020-09-01,australia,Australia/Oceania,26050899,73,25819
2020-09-02,australia,Australia/Oceania,26050899,104,25923
2020-09-03,australia,Australia/Oceania,26050899,126,26049
2020-09-04,australia,Australia/Oceania,26050899,87,26136
2020-09-05,australia,Australia/Oceania,26050899,71,26207
2020-09-06,australia,Australia/Oceania,26050899,72,26279
2020-09-07,australia,Australia/Oceania,26050899,43,26322
2020-09-08,australia,Australia/Oceania,26050899,52,26374
2020-09-09,australia,Australia/Oceania,26050899,91,26465
2020-09-10,australia,Australia/Oceania,26050899,48,26513
2020-09-11,australia,Australia/Oceania,26050899,52,26565
2020-09-12,australia,Australia/Oceania,26050899,42,26607
2020-09-13,australia,Australia/Oceania,26050899,44,26651
2020-09-14,australia,Australia/Oceania,26050899,41,26692
2020-09-15,australia,Australia/Oceania,26050899,47,26739
2020-09-16,australia,Australia/Oceania,26050899,40,26779
2020-09-17,australia,Australia/Oceania,26050899,34,26813
2020-09-18,australia,Australia/Oceania,26050899,48,26861
2020-09-19,australia,Australia/Oceania,26050899,24,26885
2020-09-20,australia,Australia/Oceania,26050899,13,26898
2020-09-21,australia,Australia/Oceania,26050899,14,26912
2020-09-22,australia,Australia/Oceania,26050899,30,26942
2020-09-23,australia,Australia/Oceania,26050899,32,26974
2020-09-24,australia,Australia/Oceania,26050899,9,26983
2020-09-25,australia,Australia/Oceania,26050899,17,27000
2020-09-26,australia,Australia/Oceania,26050899,16,27016
2020-09-27,australia,Australia/Oceania,26050899,24,27040
2020-09-28,australia,Australia/Oceania,26050899,4,27044
2020-09-29,australia,Australia/Oceania,26050899,19,27063
2020-09-30,australia,Australia/Oceania,26050899,15,27078
2020-10-01,australia,Australia/Oceania,26050899,18,27096
2020-10-02,australia,Australia/Oceania,26050899,17,27113
2020-10-03,australia,Australia/Oceania,26050899,8,27121
2020-10-04,australia,Australia/Oceania,26050899,15,27136
2020-10-05,australia,Australia/Oceania,26050899,13,27149
2020-10-06,australia,Australia/Oceania,26050899,25,27174
2020-10-07,australia,Australia/Oceania,26050899,8,27182
2020-10-08,australia,Australia/Oceania,26050899,24,27206
2020-10-09,australia,Australia/Oceania,26050899,23,27229
2020-10-10,australia,Australia/Oceania,26050899,15,27244
2020-10-11,australia,Australia/Oceania,26050899,21,27265
2020-10-12,australia,Australia/Oceania,26050899,21,27286
2020-10-13,australia,Australia/Oceania,26050899,31,27317
2020-10-14,australia,Australia/Oceania,26050899,24,27341
2020-10-15,australia,Australia/Oceania,26050899,21,27362
2020-10-16,australia,Australia/Oceania,26050899,9,27371
2020-10-17,australia,Australia/Oceania,26050899,12,27383
2020-10-18,australia,Australia/Oceania,26050899,8,27391
2020-10-19,australia,Australia/Oceania,26050899,8,27399
2020-10-20,australia,Australia/Oceania,26050899,30,27429
2020-10-21,australia,Australia/Oceania,26050899,15,27444
2020-10-22,australia,Australia/Oceania,26050899,22,27466
2020-10-23,australia,Australia/Oceania,26050899,18,27484
2020-10-24,australia,Australia/Oceania,26050899,15,27499
2020-10-25,australia,Australia/Oceania,26050899,21,27520
2020-10-26,australia,Australia/Oceania,26050899,7,27527
2020-10-27,australia,Australia/Oceania,26050899,14,27541
2020-10-28,australia,Australia/Oceania,26050899,13,27554
2020-10-29,australia,Australia/Oceania,26050899,15,27569
2020-10-30,australia,Australia/Oceania,26050899,13,27582
2020-10-31,australia,Australia/Oceania,26050899,8,27590
2020-11-01,australia,Australia/Oceania,26050899,5,27595
2020-11-02,australia,Australia/Oceania,26050899,7,27602
2020-11-03,australia,Australia/Oceania,26050899,8,27610
2020-11-04,australia,Australia/Oceania,26050899,12,27622
2020-11-05,australia,Australia/Oceania,26050899,12,27634
2020-11-06,australia,Australia/Oceania,26050899,11,27645
2020-11-07,australia,Australia/Oceania,26050899,7,27652
2020-11-08,australia,Australia/Oceania,26050899,6,27658
2020-11-09,australia,Australia/Oceania,26050899,10,27668
2020-11-10,australia,Australia/Oceania,26050899,10,27678
2020-11-11,australia,Australia/Oceania,26050899,8,27686
2020-11-12,australia,Australia/Oceania,26050899,13,27699
2020-11-13,australia,Australia/Oceania,26050899,4,27703
2020-11-14,australia,Australia/Oceania,26050899,8,27711
2020-11-15,australia,Australia/Oceania,26050899,17,27728
2020-11-16,australia,Australia/Oceania,26050899,22,27750
2020-11-17,australia,Australia/Oceania,26050899,10,27760
2020-11-18,australia,Australia/Oceania,26050899,17,27777
2020-11-19,australia,Australia/Oceania,26050899,7,27784
2020-11-20,australia,Australia/Oceania,26050899,8,27792
2020-11-21,australia,Australia/Oceania,26050899,14,27806
2020-11-22,australia,Australia/Oceania,26050899,15,27821
2020-11-23,australia,Australia/Oceania,26050899,14,27835
2020-11-24,australia,Australia/Oceania,26050899,14,27849
2020-11-25,australia,Australia/Oceania,26050899,7,27856
2020-11-26,australia,Australia/Oceania,26050899,11,27867
2020-11-27,australia,Australia/Oceania,26050899,7,27874
2020-11-28,australia,Australia/Oceania,26050899,11,27885
2020-11-29,australia,Australia/Oceania,26050899,8,27893
2020-11-30,australia,Australia/Oceania,26050899,11,27904
2020-12-01,australia,Australia/Oceania,26050899,8,27912
2020-12-02,australia,Australia/Oceania,26050899,11,27923
2020-12-03,australia,Australia/Oceania,26050899,16,27939
2020-12-04,australia,Australia/Oceania,26050899,10,27949
2020-12-05,australia,Australia/Oceania,26050899,7,27956
2020-12-06,australia,Australia/Oceania,26050899,9,27965
2020-12-07,australia,Australia/Oceania,26050899,7,27972
2020-12-08,australia,Australia/Oceania,26050899,15,27987
2020-12-09,australia,Australia/Oceania,26050899,6,27993
2020-12-10,australia,Australia/Oceania,26050899,7,28000
2020-12-11,australia,Australia/Oceania,26050899,12,28012
2020-12-12,australia,Australia/Oceania,26050899,13,28025
2020-12-13,australia,Australia/Oceania,26050899,6,28031
2020-12-14,australia,Australia/Oceania,26050899,8,28039
2020-12-15,australia,Australia/Oceania,26050899,9,28048
2020-12-16,australia,Australia/Oceania,26050899,11,28059
2020-12-17,australia,Australia/Oceania,26050899,12,28071
2020-12-18,australia,Australia/Oceania,26050899,23,28094
2020-12-19,australia,Australia/Oceania,26050899,34,28128
2020-12-20,australia,Australia/Oceania,26050899,44,28172
2020-12-21,australia,Australia/Oceania,26050899,26,28198
2020-12-22,australia,Australia/Oceania,26050899,21,28219
2020-12-23,australia,Australia/Oceania,26050899,19,28238
2020-12-24,australia,Australia/Oceania,26050899,24,28262
2020-12-25,australia,Australia/Oceania,26050899,14,28276
2020-12-26,australia,Australia/Oceania,26050899,21,28297
2020-12-27,australia,Australia/Oceania,26050899,15,28312
2020-12-28,australia,Australia/Oceania,26050899,25,28337
2020-12-29,australia,Australia/Oceania,26050899,13,28350
2020-12-30,australia,Australia/Oceania,26050899,31,28381
2020-12-31,australia,Australia/Oceania,26050899,24,28405
2021-01-01,australia,Australia/Oceania,26050899,22,28427
2021-01-02,australia,Australia/Oceania,26050899,43,28470
2021-01-03,australia,Australia/Oceania,26050899,13,28483
2021-01-04,australia,Australia/Oceania,26050899,21,28504
2021-01-05,australia,Australia/Oceania,26050899,19,28523
2021-01-06,australia,Australia/Oceania,26050899,13,28536
2021-01-07,australia,Australia/Oceania,26050899,10,28546
2021-01-08,australia,Australia/Oceania,26050899,25,28571
2021-01-09,australia,Australia/Oceania,26050899,12,28583
2021-01-10,australia,Australia/Oceania,26050899,12,28595
2021-01-11,australia,Australia/Oceania,26050899,19,28614
2021-01-12,australia,Australia/Oceania,26050899,19,28633
2021-01-13,australia,Australia/Oceania,26050899,17,28650
2021-01-14,australia,Australia/Oceania,26050899,8,28658
2021-01-15,australia,Australia/Oceania,26050899,7,28665
2021-01-16,australia,Australia/Oceania,26050899,24,28689
2021-01-17,australia,Australia/Oceania,26050899,19,28708
2021-01-18,australia,Australia/Oceania,26050899,13,28721
2021-01-19,australia,Australia/Oceania,26050899,9,28730
2021-01-20,australia,Australia/Oceania,26050899,10,28740
2021-01-21,australia,Australia/Oceania,26050899,10,28750
2021-01-22,australia,Australia/Oceania,26050899,5,28755
2021-01-23,australia,Australia/Oceania,26050899,6,28761
2021-01-24,australia,Australia/Oceania,26050899,5,28766
2021-01-25,australia,Australia/Oceania,26050899,11,28777
2021-01-26,australia,Australia/Oceania,26050899,3,28780
2021-01-27,australia,Australia/Oceania,26050899,5,28785
2021-01-28,australia,Australia/Oceania,26050899,8,28793
2021-01-29,australia,Australia/Oceania,26050899,7,28800
2021-01-30,australia,Australia/Oceania,26050899,6,28806
2021-01-31,australia,Australia/Oceania,26050899,5,28811
2021-02-01,australia,Australia/Oceania,26050899,7,28818
2021-02-02,australia,Australia/Oceania,26050899,6,28824
2021-02-03,australia,Australia/Oceania,26050899,5,28829
2021-02-04,australia,Australia/Oceania,26050899,9,28838
2021-02-05,australia,Australia/Oceania,26050899,4,28842
2021-02-06,australia,Australia/Oceania,26050899,6,28848
2021-02-07,australia,Australia/Oceania,26050899,2,28850
2021-02-08,australia,Australia/Oceania,26050899,7,28857
2021-02-09,australia,Australia/Oceania,26050899,3,28860
2021-02-10,australia,Australia/Oceania,26050899,11,28871
2021-02-11,australia,Australia/Oceania,26050899,6,28877
2021-02-12,australia,Australia/Oceania,26050899,10,28887
2021-02-13,australia,Australia/Oceania,26050899,5,28892
2021-02-14,australia,Australia/Oceania,26050899,6,28898
2021-02-15,australia,Australia/Oceania,26050899,2,28900
2021-02-16,australia,Australia/Oceania,26050899,5,28905
2021-02-17,australia,Australia/Oceania,26050899,6,28911
2021-02-18,australia,Australia/Oceania,26050899,1,28912
2021-02-19,australia,Australia/Oceania,26050899,6,28918
2021-02-20,australia,Australia/Oceania,26050899,2,28920
2021-02-21,australia,Australia/Oceania,26050899,6,28926
2021-02-22,australia,Australia/Oceania,26050899,4,28930
2021-02-23,australia,Australia/Oceania,26050899,7,28937
2021-02-24,australia,Australia/Oceania,26050899,2,28939
2021-02-25,australia,Australia/Oceania,26050899,8,28947
2021-02-26,australia,Australia/Oceania,26050899,11,28958
2021-02-27,australia,Australia/Oceania,26050899,7,28965
2021-02-28,australia,Australia/Oceania,26050899,5,28970
2021-03-01,australia,Australia/Oceania,26050899,5,28975
2021-03-02,australia,Australia/Oceania,26050899,11,28986
2021-03-03,australia,Australia/Oceania,26050899,10,28996
2021-03-04,australia,Australia/Oceania,26050899,11,29007
2021-03-05,australia,Australia/Oceania,26050899,14,29021
2021-03-06,australia,Australia/Oceania,26050899,9,29030
2021-03-07,australia,Australia/Oceania,26050899,7,29037
2021-03-08,australia,Australia/Oceania,26050899,9,29046
2021-03-09,australia,Australia/Oceania,26050899,15,29061
2021-03-10,australia,Australia/Oceania,26050899,13,29074
2021-03-11,australia,Australia/Oceania,26050899,16,29090
2021-03-12,australia,Australia/Oceania,26050899,12,29102
2021-03-13,australia,Australia/Oceania,26050899,10,29112
2021-03-14,australia,Australia/Oceania,26050899,5,29117
2021-03-15,australia,Australia/Oceania,26050899,13,29130
2021-03-16,australia,Australia/Oceania,26050899,7,29137
2021-03-17,australia,Australia/Oceania,26050899,17,29154
2021-03-18,australia,Australia/Oceania,26050899,12,29166
2021-03-19,australia,Australia/Oceania,26050899,15,29181
2021-03-20,australia,Australia/Oceania,26050899,10,29191
2021-03-21,australia,Australia/Oceania,26050899,5,29196
2021-03-22,australia,Australia/Oceania,26050899,9,29205
2021-03-23,australia,Australia/Oceania,26050899,6,29211
2021-03-24,australia,Australia/Oceania,26050899,7,29218
2021-03-25,australia,Australia/Oceania,26050899,10,29228
2021-03-26,australia,Australia/Oceania,26050899,10,29238
2021-03-27,australia,Australia/Oceania,26050899,11,29249
2021-03-28,australia,Australia/Oceania,26050899,6,29255
2021-03-29,australia,Australia/Oceania,26050899,18,29273
2021-03-30,australia,Australia/Oceania,26050899,20,29293
2021-03-31,australia,Australia/Oceania,26050899,11,29304
2021-04-01,australia,Australia/Oceania,26050899,15,29319
2021-04-02,australia,Australia/Oceania,26050899,14,29333
2021-04-03,australia,Australia/Oceania,26050899,8,29341
2021-04-04,australia,Australia/Oceania,26050899,3,29344
2021-04-05,australia,Australia/Oceania,26050899,13,29357
2021-04-06,australia,Australia/Oceania,26050899,7,29364
2021-04-07,australia,Australia/Oceania,26050899,13,29377
2021-04-08,australia,Australia/Oceania,26050899,5,29382
2021-04-09,australia,Australia/Oceania,26050899,6,29388
2021-04-10,australia,Australia/Oceania,26050899,8,29396
2021-04-11,australia,Australia/Oceania,26050899,6,29402
2021-04-12,australia,Australia/Oceania,26050899,17,29419
2021-04-13,australia,Australia/Oceania,26050899,18,29437
2021-04-14,australia,Australia/Oceania,26050899,14,29451
2021-04-15,australia,Australia/Oceania,26050899,18,29469
2021-04-16,australia,Australia/Oceania,26050899,15,29484
2021-04-17,australia,Australia/Oceania,26050899,21,29505
2021-04-18,australia,Australia/Oceania,26050899,14,29519
2021-04-19,australia,Australia/Oceania,26050899,24,29543
2021-04-20,australia,Australia/Oceania,26050899,16,29559
2021-04-21,australia,Australia/Oceania,26050899,19,29578
2021-04-22,australia,Australia/Oceania,26050899,24,29602
2021-04-23,australia,Australia/Oceania,26050899,37,29639
2021-04-24,australia,Australia/Oceania,26050899,19,29658
2021-04-25,australia,Australia/Oceania,26050899,8,29666
2021-04-26,australia,Australia/Oceania,26050899,29,29695
2021-04-27,australia,Australia/Oceania,26050899,30,29725
2021-04-28,australia,Australia/Oceania,26050899,24,29749
2021-04-29,australia,Australia/Oceania,26050899,30,29779
2021-04-30,australia,Australia/Oceania,26050899,22,29801
2021-05-01,australia,Australia/Oceania,26050899,11,29812
2021-05-02,australia,Australia/Oceania,26050899,14,29826
2021-05-03,australia,Australia/Oceania,26050899,15,29841
2021-05-04,australia,Australia/Oceania,26050899,11,29852
2021-05-05,australia,Australia/Oceania,26050899,13,29865
2021-05-06,australia,Australia/Oceania,26050899,21,29886
2021-05-07,australia,Australia/Oceania,26050899,11,29897
2021-05-08,australia,Australia/Oceania,26050899,9,29906
2021-05-09,australia,Australia/Oceania,26050899,10,29916
2021-05-10,australia,Australia/Oceania,26050899,15,29931
2021-05-11,australia,Australia/Oceania,26050899,7,29938
2021-05-12,australia,Australia/Oceania,26050899,9,29947
2021-05-13,australia,Australia/Oceania,26050899,8,29955
2021-05-14,australia,Australia/Oceania,26050899,2,29957
2021-05-15,australia,Australia/Oceania,26050899,10,29967
2021-05-16,australia,Australia/Oceania,26050899,8,29975
2021-05-17,australia,Australia/Oceania,26050899,3,29978
2021-05-18,australia,Australia/Oceania,26050899,10,29988
2021-05-19,australia,Australia/Oceania,26050899,3,29991
2021-05-20,australia,Australia/Oceania,26050899,6,29997
2021-05-21,australia,Australia/Oceania,26050899,3,30000
2021-05-22,australia,Australia/Oceania,26050899,4,30004
2021-05-23,australia,Australia/Oceania,26050899,7,30011
2021-05-24,australia,Australia/Oceania,26050899,8,30019
2021-05-25,australia,Australia/Oceania,26050899,11,30030
2021-05-26,australia,Australia/Oceania,26050899,18,30048
2021-05-27,australia,Australia/Oceania,26050899,15,30063
2021-05-28,australia,Australia/Oceania,26050899,10,30073
2021-05-29,australia,Australia/Oceania,26050899,10,30083
2021-05-30,australia,Australia/Oceania,26050899,15,30098
2021-05-31,australia,Australia/Oceania,26050899,8,30106
2021-06-01,australia,Australia/Oceania,26050899,12,30118
2021-06-02,australia,Australia/Oceania,26050899,12,30130
2021-06-03,australia,Australia/Oceania,26050899,7,30137
2021-06-04,australia,Australia/Oceania,26050899,13,30150
2021-06-05,australia,Australia/Oceania,26050899,8,30158
2021-06-06,australia,Australia/Oceania,26050899,17,30175
2021-06-07,australia,Australia/Oceania,26050899,19,30194
2021-06-08,australia,Australia/Oceania,26050899,10,30204
2021-06-09,australia,Australia/Oceania,26050899,6,30210
2021-06-10,australia,Australia/Oceania,26050899,15,30225
2021-06-11,australia,Australia/Oceania,26050899,4,30229
2021-06-12,australia,Australia/Oceania,26050899,8,30237
2021-06-13,australia,Australia/Oceania,26050899,11,30248
2021-06-14,australia,Australia/Oceania,26050899,14,30262
2021-06-15,australia,Australia/Oceania,26050899,10,30272
2021-06-16,australia,Australia/Oceania,26050899,19,30291
2021-06-17,australia,Australia/Oceania,26050899,11,30302
2021-06-18,australia,Australia/Oceania,26050899,11,30313
2021-06-19,australia,Australia/Oceania,26050899,9,30322
2021-06-20,australia,Australia/Oceania,26050899,9,30331
2021-06-21,australia,Australia/Oceania,26050899,25,30356
2021-06-22,australia,Australia/Oceania,26050899,10,30366
2021-06-23,australia,Australia/Oceania,26050899,12,30378
2021-06-24,australia,Australia/Oceania,26050899,30,30408
2021-06-25,australia,Australia/Oceania,26050899,14,30422
2021-06-26,australia,Australia/Oceania,26050899,34,30456
2021-06-27,australia,Australia/Oceania,26050899,43,30499
2021-06-28,australia,Australia/Oceania,26050899,30,30529
2021-06-29,australia,Australia/Oceania,26050899,33,30562
2021-06-30,australia,Australia/Oceania,26050899,49,30611
2021-07-01,australia,Australia/Oceania,26050899,33,30644
2021-07-02,australia,Australia/Oceania,26050899,41,30685
2021-07-03,australia,Australia/Oceania,26050899,49,30734
2021-07-04,australia,Australia/Oceania,26050899,23,30757
2021-07-05,australia,Australia/Oceania,26050899,46,30803
2021-07-06,australia,Australia/Oceania,26050899,29,30832
2021-07-07,australia,Australia/Oceania,26050899,29,30861
2021-07-08,australia,Australia/Oceania,26050899,44,30905
2021-07-09,australia,Australia/Oceania,26050899,46,30951
2021-07-10,australia,Australia/Oceania,26050899,64,31015
2021-07-11,australia,Australia/Oceania,26050899,88,31103
2021-07-12,australia,Australia/Oceania,26050899,121,31224
2021-07-13,australia,Australia/Oceania,26050899,99,31323
2021-07-14,australia,Australia/Oceania,26050899,108,31431
2021-07-15,australia,Australia/Oceania,26050899,85,31516
2021-07-16,australia,Australia/Oceania,26050899,116,31632
2021-07-17,australia,Australia/Oceania,26050899,138,31770
2021-07-18,australia,Australia/Oceania,26050899,129,31899
2021-07-19,australia,Australia/Oceania,26050899,118,32017
2021-07-20,australia,Australia/Oceania,26050899,112,32129
2021-07-21,australia,Australia/Oceania,26050899,140,32269
2021-07-22,australia,Australia/Oceania,26050899,157,32426
2021-07-23,australia,Australia/Oceania,26050899,156,32582
2021-07-24,australia,Australia/Oceania,26050899,173,32755
2021-07-25,australia,Australia/Oceania,26050899,162,32917
2021-07-26,australia,Australia/Oceania,26050899,165,33082
2021-07-27,australia,Australia/Oceania,26050899,186,33268
2021-07-28,australia,Australia/Oceania,26050899,206,33474
2021-07-29,australia,Australia/Oceania,26050899,258,33732
2021-07-30,australia,Australia/Oceania,26050899,177,33909
2021-07-31,australia,Australia/Oceania,26050899,221,34130
2021-08-01,australia,Australia/Oceania,26050899,254,34384
2021-08-02,australia,Australia/Oceania,26050899,229,34613
2021-08-03,australia,Australia/Oceania,26050899,220,34833
2021-08-04,australia,Australia/Oceania,26050899,253,35086
2021-08-05,australia,Australia/Oceania,26050899,298,35384
2021-08-06,australia,Australia/Oceania,26050899,304,35688
2021-08-07,australia,Australia/Oceania,26050899,357,36045
2021-08-08,australia,Australia/Oceania,26050899,290,36335
2021-08-09,australia,Australia/Oceania,26050899,295,36630
2021-08-10,australia,Australia/Oceania,26050899,383,37013
2021-08-11,australia,Australia/Oceania,26050899,365,37378
2021-08-12,australia,Australia/Oceania,26050899,376,37754
2021-08-13,australia,Australia/Oceania,26050899,414,38168
2021-08-14,australia,Australia/Oceania,26050899,490,38658
2021-08-15,australia,Australia/Oceania,26050899,445,39103
2021-08-16,australia,Australia/Oceania,26050899,512,39615
2021-08-17,australia,Australia/Oceania,26050899,482,40097
2021-08-18,australia,Australia/Oceania,26050899,677,40774
2021-08-19,australia,Australia/Oceania,26050899,747,41521
2021-08-20,australia,Australia/Oceania,26050899,708,42229
2021-08-21,australia,Australia/Oceania,26050899,890,43119
2021-08-22,australia,Australia/Oceania,26050899,909,44028
2021-08-23,australia,Australia/Oceania,26050899,892,44920
2021-08-24,australia,Australia/Oceania,26050899,830,45750
2021-08-25,australia,Australia/Oceania,26050899,978,46728
2021-08-26,australia,Australia/Oceania,26050899,1112,47840
2021-08-27,australia,Australia/Oceania,26050899,976,48816
2021-08-28,australia,Australia/Oceania,26050899,1122,49938
2021-08-29,australia,Australia/Oceania,26050899,1318,51256
2021-08-30,australia,Australia/Oceania,26050899,1356,52612
2021-08-31,australia,Australia/Oceania,26050899,1239,53851
2021-09-01,australia,Australia/Oceania,26050899,1242,55093
2021-09-02,australia,Australia/Oceania,26050899,1472,56565
2021-09-03,australia,Australia/Oceania,26050899,1645,58210
2021-09-04,australia,Australia/Oceania,26050899,1741,59951
2021-09-05,australia,Australia/Oceania,26050899,1658,61609
2021-09-06,australia,Australia/Oceania,26050899,1545,63154
2021-09-07,australia,Australia/Oceania,26050899,1474,64628
2021-09-08,australia,Australia/Oceania,26050899,1690,66318
2021-09-09,australia,Australia/Oceania,26050899,1723,68041
2021-09-10,australia,Australia/Oceania,26050899,1871,69912
2021-09-11,australia,Australia/Oceania,26050899,2043,71955
2021-09-12,australia,Australia/Oceania,26050899,1655,73610
2021-09-13,australia,Australia/Oceania,26050899,1714,75324
2021-09-14,australia,Australia/Oceania,26050899,1571,76895
2021-09-15,australia,Australia/Oceania,26050899,1650,78545
2021-09-16,australia,Australia/Oceania,26050899,1857,80402
2021-09-17,australia,Australia/Oceania,26050899,1798,82200
2021-09-18,australia,Australia/Oceania,26050899,1856,84056
2021-09-19,australia,Australia/Oceania,26050899,1573,85629
2021-09-20,australia,Australia/Oceania,26050899,1472,87101
2021-09-21,australia,Australia/Oceania,26050899,1609,88710
2021-09-22,australia,Australia/Oceania,26050899,1662,90372
2021-09-23,australia,Australia/Oceania,26050899,1807,92179
2021-09-24,australia,Australia/Oceania,26050899,1764,93943
2021-09-25,australia,Australia/Oceania,26050899,1864,95807
2021-09-26,australia,Australia/Oceania,26050899,1733,97540
2021-09-27,australia,Australia/Oceania,26050899,1492,99032
2021-09-28,australia,Australia/Oceania,26050899,1887,100919
2021-09-29,australia,Australia/Oceania,26050899,1804,102723
2021-09-30,australia,Australia/Oceania,26050899,2400,105123
2021-10-01,australia,Australia/Oceania,26050899,2048,107171
2021-10-02,australia,Australia/Oceania,26050899,2144,109315
2021-10-03,australia,Australia/Oceania,26050899,2077,111392
2021-10-04,australia,Australia/Oceania,26050899,2019,113411
2021-10-05,australia,Australia/Oceania,26050899,2389,115800
2021-10-06,australia,Australia/Oceania,26050899,2026,117826
2021-10-07,australia,Australia/Oceania,26050899,2217,120043
2021-10-08,australia,Australia/Oceania,26050899,2509,122552
2021-10-09,australia,Australia/Oceania,26050899,2528,125080
2021-10-10,australia,Australia/Oceania,26050899,2374,127454
2021-10-11,australia,Australia/Oceania,26050899,2113,129567
2021-10-12,australia,Australia/Oceania,26050899,1813,131380
2021-10-13,australia,Australia/Oceania,26050899,2066,133446
2021-10-14,australia,Australia/Oceania,26050899,2688,136134
2021-10-15,australia,Australia/Oceania,26050899,2587,138721
2021-10-16,australia,Australia/Oceania,26050899,2312,141033
2021-10-17,australia,Australia/Oceania,26050899,2102,143135
2021-10-18,australia,Australia/Oceania,26050899,2128,145263
2021-10-19,australia,Australia/Oceania,26050899,2012,147275
2021-10-20,australia,Australia/Oceania,26050899,2123,149398
2021-10-21,australia,Australia/Oceania,26050899,2545,151943
2021-10-22,australia,Australia/Oceania,26050899,2371,154314
2021-10-23,australia,Australia/Oceania,26050899,2058,156372
2021-10-24,australia,Australia/Oceania,26050899,2175,158547
2021-10-25,australia,Australia/Oceania,26050899,1683,160230
2021-10-26,australia,Australia/Oceania,26050899,1786,162016
2021-10-27,australia,Australia/Oceania,26050899,1753,163769
2021-10-28,australia,Australia/Oceania,26050899,2135,165904
2021-10-29,australia,Australia/Oceania,26050899,1886,167790
2021-10-30,australia,Australia/Oceania,26050899,1565,169355
2021-10-31,australia,Australia/Oceania,26050899,1103,170458
2021-11-01,australia,Australia/Oceania,26050899,1572,172030
2021-11-02,australia,Australia/Oceania,26050899,1135,173165
2021-11-03,australia,Australia/Oceania,26050899,1111,174276
2021-11-04,australia,Australia/Oceania,26050899,1537,175813
2021-11-05,australia,Australia/Oceania,26050899,1580,177393
2021-11-06,australia,Australia/Oceania,26050899,1535,178928
2021-11-07,australia,Australia/Oceania,26050899,1379,180307
2021-11-08,australia,Australia/Oceania,26050899,1271,181578
2021-11-09,australia,Australia/Oceania,26050899,1292,182870
2021-11-10,australia,Australia/Oceania,26050899,1202,184072
2021-11-11,australia,Australia/Oceania,26050899,1555,185627
2021-11-12,australia,Australia/Oceania,26050899,1401,187028
2021-11-13,australia,Australia/Oceania,26050899,1466,188494
2021-11-14,australia,Australia/Oceania,26050899,1094,189588
2021-11-15,australia,Australia/Oceania,26050899,1016,190604
2021-11-16,australia,Australia/Oceania,26050899,1010,191614
2021-11-17,australia,Australia/Oceania,26050899,1226,192840
2021-11-18,australia,Australia/Oceania,26050899,1279,194119
2021-11-19,australia,Australia/Oceania,26050899,1499,195618
2021-11-20,australia,Australia/Oceania,26050899,1360,196978
2021-11-21,australia,Australia/Oceania,26050899,1466,198444
2021-11-22,australia,Australia/Oceania,26050899,1207,199651
2021-11-23,australia,Australia/Oceania,26050899,1003,200654
2021-11-24,australia,Australia/Oceania,26050899,1453,202107
2021-11-25,australia,Australia/Oceania,26050899,1543,203650
2020-02-29,azerbaijan,Asia,10309383,2,3
2020-03-01,azerbaijan,Asia,10309383,0,3
2020-03-02,azerbaijan,Asia,10309383,0,3
2020-03-03,azerbaijan,Asia,10309383,0,3
2020-03-04,azerbaijan,Asia,10309383,0,3
2020-03-05,azerbaijan,Asia,10309383,3,6
2020-03-06,azerbaijan,Asia,10309383,3,9
2020-03-07,azerbaijan,Asia,10309383,0,9
2020-03-08,azerbaijan,Asia,10309383,0,9
2020-03-09,azerbaijan,Asia,10309383,0,9
2020-03-10,azerbaijan,Asia,10309383,2,11
2020-03-11,azerbaijan,Asia,10309383,0,11
2020-03-12,azerbaijan,Asia,10309383,4,15
2020-03-13,azerbaijan,Asia,10309383,0,15
2020-03-14,azerbaijan,Asia,10309383,4,19
2020-03-15,azerbaijan,Asia,10309383,4,23
2020-03-16,azerbaijan,Asia,10309383,2,25
2020-03-17,azerbaijan,Asia,10309383,9,34
2020-03-18,azerbaijan,Asia,10309383,0,34
2020-03-19,azerbaijan,Asia,10309383,10,44
2020-03-20,azerbaijan,Asia,10309383,0,44
2020-04-02,bahamas,North America,400242,3,24
2020-04-03,bahamas,North America,400242,0,24
2020-04-04,bahamas,North America,400242,4,28
2020-04-05,bahamas,North America,400242,1,29
2020-04-06,bahamas,North America,400242,4,33
2020-04-07,bahamas,North America,400242,0,33
2020-04-08,bahamas,North America,400242,7,40
2020-04-09,bahamas,North America,400242,1,41
2020-04-10,bahamas,North America,400242,1,42
2020-04-11,bahamas,North America,400242,4,46
2020-04-12,bahamas,North America,400242,0,46
2020-04-13,bahamas,North America,400242,3,49
2020-04-14,bahamas,North America,400242,0,49
2020-04-15,bahamas,North America,400242,4,53
2020-04-16,bahamas,North America,400242,0,53
2020-04-17,bahamas,North America,400242,1,54
2020-04-18,bahamas,North America,400242,4,58
2020-04-19,bahamas,North America,400242,2,60
2020-04-20,bahamas,North America,400242,0,60
2020-04-21,bahamas,North America,400242,5,65
2020-04-22,bahamas,North America,400242,0,65
2020-04-23,bahamas,North America,400242,7,72
2020-04-24,bahamas,North America,400242,1,73
2020-04-25,bahamas,North America,400242,5,78
2020-04-26,bahamas,North America,400242,2,80
2020-04-27,bahamas,North America,400242,0,80
2020-04-28,bahamas,North America,400242,0,80
2020-04-29,bahamas,North America,400242,0,80
2020-04-30,bahamas,North America,400242,1,81
2020-05-01,bahamas,North America,400242,0,81
2020-05-02,bahamas,North America,400242,2,83
2020-05-03,bahamas,North America,400242,0,83
2020-05-04,bahamas,North America,400242,0,83
2020-05-05,bahamas,North America,400242,6,89
2020-05-06,bahamas,North America,400242,3,92
2020-05-07,bahamas,North America,400242,0,92
2020-05-08,bahamas,North America,400242,0,92
2020-05-09,bahamas,North America,400242,0,92
2020-05-10,bahamas,North America,400242,0,92
2020-05-11,bahamas,North America,400242,1,93
2020-05-12,bahamas,North America,400242,0,93
2020-05-13,bahamas,North America,400242,1,94
2020-05-14,bahamas,North America,400242,2,96
2020-05-15,bahamas,North America,400242,0,96
2020-05-16,bahamas,North America,400242,0,96
2020-05-17,bahamas,North America,400242,0,96
2020-05-18,bahamas,North America,400242,0,96
2020-05-19,bahamas,North America,400242,0,96
2020-05-20,bahamas,North America,400242,1,97
2020-05-21,bahamas,North America,400242,0,97
2020-05-22,bahamas,North America,400242,0,97
2020-05-23,bahamas,North America,400242,3,100
2020-05-24,bahamas,North America,400242,0,100
2020-05-25,bahamas,North America,400242,0,100
2020-05-26,bahamas,North America,400242,0,100
2020-05-27,bahamas,North America,400242,0,100
2020-05-28,bahamas,North America,400242,0,100
2020-05-29,bahamas,North America,400242,2,102
2020-05-30,bahamas,North America,400242,0,102
2020-05-31,bahamas,North America,400242,0,102
2020-06-01,bahamas,North America,400242,0,102
2020-06-02,bahamas,North America,400242,0,102
2020-06-03,bahamas,North America,400242,0,102
2020-06-04,bahamas,North America,400242,0,102
2020-06-05,bahamas,North America,400242,0,102
2020-06-06,bahamas,North America,400242,1,103
2020-06-07,bahamas,North America,400242,0,103
2020-06-08,bahamas,North America,400242,0,103
2020-06-09,bahamas,North America,400242,0,103
2020-06-10,bahamas,North America,400242,0,103
2020-06-11,bahamas,North America,400242,0,103
2020-06-12,bahamas,North America,400242,0,103
2020-06-13,bahamas,North America,400242,0,103
2020-06-14,bahamas,North America,400242,0,103
2020-06-15,bahamas,North America,400242,0,103
2020-06-16,bahamas,North America,400242,1,104
2020-06-17,bahamas,North America,400242,0,104
2020-06-18,bahamas,North America,400242,0,104
2020-06-19,bahamas,North America,400242,0,104
2020-06-20,bahamas,North America,400242,0,104
2020-06-21,bahamas,North America,400242,0,104
2020-06-22,bahamas,North America,400242,0,104
2020-06-23,bahamas,North America,400242,0,104
2020-06-24,bahamas,North America,400242,0,104
2020-06-25,bahamas,North America,400242,0,104
2020-06-26,bahamas,North America,400242,0,104
2020-06-27,bahamas,North America,400242,0,104
2020-06-28,bahamas,North America,400242,0,104
2020-06-29,bahamas,North America,400242,0,104
2020-06-30,bahamas,North America,400242,0,104
2020-07-01,bahamas,North America,400242,0,104
2020-07-02,bahamas,North America,400242,0,104
2020-07-03,bahamas,North America,400242,0,104
2020-07-04,bahamas,North America,400242,0,104
2020-07-05,bahamas,North America,400242,0,104
2020-07-06,bahamas,North America,400242,0,104
2020-07-07,bahamas,North America,400242,0,104
2020-07-08,bahamas,North America,400242,0,104
2020-07-09,bahamas,North America,400242,2,106
2020-07-10,bahamas,North America,400242,1,107
2020-07-11,bahamas,North America,400242,4,111
2020-07-12,bahamas,North America,400242,0,111
2020-07-13,bahamas,North America,400242,0,111
2020-07-14,bahamas,North America,400242,2,113
2020-07-15,bahamas,North America,400242,6,119
2020-07-16,bahamas,North America,400242,5,124
2020-07-17,bahamas,North America,400242,5,129
2020-07-18,bahamas,North America,400242,9,138
2020-07-19,bahamas,North America,400242,15,153
2020-07-20,bahamas,North America,400242,21,174
2020-07-21,bahamas,North America,400242,20,194
2020-07-22,bahamas,North America,400242,25,219
2020-07-23,bahamas,North America,400242,55,274
2020-07-24,bahamas,North America,400242,42,316
2020-07-25,bahamas,North America,400242,10,326
2020-07-26,bahamas,North America,400242,16,342
2020-07-27,bahamas,North America,400242,40,382
2020-07-28,bahamas,North America,400242,65,447
2020-07-29,bahamas,North America,400242,37,484
2020-07-30,bahamas,North America,400242,24,508
2020-07-31,bahamas,North America,400242,66,574
2020-08-01,bahamas,North America,400242,25,599
2020-08-02,bahamas,North America,400242,49,648
2020-08-03,bahamas,North America,400242,31,679
2020-08-04,bahamas,North America,400242,36,715
2020-08-05,bahamas,North America,400242,36,751
2020-08-06,bahamas,North America,400242,10,761
2020-08-07,bahamas,North America,400242,69,830
2020-08-08,bahamas,North America,400242,48,878
2020-08-09,bahamas,North America,400242,20,898
2020-08-10,bahamas,North America,400242,47,945
2020-08-11,bahamas,North America,400242,44,989
2020-08-12,bahamas,North America,400242,47,1036
2020-08-13,bahamas,North America,400242,53,1089
2020-08-14,bahamas,North America,400242,30,1119
2020-08-15,bahamas,North America,400242,133,1252
2020-08-16,bahamas,North America,400242,63,1315
2020-08-17,bahamas,North America,400242,14,1329
2020-08-18,bahamas,North America,400242,95,1424
2020-08-19,bahamas,North America,400242,107,1531
2020-08-20,bahamas,North America,400242,79,1610
2020-08-21,bahamas,North America,400242,93,1703
2020-08-22,bahamas,North America,400242,0,1703
2020-08-23,bahamas,North America,400242,81,1784
2020-08-24,bahamas,North America,400242,14,1798
2020-08-25,bahamas,North America,400242,0,1798
2020-08-26,bahamas,North America,400242,15,1813
2020-08-27,bahamas,North America,400242,110,1923
2020-08-28,bahamas,North America,400242,134,2057
2020-08-29,bahamas,North America,400242,78,2135
2020-08-30,bahamas,North America,400242,32,2167
2020-08-31,bahamas,North America,400242,50,2217
2020-09-01,bahamas,North America,400242,59,2276
2020-09-02,bahamas,North America,400242,61,2337
2020-09-03,bahamas,North America,400242,49,2386
2020-09-04,bahamas,North America,400242,0,2386
2020-09-05,bahamas,North America,400242,90,2476
2020-09-06,bahamas,North America,400242,30,2506
2020-09-07,bahamas,North America,400242,40,2546
2020-09-08,bahamas,North America,400242,39,2585
2020-09-09,bahamas,North America,400242,72,2657
2020-09-10,bahamas,North America,400242,64,2721
2020-09-11,bahamas,North America,400242,93,2814
2020-09-12,bahamas,North America,400242,114,2928
2020-09-13,bahamas,North America,400242,0,2928
2020-09-14,bahamas,North America,400242,46,2974
2020-09-15,bahamas,North America,400242,58,3032
2020-09-16,bahamas,North America,400242,55,3087
2020-09-17,bahamas,North America,400242,90,3177
2020-09-18,bahamas,North America,400242,0,3177
2020-09-19,bahamas,North America,400242,37,3214
2020-09-20,bahamas,North America,400242,101,3315
2020-09-21,bahamas,North America,400242,103,3418
2020-09-22,bahamas,North America,400242,49,3467
2020-09-23,bahamas,North America,400242,151,3618
2020-09-24,bahamas,North America,400242,0,3618
2020-09-25,bahamas,North America,400242,81,3699
2020-09-26,bahamas,North America,400242,91,3790
2020-09-27,bahamas,North America,400242,48,3838
2020-09-28,bahamas,North America,400242,0,3838
2020-09-29,bahamas,North America,400242,65,3903
2020-09-30,bahamas,North America,400242,119,4022
2020-10-01,bahamas,North America,400242,101,4123
2020-10-02,bahamas,North America,400242,97,4220
2020-10-03,bahamas,North America,400242,112,4332
2020-10-04,bahamas,North America,400242,77,4409
2020-10-05,bahamas,North America,400242,43,4452
2020-10-06,bahamas,North America,400242,107,4559
2020-10-07,bahamas,North America,400242,73,4632
2020-10-08,bahamas,North America,400242,81,4713
2020-10-09,bahamas,North America,400242,0,4713
2020-10-10,bahamas,North America,400242,242,4955
2020-10-11,bahamas,North America,400242,123,5078
2020-10-12,bahamas,North America,400242,0,5078
2020-10-13,bahamas,North America,400242,85,5163
2020-10-14,bahamas,North America,400242,28,5191
2020-10-15,bahamas,North America,400242,194,5385
2020-10-16,bahamas,North America,400242,132,5517
2020-10-17,bahamas,North America,400242,111,5628
2020-10-18,bahamas,North America,400242,75,5703
2020-10-19,bahamas,North America,400242,70,5773
2020-10-20,bahamas,North America,400242,150,5923
2020-10-21,bahamas,North America,400242,128,6051
2020-10-22,bahamas,North America,400242,84,6135
2020-10-23,bahamas,North America,400242,133,6268
2020-10-24,bahamas,North America,400242,0,6268
2020-10-25,bahamas,North America,400242,142,6410
2020-10-26,bahamas,North America,400242,0,6410
2020-10-27,bahamas,North America,400242,92,6502
2020-10-28,bahamas,North America,400242,47,6549
2020-10-29,bahamas,North America,400242,58,6607
2020-10-30,bahamas,North America,400242,37,6644
2020-10-31,bahamas,North America,400242,70,6714
2020-11-01,bahamas,North America,400242,0,6714
2020-11-02,bahamas,North America,400242,21,6735
2020-02-25,bahrain,Asia,1811659,18,23
2020-02-26,bahrain,Asia,1811659,10,33
2020-02-27,bahrain,Asia,1811659,0,33
2020-02-28,bahrain,Asia,1811659,7,40
2020-02-29,bahrain,Asia,1811659,2,42
2020-03-01,bahrain,Asia,1811659,6,48
2020-03-02,bahrain,Asia,1811659,1,49
2020-03-03,bahrain,Asia,1811659,0,49
2020-03-04,bahrain,Asia,1811659,5,54
2020-03-05,bahrain,Asia,1811659,2,56
2020-03-06,bahrain,Asia,1811659,6,62
2020-03-07,bahrain,Asia,1811659,23,85
2020-03-08,bahrain,Asia,1811659,2,87
2020-03-09,bahrain,Asia,1811659,24,111
2020-03-10,bahrain,Asia,1811659,79,190
2020-03-11,bahrain,Asia,1811659,7,197
2020-03-12,bahrain,Asia,1811659,9,206
2020-03-13,bahrain,Asia,1811659,6,212
2020-03-14,bahrain,Asia,1811659,2,214
2020-03-15,bahrain,Asia,1811659,3,217
2020-03-16,bahrain,Asia,1811659,18,235
2020-03-17,bahrain,Asia,1811659,11,246
2020-03-18,bahrain,Asia,1811659,18,264
2020-03-19,bahrain,Asia,1811659,20,284
2020-03-20,bahrain,Asia,1811659,16,300
2020-03-21,bahrain,Asia,1811659,12,312
2020-03-22,bahrain,Asia,1811659,26,338
2020-03-23,bahrain,Asia,1811659,45,383
2020-03-24,bahrain,Asia,1811659,25,408
2020-03-25,bahrain,Asia,1811659,15,423
2020-03-26,bahrain,Asia,1811659,37,460
2020-03-27,bahrain,Asia,1811659,8,468
2020-03-28,bahrain,Asia,1811659,32,500
2020-03-29,bahrain,Asia,1811659,2,502
2020-03-30,bahrain,Asia,1811659,26,528
2020-03-31,bahrain,Asia,1811659,41,569
2020-04-01,bahrain,Asia,1811659,8,577
2020-04-02,bahrain,Asia,1811659,89,666
2020-04-03,bahrain,Asia,1811659,10,676
2020-04-04,bahrain,Asia,1811659,18,694
2020-04-05,bahrain,Asia,1811659,10,704
2020-04-06,bahrain,Asia,1811659,61,765
2020-04-07,bahrain,Asia,1811659,48,813
2020-04-08,bahrain,Asia,1811659,12,825
2020-04-09,bahrain,Asia,1811659,78,903
2020-04-10,bahrain,Asia,1811659,97,1000
2020-04-11,bahrain,Asia,1811659,53,1053
2020-04-12,bahrain,Asia,1811659,259,1312
2020-04-13,bahrain,Asia,1811659,75,1387
2020-04-14,bahrain,Asia,1811659,168,1555
2020-04-15,bahrain,Asia,1811659,133,1688
2020-04-16,bahrain,Asia,1811659,39,1727
2020-04-17,bahrain,Asia,1811659,29,1756
2020-04-18,bahrain,Asia,1811659,38,1794
2020-04-19,bahrain,Asia,1811659,100,1894
2020-04-20,bahrain,Asia,1811659,20,1914
2020-04-21,bahrain,Asia,1811659,62,1976
2020-04-22,bahrain,Asia,1811659,67,2043
2020-04-23,bahrain,Asia,1811659,284,2327
2020-04-24,bahrain,Asia,1811659,193,2520
2020-04-25,bahrain,Asia,1811659,109,2629
2020-04-26,bahrain,Asia,1811659,27,2656
2020-04-27,bahrain,Asia,1811659,103,2759
2020-04-28,bahrain,Asia,1811659,61,2820
2020-04-29,bahrain,Asia,1811659,167,2987
2020-04-30,bahrain,Asia,1811659,73,3060
2020-05-01,bahrain,Asia,1811659,156,3216
2020-05-02,bahrain,Asia,1811659,101,3317
2020-05-03,bahrain,Asia,1811659,74,3391
2020-05-04,bahrain,Asia,1811659,172,3563
2020-05-05,bahrain,Asia,1811659,171,3734
2020-05-06,bahrain,Asia,1811659,305,4039
2020-05-07,bahrain,Asia,1811659,251,4290
2020-05-08,bahrain,Asia,1811659,173,4463
2020-05-09,bahrain,Asia,1811659,325,4788
2020-05-10,bahrain,Asia,1811659,302,5090
2020-05-11,bahrain,Asia,1811659,189,5279
2020-05-12,bahrain,Asia,1811659,372,5651
2020-05-13,bahrain,Asia,1811659,312,5963
2020-05-14,bahrain,Asia,1811659,426,6389
2020-05-15,bahrain,Asia,1811659,263,6652
2020-05-16,bahrain,Asia,1811659,162,6814
2020-05-17,bahrain,Asia,1811659,193,7007
2020-05-18,bahrain,Asia,1811659,238,7245
2020-05-19,bahrain,Asia,1811659,351,7596
2020-05-20,bahrain,Asia,1811659,378,7974
2020-05-21,bahrain,Asia,1811659,281,8255
2020-05-22,bahrain,Asia,1811659,386,8641
2020-05-23,bahrain,Asia,1811659,330,8971
2020-05-24,bahrain,Asia,1811659,186,9157
2020-05-25,bahrain,Asia,1811659,30,9187
2020-05-26,bahrain,Asia,1811659,391,9578
2020-05-27,bahrain,Asia,1811659,197,9775
2020-05-28,bahrain,Asia,1811659,411,10186
2020-05-29,bahrain,Asia,1811659,441,10627
2020-05-30,bahrain,Asia,1811659,500,11127
2020-05-31,bahrain,Asia,1811659,482,11609
2020-06-01,bahrain,Asia,1811659,447,12056
2020-06-02,bahrain,Asia,1811659,451,12507
2020-06-03,bahrain,Asia,1811659,492,12999
2020-06-04,bahrain,Asia,1811659,521,13520
2020-06-05,bahrain,Asia,1811659,508,14028
2020-06-06,bahrain,Asia,1811659,511,14539
2020-06-07,bahrain,Asia,1811659,593,15132
2020-06-08,bahrain,Asia,1811659,602,15734
2020-06-09,bahrain,Asia,1811659,468,16202
2020-06-10,bahrain,Asia,1811659,467,16669
2020-06-11,bahrain,Asia,1811659,601,17270
2020-06-12,bahrain,Asia,1811659,445,17715
2020-06-13,bahrain,Asia,1811659,514,18229
2020-06-14,bahrain,Asia,1811659,317,18546
2020-06-15,bahrain,Asia,1811659,469,19015
2020-06-16,bahrain,Asia,1811659,539,19554
2020-06-17,bahrain,Asia,1811659,406,19960
2020-06-18,bahrain,Asia,1811659,469,20429
2020-06-19,bahrain,Asia,1811659,486,20915
2020-06-20,bahrain,Asia,1811659,415,21330
2020-06-21,bahrain,Asia,1811659,434,21764
2020-06-22,bahrain,Asia,1811659,643,22407
2020-06-23,bahrain,Asia,1811659,655,23062
2020-06-24,bahrain,Asia,1811659,508,23570
2020-06-25,bahrain,Asia,1811659,511,24081
2020-06-26,bahrain,Asia,1811659,724,24805
2020-06-27,bahrain,Asia,1811659,462,25267
2020-06-28,bahrain,Asia,1811659,438,25705
2020-06-29,bahrain,Asia,1811659,534,26239
2020-06-30,bahrain,Asia,1811659,519,26758
2020-07-01,bahrain,Asia,1811659,656,27414
2020-07-02,bahrain,Asia,1811659,423,27837
2020-07-03,bahrain,Asia,1811659,573,28410
2020-07-04,bahrain,Asia,1811659,447,28857
2020-07-05,bahrain,Asia,1811659,510,29367
2020-07-06,bahrain,Asia,1811659,454,29821
2020-07-07,bahrain,Asia,1811659,500,30321
2020-07-08,bahrain,Asia,1811659,610,30931
2020-07-09,bahrain,Asia,1811659,597,31528
2020-07-10,bahrain,Asia,1811659,511,32039
2020-07-11,bahrain,Asia,1811659,431,32470
2020-07-12,bahrain,Asia,1811659,471,32941
2020-07-13,bahrain,Asia,1811659,535,33476
2020-07-14,bahrain,Asia,1811659,602,34078
2020-07-15,bahrain,Asia,1811659,482,34560
2020-07-16,bahrain,Asia,1811659,524,35084
2020-07-17,bahrain,Asia,1811659,389,35473
2020-07-18,bahrain,Asia,1811659,531,36004
2020-07-19,bahrain,Asia,1811659,418,36422
2020-07-20,bahrain,Asia,1811659,514,36936
2020-07-21,bahrain,Asia,1811659,380,37316
2020-07-22,bahrain,Asia,1811659,321,37637
2020-07-23,bahrain,Asia,1811659,359,37996
2020-07-24,bahrain,Asia,1811659,462,38458
2020-07-25,bahrain,Asia,1811659,289,38747
2020-07-26,bahrain,Asia,1811659,384,39131
2020-07-27,bahrain,Asia,1811659,351,39482
2020-07-28,bahrain,Asia,1811659,439,39921
2020-07-29,bahrain,Asia,1811659,390,40311
2020-07-30,bahrain,Asia,1811659,444,40755
2020-07-31,bahrain,Asia,1811659,227,40982
2020-08-01,bahrain,Asia,1811659,208,41190
2020-08-02,bahrain,Asia,1811659,346,41536
2020-08-03,bahrain,Asia,1811659,299,41835
2020-08-04,bahrain,Asia,1811659,297,42132
2020-08-05,bahrain,Asia,1811659,382,42514
2020-08-06,bahrain,Asia,1811659,375,42889
2020-08-07,bahrain,Asia,1811659,418,43307
2020-08-08,bahrain,Asia,1811659,322,43629
2020-08-09,bahrain,Asia,1811659,382,44011
2020-08-10,bahrain,Asia,1811659,386,44397
2020-08-11,bahrain,Asia,1811659,407,44804
2020-08-12,bahrain,Asia,1811659,460,45264
2020-08-13,bahrain,Asia,1811659,462,45726
2020-08-14,bahrain,Asia,1811659,326,46052
2020-08-15,bahrain,Asia,1811659,378,46430
2020-08-16,bahrain,Asia,1811659,405,46835
2020-08-17,bahrain,Asia,1811659,350,47185
2020-08-18,bahrain,Asia,1811659,396,47581
2020-08-19,bahrain,Asia,1811659,369,47950
2020-08-20,bahrain,Asia,1811659,353,48303
2020-08-21,bahrain,Asia,1811659,358,48661
2020-08-22,bahrain,Asia,1811659,377,49038
2020-08-23,bahrain,Asia,1811659,292,49330
2020-08-24,bahrain,Asia,1811659,389,49719
2020-08-25,bahrain,Asia,1811659,357,50076
2020-08-26,bahrain,Asia,1811659,317,50393
2020-08-27,bahrain,Asia,1811659,363,50756
2020-08-28,bahrain,Asia,1811659,357,51113
2020-08-29,bahrain,Asia,1811659,278,51391
2020-08-30,bahrain,Asia,1811659,183,51574
2020-08-31,bahrain,Asia,1811659,398,51972
2020-09-01,bahrain,Asia,1811659,468,52440
2020-09-02,bahrain,Asia,1811659,367,52807
2020-09-03,bahrain,Asia,1811659,626,53433
2020-09-04,bahrain,Asia,1811659,662,54095
2020-09-05,bahrain,Asia,1811659,676,54771
2020-09-06,bahrain,Asia,1811659,644,55415
2020-09-07,bahrain,Asia,1811659,661,56076
2020-09-08,bahrain,Asia,1811659,702,56778
2020-09-09,bahrain,Asia,1811659,672,57450
2020-09-10,bahrain,Asia,1811659,757,58207
2020-09-11,bahrain,Asia,1811659,632,58839
2020-09-12,bahrain,Asia,1811659,747,59586
2020-09-13,bahrain,Asia,1811659,721,60307
2020-09-14,bahrain,Asia,1811659,658,60965
2020-09-15,bahrain,Asia,1811659,678,61643
2020-09-16,bahrain,Asia,1811659,841,62484
2020-09-17,bahrain,Asia,1811659,705,63189
2020-09-18,bahrain,Asia,1811659,690,63879
2020-09-19,bahrain,Asia,1811659,620,64499
2020-09-20,bahrain,Asia,1811659,540,65039
2020-09-21,bahrain,Asia,1811659,713,65752
2020-09-22,bahrain,Asia,1811659,650,66402
2020-09-23,bahrain,Asia,1811659,612,67014
2020-09-24,bahrain,Asia,1811659,687,67701
2020-09-25,bahrain,Asia,1811659,489,68190
2020-09-26,bahrain,Asia,1811659,585,68775
2020-09-27,bahrain,Asia,1811659,586,69361
2020-09-28,bahrain,Asia,1811659,487,69848
2020-09-29,bahrain,Asia,1811659,574,70422
2020-09-30,bahrain,Asia,1811659,442,70864
2020-10-01,bahrain,Asia,1811659,510,71374
2020-10-02,bahrain,Asia,1811659,429,71803
2020-10-03,bahrain,Asia,1811659,507,72310
2020-10-04,bahrain,Asia,1811659,352,72662
2020-10-05,bahrain,Asia,1811659,454,73116
2020-10-06,bahrain,Asia,1811659,360,73476
2020-10-07,bahrain,Asia,1811659,456,73932
2020-10-08,bahrain,Asia,1811659,490,74422
2020-10-09,bahrain,Asia,1811659,438,74860
2020-10-10,bahrain,Asia,1811659,427,75287
2020-10-11,bahrain,Asia,1811659,327,75614
2020-10-12,bahrain,Asia,1811659,334,75948
2020-10-13,bahrain,Asia,1811659,324,76272
2020-10-14,bahrain,Asia,1811659,349,76621
2020-10-15,bahrain,Asia,1811659,333,76954
2020-10-16,bahrain,Asia,1811659,371,77325
2020-10-17,bahrain,Asia,1811659,246,77571
2020-10-18,bahrain,Asia,1811659,331,77902
2020-10-19,bahrain,Asia,1811659,322,78224
2020-10-20,bahrain,Asia,1811659,309,78533
2020-10-21,bahrain,Asia,1811659,374,78907
2020-10-22,bahrain,Asia,1811659,304,79211
2020-10-23,bahrain,Asia,1811659,363,79574
2020-10-24,bahrain,Asia,1811659,401,79975
2020-10-25,bahrain,Asia,1811659,280,80255
2020-10-26,bahrain,Asia,1811659,278,80533
2020-10-27,bahrain,Asia,1811659,232,80765
2020-10-28,bahrain,Asia,1811659,257,81022
2020-10-29,bahrain,Asia,1811659,240,81262
2020-10-30,bahrain,Asia,1811659,204,81466
2020-10-31,bahrain,Asia,1811659,179,81645
2020-11-01,bahrain,Asia,1811659,278,81923
2020-11-02,bahrain,Asia,1811659,210,82133
2020-11-03,bahrain,Asia,1811659,230,82363
2020-11-04,bahrain,Asia,1811659,261,82624
2020-11-05,bahrain,Asia,1811659,162,82786
2020-11-06,bahrain,Asia,1811659,237,83023
2020-11-07,bahrain,Asia,1811659,241,83264
2020-11-08,bahrain,Asia,1811659,192,83456
2020-11-09,bahrain,Asia,1811659,176,83632
2020-11-10,bahrain,Asia,1811659,179,83811
2020-11-11,bahrain,Asia,1811659,231,84042
2020-11-12,bahrain,Asia,1811659,150,84192
2020-11-13,bahrain,Asia,1811659,157,84349
2020-11-14,bahrain,Asia,1811659,174,84523
2020-11-15,bahrain,Asia,1811659,180,84703
2020-11-16,bahrain,Asia,1811659,179,84882
2020-11-17,bahrain,Asia,1811659,126,85008
2020-11-18,bahrain,Asia,1811659,174,85182
2020-11-19,bahrain,Asia,1811659,135,85317
2020-11-20,bahrain,Asia,1811659,150,85467
2020-11-21,bahrain,Asia,1811659,124,85591
2020-11-22,bahrain,Asia,1811659,114,85705
2020-11-23,bahrain,Asia,1811659,181,85886
2020-11-24,bahrain,Asia,1811659,130,86016
2020-11-25,bahrain,Asia,1811659,169,86185
2020-11-26,bahrain,Asia,1811659,162,86347
2020-11-27,bahrain,Asia,1811659,168,86515
2020-11-28,bahrain,Asia,1811659,130,86645
2020-11-29,bahrain,Asia,1811659,142,86787
2020-11-30,bahrain,Asia,1811659,169,86956
2020-12-01,bahrain,Asia,1811659,181,87137
2020-12-02,bahrain,Asia,1811659,133,87270
2020-12-03,bahrain,Asia,1811659,162,87432
2020-12-04,bahrain,Asia,1811659,168,87600
2020-12-05,bahrain,Asia,1811659,132,87732
2020-12-06,bahrain,Asia,1811659,198,87930
2020-12-07,bahrain,Asia,1811659,181,88111
2020-12-08,bahrain,Asia,1811659,183,88294
2020-12-09,bahrain,Asia,1811659,201,88495
2020-12-10,bahrain,Asia,1811659,137,88632
2020-12-11,bahrain,Asia,1811659,188,88820
2020-12-12,bahrain,Asia,1811659,145,88965
2020-12-13,bahrain,Asia,1811659,178,89143
2020-12-14,bahrain,Asia,1811659,125,89268
2020-12-15,bahrain,Asia,1811659,176,89444
2020-12-16,bahrain,Asia,1811659,156,89600
2020-12-17,bahrain,Asia,1811659,143,89743
2020-12-18,bahrain,Asia,1811659,140,89883
2020-12-19,bahrain,Asia,1811659,179,90062
2020-12-20,bahrain,Asia,1811659,220,90282
2020-12-21,bahrain,Asia,1811659,168,90450
2020-12-22,bahrain,Asia,1811659,184,90634
2020-12-23,bahrain,Asia,1811659,183,90817
2020-12-24,bahrain,Asia,1811659,253,91070
2020-12-25,bahrain,Asia,1811659,234,91304
2020-12-26,bahrain,Asia,1811659,214,91518
2020-12-27,bahrain,Asia,1811659,215,91733
2020-12-28,bahrain,Asia,1811659,202,91935
2020-12-29,bahrain,Asia,1811659,234,92169
2020-12-30,bahrain,Asia,1811659,256,92425
2020-12-31,bahrain,Asia,1811659,250,92675
2021-01-01,bahrain,Asia,1811659,238,92913
2021-01-02,bahrain,Asia,1811659,271,93184
2021-01-03,bahrain,Asia,1811659,294,93478
2021-01-04,bahrain,Asia,1811659,288,93766
2021-01-05,bahrain,Asia,1811659,229,93995
2021-01-06,bahrain,Asia,1811659,289,94284
2021-01-07,bahrain,Asia,1811659,349,94633
2021-01-08,bahrain,Asia,1811659,397,95030
2021-01-09,bahrain,Asia,1811659,287,95317
2021-01-10,bahrain,Asia,1811659,241,95558
2021-01-11,bahrain,Asia,1811659,321,95879
2021-01-12,bahrain,Asia,1811659,316,96195
2021-01-13,bahrain,Asia,1811659,275,96470
2021-01-14,bahrain,Asia,1811659,342,96812
2021-01-15,bahrain,Asia,1811659,208,97020
2021-01-16,bahrain,Asia,1811659,248,97268
2021-01-17,bahrain,Asia,1811659,339,97607
2021-01-18,bahrain,Asia,1811659,333,97940
2021-01-19,bahrain,Asia,1811659,320,98260
2021-01-20,bahrain,Asia,1811659,313,98573
2021-01-21,bahrain,Asia,1811659,305,98878
2021-01-22,bahrain,Asia,1811659,332,99210
2021-01-23,bahrain,Asia,1811659,246,99456
2021-01-24,bahrain,Asia,1811659,361,99817
2021-01-25,bahrain,Asia,1811659,413,100230
2021-01-26,bahrain,Asia,1811659,459,100689
2021-01-27,bahrain,Asia,1811659,427,101116
2021-01-28,bahrain,Asia,1811659,387,101503
2021-01-29,bahrain,Asia,1811659,468,101971
2021-01-30,bahrain,Asia,1811659,655,102626
2021-01-31,bahrain,Asia,1811659,431,103057
2021-02-01,bahrain,Asia,1811659,525,103582
2021-02-02,bahrain,Asia,1811659,657,104239
2021-02-03,bahrain,Asia,1811659,553,104792
2021-02-04,bahrain,Asia,1811659,704,105496
2021-02-05,bahrain,Asia,1811659,702,106198
2021-02-06,bahrain,Asia,1811659,515,106713
2021-02-07,bahrain,Asia,1811659,616,107329
2021-02-08,bahrain,Asia,1811659,719,108048
2021-02-09,bahrain,Asia,1811659,759,108807
2021-02-10,bahrain,Asia,1811659,797,109604
2021-02-11,bahrain,Asia,1811659,812,110416
2021-02-12,bahrain,Asia,1811659,896,111312
2021-02-13,bahrain,Asia,1811659,790,112102
2021-02-14,bahrain,Asia,1811659,640,112742
2021-02-15,bahrain,Asia,1811659,848,113590
2021-02-16,bahrain,Asia,1811659,771,114361
2021-02-17,bahrain,Asia,1811659,696,115057
2021-02-18,bahrain,Asia,1811659,648,115705
2021-02-19,bahrain,Asia,1811659,777,116482
2021-02-20,bahrain,Asia,1811659,752,117234
2021-02-21,bahrain,Asia,1811659,575,117809
2021-02-22,bahrain,Asia,1811659,721,118530
2021-02-23,bahrain,Asia,1811659,675,119205
2021-02-24,bahrain,Asia,1811659,653,119858
2021-02-25,bahrain,Asia,1811659,637,120495
2021-02-26,bahrain,Asia,1811659,632,121127
2021-02-27,bahrain,Asia,1811659,651,121778
2021-02-28,bahrain,Asia,1811659,616,122394
2021-03-01,bahrain,Asia,1811659,645,123039
2021-03-02,bahrain,Asia,1811659,492,123531
2021-03-03,bahrain,Asia,1811659,738,124269
2021-03-04,bahrain,Asia,1811659,588,124857
2021-03-05,bahrain,Asia,1811659,657,125514
2021-03-06,bahrain,Asia,1811659,612,126126
2021-03-07,bahrain,Asia,1811659,476,126602
2021-03-08,bahrain,Asia,1811659,653,127255
2021-03-09,bahrain,Asia,1811659,545,127800
2021-03-10,bahrain,Asia,1811659,628,128428
2021-03-11,bahrain,Asia,1811659,653,129081
2021-03-12,bahrain,Asia,1811659,744,129825
2021-03-13,bahrain,Asia,1811659,579,130404
2021-03-14,bahrain,Asia,1811659,597,131001
2021-03-15,bahrain,Asia,1811659,682,131683
2021-03-16,bahrain,Asia,1811659,686,132369
2021-03-17,bahrain,Asia,1811659,768,133137
2021-03-18,bahrain,Asia,1811659,642,133779
2021-03-19,bahrain,Asia,1811659,731,134510
2021-03-20,bahrain,Asia,1811659,816,135326
2021-03-21,bahrain,Asia,1811659,656,135982
2021-03-22,bahrain,Asia,1811659,759,136741
2021-03-23,bahrain,Asia,1811659,809,137550
2021-03-24,bahrain,Asia,1811659,733,138283
2021-03-25,bahrain,Asia,1811659,841,139124
2021-03-26,bahrain,Asia,1811659,829,139953
2021-03-27,bahrain,Asia,1811659,865,140818
2021-03-28,bahrain,Asia,1811659,1027,141845
2021-03-29,bahrain,Asia,1811659,824,142669
2021-03-30,bahrain,Asia,1811659,905,143574
2021-03-31,bahrain,Asia,1811659,871,144445
2021-04-01,bahrain,Asia,1811659,935,145380
2021-04-02,bahrain,Asia,1811659,1074,146454
2021-04-03,bahrain,Asia,1811659,1316,147770
2021-04-04,bahrain,Asia,1811659,1047,148817
2021-04-05,bahrain,Asia,1811659,974,149791
2021-04-06,bahrain,Asia,1811659,1020,150811
2021-04-07,bahrain,Asia,1811659,1120,151931
2021-04-08,bahrain,Asia,1811659,1143,153074
2021-04-09,bahrain,Asia,1811659,1206,154280
2021-04-10,bahrain,Asia,1811659,1122,155402
2021-04-11,bahrain,Asia,1811659,1060,156462
2021-04-12,bahrain,Asia,1811659,1267,157729
2021-04-13,bahrain,Asia,1811659,1060,158789
2021-04-14,bahrain,Asia,1811659,1175,159964
2021-04-15,bahrain,Asia,1811659,970,160934
2021-04-16,bahrain,Asia,1811659,1155,162089
2021-04-17,bahrain,Asia,1811659,1024,163113
2021-04-18,bahrain,Asia,1811659,997,164110
2021-04-19,bahrain,Asia,1811659,1008,165118
2021-04-20,bahrain,Asia,1811659,1039,166157
2021-04-21,bahrain,Asia,1811659,1008,167165
2021-04-22,bahrain,Asia,1811659,1036,168201
2021-04-23,bahrain,Asia,1811659,1053,169254
2021-04-24,bahrain,Asia,1811659,1081,170335
2021-04-25,bahrain,Asia,1811659,1035,171370
2021-04-26,bahrain,Asia,1811659,1206,172576
2021-04-27,bahrain,Asia,1811659,972,173548
2021-04-28,bahrain,Asia,1811659,1111,174659
2021-04-29,bahrain,Asia,1811659,1093,175752
2021-04-30,bahrain,Asia,1811659,1182,176934
2021-05-01,bahrain,Asia,1811659,1063,177997
2021-05-02,bahrain,Asia,1811659,1300,179297
2021-05-03,bahrain,Asia,1811659,1165,180462
2021-05-04,bahrain,Asia,1811659,1418,181880
2021-05-05,bahrain,Asia,1811659,1450,183330
2021-05-06,bahrain,Asia,1811659,1367,184697
2021-05-07,bahrain,Asia,1811659,1706,186403
2021-05-08,bahrain,Asia,1811659,1502,187905
2021-05-09,bahrain,Asia,1811659,1451,189356
2021-05-10,bahrain,Asia,1811659,1662,191018
2021-05-11,bahrain,Asia,1811659,1732,192750
2020-03-19,bangladesh,Asia,167745162,4,18
2020-03-20,bangladesh,Asia,167745162,2,20
2020-03-21,bangladesh,Asia,167745162,4,24
2020-03-22,bangladesh,Asia,167745162,3,27
2020-03-23,bangladesh,Asia,167745162,6,33
2020-03-24,bangladesh,Asia,167745162,6,39
2020-03-25,bangladesh,Asia,167745162,0,39
2020-03-26,bangladesh,Asia,167745162,5,44
2020-03-27,bangladesh,Asia,167745162,4,48
2020-03-28,bangladesh,Asia,167745162,0,48
2020-03-29,bangladesh,Asia,167745162,0,48
2020-03-30,bangladesh,Asia,167745162,1,49
2020-03-31,bangladesh,Asia,167745162,2,51
2020-04-01,bangladesh,Asia,167745162,3,54
2020-04-02,bangladesh,Asia,167745162,2,56
2020-04-03,bangladesh,Asia,167745162,5,61
2020-04-04,bangladesh,Asia,167745162,9,70
2020-04-05,bangladesh,Asia,167745162,18,88
2020-04-06,bangladesh,Asia,167745162,35,123
2020-04-07,bangladesh,Asia,167745162,41,164
2020-04-08,bangladesh,Asia,167745162,54,218
2020-04-09,bangladesh,Asia,167745162,112,330
2020-04-10,bangladesh,Asia,167745162,94,424
2020-04-11,bangladesh,Asia,167745162,58,482
2020-04-12,bangladesh,Asia,167745162,139,621
2020-04-13,bangladesh,Asia,167745162,182,803
2020-04-14,bangladesh,Asia,167745162,209,1012
2020-04-15,bangladesh,Asia,167745162,219,1231
2020-04-16,bangladesh,Asia,167745162,341,1572
2020-04-17,bangladesh,Asia,167745162,266,1838
2020-04-18,bangladesh,Asia,167745162,306,2144
2020-04-19,bangladesh,Asia,167745162,312,2456
2020-04-20,bangladesh,Asia,167745162,492,2948
2020-04-21,bangladesh,Asia,167745162,434,3382
2020-04-22,bangladesh,Asia,167745162,390,3772
2020-04-23,bangladesh,Asia,167745162,414,4186
2020-04-24,bangladesh,Asia,167745162,503,4689
2020-04-25,bangladesh,Asia,167745162,309,4998
2020-04-26,bangladesh,Asia,167745162,418,5416
2020-04-27,bangladesh,Asia,167745162,497,5913
2020-04-28,bangladesh,Asia,167745162,549,6462
2020-04-29,bangladesh,Asia,167745162,641,7103
2020-04-30,bangladesh,Asia,167745162,564,7667
2020-05-01,bangladesh,Asia,167745162,571,8238
2020-05-02,bangladesh,Asia,167745162,552,8790
2020-05-03,bangladesh,Asia,167745162,665,9455
2020-05-04,bangladesh,Asia,167745162,688,10143
2020-05-05,bangladesh,Asia,167745162,786,10929
2020-05-06,bangladesh,Asia,167745162,790,11719
2020-05-07,bangladesh,Asia,167745162,706,12425
2020-05-08,bangladesh,Asia,167745162,709,13134
2020-05-09,bangladesh,Asia,167745162,636,13770
2020-05-10,bangladesh,Asia,167745162,887,14657
2020-05-11,bangladesh,Asia,167745162,1034,15691
2020-05-12,bangladesh,Asia,167745162,969,16660
2020-05-13,bangladesh,Asia,167745162,1162,17822
2020-05-14,bangladesh,Asia,167745162,1041,18863
2020-05-15,bangladesh,Asia,167745162,1202,20065
2020-05-16,bangladesh,Asia,167745162,930,20995
2020-05-17,bangladesh,Asia,167745162,1273,22268
2020-05-18,bangladesh,Asia,167745162,1602,23870
2020-05-19,bangladesh,Asia,167745162,1251,25121
2020-05-20,bangladesh,Asia,167745162,1617,26738
2020-05-21,bangladesh,Asia,167745162,1773,28511
2020-05-22,bangladesh,Asia,167745162,1694,30205
2020-05-23,bangladesh,Asia,167745162,1873,32078
2020-05-24,bangladesh,Asia,167745162,1532,33610
2020-05-25,bangladesh,Asia,167745162,1975,35585
2020-05-26,bangladesh,Asia,167745162,1166,36751
2020-05-27,bangladesh,Asia,167745162,1541,38292
2020-05-28,bangladesh,Asia,167745162,2029,40321
2020-05-29,bangladesh,Asia,167745162,2523,42844
2020-05-30,bangladesh,Asia,167745162,1764,44608
2020-05-31,bangladesh,Asia,167745162,2545,47153
2020-06-01,bangladesh,Asia,167745162,2381,49534
2020-06-02,bangladesh,Asia,167745162,2911,52445
2020-06-03,bangladesh,Asia,167745162,2695,55140
2020-06-04,bangladesh,Asia,167745162,2423,57563
2020-06-05,bangladesh,Asia,167745162,2828,60391
2020-06-06,bangladesh,Asia,167745162,2635,63026
2020-06-07,bangladesh,Asia,167745162,2743,65769
2020-06-08,bangladesh,Asia,167745162,2735,68504
2020-06-09,bangladesh,Asia,167745162,3171,71675
2020-06-10,bangladesh,Asia,167745162,3190,74865
2020-06-11,bangladesh,Asia,167745162,3187,78052
2020-06-12,bangladesh,Asia,167745162,3471,81523
2020-06-13,bangladesh,Asia,167745162,2856,84379
2020-06-14,bangladesh,Asia,167745162,3141,87520
2020-06-15,bangladesh,Asia,167745162,3099,90619
2020-06-16,bangladesh,Asia,167745162,3862,94481
2020-06-17,bangladesh,Asia,167745162,4008,98489
2020-06-18,bangladesh,Asia,167745162,3803,102292
2020-06-19,bangladesh,Asia,167745162,3243,105535
2020-06-20,bangladesh,Asia,167745162,3240,108775
2020-06-21,bangladesh,Asia,167745162,3531,112306
2020-06-22,bangladesh,Asia,167745162,3480,115786
2020-06-23,bangladesh,Asia,167745162,3412,119198
2020-06-24,bangladesh,Asia,167745162,3462,122660
2020-06-25,bangladesh,Asia,167745162,3946,126606
2020-06-26,bangladesh,Asia,167745162,3868,130474
2020-06-27,bangladesh,Asia,167745162,3504,133978
2020-06-28,bangladesh,Asia,167745162,3809,137787
2020-06-29,bangladesh,Asia,167745162,4014,141801
2020-06-30,bangladesh,Asia,167745162,3682,145483
2020-07-01,bangladesh,Asia,167745162,3775,149258
2020-07-02,bangladesh,Asia,167745162,4019,153277
2020-07-03,bangladesh,Asia,167745162,3114,156391
2020-07-04,bangladesh,Asia,167745162,3288,159679
2020-07-05,bangladesh,Asia,167745162,2738,162417
2020-07-06,bangladesh,Asia,167745162,3201,165618
2020-07-07,bangladesh,Asia,167745162,3027,168645
2020-07-08,bangladesh,Asia,167745162,3489,172134
2020-07-09,bangladesh,Asia,167745162,3360,175494
2020-07-10,bangladesh,Asia,167745162,2949,178443
2020-07-11,bangladesh,Asia,167745162,2686,181129
2020-07-12,bangladesh,Asia,167745162,2666,183795
2020-07-13,bangladesh,Asia,167745162,3099,186894
2020-07-14,bangladesh,Asia,167745162,3163,190057
2020-07-15,bangladesh,Asia,167745162,3533,193590
2020-07-16,bangladesh,Asia,167745162,2733,196323
2020-07-17,bangladesh,Asia,167745162,3034,199357
2020-07-18,bangladesh,Asia,167745162,2709,202066
2020-07-19,bangladesh,Asia,167745162,2459,204525
2020-07-20,bangladesh,Asia,167745162,2928,207453
2020-07-21,bangladesh,Asia,167745162,3057,210510
2020-07-22,bangladesh,Asia,167745162,2744,213254
2020-07-23,bangladesh,Asia,167745162,2856,216110
2020-07-24,bangladesh,Asia,167745162,2548,218658
2020-07-25,bangladesh,Asia,167745162,2520,221178
2020-07-26,bangladesh,Asia,167745162,2275,223453
2020-07-27,bangladesh,Asia,167745162,2772,226225
2020-07-28,bangladesh,Asia,167745162,2960,229185
2020-07-29,bangladesh,Asia,167745162,3009,232194
2020-07-30,bangladesh,Asia,167745162,2695,234889
2020-07-31,bangladesh,Asia,167745162,2772,237661
2020-08-01,bangladesh,Asia,167745162,2199,239860
2020-08-02,bangladesh,Asia,167745162,886,240746
2020-08-03,bangladesh,Asia,167745162,1356,242102
2020-08-04,bangladesh,Asia,167745162,1918,244020
2020-08-05,bangladesh,Asia,167745162,2654,246674
2020-08-06,bangladesh,Asia,167745162,2977,249651
2020-08-07,bangladesh,Asia,167745162,2851,252502
2020-08-08,bangladesh,Asia,167745162,2611,255113
2020-08-09,bangladesh,Asia,167745162,2487,257600
2020-08-10,bangladesh,Asia,167745162,2907,260507
2020-08-11,bangladesh,Asia,167745162,2996,263503
2020-08-12,bangladesh,Asia,167745162,2995,266498
2020-08-13,bangladesh,Asia,167745162,2617,269115
2020-08-14,bangladesh,Asia,167745162,2766,271881
2020-08-15,bangladesh,Asia,167745162,2644,274525
2020-08-16,bangladesh,Asia,167745162,2024,276549
2020-08-17,bangladesh,Asia,167745162,2595,279144
2020-08-18,bangladesh,Asia,167745162,3200,282344
2020-08-19,bangladesh,Asia,167745162,2747,285091
2020-08-20,bangladesh,Asia,167745162,2868,287959
2020-08-21,bangladesh,Asia,167745162,2401,290360
2020-08-22,bangladesh,Asia,167745162,2265,292625
2020-08-23,bangladesh,Asia,167745162,1973,294598
2020-08-24,bangladesh,Asia,167745162,2485,297083
2020-08-25,bangladesh,Asia,167745162,2545,299628
2020-08-26,bangladesh,Asia,167745162,2519,302147
2020-08-27,bangladesh,Asia,167745162,2436,304583
2020-08-28,bangladesh,Asia,167745162,2211,306794
2020-08-29,bangladesh,Asia,167745162,2131,308925
2020-08-30,bangladesh,Asia,167745162,1897,310822
2020-08-31,bangladesh,Asia,167745162,2174,312996
2020-09-01,bangladesh,Asia,167745162,1950,314946
2020-09-02,bangladesh,Asia,167745162,2582,317528
2020-09-03,bangladesh,Asia,167745162,2158,319686
2020-09-04,bangladesh,Asia,167745162,1929,321615
2020-09-05,bangladesh,Asia,167745162,1950,323565
2020-09-06,bangladesh,Asia,167745162,1592,325157
2020-09-07,bangladesh,Asia,167745162,2202,327359
2020-09-08,bangladesh,Asia,167745162,1892,329251
2020-09-09,bangladesh,Asia,167745162,1827,331078
2020-09-10,bangladesh,Asia,167745162,1892,332970
2020-09-11,bangladesh,Asia,167745162,1792,334762
2020-09-12,bangladesh,Asia,167745162,1282,336044
2020-09-13,bangladesh,Asia,167745162,1476,337520
2020-09-14,bangladesh,Asia,167745162,1812,339332
2020-09-15,bangladesh,Asia,167745162,1724,341056
2020-09-16,bangladesh,Asia,167745162,1615,342671
2020-09-17,bangladesh,Asia,167745162,1593,344264
2020-09-18,bangladesh,Asia,167745162,1541,345805
2020-09-19,bangladesh,Asia,167745162,1569,347374
2020-09-20,bangladesh,Asia,167745162,1542,348916
2020-09-21,bangladesh,Asia,167745162,1705,350621
2020-09-22,bangladesh,Asia,167745162,1557,352178
2020-09-23,bangladesh,Asia,167745162,1666,353844
2020-09-24,bangladesh,Asia,167745162,1540,355384
2020-09-25,bangladesh,Asia,167745162,1383,356767
2020-09-26,bangladesh,Asia,167745162,1106,357873
2020-09-27,bangladesh,Asia,167745162,1275,359148
2020-09-28,bangladesh,Asia,167745162,1407,360555
2020-09-29,bangladesh,Asia,167745162,1488,362043
2020-09-30,bangladesh,Asia,167745162,1436,363479
2020-10-01,bangladesh,Asia,167745162,1508,364987
2020-10-02,bangladesh,Asia,167745162,1396,366383
2020-10-03,bangladesh,Asia,167745162,1182,367565
2020-10-04,bangladesh,Asia,167745162,1125,368690
2020-10-05,bangladesh,Asia,167745162,1442,370132
2020-10-06,bangladesh,Asia,167745162,1499,371631
2020-10-07,bangladesh,Asia,167745162,1520,373151
2020-10-08,bangladesh,Asia,167745162,1441,374592
2020-10-09,bangladesh,Asia,167745162,1278,375870
2020-10-10,bangladesh,Asia,167745162,1203,377073
2020-10-11,bangladesh,Asia,167745162,1193,378266
2020-10-12,bangladesh,Asia,167745162,1472,379738
2020-10-13,bangladesh,Asia,167745162,1537,381275
2020-10-14,bangladesh,Asia,167745162,1684,382959
2020-10-15,bangladesh,Asia,167745162,1600,384559
2020-10-16,bangladesh,Asia,167745162,1527,386086
2020-10-17,bangladesh,Asia,167745162,1209,387295
2020-10-18,bangladesh,Asia,167745162,1274,388569
2020-10-19,bangladesh,Asia,167745162,1637,390206
2020-10-20,bangladesh,Asia,167745162,1380,391586
2020-10-21,bangladesh,Asia,167745162,1545,393131
2020-10-22,bangladesh,Asia,167745162,1696,394827
2020-10-23,bangladesh,Asia,167745162,1586,396413
2020-10-24,bangladesh,Asia,167745162,1094,397507
2020-10-25,bangladesh,Asia,167745162,1308,398815
2020-10-26,bangladesh,Asia,167745162,1436,400251
2020-10-27,bangladesh,Asia,167745162,1335,401586
2020-10-28,bangladesh,Asia,167745162,1493,403079
2020-10-29,bangladesh,Asia,167745162,1681,404760
2020-10-30,bangladesh,Asia,167745162,1604,406364
2020-10-31,bangladesh,Asia,167745162,1320,407684
2020-11-01,bangladesh,Asia,167745162,1568,409252
2020-11-02,bangladesh,Asia,167745162,1736,410988
2020-11-03,bangladesh,Asia,167745162,1659,412647
2020-11-04,bangladesh,Asia,167745162,1517,414164
2020-11-05,bangladesh,Asia,167745162,1842,416006
2020-11-06,bangladesh,Asia,167745162,1469,417475
2020-11-07,bangladesh,Asia,167745162,1289,418764
2020-11-08,bangladesh,Asia,167745162,1474,420238
2020-11-09,bangladesh,Asia,167745162,1683,421921
2020-11-10,bangladesh,Asia,167745162,1699,423620
2020-11-11,bangladesh,Asia,167745162,1733,425353
2020-11-12,bangladesh,Asia,167745162,1845,427198
2020-11-13,bangladesh,Asia,167745162,1767,428965
2020-11-14,bangladesh,Asia,167745162,1531,430496
2020-11-15,bangladesh,Asia,167745162,1837,432333
2020-11-16,bangladesh,Asia,167745162,2139,434472
2020-11-17,bangladesh,Asia,167745162,2212,436684
2020-11-18,bangladesh,Asia,167745162,2111,438795
2020-11-19,bangladesh,Asia,167745162,2364,441159
2020-11-20,bangladesh,Asia,167745162,2275,443434
2020-11-21,bangladesh,Asia,167745162,1847,445281
2020-11-22,bangladesh,Asia,167745162,2060,447341
2020-11-23,bangladesh,Asia,167745162,2419,449760
2020-11-24,bangladesh,Asia,167745162,2230,451990
2020-11-25,bangladesh,Asia,167745162,2156,454146
2020-11-26,bangladesh,Asia,167745162,2292,456438
2020-11-27,bangladesh,Asia,167745162,2273,458711
2020-11-28,bangladesh,Asia,167745162,1908,460619
2020-11-29,bangladesh,Asia,167745162,1788,462407
2020-11-30,bangladesh,Asia,167745162,2525,464932
2020-12-01,bangladesh,Asia,167745162,2293,467225
2020-12-02,bangladesh,Asia,167745162,2178,469403
2020-12-03,bangladesh,Asia,167745162,2336,471739
2020-12-04,bangladesh,Asia,167745162,2162,473901
2020-12-05,bangladesh,Asia,167745162,1978,475879
2020-12-06,bangladesh,Asia,167745162,1666,477545
2020-12-07,bangladesh,Asia,167745162,2198,479743
2020-12-08,bangladesh,Asia,167745162,2202,481945
2020-12-09,bangladesh,Asia,167745162,2159,484104
2020-12-10,bangladesh,Asia,167745162,1861,485965
2020-12-11,bangladesh,Asia,167745162,1884,487849
2020-12-12,bangladesh,Asia,167745162,1329,489178
2020-12-13,bangladesh,Asia,167745162,1355,490533
2020-12-14,bangladesh,Asia,167745162,1799,492332
2020-12-15,bangladesh,Asia,167745162,1877,494209
2020-12-16,bangladesh,Asia,167745162,1629,495838
2020-12-17,bangladesh,Asia,167745162,1137,496975
2020-12-18,bangladesh,Asia,167745162,1318,498293
2020-12-19,bangladesh,Asia,167745162,1267,499560
2020-12-20,bangladesh,Asia,167745162,1153,500713
2020-12-21,bangladesh,Asia,167745162,1470,502183
2020-12-22,bangladesh,Asia,167745162,1318,503501
2020-12-23,bangladesh,Asia,167745162,1367,504868
2020-12-24,bangladesh,Asia,167745162,1234,506102
2020-12-25,bangladesh,Asia,167745162,1163,507265
2020-12-26,bangladesh,Asia,167745162,834,508099
2020-12-27,bangladesh,Asia,167745162,1049,509148
2020-12-28,bangladesh,Asia,167745162,932,510080
2020-12-29,bangladesh,Asia,167745162,1181,511261
2020-12-30,bangladesh,Asia,167745162,1235,512496
2020-12-31,bangladesh,Asia,167745162,1014,513510
2021-01-01,bangladesh,Asia,167745162,990,514500
2021-01-02,bangladesh,Asia,167745162,684,515184
2021-01-03,bangladesh,Asia,167745162,835,516019
2021-01-04,bangladesh,Asia,167745162,910,516929
2021-01-05,bangladesh,Asia,167745162,991,517920
2021-01-06,bangladesh,Asia,167745162,978,518898
2021-01-07,bangladesh,Asia,167745162,1007,519905
2021-01-08,bangladesh,Asia,167745162,785,520690
2021-01-09,bangladesh,Asia,167745162,692,521382
2021-01-10,bangladesh,Asia,167745162,1071,522453
2021-01-11,bangladesh,Asia,167745162,849,523302
2021-01-12,bangladesh,Asia,167745162,718,524020
2021-01-13,bangladesh,Asia,167745162,890,524910
2021-01-14,bangladesh,Asia,167745162,813,525723
2021-01-15,bangladesh,Asia,167745162,762,526485
2021-01-16,bangladesh,Asia,167745162,578,527063
2021-01-17,bangladesh,Asia,167745162,569,527632
2021-01-18,bangladesh,Asia,167745162,697,528329
2021-01-19,bangladesh,Asia,167745162,702,529031
2021-01-20,bangladesh,Asia,167745162,656,529687
2021-01-21,bangladesh,Asia,167745162,584,530271
2021-01-22,bangladesh,Asia,167745162,619,530890
2021-01-23,bangladesh,Asia,167745162,436,531326
2021-01-24,bangladesh,Asia,167745162,473,531799
2021-01-25,bangladesh,Asia,167745162,602,532401
2021-01-26,bangladesh,Asia,167745162,515,532916
2021-01-27,bangladesh,Asia,167745162,528,533444
2021-01-28,bangladesh,Asia,167745162,509,533953
2021-01-29,bangladesh,Asia,167745162,454,534407
2021-01-30,bangladesh,Asia,167745162,363,534770
2021-01-31,bangladesh,Asia,167745162,369,535139
2021-02-01,bangladesh,Asia,167745162,443,535582
2021-02-02,bangladesh,Asia,167745162,525,536107
2021-02-03,bangladesh,Asia,167745162,438,536545
2021-02-04,bangladesh,Asia,167745162,485,537030
2021-02-05,bangladesh,Asia,167745162,435,537465
2021-02-06,bangladesh,Asia,167745162,305,537770
2021-02-07,bangladesh,Asia,167745162,292,538062
2021-02-08,bangladesh,Asia,167745162,316,538378
2021-02-09,bangladesh,Asia,167745162,387,538765
2021-02-10,bangladesh,Asia,167745162,348,539113
2021-02-11,bangladesh,Asia,167745162,458,539571
2021-02-12,bangladesh,Asia,167745162,404,539975
2021-02-13,bangladesh,Asia,167745162,291,540266
2021-02-14,bangladesh,Asia,167745162,326,540592
2021-02-15,bangladesh,Asia,167745162,446,541038
2021-02-16,bangladesh,Asia,167745162,396,541434
2021-02-17,bangladesh,Asia,167745162,443,541877
2021-02-18,bangladesh,Asia,167745162,391,542268
2021-02-19,bangladesh,Asia,167745162,406,542674
2021-02-20,bangladesh,Asia,167745162,350,543024
2021-02-21,bangladesh,Asia,167745162,327,543351
2021-02-22,bangladesh,Asia,167745162,366,543717
2021-02-23,bangladesh,Asia,167745162,399,544116
2021-02-24,bangladesh,Asia,167745162,428,544544
2021-02-25,bangladesh,Asia,167745162,410,544954
2021-02-26,bangladesh,Asia,167745162,470,545424
2021-02-27,bangladesh,Asia,167745162,407,545831
2021-02-28,bangladesh,Asia,167745162,385,546216
2021-03-01,bangladesh,Asia,167745162,585,546801
2021-03-02,bangladesh,Asia,167745162,515,547316
2021-03-03,bangladesh,Asia,167745162,614,547930
2021-03-04,bangladesh,Asia,167745162,619,548549
2021-03-05,bangladesh,Asia,167745162,635,549184
2021-03-06,bangladesh,Asia,167745162,540,549724
2021-03-07,bangladesh,Asia,167745162,606,550330
2021-03-08,bangladesh,Asia,167745162,845,551175
2021-03-09,bangladesh,Asia,167745162,912,552087
2021-03-10,bangladesh,Asia,167745162,1018,553105
2021-03-11,bangladesh,Asia,167745162,1051,554156
2021-03-12,bangladesh,Asia,167745162,1066,555222
2021-03-13,bangladesh,Asia,167745162,1014,556236
2021-03-14,bangladesh,Asia,167745162,1159,557395
2021-03-15,bangladesh,Asia,167745162,1773,559168
2021-03-16,bangladesh,Asia,167745162,1719,560887
2021-03-17,bangladesh,Asia,167745162,1865,562752
2021-03-18,bangladesh,Asia,167745162,2187,564939
2021-03-19,bangladesh,Asia,167745162,1899,566838
2021-03-20,bangladesh,Asia,167745162,1868,568706
2021-03-21,bangladesh,Asia,167745162,2172,570878
2021-03-22,bangladesh,Asia,167745162,2809,573687
2021-03-23,bangladesh,Asia,167745162,3554,577241
2021-03-24,bangladesh,Asia,167745162,3567,580808
2021-03-25,bangladesh,Asia,167745162,3587,584395
2021-03-26,bangladesh,Asia,167745162,3737,588132
2021-03-27,bangladesh,Asia,167745162,3674,591806
2021-03-28,bangladesh,Asia,167745162,3908,595714
2021-03-29,bangladesh,Asia,167745162,5181,600895
2021-03-30,bangladesh,Asia,167745162,5042,605937
2021-03-31,bangladesh,Asia,167745162,5358,611295
2021-04-01,bangladesh,Asia,167745162,6469,617764
2021-04-02,bangladesh,Asia,167745162,6830,624594
2021-04-03,bangladesh,Asia,167745162,5683,630277
2021-04-04,bangladesh,Asia,167745162,7087,637364
2021-04-05,bangladesh,Asia,167745162,7075,644439
2021-04-06,bangladesh,Asia,167745162,7213,651652
2021-04-07,bangladesh,Asia,167745162,7626,659278
2021-04-08,bangladesh,Asia,167745162,6854,666132
2021-04-09,bangladesh,Asia,167745162,7462,673594
2021-04-10,bangladesh,Asia,167745162,5343,678937
2021-04-11,bangladesh,Asia,167745162,5819,684756
2021-04-12,bangladesh,Asia,167745162,7201,691957
2021-04-13,bangladesh,Asia,167745162,6028,697985
2021-04-14,bangladesh,Asia,167745162,5185,703170
2021-04-15,bangladesh,Asia,167745162,4192,707362
2021-04-16,bangladesh,Asia,167745162,4417,711779
2021-04-17,bangladesh,Asia,167745162,3473,715252
2021-04-18,bangladesh,Asia,167745162,3698,718950
2021-04-19,bangladesh,Asia,167745162,4271,723221
2021-04-20,bangladesh,Asia,167745162,4559,727780
2021-04-21,bangladesh,Asia,167745162,4280,732060
2021-04-22,bangladesh,Asia,167745162,4014,736074
2021-04-23,bangladesh,Asia,167745162,3629,739703
2021-04-24,bangladesh,Asia,167745162,2697,742400
2021-04-25,bangladesh,Asia,167745162,2922,745322
2021-04-26,bangladesh,Asia,167745162,3306,748628
2021-04-27,bangladesh,Asia,167745162,3031,751659
2021-04-28,bangladesh,Asia,167745162,2955,754614
2021-04-29,bangladesh,Asia,167745162,2341,756955
2021-04-30,bangladesh,Asia,167745162,2177,759132
2021-05-01,bangladesh,Asia,167745162,1452,760584
2021-05-02,bangladesh,Asia,167745162,1359,761943
2021-05-03,bangladesh,Asia,167745162,1739,763682
2021-05-04,bangladesh,Asia,167745162,1914,765596
2021-05-05,bangladesh,Asia,167745162,1742,767338
2021-05-06,bangladesh,Asia,167745162,1822,769160
2021-05-07,bangladesh,Asia,167745162,1682,770842
2021-05-08,bangladesh,Asia,167745162,1285,772127
2021-05-09,bangladesh,Asia,167745162,1386,773513
2021-05-10,bangladesh,Asia,167745162,1514,775027
2021-05-11,bangladesh,Asia,167745162,1230,776257
2021-05-12,bangladesh,Asia,167745162,1140,777397
2021-05-13,bangladesh,Asia,167745162,1290,778687
2021-05-14,bangladesh,Asia,167745162,848,779535
2021-05-15,bangladesh,Asia,167745162,261,779796
2021-05-16,bangladesh,Asia,167745162,363,780159
2021-05-17,bangladesh,Asia,167745162,698,780857
2021-05-18,bangladesh,Asia,167745162,1272,782129
2021-05-19,bangladesh,Asia,167745162,1608,783737
2021-05-20,bangladesh,Asia,167745162,1457,785194
2021-05-21,bangladesh,Asia,167745162,1504,786698
2021-05-22,bangladesh,Asia,167745162,1028,787726
2021-05-23,bangladesh,Asia,167745162,1354,789080
2021-05-24,bangladesh,Asia,167745162,1441,790521
2021-05-25,bangladesh,Asia,167745162,1675,792196
2021-05-26,bangladesh,Asia,167745162,1497,793693
2021-05-27,bangladesh,Asia,167745162,1292,794985
2021-05-28,bangladesh,Asia,167745162,1358,796343
2021-05-29,bangladesh,Asia,167745162,1043,797386
2021-05-30,bangladesh,Asia,167745162,1444,798830
2021-05-31,bangladesh,Asia,167745162,1710,800540
2021-06-01,bangladesh,Asia,167745162,1765,802305
2021-06-02,bangladesh,Asia,167745162,1988,804293
2021-06-03,bangladesh,Asia,167745162,1687,805980
2021-06-04,bangladesh,Asia,167745162,1887,807867
2021-06-05,bangladesh,Asia,167745162,1447,809314
2021-06-06,bangladesh,Asia,167745162,1676,810990
2021-06-07,bangladesh,Asia,167745162,1970,812960
2021-06-08,bangladesh,Asia,167745162,2322,815282
2021-06-09,bangladesh,Asia,167745162,2537,817819
2021-06-10,bangladesh,Asia,167745162,2576,820395
2021-06-11,bangladesh,Asia,167745162,2454,822849
2021-06-12,bangladesh,Asia,167745162,1637,824486
2021-06-13,bangladesh,Asia,167745162,2436,826922
2021-06-14,bangladesh,Asia,167745162,3050,829972
2021-06-15,bangladesh,Asia,167745162,3319,833291
2021-06-16,bangladesh,Asia,167745162,3956,837247
2021-06-17,bangladesh,Asia,167745162,3840,841087
2021-06-18,bangladesh,Asia,167745162,3883,844970
2021-06-19,bangladesh,Asia,167745162,3057,848027
2021-06-20,bangladesh,Asia,167745162,3641,851668
2021-06-21,bangladesh,Asia,167745162,4636,856304
2021-06-22,bangladesh,Asia,167745162,4846,861150
2021-06-23,bangladesh,Asia,167745162,5727,866877
2021-06-24,bangladesh,Asia,167745162,6058,872935
2021-06-25,bangladesh,Asia,167745162,5869,878804
2021-06-26,bangladesh,Asia,167745162,4334,883138
2021-06-27,bangladesh,Asia,167745162,5268,888406
2021-06-28,bangladesh,Asia,167745162,8364,896770
2021-06-29,bangladesh,Asia,167745162,7666,904436
2021-06-30,bangladesh,Asia,167745162,8822,913258
2021-07-01,bangladesh,Asia,167745162,8301,921559
2021-07-02,bangladesh,Asia,167745162,8483,930042
2021-07-03,bangladesh,Asia,167745162,6214,936256
2021-07-04,bangladesh,Asia,167745162,8661,944917
2021-07-05,bangladesh,Asia,167745162,9964,954881
2021-07-06,bangladesh,Asia,167745162,11525,966406
2021-07-07,bangladesh,Asia,167745162,11162,977568
2021-07-08,bangladesh,Asia,167745162,11651,989219
2021-07-09,bangladesh,Asia,167745162,11324,1000543
2021-07-10,bangladesh,Asia,167745162,8772,1009315
2021-07-11,bangladesh,Asia,167745162,11874,1021189
2021-07-12,bangladesh,Asia,167745162,13768,1034957
2021-07-13,bangladesh,Asia,167745162,12198,1047155
2021-07-14,bangladesh,Asia,167745162,12383,1059538
2021-07-15,bangladesh,Asia,167745162,12236,1071774
2021-07-16,bangladesh,Asia,167745162,12148,1083922
2021-07-17,bangladesh,Asia,167745162,8489,1092411
2021-07-18,bangladesh,Asia,167745162,11578,1103989
2021-07-19,bangladesh,Asia,167745162,13321,1117310
2021-07-20,bangladesh,Asia,167745162,11579,1128889
2021-07-21,bangladesh,Asia,167745162,7614,1136503
2021-07-22,bangladesh,Asia,167745162,3697,1140200
2021-07-23,bangladesh,Asia,167745162,6364,1146564
2021-07-24,bangladesh,Asia,167745162,6780,1153344
2021-07-25,bangladesh,Asia,167745162,11291,1164635
2021-07-26,bangladesh,Asia,167745162,15192,1179827
2021-07-27,bangladesh,Asia,167745162,14925,1194752
2021-07-28,bangladesh,Asia,167745162,16230,1210982
2021-07-29,bangladesh,Asia,167745162,15271,1226253
2021-07-30,bangladesh,Asia,167745162,13862,1240115
2021-07-31,bangladesh,Asia,167745162,9369,1249484
2021-08-01,bangladesh,Asia,167745162,14844,1264328
2021-08-02,bangladesh,Asia,167745162,15989,1280317
2021-08-03,bangladesh,Asia,167745162,15776,1296093
2021-08-04,bangladesh,Asia,167745162,13817,1309910
2021-08-05,bangladesh,Asia,167745162,12744,1322654
2021-08-06,bangladesh,Asia,167745162,12606,1335260
2021-08-07,bangladesh,Asia,167745162,8136,1343396
2021-08-08,bangladesh,Asia,167745162,10299,1353695
2021-08-09,bangladesh,Asia,167745162,11463,1365158
2021-08-10,bangladesh,Asia,167745162,11164,1376322
2021-08-11,bangladesh,Asia,167745162,10420,1386742
2021-08-12,bangladesh,Asia,167745162,10126,1396868
2021-08-13,bangladesh,Asia,167745162,8465,1405333
2021-08-14,bangladesh,Asia,167745162,6885,1412218
2021-08-15,bangladesh,Asia,167745162,6684,1418902
2021-08-16,bangladesh,Asia,167745162,6959,1425861
2021-08-17,bangladesh,Asia,167745162,7535,1433396
2021-08-18,bangladesh,Asia,167745162,7248,1440644
2021-08-19,bangladesh,Asia,167745162,6566,1447210
2021-08-20,bangladesh,Asia,167745162,5993,1453203
2021-08-21,bangladesh,Asia,167745162,3991,1457194
2021-08-22,bangladesh,Asia,167745162,4804,1461998
2021-08-23,bangladesh,Asia,167745162,5717,1467715
2021-08-24,bangladesh,Asia,167745162,5249,1472964
2021-08-25,bangladesh,Asia,167745162,4966,1477930
2021-08-26,bangladesh,Asia,167745162,4698,1482628
2021-08-27,bangladesh,Asia,167745162,3525,1486153
2021-08-28,bangladesh,Asia,167745162,3436,1489589
2021-08-29,bangladesh,Asia,167745162,3948,1493537
2021-08-30,bangladesh,Asia,167745162,3724,1497261
2021-08-31,bangladesh,Asia,167745162,3357,1500618
2021-09-01,bangladesh,Asia,167745162,3062,1503680
2021-09-02,bangladesh,Asia,167745162,3436,1507116
2021-09-03,bangladesh,Asia,167745162,3167,1510283
2021-09-04,bangladesh,Asia,167745162,1743,1512026
2021-09-05,bangladesh,Asia,167745162,2430,1514456
2021-09-06,bangladesh,Asia,167745162,2710,1517166
2021-09-07,bangladesh,Asia,167745162,2639,1519805
2021-09-08,bangladesh,Asia,167745162,2497,1522302
2021-09-09,bangladesh,Asia,167745162,2588,1524890
2021-09-10,bangladesh,Asia,167745162,2325,1527215
2021-09-11,bangladesh,Asia,167745162,1327,1528542
2021-09-12,bangladesh,Asia,167745162,1871,1530413
2021-09-13,bangladesh,Asia,167745162,1953,1532366
2021-09-14,bangladesh,Asia,167745162,2074,1534440
2021-09-15,bangladesh,Asia,167745162,1901,1536341
2021-09-16,bangladesh,Asia,167745162,1862,1538203
2021-09-17,bangladesh,Asia,167745162,1907,1540110
2021-09-18,bangladesh,Asia,167745162,1190,1541300
2021-09-19,bangladesh,Asia,167745162,1383,1542683
2021-09-20,bangladesh,Asia,167745162,1555,1544238
2021-09-21,bangladesh,Asia,167745162,1562,1545800
2021-09-22,bangladesh,Asia,167745162,1376,1547176
2021-09-23,bangladesh,Asia,167745162,1144,1548320
2021-09-24,bangladesh,Asia,167745162,1233,1549553
2021-09-25,bangladesh,Asia,167745162,818,1550371
2021-09-26,bangladesh,Asia,167745162,980,1551351
2021-09-27,bangladesh,Asia,167745162,1212,1552563
2021-09-28,bangladesh,Asia,167745162,1310,1553873
2021-09-29,bangladesh,Asia,167745162,1178,1555051
2021-09-30,bangladesh,Asia,167745162,860,1555911
2021-10-01,bangladesh,Asia,167745162,847,1556758
2021-10-02,bangladesh,Asia,167745162,589,1557347
2021-10-03,bangladesh,Asia,167745162,617,1557964
2021-10-04,bangladesh,Asia,167745162,794,1558758
2021-10-05,bangladesh,Asia,167745162,694,1559452
2021-10-06,bangladesh,Asia,167745162,703,1560155
2021-10-07,bangladesh,Asia,167745162,663,1560818
2021-10-08,bangladesh,Asia,167745162,645,1561463
2021-10-09,bangladesh,Asia,167745162,415,1561878
2021-10-10,bangladesh,Asia,167745162,481,1562359
2021-10-11,bangladesh,Asia,167745162,599,1562958
2021-10-12,bangladesh,Asia,167745162,543,1563501
2021-10-13,bangladesh,Asia,167745162,518,1564019
2021-10-14,bangladesh,Asia,167745162,466,1564485
2021-10-15,bangladesh,Asia,167745162,396,1564881
2021-10-16,bangladesh,Asia,167745162,293,1565174
2021-10-17,bangladesh,Asia,167745162,314,1565488
2021-10-18,bangladesh,Asia,167745162,339,1565827
2021-10-19,bangladesh,Asia,167745162,469,1566296
2021-10-20,bangladesh,Asia,167745162,368,1566664
2021-10-21,bangladesh,Asia,167745162,243,1566907
2021-10-22,bangladesh,Asia,167745162,232,1567139
2021-10-23,bangladesh,Asia,167745162,278,1567417
2021-10-24,bangladesh,Asia,167745162,275,1567692
2021-10-25,bangladesh,Asia,167745162,289,1567981
2021-10-26,bangladesh,Asia,167745162,276,1568257
2021-10-27,bangladesh,Asia,167745162,306,1568563
2021-10-28,bangladesh,Asia,167745162,294,1568857
2021-10-29,bangladesh,Asia,167745162,305,1569162
2021-10-30,bangladesh,Asia,167745162,166,1569328
2021-10-31,bangladesh,Asia,167745162,211,1569539
2021-11-01,bangladesh,Asia,167745162,214,1569753
2021-11-02,bangladesh,Asia,167745162,229,1569982
2021-11-03,bangladesh,Asia,167745162,256,1570238
2021-11-04,bangladesh,Asia,167745162,247,1570485
2021-11-05,bangladesh,Asia,167745162,196,1570681
2021-11-06,bangladesh,Asia,167745162,154,1570835
2021-11-07,bangladesh,Asia,167745162,178,1571013
2021-11-08,bangladesh,Asia,167745162,215,1571228
2021-11-09,bangladesh,Asia,167745162,206,1571434
2021-11-10,bangladesh,Asia,167745162,235,1571669
2021-11-11,bangladesh,Asia,167745162,237,1571906
2021-11-12,bangladesh,Asia,167745162,221,1572127
2021-11-13,bangladesh,Asia,167745162,151,1572278
2021-11-14,bangladesh,Asia,167745162,223,1572501
2021-11-15,bangladesh,Asia,167745162,234,1572735
2021-11-16,bangladesh,Asia,167745162,213,1572948
2021-11-17,bangladesh,Asia,167745162,266,1573214
2021-11-18,bangladesh,Asia,167745162,244,1573458
2021-11-19,bangladesh,Asia,167745162,253,1573711
2021-11-20,bangladesh,Asia,167745162,178,1573889
2021-11-21,bangladesh,Asia,167745162,199,1574088
2021-11-22,bangladesh,Asia,167745162,264,1574352
2021-11-23,bangladesh,Asia,167745162,284,1574636
2021-11-24,bangladesh,Asia,167745162,312,1574948
2021-11-25,bangladesh,Asia,167745162,237,1575185
2021-11-26,bangladesh,Asia,167745162,239,1575424
2021-11-27,bangladesh,Asia,167745162,155,1575579
2021-11-28,bangladesh,Asia,167745162,205,1575784
2021-11-29,bangladesh,Asia,167745162,227,1576011
2021-11-30,bangladesh,Asia,167745162,273,1576284
2021-12-01,bangladesh,Asia,167745162,282,1576566
2021-12-02,bangladesh,Asia,167745162,261,1576827
2021-12-03,bangladesh,Asia,167745162,243,1577070
2021-12-04,bangladesh,Asia,167745162,176,1577246
2021-12-05,bangladesh,Asia,167745162,197,1577443
2021-12-06,bangladesh,Asia,167745162,277,1577720
2021-12-07,bangladesh,Asia,167745162,291,1578011
2021-12-08,bangladesh,Asia,167745162,277,1578288
2021-12-09,bangladesh,Asia,167745162,262,1578550
2021-12-10,bangladesh,Asia,167745162,269,1578819
2020-02-20,belgium,Europe,11683561,0,1
2020-02-21,belgium,Europe,11683561,0,1
2020-02-22,belgium,Europe,11683561,0,1
2020-02-23,belgium,Europe,11683561,0,1
2020-02-24,belgium,Europe,11683561,0,1
2020-02-25,belgium,Europe,11683561,0,1
2020-02-26,belgium,Europe,11683561,0,1
2020-02-27,belgium,Europe,11683561,0,1
2020-02-28,belgium,Europe,11683561,0,1
2020-02-29,belgium,Europe,11683561,0,1
2020-03-01,belgium,Europe,11683561,1,2
2020-03-02,belgium,Europe,11683561,6,8
2020-03-03,belgium,Europe,11683561,7,15
2020-03-04,belgium,Europe,11683561,8,23
2020-03-05,belgium,Europe,11683561,27,50
2020-03-06,belgium,Europe,11683561,59,109
2020-03-07,belgium,Europe,11683561,60,169
2020-03-08,belgium,Europe,11683561,31,200
2020-03-09,belgium,Europe,11683561,39,239
2020-03-10,belgium,Europe,11683561,28,267
2020-03-11,belgium,Europe,11683561,47,314
2020-03-12,belgium,Europe,11683561,85,399
2020-03-13,belgium,Europe,11683561,160,559
2020-03-14,belgium,Europe,11683561,130,689
2020-03-15,belgium,Europe,11683561,197,886
2020-03-16,belgium,Europe,11683561,172,1058
2020-03-17,belgium,Europe,11683561,185,1243
2020-03-18,belgium,Europe,11683561,243,1486
2020-03-19,belgium,Europe,11683561,309,1795
2020-03-20,belgium,Europe,11683561,462,2257
2020-03-21,belgium,Europe,11683561,558,2815
2020-03-22,belgium,Europe,11683561,586,3401
2020-03-23,belgium,Europe,11683561,342,3743
2020-03-24,belgium,Europe,11683561,526,4269
2020-03-25,belgium,Europe,11683561,668,4937
2020-03-26,belgium,Europe,11683561,1298,6235
2020-03-27,belgium,Europe,11683561,1049,7284
2020-03-28,belgium,Europe,11683561,1850,9134
2020-03-29,belgium,Europe,11683561,1702,10836
2020-03-30,belgium,Europe,11683561,1063,11899
2020-03-31,belgium,Europe,11683561,876,12775
2020-04-01,belgium,Europe,11683561,1189,13964
2020-04-02,belgium,Europe,11683561,1384,15348
2020-04-03,belgium,Europe,11683561,1422,16770
2020-04-04,belgium,Europe,11683561,1661,18431
2020-04-05,belgium,Europe,11683561,1260,19691
2020-04-06,belgium,Europe,11683561,1123,20814
2020-04-07,belgium,Europe,11683561,1380,22194
2020-04-08,belgium,Europe,11683561,1209,23403
2020-04-09,belgium,Europe,11683561,1580,24983
2020-04-10,belgium,Europe,11683561,1684,26667
2020-04-11,belgium,Europe,11683561,1351,28018
2020-04-12,belgium,Europe,11683561,1629,29647
2020-04-13,belgium,Europe,11683561,942,30589
2020-04-14,belgium,Europe,11683561,530,31119
2020-04-15,belgium,Europe,11683561,2454,33573
2020-04-16,belgium,Europe,11683561,1236,34809
2020-04-17,belgium,Europe,11683561,1329,36138
2020-04-18,belgium,Europe,11683561,1045,37183
2020-04-19,belgium,Europe,11683561,1313,38496
2020-04-20,belgium,Europe,11683561,1487,39983
2020-04-21,belgium,Europe,11683561,973,40956
2020-04-22,belgium,Europe,11683561,933,41889
2020-04-23,belgium,Europe,11683561,908,42797
2020-04-24,belgium,Europe,11683561,1496,44293
2020-04-25,belgium,Europe,11683561,1032,45325
2020-04-26,belgium,Europe,11683561,809,46134
2020-04-27,belgium,Europe,11683561,553,46687
2020-04-28,belgium,Europe,11683561,647,47334
2020-04-29,belgium,Europe,11683561,525,47859
2020-04-30,belgium,Europe,11683561,660,48519
2020-05-01,belgium,Europe,11683561,513,49032
2020-05-02,belgium,Europe,11683561,485,49517
2020-05-03,belgium,Europe,11683561,389,49906
2020-05-04,belgium,Europe,11683561,361,50267
2020-05-05,belgium,Europe,11683561,242,50509
2020-04-07,belize,North America,411069,0,7
2020-04-08,belize,North America,411069,1,8
2020-04-09,belize,North America,411069,1,9
2020-04-10,belize,North America,411069,1,10
2020-04-11,belize,North America,411069,3,13
2020-04-12,belize,North America,411069,1,14
2020-04-13,belize,North America,411069,4,18
2020-04-14,belize,North America,411069,0,18
2020-04-15,belize,North America,411069,0,18
2020-04-16,belize,North America,411069,0,18
2020-04-17,belize,North America,411069,0,18
2020-04-18,belize,North America,411069,0,18
2020-04-19,belize,North America,411069,0,18
2020-04-20,belize,North America,411069,0,18
2020-04-21,belize,North America,411069,0,18
2020-04-22,belize,North America,411069,0,18
2020-04-23,belize,North America,411069,0,18
2020-04-24,belize,North America,411069,0,18
2020-04-25,belize,North America,411069,0,18
2020-04-26,belize,North America,411069,0,18
2020-04-27,belize,North America,411069,0,18
2020-04-28,belize,North America,411069,0,18
2020-04-29,belize,North America,411069,0,18
2020-04-30,belize,North America,411069,0,18
2020-05-01,belize,North America,411069,0,18
2020-05-02,belize,North America,411069,0,18
2020-05-03,belize,North America,411069,0,18
2020-05-04,belize,North America,411069,0,18
2020-05-05,belize,North America,411069,0,18
2020-05-06,belize,North America,411069,0,18
2020-05-07,belize,North America,411069,0,18
2020-05-08,belize,North America,411069,0,18
2020-05-09,belize,North America,411069,0,18
2020-05-10,belize,North America,411069,0,18
2020-05-11,belize,North America,411069,0,18
2020-05-12,belize,North America,411069,0,18
2020-05-13,belize,North America,411069,0,18
2020-05-14,belize,North America,411069,0,18
2020-05-15,belize,North America,411069,0,18
2020-05-16,belize,North America,411069,0,18
2020-05-17,belize,North America,411069,0,18
2020-05-18,belize,North America,411069,0,18
2020-05-19,belize,North America,411069,0,18
2020-05-20,belize,North America,411069,0,18
2020-05-21,belize,North America,411069,0,18
2020-05-22,belize,North America,411069,0,18
2020-05-23,belize,North America,411069,0,18
2020-05-24,belize,North America,411069,0,18
2020-05-25,belize,North America,411069,0,18
2020-05-26,belize,North America,411069,0,18
2020-05-27,belize,North America,411069,0,18
2020-05-28,belize,North America,411069,0,18
2020-05-29,belize,North America,411069,0,18
2020-05-30,belize,North America,411069,0,18
2020-05-31,belize,North America,411069,0,18
2020-06-01,belize,North America,411069,0,18
2020-06-02,belize,North America,411069,0,18
2020-06-03,belize,North America,411069,0,18
2020-06-04,belize,North America,411069,0,18
2020-06-05,belize,North America,411069,1,19
2020-06-06,belize,North America,411069,0,19
2020-06-07,belize,North America,411069,0,19
2020-06-08,belize,North America,411069,0,19
2020-06-09,belize,North America,411069,1,20
2020-06-10,belize,North America,411069,0,20
2020-06-11,belize,North America,411069,0,20
2020-06-12,belize,North America,411069,0,20
2020-06-13,belize,North America,411069,0,20
2020-06-14,belize,North America,411069,0,20
2020-06-15,belize,North America,411069,1,21
2020-06-16,belize,North America,411069,0,21
2020-06-17,belize,North America,411069,1,22
2020-06-18,belize,North America,411069,0,22
2020-06-19,belize,North America,411069,0,22
2020-06-20,belize,North America,411069,0,22
2020-06-21,belize,North America,411069,0,22
2020-06-22,belize,North America,411069,0,22
2020-06-23,belize,North America,411069,1,23
2020-06-24,belize,North America,411069,0,23
2020-06-25,belize,North America,411069,0,23
2020-06-26,belize,North America,411069,0,23
2020-06-27,belize,North America,411069,1,24
2020-06-28,belize,North America,411069,0,24
2020-06-29,belize,North America,411069,0,24
2020-06-30,belize,North America,411069,0,24
2020-07-01,belize,North America,411069,4,28
2020-07-02,belize,North America,411069,0,28
2020-07-03,belize,North America,411069,0,28
2020-07-04,belize,North America,411069,2,30
2020-07-05,belize,North America,411069,0,30
2020-07-06,belize,North America,411069,0,30
2020-07-07,belize,North America,411069,0,30
2020-07-08,belize,North America,411069,0,30
2020-07-09,belize,North America,411069,0,30
2020-07-10,belize,North America,411069,3,33
2020-07-11,belize,North America,411069,4,37
2020-07-12,belize,North America,411069,0,37
2020-07-13,belize,North America,411069,0,37
2020-07-14,belize,North America,411069,2,39
2020-07-15,belize,North America,411069,0,39
2020-07-16,belize,North America,411069,1,40
2020-07-17,belize,North America,411069,0,40
2020-07-18,belize,North America,411069,0,40
2020-07-19,belize,North America,411069,0,40
2020-07-20,belize,North America,411069,0,40
2020-07-21,belize,North America,411069,2,42
2020-07-22,belize,North America,411069,1,43
2020-07-23,belize,North America,411069,0,43
2020-07-24,belize,North America,411069,4,47
2020-07-25,belize,North America,411069,1,48
2020-07-26,belize,North America,411069,0,48
2020-07-27,belize,North America,411069,0,48
2020-07-28,belize,North America,411069,0,48
2020-07-29,belize,North America,411069,0,48
2020-07-30,belize,North America,411069,0,48
2020-07-31,belize,North America,411069,0,48
2020-08-01,belize,North America,411069,0,48
2020-08-02,belize,North America,411069,9,57
2020-08-03,belize,North America,411069,0,57
2020-08-04,belize,North America,411069,0,57
2020-08-05,belize,North America,411069,15,72
2020-08-06,belize,North America,411069,14,86
2020-08-07,belize,North America,411069,28,114
2020-08-08,belize,North America,411069,32,146
2020-08-09,belize,North America,411069,7,153
2020-08-10,belize,North America,411069,1,154
2020-08-11,belize,North America,411069,23,177
2020-08-12,belize,North America,411069,33,210
2020-08-13,belize,North America,411069,86,296
2020-08-14,belize,North America,411069,60,356
2020-08-15,belize,North America,411069,32,388
2020-08-16,belize,North America,411069,64,452
2020-08-17,belize,North America,411069,0,452
2020-08-18,belize,North America,411069,23,475
2020-08-19,belize,North America,411069,78,553
2020-08-20,belize,North America,411069,52,605
2020-08-21,belize,North America,411069,43,648
2020-08-22,belize,North America,411069,20,668
2020-08-23,belize,North America,411069,18,686
2020-08-24,belize,North America,411069,27,713
2020-08-25,belize,North America,411069,17,730
2020-08-26,belize,North America,411069,30,760
2020-08-27,belize,North America,411069,58,818
2020-08-28,belize,North America,411069,52,870
2020-08-29,belize,North America,411069,94,964
2020-08-30,belize,North America,411069,29,993
2020-08-31,belize,North America,411069,14,1007
2020-09-01,belize,North America,411069,43,1050
2020-09-02,belize,North America,411069,51,1101
2020-09-03,belize,North America,411069,17,1118
2020-09-04,belize,North America,411069,34,1152
2020-09-05,belize,North America,411069,42,1194
2020-09-06,belize,North America,411069,67,1261
2020-09-07,belize,North America,411069,46,1307
2020-09-08,belize,North America,411069,0,1307
2020-09-09,belize,North America,411069,54,1361
2020-09-10,belize,North America,411069,4,1365
2020-09-11,belize,North America,411069,34,1399
2020-09-12,belize,North America,411069,36,1435
2020-09-13,belize,North America,411069,23,1458
2020-09-14,belize,North America,411069,22,1480
2020-09-15,belize,North America,411069,21,1501
2020-09-16,belize,North America,411069,27,1528
2020-09-17,belize,North America,411069,8,1536
2020-09-18,belize,North America,411069,31,1567
2020-09-19,belize,North America,411069,23,1590
2020-09-20,belize,North America,411069,16,1606
2020-09-21,belize,North America,411069,21,1627
2020-09-22,belize,North America,411069,8,1635
2020-09-23,belize,North America,411069,34,1669
2020-09-24,belize,North America,411069,37,1706
2020-09-25,belize,North America,411069,52,1758
2020-09-26,belize,North America,411069,50,1808
2020-09-27,belize,North America,411069,17,1825
2020-09-28,belize,North America,411069,29,1854
2020-09-29,belize,North America,411069,37,1891
2020-09-30,belize,North America,411069,52,1943
2020-10-01,belize,North America,411069,49,1992
2020-10-02,belize,North America,411069,34,2026
2020-10-03,belize,North America,411069,54,2080
2020-10-04,belize,North America,411069,51,2131
2020-10-05,belize,North America,411069,65,2196
2020-10-06,belize,North America,411069,8,2204
2020-10-07,belize,North America,411069,39,2243
2020-10-08,belize,North America,411069,67,2310
2020-10-09,belize,North America,411069,63,2373
2020-10-10,belize,North America,411069,54,2427
2020-10-11,belize,North America,411069,69,2496
2020-10-12,belize,North America,411069,35,2531
2020-10-13,belize,North America,411069,38,2569
2020-10-14,belize,North America,411069,16,2585
2020-10-15,belize,North America,411069,34,2619
2020-10-16,belize,North America,411069,63,2682
2020-10-17,belize,North America,411069,46,2728
2020-10-18,belize,North America,411069,47,2775
2020-10-19,belize,North America,411069,38,2813
2020-10-20,belize,North America,411069,20,2833
2020-10-21,belize,North America,411069,53,2886
2020-10-22,belize,North America,411069,51,2937
2020-10-23,belize,North America,411069,58,2995
2020-10-24,belize,North America,411069,55,3050
2020-10-25,belize,North America,411069,56,3106
2020-10-26,belize,North America,411069,39,3145
2020-10-27,belize,North America,411069,55,3200
2020-10-28,belize,North America,411069,32,3232
2020-10-29,belize,North America,411069,29,3261
2020-10-30,belize,North America,411069,121,3382
2020-10-31,belize,North America,411069,80,3462
2020-11-01,belize,North America,411069,25,3487
2020-11-02,belize,North America,411069,90,3577
2020-11-03,belize,North America,411069,47,3624
2020-11-04,belize,North America,411069,166,3790
2020-11-05,belize,North America,411069,115,3905
2020-11-06,belize,North America,411069,72,3977
2020-11-07,belize,North America,411069,39,4016
2020-11-08,belize,North America,411069,60,4076
2020-11-09,belize,North America,411069,100,4176
2020-11-10,belize,North America,411069,54,4230
2020-11-11,belize,North America,411069,184,4414
2020-11-12,belize,North America,411069,106,4520
2020-11-13,belize,North America,411069,76,4596
2020-11-14,belize,North America,411069,119,4715
2020-11-15,belize,North America,411069,68,4783
2020-11-16,belize,North America,411069,78,4861
2020-11-17,belize,North America,411069,22,4883
2020-11-18,belize,North America,411069,37,4920
2020-11-19,belize,North America,411069,38,4958
2020-11-20,belize,North America,411069,60,5018
2020-11-21,belize,North America,411069,38,5056
2020-11-22,belize,North America,411069,54,5110
2020-11-23,belize,North America,411069,73,5183
2020-11-24,belize,North America,411069,66,5249
2020-11-25,belize,North America,411069,86,5335
2020-11-26,belize,North America,411069,88,5423
2020-11-27,belize,North America,411069,92,5515
2020-11-28,belize,North America,411069,72,5587
2020-11-29,belize,North America,411069,60,5647
2020-11-30,belize,North America,411069,96,5743
2020-12-01,belize,North America,411069,111,5854
2020-12-02,belize,North America,411069,0,5854
2020-12-03,belize,North America,411069,1382,7236
2020-12-04,belize,North America,411069,147,7383
2020-12-05,belize,North America,411069,218,7601
2020-12-06,belize,North America,411069,168,7769
2020-12-07,belize,North America,411069,184,7953
2020-12-08,belize,North America,411069,60,8013
2020-12-09,belize,North America,411069,506,8519
2020-12-10,belize,North America,411069,286,8805
2020-12-11,belize,North America,411069,160,8965
2020-12-12,belize,North America,411069,208,9173
2020-12-13,belize,North America,411069,122,9295
2020-12-14,belize,North America,411069,82,9377
2020-12-15,belize,North America,411069,134,9511
2020-12-16,belize,North America,411069,161,9672
2020-12-17,belize,North America,411069,119,9791
2020-12-18,belize,North America,411069,138,9929
2020-12-19,belize,North America,411069,94,10023
2020-12-20,belize,North America,411069,72,10095
2020-12-21,belize,North America,411069,50,10145
2020-12-22,belize,North America,411069,112,10257
2020-12-23,belize,North America,411069,113,10370
2020-04-07,benin,Africa,12714341,0,26
2020-04-08,benin,Africa,12714341,0,26
2020-04-09,benin,Africa,12714341,0,26
2020-04-10,benin,Africa,12714341,9,35
2020-04-11,benin,Africa,12714341,0,35
2020-04-12,benin,Africa,12714341,0,35
2020-04-13,benin,Africa,12714341,0,35
2020-04-14,benin,Africa,12714341,0,35
2020-04-15,benin,Africa,12714341,0,35
2020-04-16,benin,Africa,12714341,0,35
2020-04-17,benin,Africa,12714341,0,35
2020-04-18,benin,Africa,12714341,0,35
2020-04-19,benin,Africa,12714341,0,35
2020-04-20,benin,Africa,12714341,19,54
2020-04-21,benin,Africa,12714341,0,54
2020-04-22,benin,Africa,12714341,0,54
2020-04-23,benin,Africa,12714341,0,54
2020-04-24,benin,Africa,12714341,0,54
2020-04-25,benin,Africa,12714341,0,54
2020-04-26,benin,Africa,12714341,10,64
2020-04-27,benin,Africa,12714341,0,64
2020-04-28,benin,Africa,12714341,0,64
2020-04-29,benin,Africa,12714341,0,64
2020-04-30,benin,Africa,12714341,0,64
2020-05-01,benin,Africa,12714341,26,90
2020-05-02,benin,Africa,12714341,0,90
2020-05-03,benin,Africa,12714341,0,90
2020-05-04,benin,Africa,12714341,6,96
2020-05-05,benin,Africa,12714341,0,96
2020-05-06,benin,Africa,12714341,0,96
2020-05-07,benin,Africa,12714341,44,140
2020-05-08,benin,Africa,12714341,102,242
2020-05-09,benin,Africa,12714341,42,284
2020-05-10,benin,Africa,12714341,35,319
2020-05-11,benin,Africa,12714341,0,319
2020-05-12,benin,Africa,12714341,8,327
2020-05-13,benin,Africa,12714341,0,327
2020-05-14,benin,Africa,12714341,12,339
2020-05-15,benin,Africa,12714341,0,339
2020-05-16,benin,Africa,12714341,0,339
2020-05-17,benin,Africa,12714341,0,339
2020-05-18,benin,Africa,12714341,0,339
2020-05-20,benin,Africa,12714341,0,130
2020-05-21,benin,Africa,12714341,5,135
2020-05-22,benin,Africa,12714341,0,135
2020-05-23,benin,Africa,12714341,0,135
2020-05-24,benin,Africa,12714341,56,191
2020-05-25,benin,Africa,12714341,0,191
2020-05-26,benin,Africa,12714341,17,208
2020-05-27,benin,Africa,12714341,2,210
2020-05-28,benin,Africa,12714341,0,210
2020-05-29,benin,Africa,12714341,14,224
2020-05-30,benin,Africa,12714341,0,224
2020-05-31,benin,Africa,12714341,8,232
2020-06-01,benin,Africa,12714341,11,243
2020-06-02,benin,Africa,12714341,1,244
2020-06-03,benin,Africa,12714341,0,244
2020-06-04,benin,Africa,12714341,17,261
2020-06-05,benin,Africa,12714341,0,261
2020-06-06,benin,Africa,12714341,0,261
2020-06-07,benin,Africa,12714341,0,261
2020-06-08,benin,Africa,12714341,27,288
2020-06-09,benin,Africa,12714341,17,305
2020-06-10,benin,Africa,12714341,0,305
2020-06-11,benin,Africa,12714341,0,305
2020-06-12,benin,Africa,12714341,83,388
2020-06-13,benin,Africa,12714341,24,412
2020-06-14,benin,Africa,12714341,30,442
2020-06-15,benin,Africa,12714341,41,483
2020-06-16,benin,Africa,12714341,49,532
2020-06-17,benin,Africa,12714341,40,572
2020-06-18,benin,Africa,12714341,25,597
2020-06-19,benin,Africa,12714341,53,650
2020-06-20,benin,Africa,12714341,0,650
2020-06-21,benin,Africa,12714341,115,765
2020-06-22,benin,Africa,12714341,42,807
2020-06-23,benin,Africa,12714341,43,850
2020-06-24,benin,Africa,12714341,52,902
2020-06-25,benin,Africa,12714341,115,1017
2020-06-26,benin,Africa,12714341,36,1053
2020-06-27,benin,Africa,12714341,71,1124
2020-06-28,benin,Africa,12714341,25,1149
2020-06-29,benin,Africa,12714341,38,1187
2020-06-30,benin,Africa,12714341,12,1199
2020-07-01,benin,Africa,12714341,0,1199
2020-07-02,benin,Africa,12714341,0,1199
2020-07-03,benin,Africa,12714341,0,1199
2020-07-04,benin,Africa,12714341,0,1199
2020-07-05,benin,Africa,12714341,0,1199
2020-07-06,benin,Africa,12714341,0,1199
2020-07-07,benin,Africa,12714341,0,1199
2020-07-08,benin,Africa,12714341,0,1199
2020-07-09,benin,Africa,12714341,0,1199
2020-07-10,benin,Africa,12714341,86,1285
2020-07-11,benin,Africa,12714341,93,1378
2020-07-12,benin,Africa,12714341,0,1378
2020-07-13,benin,Africa,12714341,0,1378
2020-07-14,benin,Africa,12714341,0,1378
2020-07-15,benin,Africa,12714341,0,1378
2020-07-16,benin,Africa,12714341,85,1463
2020-07-17,benin,Africa,12714341,139,1602
2020-07-18,benin,Africa,12714341,0,1602
2020-07-19,benin,Africa,12714341,0,1602
2020-07-20,benin,Africa,12714341,0,1602
2020-07-21,benin,Africa,12714341,0,1602
2020-07-22,benin,Africa,12714341,88,1690
2020-07-23,benin,Africa,12714341,4,1694
2020-07-24,benin,Africa,12714341,0,1694
2020-07-25,benin,Africa,12714341,0,1694
2020-07-26,benin,Africa,12714341,76,1770
2020-07-27,benin,Africa,12714341,0,1770
2020-07-28,benin,Africa,12714341,0,1770
2020-07-29,benin,Africa,12714341,35,1805
2020-07-30,benin,Africa,12714341,0,1805
2020-07-31,benin,Africa,12714341,0,1805
2020-08-01,benin,Africa,12714341,0,1805
2020-08-02,benin,Africa,12714341,0,1805
2020-08-03,benin,Africa,12714341,0,1805
2020-08-04,benin,Africa,12714341,109,1914
2020-08-05,benin,Africa,12714341,22,1936
2020-08-06,benin,Africa,12714341,0,1936
2020-08-07,benin,Africa,12714341,0,1936
2020-08-08,benin,Africa,12714341,0,1936
2020-08-09,benin,Africa,12714341,0,1936
2020-08-10,benin,Africa,12714341,0,1936
2020-08-11,benin,Africa,12714341,65,2001
2020-08-12,benin,Africa,12714341,13,2014
2020-08-13,benin,Africa,12714341,0,2014
2020-08-14,benin,Africa,12714341,0,2014
2020-08-15,benin,Africa,12714341,49,2063
2020-08-16,benin,Africa,12714341,0,2063
2020-08-17,benin,Africa,12714341,0,2063
2020-08-18,benin,Africa,12714341,0,2063
2020-08-19,benin,Africa,12714341,32,2095
2020-08-20,benin,Africa,12714341,0,2095
2020-08-21,benin,Africa,12714341,0,2095
2020-08-22,benin,Africa,12714341,20,2115
2020-08-23,benin,Africa,12714341,0,2115
2020-08-24,benin,Africa,12714341,0,2115
2020-08-25,benin,Africa,12714341,0,2115
2020-08-26,benin,Africa,12714341,30,2145
2020-08-27,benin,Africa,12714341,0,2145
2020-08-28,benin,Africa,12714341,0,2145
2020-08-29,benin,Africa,12714341,0,2145
2020-08-30,benin,Africa,12714341,0,2145
2020-08-31,benin,Africa,12714341,0,2145
2020-09-01,benin,Africa,12714341,0,2145
2020-09-02,benin,Africa,12714341,49,2194
2020-09-03,benin,Africa,12714341,0,2194
2020-09-04,benin,Africa,12714341,0,2194
2020-09-05,benin,Africa,12714341,19,2213
2020-09-06,benin,Africa,12714341,0,2213
2020-09-07,benin,Africa,12714341,0,2213
2020-09-08,benin,Africa,12714341,0,2213
2020-09-09,benin,Africa,12714341,29,2242
2020-09-10,benin,Africa,12714341,0,2242
2020-09-11,benin,Africa,12714341,0,2242
2020-09-12,benin,Africa,12714341,0,2242
2020-09-13,benin,Africa,12714341,25,2267
2020-09-14,benin,Africa,12714341,0,2267
2020-09-15,benin,Africa,12714341,0,2267
2020-09-16,benin,Africa,12714341,13,2280
2020-09-17,benin,Africa,12714341,0,2280
2020-09-18,benin,Africa,12714341,0,2280
2020-09-19,benin,Africa,12714341,0,2280
2020-09-20,benin,Africa,12714341,0,2280
2020-09-21,benin,Africa,12714341,14,2294
2020-09-22,benin,Africa,12714341,0,2294
2020-09-23,benin,Africa,12714341,31,2325
2020-09-24,benin,Africa,12714341,0,2325
2020-09-25,benin,Africa,12714341,0,2325
2020-09-26,benin,Africa,12714341,0,2325
2020-09-27,benin,Africa,12714341,15,2340
2020-09-28,benin,Africa,12714341,0,2340
2020-09-29,benin,Africa,12714341,0,2340
2020-09-30,benin,Africa,12714341,17,2357
2020-10-01,benin,Africa,12714341,0,2357
2020-10-02,benin,Africa,12714341,0,2357
2020-10-03,benin,Africa,12714341,0,2357
2020-10-04,benin,Africa,12714341,0,2357
2020-10-05,benin,Africa,12714341,0,2357
2020-10-06,benin,Africa,12714341,0,2357
2020-10-07,benin,Africa,12714341,54,2411
2020-10-08,benin,Africa,12714341,0,2411
2020-10-09,benin,Africa,12714341,0,2411
2020-10-10,benin,Africa,12714341,0,2411
2020-10-11,benin,Africa,12714341,0,2411
2020-10-12,benin,Africa,12714341,0,2411
2020-10-13,benin,Africa,12714341,0,2411
2020-10-14,benin,Africa,12714341,67,2478
2020-10-15,benin,Africa,12714341,18,2496
2020-10-16,benin,Africa,12714341,0,2496
2020-10-17,benin,Africa,12714341,0,2496
2020-10-18,benin,Africa,12714341,0,2496
2020-10-19,benin,Africa,12714341,0,2496
2020-10-20,benin,Africa,12714341,0,2496
2020-10-21,benin,Africa,12714341,61,2557
2020-10-22,benin,Africa,12714341,0,2557
2020-10-23,benin,Africa,12714341,0,2557
2020-10-24,benin,Africa,12714341,0,2557
2020-10-25,benin,Africa,12714341,0,2557
2020-10-26,benin,Africa,12714341,0,2557
2020-10-27,benin,Africa,12714341,0,2557
2020-10-28,benin,Africa,12714341,86,2643
2020-10-29,benin,Africa,12714341,0,2643
2020-10-30,benin,Africa,12714341,0,2643
2020-10-31,benin,Africa,12714341,0,2643
2020-11-01,benin,Africa,12714341,40,2683
2020-11-02,benin,Africa,12714341,0,2683
2020-11-03,benin,Africa,12714341,0,2683
2020-11-04,benin,Africa,12714341,62,2745
2020-11-05,benin,Africa,12714341,0,2745
2020-11-06,benin,Africa,12714341,0,2745
2020-11-07,benin,Africa,12714341,0,2745
2020-11-08,benin,Africa,12714341,0,2745
2020-11-09,benin,Africa,12714341,36,2781
2020-11-10,benin,Africa,12714341,0,2781
2020-11-11,benin,Africa,12714341,63,2844
2020-11-12,benin,Africa,12714341,0,2844
2020-11-13,benin,Africa,12714341,0,2844
2020-11-14,benin,Africa,12714341,0,2844
2020-11-15,benin,Africa,12714341,0,2844
2020-11-16,benin,Africa,12714341,40,2884
2020-11-17,benin,Africa,12714341,0,2884
2020-11-18,benin,Africa,12714341,32,2916
2020-11-19,benin,Africa,12714341,0,2916
2020-11-20,benin,Africa,12714341,0,2916
2020-11-21,benin,Africa,12714341,0,2916
2020-11-22,benin,Africa,12714341,0,2916
2020-11-23,benin,Africa,12714341,0,2916
2020-11-24,benin,Africa,12714341,0,2916
2020-11-25,benin,Africa,12714341,58,2974
2020-11-26,benin,Africa,12714341,0,2974
2020-11-27,benin,Africa,12714341,0,2974
2020-11-28,benin,Africa,12714341,0,2974
2020-11-29,benin,Africa,12714341,0,2974
2020-11-30,benin,Africa,12714341,41,3015
2020-12-01,benin,Africa,12714341,0,3015
2020-12-02,benin,Africa,12714341,40,3055
2020-12-03,benin,Africa,12714341,0,3055
2020-12-04,benin,Africa,12714341,0,3055
2020-12-05,benin,Africa,12714341,0,3055
2020-12-06,benin,Africa,12714341,0,3055
2020-12-07,benin,Africa,12714341,18,3073
2020-12-08,benin,Africa,12714341,0,3073
2020-12-09,benin,Africa,12714341,17,3090
2020-12-10,benin,Africa,12714341,0,3090
2020-12-11,benin,Africa,12714341,0,3090
2020-12-12,benin,Africa,12714341,0,3090
2020-12-13,benin,Africa,12714341,0,3090
2020-12-14,benin,Africa,12714341,0,3090
2020-12-15,benin,Africa,12714341,0,3090
2020-12-16,benin,Africa,12714341,62,3152
2020-12-17,benin,Africa,12714341,0,3152
2020-12-18,benin,Africa,12714341,0,3152
2020-12-19,benin,Africa,12714341,0,3152
2020-12-20,benin,Africa,12714341,15,3167
2020-12-21,benin,Africa,12714341,0,3167
2020-12-22,benin,Africa,12714341,0,3167
2020-12-23,benin,Africa,12714341,38,3205
2020-12-24,benin,Africa,12714341,0,3205
2020-12-25,benin,Africa,12714341,0,3205
2020-12-26,benin,Africa,12714341,0,3205
2020-12-27,benin,Africa,12714341,0,3205
2020-12-28,benin,Africa,12714341,0,3205
2020-12-29,benin,Africa,12714341,0,3205
2020-12-30,benin,Africa,12714341,46,3251
2020-12-31,benin,Africa,12714341,0,3251
2021-01-01,benin,Africa,12714341,0,3251
2021-01-02,benin,Africa,12714341,0,3251
2021-01-03,benin,Africa,12714341,0,3251
2021-01-04,benin,Africa,12714341,0,3251
2021-01-05,benin,Africa,12714341,53,3304
2021-01-06,benin,Africa,12714341,0,3304
2021-01-07,benin,Africa,12714341,0,3304
2021-01-08,benin,Africa,12714341,0,3304
2021-01-09,benin,Africa,12714341,0,3304
2021-01-10,benin,Africa,12714341,0,3304
2021-01-11,benin,Africa,12714341,59,3363
2021-01-12,benin,Africa,12714341,0,3363
2021-01-13,benin,Africa,12714341,50,3413
2021-01-14,benin,Africa,12714341,0,3413
2021-01-15,benin,Africa,12714341,0,3413
2021-01-16,benin,Africa,12714341,0,3413
2021-01-17,benin,Africa,12714341,0,3413
2021-01-18,benin,Africa,12714341,0,3413
2021-01-19,benin,Africa,12714341,0,3413
2021-01-20,benin,Africa,12714341,144,3557
2021-01-21,benin,Africa,12714341,25,3582
2021-01-22,benin,Africa,12714341,61,3643
2021-01-23,benin,Africa,12714341,0,3643
2021-01-24,benin,Africa,12714341,0,3643
2021-01-25,benin,Africa,12714341,0,3643
2021-01-26,benin,Africa,12714341,0,3643
2021-01-27,benin,Africa,12714341,143,3786
2021-01-28,benin,Africa,12714341,0,3786
2021-01-29,benin,Africa,12714341,0,3786
2021-01-30,benin,Africa,12714341,0,3786
2021-01-31,benin,Africa,12714341,107,3893
2021-02-01,benin,Africa,12714341,0,3893
2021-02-02,benin,Africa,12714341,0,3893
2021-02-03,benin,Africa,12714341,226,4119
2021-02-04,benin,Africa,12714341,74,4193
2021-02-05,benin,Africa,12714341,0,4193
2021-02-06,benin,Africa,12714341,0,4193
2021-02-07,benin,Africa,12714341,0,4193
2021-02-08,benin,Africa,12714341,0,4193
2021-02-09,benin,Africa,12714341,0,4193
2021-02-10,benin,Africa,12714341,367,4560
2021-02-11,benin,Africa,12714341,0,4560
2021-02-12,benin,Africa,12714341,0,4560
2021-02-13,benin,Africa,12714341,0,4560
2021-02-14,benin,Africa,12714341,0,4560
2021-02-15,benin,Africa,12714341,479,5039
2021-02-16,benin,Africa,12714341,0,5039
2021-02-17,benin,Africa,12714341,104,5143
2021-02-18,benin,Africa,12714341,0,5143
2021-02-19,benin,Africa,12714341,0,5143
2021-02-20,benin,Africa,12714341,0,5143
2021-02-21,benin,Africa,12714341,291,5434
2021-02-22,benin,Africa,12714341,0,5434
2021-02-23,benin,Africa,12714341,0,5434
2021-02-24,benin,Africa,12714341,0,5434
2021-02-25,benin,Africa,12714341,0,5434
2021-02-26,benin,Africa,12714341,0,5434
2021-02-27,benin,Africa,12714341,0,5434
2021-02-28,benin,Africa,12714341,0,5434
2021-03-01,benin,Africa,12714341,637,6071
2021-03-02,benin,Africa,12714341,0,6071
2021-03-03,benin,Africa,12714341,0,6071
2021-03-04,benin,Africa,12714341,0,6071
2021-03-05,benin,Africa,12714341,267,6338
2021-03-06,benin,Africa,12714341,0,6338
2021-03-07,benin,Africa,12714341,0,6338
2021-03-08,benin,Africa,12714341,0,6338
2021-03-09,benin,Africa,12714341,0,6338
2021-03-10,benin,Africa,12714341,163,6501
2021-03-11,benin,Africa,12714341,0,6501
2021-03-12,benin,Africa,12714341,0,6501
2021-03-13,benin,Africa,12714341,0,6501
2021-03-14,benin,Africa,12714341,0,6501
2021-03-15,benin,Africa,12714341,0,6501
2021-03-16,benin,Africa,12714341,0,6501
2021-03-17,benin,Africa,12714341,0,6501
2021-03-18,benin,Africa,12714341,0,6501
2021-03-19,benin,Africa,12714341,317,6818
2021-03-20,benin,Africa,12714341,0,6818
2021-03-21,benin,Africa,12714341,0,6818
2021-03-22,benin,Africa,12714341,0,6818
2021-03-23,benin,Africa,12714341,0,6818
2021-03-24,benin,Africa,12714341,282,7100
2021-03-25,benin,Africa,12714341,0,7100
2021-03-26,benin,Africa,12714341,0,7100
2021-03-27,benin,Africa,12714341,0,7100
2021-03-28,benin,Africa,12714341,0,7100
2021-03-29,benin,Africa,12714341,0,7100
2021-03-30,benin,Africa,12714341,0,7100
2021-03-31,benin,Africa,12714341,0,7100
2021-04-01,benin,Africa,12714341,213,7313
2021-04-02,benin,Africa,12714341,0,7313
2021-04-03,benin,Africa,12714341,0,7313
2021-04-04,benin,Africa,12714341,0,7313
2021-04-05,benin,Africa,12714341,0,7313
2021-04-06,benin,Africa,12714341,0,7313
2021-04-07,benin,Africa,12714341,0,7313
2021-04-08,benin,Africa,12714341,202,7515
2021-04-09,benin,Africa,12714341,0,7515
2021-04-10,benin,Africa,12714341,0,7515
2021-04-11,benin,Africa,12714341,0,7515
2021-04-12,benin,Africa,12714341,0,7515
2021-04-13,benin,Africa,12714341,0,7515
2021-04-14,benin,Africa,12714341,96,7611
2021-04-15,benin,Africa,12714341,0,7611
2021-04-16,benin,Africa,12714341,0,7611
2021-04-17,benin,Africa,12714341,0,7611
2021-04-18,benin,Africa,12714341,0,7611
2021-04-19,benin,Africa,12714341,0,7611
2021-04-20,benin,Africa,12714341,109,7720
2021-04-21,benin,Africa,12714341,0,7720
2021-04-22,benin,Africa,12714341,0,7720
2021-04-23,benin,Africa,12714341,0,7720
2021-04-24,benin,Africa,12714341,0,7720
2021-04-25,benin,Africa,12714341,0,7720
2021-04-26,benin,Africa,12714341,0,7720
2021-04-27,benin,Africa,12714341,0,7720
2021-04-28,benin,Africa,12714341,101,7821
2021-04-29,benin,Africa,12714341,0,7821
2021-04-30,benin,Africa,12714341,0,7821
2021-05-01,benin,Africa,12714341,0,7821
2021-05-02,benin,Africa,12714341,0,7821
2021-05-03,benin,Africa,12714341,63,7884
2021-05-04,benin,Africa,12714341,0,7884
2021-05-05,benin,Africa,12714341,0,7884
2021-05-06,benin,Africa,12714341,0,7884
2021-05-07,benin,Africa,12714341,0,7884
2021-05-08,benin,Africa,12714341,0,7884
2021-05-09,benin,Africa,12714341,0,7884
2021-05-10,benin,Africa,12714341,0,7884
2021-05-11,benin,Africa,12714341,111,7995
2021-05-12,benin,Africa,12714341,0,7995
2021-05-13,benin,Africa,12714341,0,7995
2021-05-14,benin,Africa,12714341,0,7995
2021-05-15,benin,Africa,12714341,0,7995
2021-05-16,benin,Africa,12714341,0,7995
2021-05-17,benin,Africa,12714341,0,7995
2021-05-18,benin,Africa,12714341,30,8025
2021-05-19,benin,Africa,12714341,0,8025
2021-05-20,benin,Africa,12714341,0,8025
2021-05-21,benin,Africa,12714341,0,8025
2021-05-22,benin,Africa,12714341,0,8025
2021-05-23,benin,Africa,12714341,0,8025
2021-05-24,benin,Africa,12714341,0,8025
2021-05-25,benin,Africa,12714341,0,8025
2021-05-26,benin,Africa,12714341,33,8058
2021-05-27,benin,Africa,12714341,0,8058
2021-05-28,benin,Africa,12714341,0,8058
2021-05-29,benin,Africa,12714341,0,8058
2021-05-30,benin,Africa,12714341,0,8058
2021-05-31,benin,Africa,12714341,0,8058
2021-06-01,benin,Africa,12714341,0,8058
2021-06-02,benin,Africa,12714341,24,8082
2021-06-03,benin,Africa,12714341,0,8082
2021-06-04,benin,Africa,12714341,0,8082
2021-06-05,benin,Africa,12714341,0,8082
2021-06-06,benin,Africa,12714341,0,8082
2021-06-07,benin,Africa,12714341,0,8082
2021-06-08,benin,Africa,12714341,0,8082
2021-06-09,benin,Africa,12714341,27,8109
2021-06-10,benin,Africa,12714341,0,8109
2021-06-11,benin,Africa,12714341,0,8109
2021-06-12,benin,Africa,12714341,0,8109
2021-06-13,benin,Africa,12714341,0,8109
2021-06-14,benin,Africa,12714341,0,8109
2021-06-15,benin,Africa,12714341,31,8140
2021-06-16,benin,Africa,12714341,0,8140
2021-06-17,benin,Africa,12714341,0,8140
2021-06-18,benin,Africa,12714341,0,8140
2021-06-19,benin,Africa,12714341,0,8140
2021-06-20,benin,Africa,12714341,0,8140
2021-06-21,benin,Africa,12714341,0,8140
2021-06-22,benin,Africa,12714341,30,8170
2021-06-23,benin,Africa,12714341,0,8170
2021-06-24,benin,Africa,12714341,0,8170
2021-06-25,benin,Africa,12714341,0,8170
2021-06-26,benin,Africa,12714341,0,8170
2021-06-27,benin,Africa,12714341,0,8170
2021-06-28,benin,Africa,12714341,0,8170
2021-06-29,benin,Africa,12714341,29,8199
2021-06-30,benin,Africa,12714341,0,8199
2021-07-01,benin,Africa,12714341,0,8199
2021-07-02,benin,Africa,12714341,0,8199
2021-07-03,benin,Africa,12714341,0,8199
2021-07-04,benin,Africa,12714341,0,8199
2021-07-05,benin,Africa,12714341,0,8199
2021-07-06,benin,Africa,12714341,0,8199
2021-07-07,benin,Africa,12714341,28,8227
2021-07-08,benin,Africa,12714341,0,8227
2021-07-09,benin,Africa,12714341,0,8227
2021-07-10,benin,Africa,12714341,0,8227
2021-07-11,benin,Africa,12714341,0,8227
2021-07-12,benin,Africa,12714341,0,8227
2021-07-13,benin,Africa,12714341,0,8227
2021-07-14,benin,Africa,12714341,17,8244
2021-07-15,benin,Africa,12714341,0,8244
2021-07-16,benin,Africa,12714341,0,8244
2021-07-17,benin,Africa,12714341,0,8244
2021-07-18,benin,Africa,12714341,0,8244
2021-07-19,benin,Africa,12714341,0,8244
2021-07-20,benin,Africa,12714341,0,8244
2021-07-21,benin,Africa,12714341,0,8244
2021-07-22,benin,Africa,12714341,80,8324
2021-07-23,benin,Africa,12714341,0,8324
2021-07-24,benin,Africa,12714341,0,8324
2021-07-25,benin,Africa,12714341,0,8324
2021-07-26,benin,Africa,12714341,0,8324
2021-07-27,benin,Africa,12714341,0,8324
2021-07-28,benin,Africa,12714341,70,8394
2021-07-29,benin,Africa,12714341,0,8394
2021-07-30,benin,Africa,12714341,0,8394
2021-07-31,benin,Africa,12714341,0,8394
2021-08-01,benin,Africa,12714341,0,8394
2021-08-02,benin,Africa,12714341,0,8394
2021-08-03,benin,Africa,12714341,0,8394
2021-08-04,benin,Africa,12714341,214,8608
2021-08-05,benin,Africa,12714341,0,8608
2021-08-06,benin,Africa,12714341,0,8608
2021-08-07,benin,Africa,12714341,0,8608
2021-08-08,benin,Africa,12714341,0,8608
2021-08-09,benin,Africa,12714341,0,8608
2021-08-10,benin,Africa,12714341,457,9065
2021-08-11,benin,Africa,12714341,0,9065
2021-08-12,benin,Africa,12714341,0,9065
2020-04-07,bermuda,North America,61850,0,39
2020-04-08,bermuda,North America,61850,0,39
2020-04-09,bermuda,North America,61850,9,48
2020-04-10,bermuda,North America,61850,0,48
2020-04-11,bermuda,North America,61850,0,48
2020-04-12,bermuda,North America,61850,9,57
2020-04-13,bermuda,North America,61850,0,57
2020-04-14,bermuda,North America,61850,0,57
2020-04-15,bermuda,North America,61850,24,81
2020-04-16,bermuda,North America,61850,0,81
2020-04-17,bermuda,North America,61850,2,83
2020-04-18,bermuda,North America,61850,0,83
2020-04-19,bermuda,North America,61850,3,86
2020-04-20,bermuda,North America,61850,3,89
2020-04-21,bermuda,North America,61850,9,98
2020-04-22,bermuda,North America,61850,1,99
2020-04-23,bermuda,North America,61850,0,99
2020-04-24,bermuda,North America,61850,0,99
2020-04-25,bermuda,North America,61850,10,109
2020-04-26,bermuda,North America,61850,0,109
2020-04-27,bermuda,North America,61850,1,110
2020-04-28,bermuda,North America,61850,0,110
2020-04-29,bermuda,North America,61850,1,111
2020-04-30,bermuda,North America,61850,3,114
2020-05-01,bermuda,North America,61850,0,114
2020-05-02,bermuda,North America,61850,0,114
2020-05-03,bermuda,North America,61850,1,115
2020-05-04,bermuda,North America,61850,0,115
2020-05-05,bermuda,North America,61850,0,115
2020-05-06,bermuda,North America,61850,3,118
2020-05-07,bermuda,North America,61850,0,118
2020-05-08,bermuda,North America,61850,0,118
2020-05-09,bermuda,North America,61850,0,118
2020-05-10,bermuda,North America,61850,0,118
2020-05-11,bermuda,North America,61850,1,119
2020-05-12,bermuda,North America,61850,2,121
2020-05-13,bermuda,North America,61850,0,121
2020-05-14,bermuda,North America,61850,1,122
2020-05-15,bermuda,North America,61850,0,122
2020-05-16,bermuda,North America,61850,1,123
2020-05-17,bermuda,North America,61850,0,123
2020-05-18,bermuda,North America,61850,2,125
2020-05-19,bermuda,North America,61850,0,125
2020-05-20,bermuda,North America,61850,0,125
2020-05-21,bermuda,North America,61850,0,125
2020-05-22,bermuda,North America,61850,3,128
2020-05-23,bermuda,North America,61850,0,128
2020-05-24,bermuda,North America,61850,5,133
2020-05-25,bermuda,North America,61850,0,133
2020-05-26,bermuda,North America,61850,6,139
2020-05-27,bermuda,North America,61850,0,139
2020-05-28,bermuda,North America,61850,1,140
2020-05-29,bermuda,North America,61850,0,140
2020-05-30,bermuda,North America,61850,0,140
2020-05-31,bermuda,North America,61850,0,140
2020-06-01,bermuda,North America,61850,1,141
2020-06-02,bermuda,North America,61850,0,141
2020-06-03,bermuda,North America,61850,0,141
2020-06-04,bermuda,North America,61850,0,141
2020-06-05,bermuda,North America,61850,0,141
2020-06-06,bermuda,North America,61850,0,141
2020-06-07,bermuda,North America,61850,0,141
2020-06-08,bermuda,North America,61850,0,141
2020-06-09,bermuda,North America,61850,0,141
2020-06-10,bermuda,North America,61850,0,141
2020-06-11,bermuda,North America,61850,0,141
2020-06-12,bermuda,North America,61850,0,141
2020-06-13,bermuda,North America,61850,1,142
2020-06-14,bermuda,North America,61850,0,142
2020-06-15,bermuda,North America,61850,2,144
2020-06-16,bermuda,North America,61850,0,144
2020-06-17,bermuda,North America,61850,0,144
2020-06-18,bermuda,North America,61850,0,144
2020-06-19,bermuda,North America,61850,0,144
2020-06-20,bermuda,North America,61850,2,146
2020-06-21,bermuda,North America,61850,0,146
2020-06-22,bermuda,North America,61850,0,146
2020-06-23,bermuda,North America,61850,0,146
2020-06-24,bermuda,North America,61850,0,146
2020-06-25,bermuda,North America,61850,0,146
2020-06-26,bermuda,North America,61850,0,146
2020-06-27,bermuda,North America,61850,0,146
2020-06-28,bermuda,North America,61850,0,146
2020-06-29,bermuda,North America,61850,0,146
2020-06-30,bermuda,North America,61850,0,146
2020-07-01,bermuda,North America,61850,0,146
2020-07-02,bermuda,North America,61850,0,146
2020-07-03,bermuda,North America,61850,0,146
2020-07-04,bermuda,North America,61850,0,146
2020-07-05,bermuda,North America,61850,0,146
2020-07-06,bermuda,North America,61850,0,146
2020-07-07,bermuda,North America,61850,2,148
2020-07-08,bermuda,North America,61850,1,149
2020-07-09,bermuda,North America,61850,0,149
2020-07-10,bermuda,North America,61850,1,150
2020-07-11,bermuda,North America,61850,0,150
2020-07-12,bermuda,North America,61850,0,150
2020-07-13,bermuda,North America,61850,0,150
2020-07-14,bermuda,North America,61850,0,150
2020-07-15,bermuda,North America,61850,0,150
2020-07-16,bermuda,North America,61850,2,152
2020-07-17,bermuda,North America,61850,0,152
2020-07-18,bermuda,North America,61850,1,153
2020-07-19,bermuda,North America,61850,0,153
2020-07-20,bermuda,North America,61850,0,153
2020-07-21,bermuda,North America,61850,0,153
2020-07-22,bermuda,North America,61850,0,153
2020-07-23,bermuda,North America,61850,0,153
2020-07-24,bermuda,North America,61850,0,153
2020-07-25,bermuda,North America,61850,0,153
2020-07-26,bermuda,North America,61850,0,153
2020-07-27,bermuda,North America,61850,1,154
2020-07-28,bermuda,North America,61850,2,156
2020-07-29,bermuda,North America,61850,0,156
2020-07-30,bermuda,North America,61850,0,156
2020-07-31,bermuda,North America,61850,0,156
2020-08-01,bermuda,North America,61850,0,156
2020-08-02,bermuda,North America,61850,1,157
2020-08-03,bermuda,North America,61850,0,157
2020-08-04,bermuda,North America,61850,0,157
2020-08-05,bermuda,North America,61850,0,157
2020-08-06,bermuda,North America,61850,0,157
2020-08-07,bermuda,North America,61850,0,157
2020-08-08,bermuda,North America,61850,0,157
2020-08-09,bermuda,North America,61850,1,158
2020-08-10,bermuda,North America,61850,0,158
2020-08-11,bermuda,North America,61850,1,159
2020-08-12,bermuda,North America,61850,0,159
2020-08-13,bermuda,North America,61850,0,159
2020-08-14,bermuda,North America,61850,0,159
2020-08-15,bermuda,North America,61850,3,162
2020-08-16,bermuda,North America,61850,0,162
2020-08-17,bermuda,North America,61850,0,162
2020-08-18,bermuda,North America,61850,4,166
2020-08-19,bermuda,North America,61850,0,166
2020-08-20,bermuda,North America,61850,0,166
2020-08-21,bermuda,North America,61850,1,167
2020-08-22,bermuda,North America,61850,0,167
2020-08-23,bermuda,North America,61850,0,167
2020-08-24,bermuda,North America,61850,1,168
2020-08-25,bermuda,North America,61850,0,168
2020-08-26,bermuda,North America,61850,0,168
2020-08-27,bermuda,North America,61850,0,168
2020-08-28,bermuda,North America,61850,0,168
2020-08-29,bermuda,North America,61850,1,169
2020-08-30,bermuda,North America,61850,0,169
2020-08-31,bermuda,North America,61850,3,172
2020-09-01,bermuda,North America,61850,0,172
2020-09-02,bermuda,North America,61850,0,172
2020-09-03,bermuda,North America,61850,2,174
2020-09-04,bermuda,North America,61850,1,175
2020-09-05,bermuda,North America,61850,0,175
2020-09-06,bermuda,North America,61850,0,175
2020-09-07,bermuda,North America,61850,0,175
2020-09-08,bermuda,North America,61850,0,175
2020-09-09,bermuda,North America,61850,2,177
2020-09-10,bermuda,North America,61850,0,177
2020-09-11,bermuda,North America,61850,0,177
2020-09-12,bermuda,North America,61850,0,177
2020-09-13,bermuda,North America,61850,0,177
2020-09-14,bermuda,North America,61850,0,177
2020-09-15,bermuda,North America,61850,0,177
2020-09-16,bermuda,North America,61850,1,178
2020-09-17,bermuda,North America,61850,0,178
2020-09-18,bermuda,North America,61850,0,178
2020-09-19,bermuda,North America,61850,2,180
2020-09-20,bermuda,North America,61850,0,180
2020-09-21,bermuda,North America,61850,0,180
2020-09-22,bermuda,North America,61850,0,180
2020-09-23,bermuda,North America,61850,1,181
2020-09-24,bermuda,North America,61850,0,181
2020-09-25,bermuda,North America,61850,0,181
2020-09-26,bermuda,North America,61850,0,181
2020-09-27,bermuda,North America,61850,0,181
2020-09-28,bermuda,North America,61850,0,181
2020-09-29,bermuda,North America,61850,0,181
2020-09-30,bermuda,North America,61850,0,181
2020-10-01,bermuda,North America,61850,0,181
2020-10-02,bermuda,North America,61850,0,181
2020-10-03,bermuda,North America,61850,0,181
2020-10-04,bermuda,North America,61850,0,181
2020-10-05,bermuda,North America,61850,0,181
2020-10-06,bermuda,North America,61850,0,181
2020-10-07,bermuda,North America,61850,0,181
2020-10-08,bermuda,North America,61850,1,182
2020-10-09,bermuda,North America,61850,2,184
2020-10-10,bermuda,North America,61850,0,184
2020-10-11,bermuda,North America,61850,0,184
2020-10-12,bermuda,North America,61850,0,184
2020-10-13,bermuda,North America,61850,1,185
2020-10-14,bermuda,North America,61850,0,185
2020-10-15,bermuda,North America,61850,0,185
2020-10-16,bermuda,North America,61850,0,185
2020-10-17,bermuda,North America,61850,0,185
2020-10-18,bermuda,North America,61850,0,185
2020-10-19,bermuda,North America,61850,0,185
2020-10-20,bermuda,North America,61850,3,188
2020-10-21,bermuda,North America,61850,0,188
2020-10-22,bermuda,North America,61850,0,188
2020-10-23,bermuda,North America,61850,2,190
2020-10-24,bermuda,North America,61850,0,190
2020-10-25,bermuda,North America,61850,0,190
2020-10-26,bermuda,North America,61850,3,193
2020-10-27,bermuda,North America,61850,1,194
2020-10-28,bermuda,North America,61850,0,194
2020-10-29,bermuda,North America,61850,4,198
2020-10-30,bermuda,North America,61850,1,199
2020-10-31,bermuda,North America,61850,0,199
2020-11-01,bermuda,North America,61850,0,199
2020-11-02,bermuda,North America,61850,7,206
2020-11-03,bermuda,North America,61850,0,206
2020-11-04,bermuda,North America,61850,0,206
2020-11-05,bermuda,North America,61850,1,207
2020-11-06,bermuda,North America,61850,0,207
2020-11-07,bermuda,North America,61850,2,209
2020-11-08,bermuda,North America,61850,0,209
2020-11-09,bermuda,North America,61850,5,214
2020-11-10,bermuda,North America,61850,0,214
2020-11-11,bermuda,North America,61850,0,214
2020-11-12,bermuda,North America,61850,6,220
2020-11-13,bermuda,North America,61850,2,222
2020-11-14,bermuda,North America,61850,0,222
2020-11-15,bermuda,North America,61850,0,222
2020-11-16,bermuda,North America,61850,1,223
2020-11-17,bermuda,North America,61850,0,223
2020-11-18,bermuda,North America,61850,1,224
2020-11-19,bermuda,North America,61850,2,226
2020-11-20,bermuda,North America,61850,1,227
2020-11-21,bermuda,North America,61850,0,227
2020-11-22,bermuda,North America,61850,0,227
2020-11-23,bermuda,North America,61850,0,227
2020-11-24,bermuda,North America,61850,0,227
2020-11-25,bermuda,North America,61850,12,239
2020-11-26,bermuda,North America,61850,2,241
2020-11-27,bermuda,North America,61850,1,242
2020-11-28,bermuda,North America,61850,5,247
2020-11-29,bermuda,North America,61850,4,251
2020-11-30,bermuda,North America,61850,9,260
2020-12-01,bermuda,North America,61850,2,262
2020-12-02,bermuda,North America,61850,5,267
2020-12-03,bermuda,North America,61850,5,272
2020-12-04,bermuda,North America,61850,6,278
2020-12-05,bermuda,North America,61850,10,288
2020-12-06,bermuda,North America,61850,0,288
2020-12-07,bermuda,North America,61850,18,306
2020-12-08,bermuda,North America,61850,24,330
2020-12-09,bermuda,North America,61850,10,340
2020-12-10,bermuda,North America,61850,24,364
2020-12-11,bermuda,North America,61850,27,391
2020-12-12,bermuda,North America,61850,0,391
2020-12-13,bermuda,North America,61850,0,391
2020-12-14,bermuda,North America,61850,40,431
2020-12-15,bermuda,North America,61850,25,456
2020-12-16,bermuda,North America,61850,11,467
2020-12-17,bermuda,North America,61850,18,485
2020-12-18,bermuda,North America,61850,12,497
2020-12-19,bermuda,North America,61850,19,516
2020-12-20,bermuda,North America,61850,11,527
2020-12-21,bermuda,North America,61850,0,527
2020-12-22,bermuda,North America,61850,26,553
2020-12-23,bermuda,North America,61850,0,553
2020-12-24,bermuda,North America,61850,7,560
2020-12-25,bermuda,North America,61850,1,561
2020-12-26,bermuda,North America,61850,20,581
2020-12-27,bermuda,North America,61850,0,581
2020-12-28,bermuda,North America,61850,0,581
2020-12-29,bermuda,North America,61850,14,595
2020-12-30,bermuda,North America,61850,0,595
2020-12-31,bermuda,North America,61850,9,604
2021-01-01,bermuda,North America,61850,0,604
2021-01-02,bermuda,North America,61850,18,622
2021-01-03,bermuda,North America,61850,0,622
2021-01-04,bermuda,North America,61850,2,624
2021-01-05,bermuda,North America,61850,8,632
2021-01-06,bermuda,North America,61850,0,632
2021-01-07,bermuda,North America,61850,4,636
2021-01-08,bermuda,North America,61850,5,641
2021-01-09,bermuda,North America,61850,5,646
2021-01-10,bermuda,North America,61850,6,652
2021-01-11,bermuda,North America,61850,4,656
2021-01-12,bermuda,North America,61850,0,656
2021-01-13,bermuda,North America,61850,5,661
2021-01-14,bermuda,North America,61850,3,664
2021-01-15,bermuda,North America,61850,3,667
2021-01-16,bermuda,North America,61850,3,670
2021-01-17,bermuda,North America,61850,0,670
2021-01-18,bermuda,North America,61850,13,683
2021-01-19,bermuda,North America,61850,1,684
2021-01-20,bermuda,North America,61850,0,684
2021-01-21,bermuda,North America,61850,0,684
2021-01-22,bermuda,North America,61850,0,684
2021-01-23,bermuda,North America,61850,2,686
2021-01-24,bermuda,North America,61850,0,686
2021-01-25,bermuda,North America,61850,0,686
2021-01-26,bermuda,North America,61850,2,688
2021-01-27,bermuda,North America,61850,1,689
2021-01-28,bermuda,North America,61850,1,690
2021-01-29,bermuda,North America,61850,1,691
2021-01-30,bermuda,North America,61850,0,691
2021-01-31,bermuda,North America,61850,0,691
2021-02-01,bermuda,North America,61850,1,692
2021-02-02,bermuda,North America,61850,0,692
2021-02-03,bermuda,North America,61850,0,692
2021-02-04,bermuda,North America,61850,0,692
2021-02-05,bermuda,North America,61850,0,692
2021-02-06,bermuda,North America,61850,0,692
2021-02-07,bermuda,North America,61850,0,692
2021-02-08,bermuda,North America,61850,2,694
2021-02-09,bermuda,North America,61850,0,694
2021-02-10,bermuda,North America,61850,0,694
2021-02-11,bermuda,North America,61850,0,694
2021-02-12,bermuda,North America,61850,0,694
2021-02-13,bermuda,North America,61850,0,694
2021-02-14,bermuda,North America,61850,0,694
2021-02-15,bermuda,North America,61850,1,695
2021-02-16,bermuda,North America,61850,0,695
2021-02-17,bermuda,North America,61850,2,697
2021-02-18,bermuda,North America,61850,2,699
2021-02-19,bermuda,North America,61850,0,699
2021-02-20,bermuda,North America,61850,0,699
2021-02-21,bermuda,North America,61850,0,699
2021-02-22,bermuda,North America,61850,0,699
2021-02-23,bermuda,North America,61850,4,703
2021-02-24,bermuda,North America,61850,0,703
2021-02-25,bermuda,North America,61850,2,705
2021-02-26,bermuda,North America,61850,0,705
2021-02-27,bermuda,North America,61850,0,705
2021-02-28,bermuda,North America,61850,0,705
2021-03-01,bermuda,North America,61850,2,707
2021-03-02,bermuda,North America,61850,6,713
2021-03-03,bermuda,North America,61850,0,713
2021-03-04,bermuda,North America,61850,5,718
2021-03-05,bermuda,North America,61850,4,722
2021-03-06,bermuda,North America,61850,0,722
2021-03-07,bermuda,North America,61850,0,722
2021-03-08,bermuda,North America,61850,2,724
2021-03-09,bermuda,North America,61850,0,724
2021-03-10,bermuda,North America,61850,7,731
2021-03-11,bermuda,North America,61850,1,732
2021-03-12,bermuda,North America,61850,0,732
2021-03-13,bermuda,North America,61850,3,735
2021-03-14,bermuda,North America,61850,0,735
2021-03-15,bermuda,North America,61850,5,740
2021-03-16,bermuda,North America,61850,0,740
2021-03-17,bermuda,North America,61850,0,740
2021-03-18,bermuda,North America,61850,0,740
2021-03-19,bermuda,North America,61850,27,767
2021-03-20,bermuda,North America,61850,6,773
2021-03-21,bermuda,North America,61850,16,789
2021-03-22,bermuda,North America,61850,41,830
2021-03-23,bermuda,North America,61850,10,840
2021-03-24,bermuda,North America,61850,0,840
2021-03-25,bermuda,North America,61850,40,880
2021-03-26,bermuda,North America,61850,34,914
2021-03-27,bermuda,North America,61850,33,947
2021-03-28,bermuda,North America,61850,81,1028
2021-03-29,bermuda,North America,61850,108,1136
2021-03-30,bermuda,North America,61850,21,1157
2021-03-31,bermuda,North America,61850,60,1217
2021-04-01,bermuda,North America,61850,75,1292
2021-04-02,bermuda,North America,61850,0,1292
2021-04-03,bermuda,North America,61850,0,1292
2021-04-04,bermuda,North America,61850,108,1400
2021-04-05,bermuda,North America,61850,69,1469
2021-04-06,bermuda,North America,61850,0,1469
2021-04-07,bermuda,North America,61850,28,1497
2021-04-08,bermuda,North America,61850,89,1586
2021-04-09,bermuda,North America,61850,71,1657
2021-04-10,bermuda,North America,61850,116,1773
2021-04-11,bermuda,North America,61850,0,1773
2021-04-12,bermuda,North America,61850,118,1891
2021-04-13,bermuda,North America,61850,21,1912
2021-04-14,bermuda,North America,61850,23,1935
2021-04-15,bermuda,North America,61850,88,2023
2021-04-16,bermuda,North America,61850,37,2060
2021-04-17,bermuda,North America,61850,63,2123
2021-04-18,bermuda,North America,61850,0,2123
2021-04-19,bermuda,North America,61850,91,2214
2021-04-20,bermuda,North America,61850,0,2214
2021-04-21,bermuda,North America,61850,12,2226
2021-04-22,bermuda,North America,61850,35,2261
2021-04-23,bermuda,North America,61850,23,2284
2021-04-24,bermuda,North America,61850,31,2315
2021-04-25,bermuda,North America,61850,20,2335
2021-04-26,bermuda,North America,61850,22,2357
2021-04-27,bermuda,North America,61850,5,2362
2021-04-28,bermuda,North America,61850,12,2374
2021-04-29,bermuda,North America,61850,8,2382
2021-04-30,bermuda,North America,61850,11,2393
2021-05-01,bermuda,North America,61850,0,2393
2021-05-02,bermuda,North America,61850,0,2393
2021-05-03,bermuda,North America,61850,0,2393
2021-05-04,bermuda,North America,61850,29,2422
2021-05-05,bermuda,North America,61850,5,2427
2021-05-06,bermuda,North America,61850,2,2429
2021-05-07,bermuda,North America,61850,3,2432
2021-05-08,bermuda,North America,61850,2,2434
2021-05-09,bermuda,North America,61850,0,2434
2021-05-10,bermuda,North America,61850,17,2451
2021-05-11,bermuda,North America,61850,4,2455
2021-05-12,bermuda,North America,61850,0,2455
2021-05-13,bermuda,North America,61850,6,2461
2021-05-14,bermuda,North America,61850,1,2462
2021-05-15,bermuda,North America,61850,4,2466
2021-05-16,bermuda,North America,61850,0,2466
2021-05-17,bermuda,North America,61850,11,2477
2021-05-18,bermuda,North America,61850,2,2479
2021-05-19,bermuda,North America,61850,0,2479
2021-05-20,bermuda,North America,61850,4,2483
2021-05-21,bermuda,North America,61850,5,2488
2021-05-22,bermuda,North America,61850,0,2488
2021-05-23,bermuda,North America,61850,0,2488
2021-05-24,bermuda,North America,61850,2,2490
2021-05-25,bermuda,North America,61850,0,2490
2021-05-26,bermuda,North America,61850,1,2491
2021-05-27,bermuda,North America,61850,0,2491
2021-05-28,bermuda,North America,61850,0,2491
2021-05-29,bermuda,North America,61850,0,2491
2021-05-30,bermuda,North America,61850,0,2491
2021-05-31,bermuda,North America,61850,3,2494
2021-06-01,bermuda,North America,61850,0,2494
2021-06-02,bermuda,North America,61850,0,2494
2021-06-03,bermuda,North America,61850,0,2494
2021-06-04,bermuda,North America,61850,0,2494
2021-06-05,bermuda,North America,61850,0,2494
2021-06-06,bermuda,North America,61850,0,2494
2021-06-07,bermuda,North America,61850,3,2497
2021-06-08,bermuda,North America,61850,0,2497
2021-06-09,bermuda,North America,61850,0,2497
2021-06-10,bermuda,North America,61850,0,2497
2021-06-11,bermuda,North America,61850,0,2497
2021-06-12,bermuda,North America,61850,0,2497
2021-06-13,bermuda,North America,61850,0,2497
2021-06-14,bermuda,North America,61850,1,2498
2021-06-15,bermuda,North America,61850,1,2499
2021-06-16,bermuda,North America,61850,0,2499
2021-06-17,bermuda,North America,61850,0,2499
2021-06-18,bermuda,North America,61850,5,2504
2021-06-19,bermuda,North America,61850,0,2504
2021-06-20,bermuda,North America,61850,0,2504
2021-06-21,bermuda,North America,61850,0,2504
2021-06-22,bermuda,North America,61850,0,2504
2021-06-23,bermuda,North America,61850,0,2504
2021-06-24,bermuda,North America,61850,0,2504
2021-06-25,bermuda,North America,61850,6,2510
2021-06-26,bermuda,North America,61850,0,2510
2021-06-27,bermuda,North America,61850,0,2510
2021-06-28,bermuda,North America,61850,0,2510
2021-06-29,bermuda,North America,61850,4,2514
2021-06-30,bermuda,North America,61850,0,2514
2021-07-01,bermuda,North America,61850,0,2514
2021-07-02,bermuda,North America,61850,0,2514
2021-07-03,bermuda,North America,61850,2,2516
2021-07-04,bermuda,North America,61850,0,2516
2021-07-05,bermuda,North America,61850,0,2516
2021-07-06,bermuda,North America,61850,5,2521
2021-07-07,bermuda,North America,61850,0,2521
2021-07-08,bermuda,North America,61850,0,2521
2021-07-09,bermuda,North America,61850,0,2521
2021-07-10,bermuda,North America,61850,0,2521
2021-07-11,bermuda,North America,61850,0,2521
2021-07-12,bermuda,North America,61850,0,2521
2021-07-13,bermuda,North America,61850,4,2525
2021-07-14,bermuda,North America,61850,0,2525
2021-07-15,bermuda,North America,61850,0,2525
2021-07-16,bermuda,North America,61850,5,2530
2021-07-17,bermuda,North America,61850,0,2530
2021-07-18,bermuda,North America,61850,0,2530
2021-07-19,bermuda,North America,61850,0,2530
2021-07-20,bermuda,North America,61850,0,2530
2021-07-21,bermuda,North America,61850,5,2535
2021-07-22,bermuda,North America,61850,0,2535
2021-07-23,bermuda,North America,61850,0,2535
2021-07-24,bermuda,North America,61850,3,2538
2021-07-25,bermuda,North America,61850,0,2538
2021-07-26,bermuda,North America,61850,0,2538
2021-07-27,bermuda,North America,61850,0,2538
2021-07-28,bermuda,North America,61850,15,2553
2021-07-29,bermuda,North America,61850,0,2553
2021-07-30,bermuda,North America,61850,0,2553
2021-07-31,bermuda,North America,61850,15,2568
2021-08-01,bermuda,North America,61850,0,2568
2021-08-02,bermuda,North America,61850,0,2568
2021-08-03,bermuda,North America,61850,21,2589
2021-08-04,bermuda,North America,61850,0,2589
2021-08-05,bermuda,North America,61850,0,2589
2021-08-06,bermuda,North America,61850,25,2614
2021-08-07,bermuda,North America,61850,0,2614
2021-08-08,bermuda,North America,61850,0,2614
2021-08-09,bermuda,North America,61850,0,2614
2021-08-10,bermuda,North America,61850,31,2645
2021-08-11,bermuda,North America,61850,0,2645
2021-08-12,bermuda,North America,61850,0,2645
2021-08-13,bermuda,North America,61850,18,2663
2021-08-14,bermuda,North America,61850,0,2663
2021-08-15,bermuda,North America,61850,0,2663
2021-08-16,bermuda,North America,61850,0,2663
2021-08-17,bermuda,North America,61850,0,2663
2021-08-18,bermuda,North America,61850,52,2715
2021-08-19,bermuda,North America,61850,0,2715
2021-08-20,bermuda,North America,61850,0,2715
2021-08-21,bermuda,North America,61850,35,2750
2021-08-22,bermuda,North America,61850,0,2750
2021-08-23,bermuda,North America,61850,0,2750
2021-08-24,bermuda,North America,61850,42,2792
2021-08-25,bermuda,North America,61850,0,2792
2021-08-26,bermuda,North America,61850,0,2792
2021-08-27,bermuda,North America,61850,52,2844
2021-08-28,bermuda,North America,61850,0,2844
2021-08-29,bermuda,North America,61850,0,2844
2021-08-30,bermuda,North America,61850,0,2844
2021-08-31,bermuda,North America,61850,79,2923
2021-09-01,bermuda,North America,61850,0,2923
2021-09-02,bermuda,North America,61850,0,2923
2021-09-03,bermuda,North America,61850,125,3048
2021-09-04,bermuda,North America,61850,0,3048
2021-09-05,bermuda,North America,61850,0,3048
2021-09-06,bermuda,North America,61850,0,3048
2021-09-07,bermuda,North America,61850,225,3273
2021-09-08,bermuda,North America,61850,0,3273
2021-09-09,bermuda,North America,61850,0,3273
2021-09-10,bermuda,North America,61850,192,3465
2021-09-11,bermuda,North America,61850,0,3465
2021-09-12,bermuda,North America,61850,0,3465
2021-09-13,bermuda,North America,61850,0,3465
2021-09-14,bermuda,North America,61850,412,3877
2021-09-15,bermuda,North America,61850,0,3877
2021-09-16,bermuda,North America,61850,150,4027
2021-09-17,bermuda,North America,61850,191,4218
2021-09-18,bermuda,North America,61850,0,4218
2021-09-19,bermuda,North America,61850,259,4477
2021-09-20,bermuda,North America,61850,155,4632
2021-09-21,bermuda,North America,61850,0,4632
2021-09-22,bermuda,North America,61850,168,4800
2021-09-23,bermuda,North America,61850,0,4800
2021-09-24,bermuda,North America,61850,182,4982
2021-09-25,bermuda,North America,61850,0,4982
2021-09-26,bermuda,North America,61850,0,4982
2021-09-27,bermuda,North America,61850,163,5145
2021-09-28,bermuda,North America,61850,0,5145
2021-09-29,bermuda,North America,61850,99,5244
2021-09-30,bermuda,North America,61850,0,5244
2021-10-01,bermuda,North America,61850,0,5244
2021-10-02,bermuda,North America,61850,92,5336
2021-10-03,bermuda,North America,61850,0,5336
2021-10-04,bermuda,North America,61850,83,5419
2021-10-05,bermuda,North America,61850,0,5419
2021-10-06,bermuda,North America,61850,36,5455
2021-10-07,bermuda,North America,61850,0,5455
2021-10-08,bermuda,North America,61850,46,5501
2021-10-09,bermuda,North America,61850,0,5501
2021-10-10,bermuda,North America,61850,0,5501
2021-10-11,bermuda,North America,61850,0,5501
2021-10-12,bermuda,North America,61850,35,5536
2021-10-13,bermuda,North America,61850,0,5536
2021-10-14,bermuda,North America,61850,12,5548
2021-10-15,bermuda,North America,61850,0,5548
2021-10-16,bermuda,North America,61850,0,5548
2021-10-17,bermuda,North America,61850,19,5567
2021-10-18,bermuda,North America,61850,0,5567
2021-10-19,bermuda,North America,61850,26,5593
2021-10-20,bermuda,North America,61850,0,5593
2021-10-21,bermuda,North America,61850,0,5593
2021-10-22,bermuda,North America,61850,19,5612
2021-10-23,bermuda,North America,61850,0,5612
2021-10-24,bermuda,North America,61850,0,5612
2021-10-25,bermuda,North America,61850,13,5625
2021-10-26,bermuda,North America,61850,0,5625
2021-10-27,bermuda,North America,61850,12,5637
2021-10-28,bermuda,North America,61850,0,5637
2021-10-29,bermuda,North America,61850,10,5647
2021-10-30,bermuda,North America,61850,0,5647
2021-10-31,bermuda,North America,61850,0,5647
2021-11-01,bermuda,North America,61850,10,5657
2021-11-02,bermuda,North America,61850,0,5657
2021-11-03,bermuda,North America,61850,8,5665
2021-11-04,bermuda,North America,61850,0,5665
2021-11-05,bermuda,North America,61850,12,5677
2021-11-06,bermuda,North America,61850,0,5677
2021-11-07,bermuda,North America,61850,0,5677
2021-11-08,bermuda,North America,61850,11,5688
2021-11-09,bermuda,North America,61850,0,5688
2021-11-10,bermuda,North America,61850,0,5688
2021-11-11,bermuda,North America,61850,0,5688
2021-11-12,bermuda,North America,61850,20,5708
2021-11-13,bermuda,North America,61850,0,5708
2021-11-14,bermuda,North America,61850,0,5708
2021-11-15,bermuda,North America,61850,0,5708
2021-11-16,bermuda,North America,61850,5,5713
2021-11-17,bermuda,North America,61850,1,5714
2021-11-18,bermuda,North America,61850,0,5714
2021-11-19,bermuda,North America,61850,1,5715
2021-11-20,bermuda,North America,61850,0,5715
2021-11-21,bermuda,North America,61850,0,5715
2021-11-22,bermuda,North America,61850,9,5724
2021-11-23,bermuda,North America,61850,0,5724
2021-11-24,bermuda,North America,61850,0,5724
2021-11-25,bermuda,North America,61850,6,5730
2021-11-26,bermuda,North America,61850,0,5730
2021-11-27,bermuda,North America,61850,0,5730
2021-11-28,bermuda,North America,61850,0,5730
2021-11-29,bermuda,North America,61850,18,5748
2021-11-30,bermuda,North America,61850,0,5748
2021-12-01,bermuda,North America,61850,0,5748
2021-12-02,bermuda,North America,61850,3,5751
2021-12-03,bermuda,North America,61850,0,5751
2021-12-04,bermuda,North America,61850,0,5751
2021-12-05,bermuda,North America,61850,0,5751
2021-12-06,bermuda,North America,61850,0,5751
2021-12-07,bermuda,North America,61850,0,5751
2021-12-08,bermuda,North America,61850,9,5760
2021-12-09,bermuda,North America,61850,0,5760
2021-12-10,bermuda,North America,61850,4,5764
2021-12-11,bermuda,North America,61850,0,5764
2021-12-12,bermuda,North America,61850,0,5764
2021-12-13,bermuda,North America,61850,20,5784
2021-12-14,bermuda,North America,61850,0,5784
2021-12-15,bermuda,North America,61850,0,5784
2021-12-16,bermuda,North America,61850,31,5815
2021-12-17,bermuda,North America,61850,0,5815
2021-12-18,bermuda,North America,61850,0,5815
2021-12-19,bermuda,North America,61850,0,5815
2021-12-20,bermuda,North America,61850,102,5917
2021-12-21,bermuda,North America,61850,0,5917
2021-12-22,bermuda,North America,61850,0,5917
2021-12-23,bermuda,North America,61850,97,6014
2021-12-24,bermuda,North America,61850,0,6014
2021-12-25,bermuda,North America,61850,0,6014
2021-12-26,bermuda,North America,61850,0,6014
2021-12-27,bermuda,North America,61850,0,6014
2021-12-28,bermuda,North America,61850,0,6014
2021-12-29,bermuda,North America,61850,0,6014
2021-12-30,bermuda,North America,61850,406,6420
2021-12-31,bermuda,North America,61850,0,6420
2022-01-01,bermuda,North America,61850,0,6420
2022-01-02,bermuda,North America,61850,0,6420
2022-01-03,bermuda,North America,61850,0,6420
2022-01-04,bermuda,North America,61850,516,6936
2022-01-05,bermuda,North America,61850,0,6936
2022-01-06,bermuda,North America,61850,0,6936
2022-01-07,bermuda,North America,61850,255,7191
2022-01-08,bermuda,North America,61850,0,7191
2022-01-09,bermuda,North America,61850,0,7191
2022-01-10,bermuda,North America,61850,689,7880
2022-01-11,bermuda,North America,61850,0,7880
2022-01-12,bermuda,North America,61850,0,7880
2022-01-13,bermuda,North America,61850,0,7880
2022-01-14,bermuda,North America,61850,661,8541
2022-01-15,bermuda,North America,61850,0,8541
2022-01-16,bermuda,North America,61850,0,8541
2022-01-17,bermuda,North America,61850,603,9144
2022-01-18,bermuda,North America,61850,0,9144
2022-01-19,bermuda,North America,61850,0,9144
2022-01-20,bermuda,North America,61850,622,9766
2022-01-21,bermuda,North America,61850,0,9766
2022-01-22,bermuda,North America,61850,0,9766
2022-01-23,bermuda,North America,61850,0,9766
2022-01-24,bermuda,North America,61850,496,10262
2022-01-25,bermuda,North America,61850,0,10262
2022-01-26,bermuda,North America,61850,0,10262
2022-01-27,bermuda,North America,61850,290,10552
2022-01-28,bermuda,North America,61850,0,10552
2022-01-29,bermuda,North America,61850,0,10552
2022-01-30,bermuda,North America,61850,0,10552
2022-01-31,bermuda,North America,61850,241,10793
2022-02-01,bermuda,North America,61850,0,10793
2022-02-02,bermuda,North America,61850,0,10793
2022-02-03,bermuda,North America,61850,128,10921
2022-02-04,bermuda,North America,61850,0,10921
2022-02-05,bermuda,North America,61850,0,10921
2022-02-06,bermuda,North America,61850,0,10921
2022-02-07,bermuda,North America,61850,137,11058
2022-02-08,bermuda,North America,61850,0,11058
2022-02-09,bermuda,North America,61850,0,11058
2022-02-10,bermuda,North America,61850,88,11146
2022-02-11,bermuda,North America,61850,0,11146
2022-02-12,bermuda,North America,61850,0,11146
2022-02-13,bermuda,North America,61850,0,11146
2022-02-14,bermuda,North America,61850,100,11246
2022-02-15,bermuda,North America,61850,0,11246
2022-02-16,bermuda,North America,61850,0,11246
2022-02-17,bermuda,North America,61850,70,11316
2022-02-18,bermuda,North America,61850,0,11316
2022-02-19,bermuda,North America,61850,0,11316
2022-02-20,bermuda,North America,61850,0,11316
2022-02-21,bermuda,North America,61850,107,11423
2022-02-22,bermuda,North America,61850,0,11423
2022-02-23,bermuda,North America,61850,0,11423
2022-02-24,bermuda,North America,61850,67,11490
2022-02-25,bermuda,North America,61850,0,11490
2022-02-26,bermuda,North America,61850,0,11490
2022-02-27,bermuda,North America,61850,0,11490
2022-02-28,bermuda,North America,61850,71,11561
2022-03-01,bermuda,North America,61850,0,11561
2022-03-02,bermuda,North America,61850,0,11561
2022-03-03,bermuda,North America,61850,73,11634
2022-03-04,bermuda,North America,61850,0,11634
2022-03-05,bermuda,North America,61850,0,11634
2022-03-06,bermuda,North America,61850,0,11634
2022-03-07,bermuda,North America,61850,109,11743
2022-03-08,bermuda,North America,61850,0,11743
2022-03-09,bermuda,North America,61850,0,11743
2022-03-10,bermuda,North America,61850,107,11850
2022-03-11,bermuda,North America,61850,0,11850
2022-03-12,bermuda,North America,61850,0,11850
2022-03-13,bermuda,North America,61850,0,11850
2022-03-14,bermuda,North America,61850,139,11989
2022-03-15,bermuda,North America,61850,0,11989
2022-03-16,bermuda,North America,61850,0,11989
2022-03-17,bermuda,North America,61850,105,12094
2022-03-18,bermuda,North America,61850,0,12094
2022-03-19,bermuda,North America,61850,0,12094
2022-03-20,bermuda,North America,61850,0,12094
2022-03-21,bermuda,North America,61850,137,12231
2022-03-22,bermuda,North America,61850,0,12231
2022-03-23,bermuda,North America,61850,0,12231
2022-03-24,bermuda,North America,61850,123,12354
2022-03-25,bermuda,North America,61850,0,12354
2022-03-26,bermuda,North America,61850,0,12354
2022-03-27,bermuda,North America,61850,0,12354
2022-03-28,bermuda,North America,61850,102,12456
2022-03-29,bermuda,North America,61850,0,12456
2022-03-30,bermuda,North America,61850,0,12456
2022-03-31,bermuda,North America,61850,108,12564
2022-04-01,bermuda,North America,61850,0,12564
2020-03-30,bolivia,South America,11969554,16,97
2020-03-31,bolivia,South America,11969554,10,107
2020-04-01,bolivia,South America,11969554,8,115
2020-04-02,bolivia,South America,11969554,8,123
2020-04-03,bolivia,South America,11969554,9,132
2020-04-04,bolivia,South America,11969554,7,139
2020-04-05,bolivia,South America,11969554,18,157
2020-04-06,bolivia,South America,11969554,26,183
2020-04-07,bolivia,South America,11969554,11,194
2020-04-08,bolivia,South America,11969554,16,210
2020-04-09,bolivia,South America,11969554,54,264
2020-04-10,bolivia,South America,11969554,4,268
2020-04-11,bolivia,South America,11969554,7,275
2020-04-12,bolivia,South America,11969554,25,300
2020-04-13,bolivia,South America,11969554,30,330
2020-04-14,bolivia,South America,11969554,24,354
2020-04-15,bolivia,South America,11969554,43,397
2020-04-16,bolivia,South America,11969554,44,441
2020-04-17,bolivia,South America,11969554,24,465
2020-04-18,bolivia,South America,11969554,28,493
2020-04-19,bolivia,South America,11969554,27,520
2020-04-20,bolivia,South America,11969554,44,564
2020-04-21,bolivia,South America,11969554,34,598
2020-04-22,bolivia,South America,11969554,11,609
2020-04-23,bolivia,South America,11969554,63,672
2020-04-24,bolivia,South America,11969554,31,703
2020-04-25,bolivia,South America,11969554,104,807
2020-04-26,bolivia,South America,11969554,59,866
2020-04-27,bolivia,South America,11969554,84,950
2020-04-28,bolivia,South America,11969554,64,1014
2020-04-29,bolivia,South America,11969554,39,1053
2020-04-30,bolivia,South America,11969554,57,1110
2020-05-01,bolivia,South America,11969554,57,1167
2020-05-02,bolivia,South America,11969554,62,1229
2020-05-03,bolivia,South America,11969554,241,1470
2020-05-04,bolivia,South America,11969554,124,1594
2020-05-05,bolivia,South America,11969554,87,1681
2020-05-06,bolivia,South America,11969554,121,1802
2020-05-07,bolivia,South America,11969554,84,1886
2020-05-08,bolivia,South America,11969554,195,2081
2020-05-09,bolivia,South America,11969554,185,2266
2020-05-10,bolivia,South America,11969554,171,2437
2020-05-11,bolivia,South America,11969554,119,2556
2020-05-12,bolivia,South America,11969554,275,2831
2020-05-13,bolivia,South America,11969554,133,2964
2020-05-14,bolivia,South America,11969554,184,3148
2020-05-15,bolivia,South America,11969554,224,3372
2020-05-16,bolivia,South America,11969554,205,3577
2020-05-17,bolivia,South America,11969554,249,3826
2020-05-18,bolivia,South America,11969554,262,4088
2020-05-19,bolivia,South America,11969554,175,4263
2020-05-20,bolivia,South America,11969554,218,4481
2020-05-21,bolivia,South America,11969554,438,4919
2020-05-22,bolivia,South America,11969554,268,5187
2020-05-23,bolivia,South America,11969554,392,5579
2020-05-24,bolivia,South America,11969554,336,5915
2020-05-25,bolivia,South America,11969554,348,6263
2020-05-26,bolivia,South America,11969554,397,6660
2020-05-27,bolivia,South America,11969554,476,7136
2020-05-28,bolivia,South America,11969554,632,7768
2020-05-29,bolivia,South America,11969554,619,8387
2020-05-30,bolivia,South America,11969554,344,8731
2020-05-31,bolivia,South America,11969554,861,9592
2020-06-01,bolivia,South America,11969554,390,9982
2020-06-02,bolivia,South America,11969554,549,10531
2020-06-03,bolivia,South America,11969554,460,10991
2020-06-04,bolivia,South America,11969554,647,11638
2020-06-05,bolivia,South America,11969554,607,12245
2020-06-06,bolivia,South America,11969554,483,12728
2020-06-07,bolivia,South America,11969554,630,13358
2020-06-08,bolivia,South America,11969554,285,13643
2020-06-09,bolivia,South America,11969554,306,13949
2020-06-10,bolivia,South America,11969554,695,14644
2020-06-11,bolivia,South America,11969554,637,15281
2020-06-12,bolivia,South America,11969554,884,16165
2020-06-13,bolivia,South America,11969554,764,16929
2020-06-14,bolivia,South America,11969554,913,17842
2020-06-15,bolivia,South America,11969554,617,18459
2020-06-16,bolivia,South America,11969554,614,19073
2020-06-17,bolivia,South America,11969554,810,19883
2020-06-18,bolivia,South America,11969554,802,20685
2020-06-19,bolivia,South America,11969554,814,21499
2020-06-20,bolivia,South America,11969554,977,22476
2020-06-21,bolivia,South America,11969554,1036,23512
2020-06-22,bolivia,South America,11969554,876,24388
2020-06-23,bolivia,South America,11969554,1105,25493
2020-06-24,bolivia,South America,11969554,896,26389
2020-06-25,bolivia,South America,11969554,1098,27487
2020-06-26,bolivia,South America,11969554,1016,28503
2020-06-27,bolivia,South America,11969554,920,29423
2020-06-28,bolivia,South America,11969554,1253,30676
2020-06-29,bolivia,South America,11969554,848,31524
2020-06-30,bolivia,South America,11969554,601,32125
2020-07-01,bolivia,South America,11969554,1094,33219
2020-07-02,bolivia,South America,11969554,1008,34227
2020-07-03,bolivia,South America,11969554,1301,35528
2020-07-04,bolivia,South America,11969554,1290,36818
2020-07-05,bolivia,South America,11969554,1253,38071
2020-07-06,bolivia,South America,11969554,1226,39297
2020-07-07,bolivia,South America,11969554,1212,40509
2020-07-08,bolivia,South America,11969554,1036,41545
2020-07-09,bolivia,South America,11969554,1439,42984
2020-07-10,bolivia,South America,11969554,1129,44113
2020-07-11,bolivia,South America,11969554,1452,45565
2020-07-12,bolivia,South America,11969554,1635,47200
2020-07-13,bolivia,South America,11969554,987,48187
2020-07-14,bolivia,South America,11969554,1063,49250
2020-07-15,bolivia,South America,11969554,1617,50867
2020-07-16,bolivia,South America,11969554,1351,52218
2020-07-17,bolivia,South America,11969554,1938,54156
2020-07-18,bolivia,South America,11969554,1946,56102
2020-07-19,bolivia,South America,11969554,2036,58138
2020-07-20,bolivia,South America,11969554,1444,59582
2020-07-21,bolivia,South America,11969554,1409,60991
2020-07-22,bolivia,South America,11969554,1366,62357
2020-07-23,bolivia,South America,11969554,1778,64135
2020-07-24,bolivia,South America,11969554,1117,65252
2020-07-25,bolivia,South America,11969554,1204,66456
2020-07-26,bolivia,South America,11969554,1825,68281
2020-07-27,bolivia,South America,11969554,1148,69429
2020-07-28,bolivia,South America,11969554,1752,71181
2020-07-29,bolivia,South America,11969554,1146,72327
2020-07-30,bolivia,South America,11969554,1207,73534
2020-07-31,bolivia,South America,11969554,1700,75234
2020-08-01,bolivia,South America,11969554,1555,76789
2020-08-02,bolivia,South America,11969554,2004,78793
2020-08-03,bolivia,South America,11969554,1360,80153
2020-08-04,bolivia,South America,11969554,1693,81846
2020-08-05,bolivia,South America,11969554,1515,83361
2020-08-06,bolivia,South America,11969554,1780,85141
2020-08-07,bolivia,South America,11969554,1282,86423
2020-08-08,bolivia,South America,11969554,1468,87891
2020-08-09,bolivia,South America,11969554,1164,89055
2020-08-10,bolivia,South America,11969554,944,89999
2020-08-11,bolivia,South America,11969554,1636,91635
2020-08-12,bolivia,South America,11969554,1693,93328
2020-08-13,bolivia,South America,11969554,1743,95071
2020-08-14,bolivia,South America,11969554,1388,96459
2020-08-15,bolivia,South America,11969554,1491,97950
2020-08-16,bolivia,South America,11969554,1196,99146
2020-08-17,bolivia,South America,11969554,1198,100344
2020-08-18,bolivia,South America,11969554,879,101223
2020-08-19,bolivia,South America,11969554,1796,103019
2020-08-20,bolivia,South America,11969554,2031,105050
2020-08-21,bolivia,South America,11969554,1015,106065
2020-08-22,bolivia,South America,11969554,1370,107435
2020-08-23,bolivia,South America,11969554,992,108427
2020-08-24,bolivia,South America,11969554,722,109149
2020-08-25,bolivia,South America,11969554,999,110148
2020-08-26,bolivia,South America,11969554,851,110999
2020-08-27,bolivia,South America,11969554,1095,112094
2020-08-28,bolivia,South America,11969554,1035,113129
2020-08-29,bolivia,South America,11969554,1280,114409
2020-08-30,bolivia,South America,11969554,945,115354
2020-08-31,bolivia,South America,11969554,614,115968
2020-09-01,bolivia,South America,11969554,630,116598
2020-09-02,bolivia,South America,11969554,669,117267
2020-09-03,bolivia,South America,11969554,661,117928
2020-09-04,bolivia,South America,11969554,853,118781
2020-09-05,bolivia,South America,11969554,799,119580
2020-09-06,bolivia,South America,11969554,661,120241
2020-09-07,bolivia,South America,11969554,528,120769
2020-09-08,bolivia,South America,11969554,835,121604
2020-09-09,bolivia,South America,11969554,704,122308
2020-09-10,bolivia,South America,11969554,1037,123345
2020-09-11,bolivia,South America,11969554,860,124205
2020-09-12,bolivia,South America,11969554,967,125172
2020-09-13,bolivia,South America,11969554,810,125982
2020-09-14,bolivia,South America,11969554,809,126791
2020-09-15,bolivia,South America,11969554,828,127619
2020-09-16,bolivia,South America,11969554,667,128286
2020-09-17,bolivia,South America,11969554,586,128872
2020-09-18,bolivia,South America,11969554,547,129419
2020-09-19,bolivia,South America,11969554,632,130051
2020-09-20,bolivia,South America,11969554,419,130470
2020-09-21,bolivia,South America,11969554,206,130676
2020-09-22,bolivia,South America,11969554,310,130986
2020-09-23,bolivia,South America,11969554,467,131453
2020-09-24,bolivia,South America,11969554,537,131990
2020-09-25,bolivia,South America,11969554,628,132618
2020-09-26,bolivia,South America,11969554,604,133222
2020-09-27,bolivia,South America,11969554,370,133592
2020-09-28,bolivia,South America,11969554,309,133901
2020-09-29,bolivia,South America,11969554,322,134223
2020-09-30,bolivia,South America,11969554,418,134641
2020-10-01,bolivia,South America,11969554,670,135311
2020-10-02,bolivia,South America,11969554,405,135716
2020-10-03,bolivia,South America,11969554,503,136219
2020-10-04,bolivia,South America,11969554,350,136569
2020-10-05,bolivia,South America,11969554,299,136868
2020-10-06,bolivia,South America,11969554,239,137107
2020-10-07,bolivia,South America,11969554,361,137468
2020-10-08,bolivia,South America,11969554,238,137706
2020-10-09,bolivia,South America,11969554,263,137969
2020-10-10,bolivia,South America,11969554,257,138226
2020-10-11,bolivia,South America,11969554,237,138463
2020-10-12,bolivia,South America,11969554,111,138574
2020-10-13,bolivia,South America,11969554,121,138695
2020-10-14,bolivia,South America,11969554,227,138922
2020-10-15,bolivia,South America,11969554,219,139141
2020-10-16,bolivia,South America,11969554,178,139319
2020-10-17,bolivia,South America,11969554,243,139562
2020-10-18,bolivia,South America,11969554,148,139710
2020-10-19,bolivia,South America,11969554,61,139771
2020-10-20,bolivia,South America,11969554,119,139890
2020-10-21,bolivia,South America,11969554,147,140037
2020-10-22,bolivia,South America,11969554,191,140228
2020-10-23,bolivia,South America,11969554,217,140445
2020-10-24,bolivia,South America,11969554,167,140612
2020-10-25,bolivia,South America,11969554,167,140779
2020-10-26,bolivia,South America,11969554,74,140853
2020-10-27,bolivia,South America,11969554,99,140952
2020-10-28,bolivia,South America,11969554,172,141124
2020-10-29,bolivia,South America,11969554,197,141321
2020-10-30,bolivia,South America,11969554,163,141484
2020-10-31,bolivia,South America,11969554,147,141631
2020-11-01,bolivia,South America,11969554,126,141757
2020-11-02,bolivia,South America,11969554,76,141833
2020-11-03,bolivia,South America,11969554,34,141867
2020-11-04,bolivia,South America,11969554,69,141936
2020-11-05,bolivia,South America,11969554,126,142062
2020-11-06,bolivia,South America,11969554,139,142201
2020-11-07,bolivia,South America,11969554,142,142343
2020-11-08,bolivia,South America,11969554,84,142427
2020-11-09,bolivia,South America,11969554,48,142475
2020-11-10,bolivia,South America,11969554,86,142561
2020-11-11,bolivia,South America,11969554,103,142664
2020-11-12,bolivia,South America,11969554,112,142776
2020-11-13,bolivia,South America,11969554,113,142889
2020-11-14,bolivia,South America,11969554,180,143069
2020-11-15,bolivia,South America,11969554,112,143181
2020-11-16,bolivia,South America,11969554,65,143246
2020-11-17,bolivia,South America,11969554,125,143371
2020-11-18,bolivia,South America,11969554,102,143473
2020-11-19,bolivia,South America,11969554,96,143569
2020-11-20,bolivia,South America,11969554,187,143756
2020-11-21,bolivia,South America,11969554,98,143854
2020-11-22,bolivia,South America,11969554,68,143922
2020-11-23,bolivia,South America,11969554,56,143978
2020-11-24,bolivia,South America,11969554,56,144034
2020-11-25,bolivia,South America,11969554,113,144147
2020-11-26,bolivia,South America,11969554,129,144276
2020-11-27,bolivia,South America,11969554,114,144390
2020-11-28,bolivia,South America,11969554,104,144494
2020-11-29,bolivia,South America,11969554,98,144592
2020-11-30,bolivia,South America,11969554,30,144622
2020-12-01,bolivia,South America,11969554,86,144708
2020-12-02,bolivia,South America,11969554,102,144810
2020-12-03,bolivia,South America,11969554,184,144994
2020-12-04,bolivia,South America,11969554,192,145186
2020-12-05,bolivia,South America,11969554,139,145325
2020-12-06,bolivia,South America,11969554,167,145492
2020-12-07,bolivia,South America,11969554,68,145560
2020-12-08,bolivia,South America,11969554,97,145657
2020-12-09,bolivia,South America,11969554,189,145846
2020-12-10,bolivia,South America,11969554,214,146060
2020-12-11,bolivia,South America,11969554,325,146385
2020-12-12,bolivia,South America,11969554,312,146697
2020-12-13,bolivia,South America,11969554,333,147030
2020-12-14,bolivia,South America,11969554,120,147150
2020-12-15,bolivia,South America,11969554,195,147345
2020-12-16,bolivia,South America,11969554,371,147716
2020-12-17,bolivia,South America,11969554,498,148214
2020-12-18,bolivia,South America,11969554,451,148665
2020-12-19,bolivia,South America,11969554,484,149149
2020-12-20,bolivia,South America,11969554,621,149770
2020-12-21,bolivia,South America,11969554,253,150023
2020-12-22,bolivia,South America,11969554,362,150385
2020-12-23,bolivia,South America,11969554,674,151059
2020-12-24,bolivia,South America,11969554,1005,152064
2020-12-25,bolivia,South America,11969554,1057,153121
2020-12-26,bolivia,South America,11969554,469,153590
2020-12-27,bolivia,South America,11969554,759,154349
2020-12-28,bolivia,South America,11969554,494,154843
2020-12-29,bolivia,South America,11969554,751,155594
2020-12-30,bolivia,South America,11969554,1293,156887
2020-12-31,bolivia,South America,11969554,1485,158372
2021-01-01,bolivia,South America,11969554,1752,160124
2021-01-02,bolivia,South America,11969554,861,160985
2021-01-03,bolivia,South America,11969554,1070,162055
2021-01-04,bolivia,South America,11969554,606,162661
2021-01-05,bolivia,South America,11969554,1010,163671
2021-01-06,bolivia,South America,11969554,1597,165268
2021-01-07,bolivia,South America,11969554,1713,166981
2021-01-08,bolivia,South America,11969554,1910,168891
2021-01-09,bolivia,South America,11969554,2263,171154
2021-01-10,bolivia,South America,11969554,1644,172798
2021-01-11,bolivia,South America,11969554,1098,173896
2021-01-12,bolivia,South America,11969554,1392,175288
2021-01-13,bolivia,South America,11969554,1473,176761
2021-01-14,bolivia,South America,11969554,2057,178818
2021-01-15,bolivia,South America,11969554,2198,181016
2021-01-16,bolivia,South America,11969554,2573,183589
2021-01-17,bolivia,South America,11969554,2091,185680
2021-01-18,bolivia,South America,11969554,1503,187183
2021-01-19,bolivia,South America,11969554,1550,188733
2021-01-20,bolivia,South America,11969554,2357,191090
2021-01-21,bolivia,South America,11969554,2655,193745
2021-01-22,bolivia,South America,11969554,2648,196393
2021-01-23,bolivia,South America,11969554,1864,198257
2021-01-24,bolivia,South America,11969554,1732,199989
2021-01-25,bolivia,South America,11969554,1048,201037
2021-01-26,bolivia,South America,11969554,1781,202818
2021-01-27,bolivia,South America,11969554,2390,205208
2021-01-28,bolivia,South America,11969554,2866,208074
2021-01-29,bolivia,South America,11969554,2652,210726
2021-01-30,bolivia,South America,11969554,2666,213392
2021-01-31,bolivia,South America,11969554,2005,215397
2021-02-01,bolivia,South America,11969554,1438,216835
2021-02-02,bolivia,South America,11969554,1464,218299
2021-02-03,bolivia,South America,11969554,2127,220426
2021-02-04,bolivia,South America,11969554,2021,222447
2021-02-05,bolivia,South America,11969554,1787,224234
2021-02-06,bolivia,South America,11969554,1676,225910
2021-02-07,bolivia,South America,11969554,1218,227128
2021-02-08,bolivia,South America,11969554,839,227967
2021-02-09,bolivia,South America,11969554,1220,229187
2021-02-10,bolivia,South America,11969554,1544,230731
2021-02-11,bolivia,South America,11969554,1771,232502
2021-02-12,bolivia,South America,11969554,1352,233854
2021-02-13,bolivia,South America,11969554,1244,235098
2021-02-14,bolivia,South America,11969554,938,236036
2021-02-15,bolivia,South America,11969554,696,236732
2021-02-16,bolivia,South America,11969554,412,237144
2021-02-17,bolivia,South America,11969554,562,237706
2021-02-18,bolivia,South America,11969554,789,238495
2021-02-19,bolivia,South America,11969554,1029,239524
2021-02-20,bolivia,South America,11969554,1152,240676
2021-02-21,bolivia,South America,11969554,1095,241771
2021-02-22,bolivia,South America,11969554,521,242292
2021-02-23,bolivia,South America,11969554,884,243176
2021-02-24,bolivia,South America,11969554,1204,244380
2021-02-25,bolivia,South America,11969554,1339,245719
2021-02-26,bolivia,South America,11969554,1103,246822
2021-02-27,bolivia,South America,11969554,1069,247891
2021-02-28,bolivia,South America,11969554,656,248547
2021-03-01,bolivia,South America,11969554,463,249010
2021-03-02,bolivia,South America,11969554,757,249767
2021-03-03,bolivia,South America,11969554,790,250557
2021-03-04,bolivia,South America,11969554,834,251391
2021-03-05,bolivia,South America,11969554,969,252360
2021-03-06,bolivia,South America,11969554,937,253297
2021-03-07,bolivia,South America,11969554,653,253950
2021-03-08,bolivia,South America,11969554,323,254273
2021-03-09,bolivia,South America,11969554,463,254736
2021-03-10,bolivia,South America,11969554,885,255621
2021-03-11,bolivia,South America,11969554,841,256462
2021-03-12,bolivia,South America,11969554,778,257240
2021-03-13,bolivia,South America,11969554,1084,258324
2021-03-14,bolivia,South America,11969554,680,259004
2021-03-15,bolivia,South America,11969554,385,259389
2021-03-16,bolivia,South America,11969554,670,260059
2021-03-17,bolivia,South America,11969554,929,260988
2021-03-18,bolivia,South America,11969554,1068,262056
2021-03-19,bolivia,South America,11969554,885,262941
2021-03-20,bolivia,South America,11969554,867,263808
2021-03-21,bolivia,South America,11969554,603,264411
2021-03-22,bolivia,South America,11969554,223,264634
2021-03-23,bolivia,South America,11969554,573,265207
2021-03-24,bolivia,South America,11969554,879,266086
2021-03-25,bolivia,South America,11969554,973,267059
2021-03-26,bolivia,South America,11969554,774,267833
2021-03-27,bolivia,South America,11969554,878,268711
2021-03-28,bolivia,South America,11969554,591,269302
2021-03-29,bolivia,South America,11969554,326,269628
2021-03-30,bolivia,South America,11969554,719,270347
2021-03-31,bolivia,South America,11969554,1072,271419
2021-04-01,bolivia,South America,11969554,992,272411
2021-04-02,bolivia,South America,11969554,916,273327
2021-04-03,bolivia,South America,11969554,620,273947
2021-04-04,bolivia,South America,11969554,520,274467
2021-04-05,bolivia,South America,11969554,467,274934
2021-04-06,bolivia,South America,11969554,458,275392
2021-04-07,bolivia,South America,11969554,1498,276890
2021-04-08,bolivia,South America,11969554,1076,277966
2021-04-09,bolivia,South America,11969554,1241,279207
2021-04-10,bolivia,South America,11969554,1442,280649
2021-04-11,bolivia,South America,11969554,921,281570
2021-04-12,bolivia,South America,11969554,525,282095
2021-04-13,bolivia,South America,11969554,989,283084
2021-04-14,bolivia,South America,11969554,1099,284183
2021-04-15,bolivia,South America,11969554,1108,285291
2021-04-16,bolivia,South America,11969554,823,286114
2021-04-17,bolivia,South America,11969554,1246,287360
2021-04-18,bolivia,South America,11969554,1185,288545
2021-04-19,bolivia,South America,11969554,521,289066
2021-04-20,bolivia,South America,11969554,1296,290362
2021-04-21,bolivia,South America,11969554,1313,291675
2021-04-22,bolivia,South America,11969554,1386,293061
2021-04-23,bolivia,South America,11969554,1330,294391
2021-04-24,bolivia,South America,11969554,1501,295892
2021-04-25,bolivia,South America,11969554,1293,297185
2021-04-26,bolivia,South America,11969554,474,297659
2021-04-27,bolivia,South America,11969554,1119,298778
2021-04-28,bolivia,South America,11969554,1480,300258
2021-04-29,bolivia,South America,11969554,1573,301831
2021-04-30,bolivia,South America,11969554,1901,303732
2021-05-01,bolivia,South America,11969554,1862,305594
2021-05-02,bolivia,South America,11969554,933,306527
2021-05-03,bolivia,South America,11969554,1034,307561
2021-05-04,bolivia,South America,11969554,1423,308984
2021-05-05,bolivia,South America,11969554,1588,310572
2021-05-06,bolivia,South America,11969554,1835,312407
2021-05-07,bolivia,South America,11969554,1783,314190
2021-05-08,bolivia,South America,11969554,1963,316153
2021-05-09,bolivia,South America,11969554,1394,317547
2021-05-10,bolivia,South America,11969554,1063,318610
2021-05-11,bolivia,South America,11969554,1599,320209
2021-05-12,bolivia,South America,11969554,2369,322578
2021-05-13,bolivia,South America,11969554,2290,324868
2021-05-14,bolivia,South America,11969554,2356,327224
2021-05-15,bolivia,South America,11969554,2509,329733
2021-05-16,bolivia,South America,11969554,1783,331516
2021-05-17,bolivia,South America,11969554,1051,332567
2021-05-18,bolivia,South America,11969554,2257,334824
2021-05-19,bolivia,South America,11969554,2617,337441
2021-05-20,bolivia,South America,11969554,2766,340207
2021-05-21,bolivia,South America,11969554,2858,343065
2021-05-22,bolivia,South America,11969554,3005,346070
2021-05-23,bolivia,South America,11969554,2117,348187
2021-05-24,bolivia,South America,11969554,1466,349653
2021-05-25,bolivia,South America,11969554,2517,352170
2021-05-26,bolivia,South America,11969554,3179,355349
2021-05-27,bolivia,South America,11969554,3213,358562
2021-05-28,bolivia,South America,11969554,3018,361580
2021-05-29,bolivia,South America,11969554,2990,364570
2021-05-30,bolivia,South America,11969554,2144,366714
2021-05-31,bolivia,South America,11969554,1760,368474
2021-06-01,bolivia,South America,11969554,2805,371279
2021-06-02,bolivia,South America,11969554,3439,374718
2021-06-03,bolivia,South America,11969554,3310,378028
2021-06-04,bolivia,South America,11969554,2429,380457
2021-06-05,bolivia,South America,11969554,3000,383457
2021-06-06,bolivia,South America,11969554,2277,385734
2021-06-07,bolivia,South America,11969554,1428,387162
2021-06-08,bolivia,South America,11969554,2832,389994
2021-06-09,bolivia,South America,11969554,2981,392975
2021-06-10,bolivia,South America,11969554,3839,396814
2021-06-11,bolivia,South America,11969554,3233,400047
2021-06-12,bolivia,South America,11969554,3244,403291
2021-06-13,bolivia,South America,11969554,2056,405347
2021-06-14,bolivia,South America,11969554,1607,406954
2021-06-15,bolivia,South America,11969554,2152,409106
2021-06-16,bolivia,South America,11969554,2571,411677
2021-06-17,bolivia,South America,11969554,2836,414513
2021-06-18,bolivia,South America,11969554,2682,417195
2021-06-19,bolivia,South America,11969554,2118,419313
2021-06-20,bolivia,South America,11969554,1648,420961
2021-06-21,bolivia,South America,11969554,1086,422047
2021-06-22,bolivia,South America,11969554,764,422811
2021-06-23,bolivia,South America,11969554,1667,424478
2021-06-24,bolivia,South America,11969554,2270,426748
2021-06-25,bolivia,South America,11969554,2430,429178
2021-06-26,bolivia,South America,11969554,2182,431360
2021-06-27,bolivia,South America,11969554,1653,433013
2021-06-28,bolivia,South America,11969554,922,433935
2021-06-29,bolivia,South America,11969554,1633,435568
2021-06-30,bolivia,South America,11969554,2055,437623
2021-07-01,bolivia,South America,11969554,2001,439624
2021-07-02,bolivia,South America,11969554,1662,441286
2021-07-03,bolivia,South America,11969554,1598,442884
2021-07-04,bolivia,South America,11969554,1206,444090
2021-07-05,bolivia,South America,11969554,878,444968
2021-07-06,bolivia,South America,11969554,1394,446362
2021-07-07,bolivia,South America,11969554,1851,448213
2020-04-01,botswana,Africa,2440037,0,4
2020-04-02,botswana,Africa,2440037,0,4
2020-04-03,botswana,Africa,2440037,0,4
2020-04-04,botswana,Africa,2440037,0,4
2020-04-05,botswana,Africa,2440037,2,6
2020-04-06,botswana,Africa,2440037,0,6
2020-04-07,botswana,Africa,2440037,0,6
2020-04-08,botswana,Africa,2440037,0,6
2020-04-09,botswana,Africa,2440037,7,13
2020-04-10,botswana,Africa,2440037,0,13
2020-04-11,botswana,Africa,2440037,0,13
2020-04-12,botswana,Africa,2440037,0,13
2020-04-13,botswana,Africa,2440037,0,13
2020-04-14,botswana,Africa,2440037,0,13
2020-04-15,botswana,Africa,2440037,0,13
2020-04-16,botswana,Africa,2440037,2,15
2020-04-17,botswana,Africa,2440037,0,15
2020-04-18,botswana,Africa,2440037,0,15
2020-04-19,botswana,Africa,2440037,5,20
2020-04-20,botswana,Africa,2440037,0,20
2020-04-21,botswana,Africa,2440037,0,20
2020-04-22,botswana,Africa,2440037,2,22
2020-04-23,botswana,Africa,2440037,0,22
2020-04-24,botswana,Africa,2440037,0,22
2020-04-25,botswana,Africa,2440037,0,22
2020-04-26,botswana,Africa,2440037,0,22
2020-04-27,botswana,Africa,2440037,0,22
2020-04-28,botswana,Africa,2440037,1,23
2020-04-29,botswana,Africa,2440037,0,23
2020-04-30,botswana,Africa,2440037,0,23
2020-05-01,botswana,Africa,2440037,0,23
2020-05-02,botswana,Africa,2440037,0,23
2020-05-03,botswana,Africa,2440037,0,23
2020-05-04,botswana,Africa,2440037,0,23
2020-05-05,botswana,Africa,2440037,0,23
2020-05-06,botswana,Africa,2440037,0,23
2020-05-07,botswana,Africa,2440037,0,23
2020-05-08,botswana,Africa,2440037,0,23
2020-05-09,botswana,Africa,2440037,0,23
2020-05-10,botswana,Africa,2440037,0,23
2020-05-11,botswana,Africa,2440037,1,24
2020-05-12,botswana,Africa,2440037,0,24
2020-05-13,botswana,Africa,2440037,0,24
2020-05-14,botswana,Africa,2440037,0,24
2020-05-15,botswana,Africa,2440037,0,24
2020-05-16,botswana,Africa,2440037,0,24
2020-05-17,botswana,Africa,2440037,1,25
2020-05-18,botswana,Africa,2440037,0,25
2020-05-19,botswana,Africa,2440037,0,25
2020-05-20,botswana,Africa,2440037,0,25
2020-05-21,botswana,Africa,2440037,4,29
2020-05-22,botswana,Africa,2440037,1,30
2020-05-23,botswana,Africa,2440037,0,30
2020-05-24,botswana,Africa,2440037,5,35
2020-05-25,botswana,Africa,2440037,0,35
2020-05-26,botswana,Africa,2440037,0,35
2020-05-27,botswana,Africa,2440037,0,35
2020-05-28,botswana,Africa,2440037,0,35
2020-05-29,botswana,Africa,2440037,0,35
2020-05-30,botswana,Africa,2440037,0,35
2020-05-31,botswana,Africa,2440037,0,35
2020-06-01,botswana,Africa,2440037,3,38
2020-06-02,botswana,Africa,2440037,2,40
2020-06-03,botswana,Africa,2440037,0,40
2020-06-04,botswana,Africa,2440037,0,40
2020-06-05,botswana,Africa,2440037,0,40
2020-06-06,botswana,Africa,2440037,0,40
2020-06-07,botswana,Africa,2440037,0,40
2020-06-08,botswana,Africa,2440037,2,42
2020-06-09,botswana,Africa,2440037,0,42
2020-06-10,botswana,Africa,2440037,6,48
2020-06-11,botswana,Africa,2440037,0,48
2020-06-12,botswana,Africa,2440037,0,48
2020-06-13,botswana,Africa,2440037,12,60
2020-06-14,botswana,Africa,2440037,0,60
2020-06-15,botswana,Africa,2440037,0,60
2020-06-16,botswana,Africa,2440037,0,60
2020-06-17,botswana,Africa,2440037,19,79
2020-06-18,botswana,Africa,2440037,0,79
2020-06-19,botswana,Africa,2440037,10,89
2020-06-20,botswana,Africa,2440037,0,89
2020-06-21,botswana,Africa,2440037,0,89
2020-06-22,botswana,Africa,2440037,0,89
2020-06-23,botswana,Africa,2440037,0,89
2020-06-24,botswana,Africa,2440037,32,121
2020-06-25,botswana,Africa,2440037,0,121
2020-06-26,botswana,Africa,2440037,0,121
2020-06-27,botswana,Africa,2440037,0,121
2020-06-28,botswana,Africa,2440037,54,175
2020-06-29,botswana,Africa,2440037,0,175
2020-06-30,botswana,Africa,2440037,52,227
2020-07-01,botswana,Africa,2440037,0,227
2020-07-02,botswana,Africa,2440037,0,227
2020-07-03,botswana,Africa,2440037,50,277
2020-07-04,botswana,Africa,2440037,0,277
2020-07-05,botswana,Africa,2440037,0,277
2020-07-06,botswana,Africa,2440037,37,314
2020-07-07,botswana,Africa,2440037,0,314
2020-07-08,botswana,Africa,2440037,0,314
2020-07-09,botswana,Africa,2440037,0,314
2020-07-10,botswana,Africa,2440037,0,314
2020-07-11,botswana,Africa,2440037,0,314
2020-07-12,botswana,Africa,2440037,85,399
2020-07-13,botswana,Africa,2440037,0,399
2020-07-14,botswana,Africa,2440037,0,399
2020-07-15,botswana,Africa,2440037,0,399
2020-07-16,botswana,Africa,2440037,123,522
2020-07-17,botswana,Africa,2440037,0,522
2020-07-18,botswana,Africa,2440037,0,522
2020-07-19,botswana,Africa,2440037,70,592
2020-07-20,botswana,Africa,2440037,0,592
2020-07-21,botswana,Africa,2440037,0,592
2020-07-22,botswana,Africa,2440037,0,592
2020-07-23,botswana,Africa,2440037,0,592
2020-07-24,botswana,Africa,2440037,94,686
2020-07-25,botswana,Africa,2440037,0,686
2020-07-26,botswana,Africa,2440037,0,686
2020-07-27,botswana,Africa,2440037,53,739
2020-07-28,botswana,Africa,2440037,0,739
2020-07-29,botswana,Africa,2440037,65,804
2020-07-30,botswana,Africa,2440037,0,804
2020-07-31,botswana,Africa,2440037,90,894
2020-08-01,botswana,Africa,2440037,0,894
2020-08-02,botswana,Africa,2440037,0,894
2020-08-03,botswana,Africa,2440037,0,894
2020-08-04,botswana,Africa,2440037,0,894
2020-08-05,botswana,Africa,2440037,0,894
2020-08-06,botswana,Africa,2440037,0,894
2020-08-07,botswana,Africa,2440037,0,894
2020-08-08,botswana,Africa,2440037,0,894
2020-08-09,botswana,Africa,2440037,0,894
2020-08-10,botswana,Africa,2440037,172,1066
2020-08-11,botswana,Africa,2440037,0,1066
2020-08-12,botswana,Africa,2440037,0,1066
2020-08-13,botswana,Africa,2440037,148,1214
2020-08-14,botswana,Africa,2440037,0,1214
2020-08-15,botswana,Africa,2440037,0,1214
2020-08-16,botswana,Africa,2440037,0,1214
2020-08-17,botswana,Africa,2440037,94,1308
2020-08-18,botswana,Africa,2440037,0,1308
2020-08-19,botswana,Africa,2440037,0,1308
2020-08-20,botswana,Africa,2440037,0,1308
2020-08-21,botswana,Africa,2440037,0,1308
2020-08-22,botswana,Africa,2440037,0,1308
2020-08-23,botswana,Africa,2440037,0,1308
2020-08-24,botswana,Africa,2440037,254,1562
2020-08-25,botswana,Africa,2440037,0,1562
2020-08-26,botswana,Africa,2440037,71,1633
2020-08-27,botswana,Africa,2440037,0,1633
2020-08-28,botswana,Africa,2440037,0,1633
2020-08-29,botswana,Africa,2440037,0,1633
2020-08-30,botswana,Africa,2440037,0,1633
2020-08-31,botswana,Africa,2440037,91,1724
2020-09-01,botswana,Africa,2440037,0,1724
2020-09-02,botswana,Africa,2440037,0,1724
2020-09-03,botswana,Africa,2440037,0,1724
2020-09-04,botswana,Africa,2440037,278,2002
2020-09-05,botswana,Africa,2440037,0,2002
2020-09-06,botswana,Africa,2440037,0,2002
2020-09-07,botswana,Africa,2440037,124,2126
2020-09-08,botswana,Africa,2440037,0,2126
2020-09-09,botswana,Africa,2440037,0,2126
2020-09-10,botswana,Africa,2440037,126,2252
2020-09-11,botswana,Africa,2440037,0,2252
2020-09-12,botswana,Africa,2440037,0,2252
2020-09-13,botswana,Africa,2440037,0,2252
2020-09-14,botswana,Africa,2440037,211,2463
2020-09-15,botswana,Africa,2440037,0,2463
2020-09-16,botswana,Africa,2440037,0,2463
2020-09-17,botswana,Africa,2440037,104,2567
2020-09-18,botswana,Africa,2440037,0,2567
2020-09-19,botswana,Africa,2440037,0,2567
2020-09-20,botswana,Africa,2440037,0,2567
2020-09-21,botswana,Africa,2440037,0,2567
2020-09-22,botswana,Africa,2440037,0,2567
2020-09-23,botswana,Africa,2440037,0,2567
2020-09-24,botswana,Africa,2440037,354,2921
2020-09-25,botswana,Africa,2440037,0,2921
2020-09-26,botswana,Africa,2440037,0,2921
2020-09-27,botswana,Africa,2440037,0,2921
2020-09-28,botswana,Africa,2440037,251,3172
2020-09-29,botswana,Africa,2440037,0,3172
2020-09-30,botswana,Africa,2440037,0,3172
2020-10-01,botswana,Africa,2440037,0,3172
2020-10-02,botswana,Africa,2440037,0,3172
2020-10-03,botswana,Africa,2440037,0,3172
2020-10-04,botswana,Africa,2440037,0,3172
2020-10-05,botswana,Africa,2440037,0,3172
2020-10-06,botswana,Africa,2440037,0,3172
2020-10-07,botswana,Africa,2440037,0,3172
2020-10-08,botswana,Africa,2440037,47,3219
2020-10-09,botswana,Africa,2440037,0,3219
2020-10-10,botswana,Africa,2440037,0,3219
2020-10-11,botswana,Africa,2440037,1328,4547
2020-10-12,botswana,Africa,2440037,296,4843
2020-10-13,botswana,Africa,2440037,0,4843
2020-10-14,botswana,Africa,2440037,0,4843
2020-10-15,botswana,Africa,2440037,399,5242
2020-10-16,botswana,Africa,2440037,0,5242
2020-10-17,botswana,Africa,2440037,0,5242
2020-10-18,botswana,Africa,2440037,0,5242
2020-10-19,botswana,Africa,2440037,367,5609
2020-10-20,botswana,Africa,2440037,0,5609
2020-10-21,botswana,Africa,2440037,0,5609
2020-10-22,botswana,Africa,2440037,314,5923
2020-10-23,botswana,Africa,2440037,0,5923
2020-10-24,botswana,Africa,2440037,0,5923
2020-10-25,botswana,Africa,2440037,0,5923
2020-10-26,botswana,Africa,2440037,360,6283
2020-10-27,botswana,Africa,2440037,0,6283
2020-10-28,botswana,Africa,2440037,0,6283
2020-10-29,botswana,Africa,2440037,359,6642
2020-10-30,botswana,Africa,2440037,0,6642
2020-10-31,botswana,Africa,2440037,0,6642
2020-11-01,botswana,Africa,2440037,0,6642
2020-11-02,botswana,Africa,2440037,0,6642
2020-11-03,botswana,Africa,2440037,0,6642
2020-11-04,botswana,Africa,2440037,0,6642
2020-11-05,botswana,Africa,2440037,1193,7835
2020-11-06,botswana,Africa,2440037,0,7835
2020-11-07,botswana,Africa,2440037,0,7835
2020-11-08,botswana,Africa,2440037,0,7835
2020-11-09,botswana,Africa,2440037,0,7835
2020-11-10,botswana,Africa,2440037,0,7835
2020-11-11,botswana,Africa,2440037,0,7835
2020-11-12,botswana,Africa,2440037,390,8225
2020-11-13,botswana,Africa,2440037,0,8225
2020-11-14,botswana,Africa,2440037,0,8225
2020-11-15,botswana,Africa,2440037,0,8225
2020-11-16,botswana,Africa,2440037,878,9103
2020-11-17,botswana,Africa,2440037,0,9103
2020-11-18,botswana,Africa,2440037,0,9103
2020-11-19,botswana,Africa,2440037,491,9594
2020-11-20,botswana,Africa,2440037,0,9594
2020-11-21,botswana,Africa,2440037,0,9594
2020-11-22,botswana,Africa,2440037,0,9594
2020-11-23,botswana,Africa,2440037,398,9992
2020-11-24,botswana,Africa,2440037,0,9992
2020-11-25,botswana,Africa,2440037,0,9992
2020-11-26,botswana,Africa,2440037,266,10258
2020-11-27,botswana,Africa,2440037,0,10258
2020-11-28,botswana,Africa,2440037,0,10258
2020-11-29,botswana,Africa,2440037,0,10258
2020-11-30,botswana,Africa,2440037,484,10742
2020-12-01,botswana,Africa,2440037,0,10742
2020-12-02,botswana,Africa,2440037,0,10742
2020-12-03,botswana,Africa,2440037,789,11531
2020-12-04,botswana,Africa,2440037,0,11531
2020-12-05,botswana,Africa,2440037,0,11531
2020-12-06,botswana,Africa,2440037,0,11531
2020-12-07,botswana,Africa,2440037,527,12058
2020-12-08,botswana,Africa,2440037,0,12058
2020-12-09,botswana,Africa,2440037,0,12058
2020-12-10,botswana,Africa,2440037,443,12501
2020-12-11,botswana,Africa,2440037,0,12501
2020-12-12,botswana,Africa,2440037,0,12501
2020-12-13,botswana,Africa,2440037,0,12501
2020-12-14,botswana,Africa,2440037,372,12873
2020-12-15,botswana,Africa,2440037,0,12873
2020-12-16,botswana,Africa,2440037,0,12873
2020-12-17,botswana,Africa,2440037,141,13014
2020-12-18,botswana,Africa,2440037,0,13014
2020-12-19,botswana,Africa,2440037,0,13014
2020-12-20,botswana,Africa,2440037,0,13014
2020-12-21,botswana,Africa,2440037,608,13622
2020-12-22,botswana,Africa,2440037,0,13622
2020-12-23,botswana,Africa,2440037,0,13622
2020-12-24,botswana,Africa,2440037,403,14025
2020-12-25,botswana,Africa,2440037,0,14025
2020-12-26,botswana,Africa,2440037,0,14025
2020-12-27,botswana,Africa,2440037,0,14025
2020-12-28,botswana,Africa,2440037,0,14025
2020-12-29,botswana,Africa,2440037,0,14025
2020-12-30,botswana,Africa,2440037,675,14700
2020-12-31,botswana,Africa,2440037,105,14805
2021-01-01,botswana,Africa,2440037,0,14805
2021-01-02,botswana,Africa,2440037,0,14805
2021-01-03,botswana,Africa,2440037,0,14805
2021-01-04,botswana,Africa,2440037,635,15440
2021-01-05,botswana,Africa,2440037,0,15440
2021-01-06,botswana,Africa,2440037,0,15440
2021-01-07,botswana,Africa,2440037,610,16050
2021-01-08,botswana,Africa,2440037,0,16050
2021-01-09,botswana,Africa,2440037,0,16050
2021-01-10,botswana,Africa,2440037,0,16050
2021-01-11,botswana,Africa,2440037,718,16768
2021-01-12,botswana,Africa,2440037,0,16768
2021-01-13,botswana,Africa,2440037,0,16768
2021-01-14,botswana,Africa,2440037,597,17365
2021-01-15,botswana,Africa,2440037,0,17365
2021-01-16,botswana,Africa,2440037,0,17365
2021-01-17,botswana,Africa,2440037,0,17365
2021-01-18,botswana,Africa,2440037,1265,18630
2021-01-19,botswana,Africa,2440037,0,18630
2021-01-20,botswana,Africa,2440037,0,18630
2021-01-21,botswana,Africa,2440037,1024,19654
2021-01-22,botswana,Africa,2440037,0,19654
2021-01-23,botswana,Africa,2440037,0,19654
2021-01-24,botswana,Africa,2440037,0,19654
2021-01-25,botswana,Africa,2440037,1004,20658
2021-01-26,botswana,Africa,2440037,0,20658
2021-01-27,botswana,Africa,2440037,0,20658
2021-01-28,botswana,Africa,2440037,635,21293
2021-01-29,botswana,Africa,2440037,0,21293
2021-01-30,botswana,Africa,2440037,0,21293
2021-01-31,botswana,Africa,2440037,0,21293
2021-02-01,botswana,Africa,2440037,1445,22738
2021-02-02,botswana,Africa,2440037,0,22738
2021-02-03,botswana,Africa,2440037,0,22738
2021-02-04,botswana,Africa,2440037,765,23503
2021-02-05,botswana,Africa,2440037,0,23503
2021-02-06,botswana,Africa,2440037,0,23503
2021-02-07,botswana,Africa,2440037,0,23503
2021-02-08,botswana,Africa,2440037,932,24435
2021-02-09,botswana,Africa,2440037,0,24435
2021-02-10,botswana,Africa,2440037,0,24435
2021-02-11,botswana,Africa,2440037,491,24926
2021-02-12,botswana,Africa,2440037,0,24926
2021-02-13,botswana,Africa,2440037,0,24926
2021-02-14,botswana,Africa,2440037,0,24926
2021-02-15,botswana,Africa,2440037,876,25802
2021-02-16,botswana,Africa,2440037,0,25802
2021-02-17,botswana,Africa,2440037,0,25802
2021-02-18,botswana,Africa,2440037,722,26524
2021-02-19,botswana,Africa,2440037,0,26524
2021-02-20,botswana,Africa,2440037,0,26524
2021-02-21,botswana,Africa,2440037,0,26524
2021-02-22,botswana,Africa,2440037,1197,27721
2021-02-23,botswana,Africa,2440037,0,27721
2021-02-24,botswana,Africa,2440037,0,27721
2021-02-25,botswana,Africa,2440037,650,28371
2021-02-26,botswana,Africa,2440037,0,28371
2021-02-27,botswana,Africa,2440037,0,28371
2021-02-28,botswana,Africa,2440037,0,28371
2021-03-01,botswana,Africa,2440037,2356,30727
2021-03-02,botswana,Africa,2440037,0,30727
2021-03-03,botswana,Africa,2440037,0,30727
2021-03-04,botswana,Africa,2440037,1019,31746
2021-03-05,botswana,Africa,2440037,0,31746
2021-03-06,botswana,Africa,2440037,0,31746
2021-03-07,botswana,Africa,2440037,0,31746
2021-03-08,botswana,Africa,2440037,1166,32912
2021-03-09,botswana,Africa,2440037,0,32912
2021-03-10,botswana,Africa,2440037,0,32912
2021-03-11,botswana,Africa,2440037,1186,34098
2021-03-12,botswana,Africa,2440037,0,34098
2021-03-13,botswana,Africa,2440037,0,34098
2021-03-14,botswana,Africa,2440037,0,34098
2021-03-15,botswana,Africa,2440037,901,34999
2021-03-16,botswana,Africa,2440037,0,34999
2021-03-17,botswana,Africa,2440037,0,34999
2021-03-18,botswana,Africa,2440037,816,35815
2021-03-19,botswana,Africa,2440037,0,35815
2021-03-20,botswana,Africa,2440037,0,35815
2021-03-21,botswana,Africa,2440037,0,35815
2021-03-22,botswana,Africa,2440037,1744,37559
2021-03-23,botswana,Africa,2440037,0,37559
2021-03-24,botswana,Africa,2440037,0,37559
2021-03-25,botswana,Africa,2440037,907,38466
2021-03-26,botswana,Africa,2440037,0,38466
2021-03-27,botswana,Africa,2440037,0,38466
2021-03-28,botswana,Africa,2440037,0,38466
2021-03-29,botswana,Africa,2440037,1382,39848
2021-03-30,botswana,Africa,2440037,0,39848
2021-03-31,botswana,Africa,2440037,0,39848
2021-04-01,botswana,Africa,2440037,1030,40878
2021-04-02,botswana,Africa,2440037,0,40878
2021-04-03,botswana,Africa,2440037,0,40878
2021-04-04,botswana,Africa,2440037,0,40878
2021-04-05,botswana,Africa,2440037,832,41710
2021-04-06,botswana,Africa,2440037,0,41710
2021-04-07,botswana,Africa,2440037,0,41710
2021-04-08,botswana,Africa,2440037,0,41710
2021-04-09,botswana,Africa,2440037,964,42674
2021-04-10,botswana,Africa,2440037,0,42674
2021-04-11,botswana,Africa,2440037,0,42674
2021-04-12,botswana,Africa,2440037,770,43444
2021-04-13,botswana,Africa,2440037,0,43444
2021-04-14,botswana,Africa,2440037,0,43444
2021-04-15,botswana,Africa,2440037,631,44075
2021-04-16,botswana,Africa,2440037,0,44075
2021-04-17,botswana,Africa,2440037,0,44075
2021-04-18,botswana,Africa,2440037,0,44075
2021-04-19,botswana,Africa,2440037,627,44702
2021-04-20,botswana,Africa,2440037,0,44702
2021-04-21,botswana,Africa,2440037,0,44702
2021-04-22,botswana,Africa,2440037,1153,45855
2021-04-23,botswana,Africa,2440037,0,45855
2021-04-24,botswana,Africa,2440037,0,45855
2021-04-25,botswana,Africa,2440037,0,45855
2021-04-26,botswana,Africa,2440037,0,45855
2021-04-27,botswana,Africa,2440037,745,46600
2021-04-28,botswana,Africa,2440037,0,46600
2021-04-29,botswana,Africa,2440037,334,46934
2021-04-30,botswana,Africa,2440037,0,46934
2021-05-01,botswana,Africa,2440037,0,46934
2021-05-02,botswana,Africa,2440037,0,46934
2021-05-03,botswana,Africa,2440037,917,47851
2021-05-04,botswana,Africa,2440037,0,47851
2021-05-05,botswana,Africa,2440037,0,47851
2021-05-06,botswana,Africa,2440037,566,48417
2021-05-07,botswana,Africa,2440037,0,48417
2021-05-08,botswana,Africa,2440037,0,48417
2021-05-09,botswana,Africa,2440037,0,48417
2021-05-10,botswana,Africa,2440037,624,49041
2021-05-11,botswana,Africa,2440037,0,49041
2021-05-12,botswana,Africa,2440037,0,49041
2021-05-13,botswana,Africa,2440037,0,49041
2021-05-14,botswana,Africa,2440037,615,49656
2021-05-15,botswana,Africa,2440037,0,49656
2021-05-16,botswana,Africa,2440037,0,49656
2021-05-17,botswana,Africa,2440037,1144,50800
2021-05-18,botswana,Africa,2440037,0,50800
2021-05-19,botswana,Africa,2440037,0,50800
2021-05-20,botswana,Africa,2440037,820,51620
2021-05-21,botswana,Africa,2440037,0,51620
2021-05-22,botswana,Africa,2440037,0,51620
2021-05-23,botswana,Africa,2440037,0,51620
2021-05-24,botswana,Africa,2440037,1245,52865
2021-05-25,botswana,Africa,2440037,0,52865
2021-05-26,botswana,Africa,2440037,0,52865
2021-05-27,botswana,Africa,2440037,906,53771
2021-05-28,botswana,Africa,2440037,0,53771
2021-05-29,botswana,Africa,2440037,0,53771
2021-05-30,botswana,Africa,2440037,0,53771
2021-05-31,botswana,Africa,2440037,1202,54973
2021-06-01,botswana,Africa,2440037,0,54973
2021-06-02,botswana,Africa,2440037,0,54973
2021-06-03,botswana,Africa,2440037,1244,56217
2021-06-04,botswana,Africa,2440037,0,56217
2021-06-05,botswana,Africa,2440037,0,56217
2021-06-06,botswana,Africa,2440037,0,56217
2021-06-07,botswana,Africa,2440037,1878,58095
2021-06-08,botswana,Africa,2440037,0,58095
2021-06-09,botswana,Africa,2440037,0,58095
2021-06-10,botswana,Africa,2440037,1385,59480
2021-06-11,botswana,Africa,2440037,0,59480
2021-06-12,botswana,Africa,2440037,0,59480
2021-06-13,botswana,Africa,2440037,0,59480
2021-06-14,botswana,Africa,2440037,1977,61457
2021-06-15,botswana,Africa,2440037,0,61457
2021-06-16,botswana,Africa,2440037,0,61457
2021-06-17,botswana,Africa,2440037,1790,63247
2021-06-18,botswana,Africa,2440037,0,63247
2021-06-19,botswana,Africa,2440037,0,63247
2021-06-20,botswana,Africa,2440037,0,63247
2021-06-21,botswana,Africa,2440037,2561,65808
2021-06-22,botswana,Africa,2440037,0,65808
2021-06-23,botswana,Africa,2440037,0,65808
2021-06-24,botswana,Africa,2440037,1684,67492
2021-06-25,botswana,Africa,2440037,0,67492
2021-06-26,botswana,Africa,2440037,0,67492
2021-06-27,botswana,Africa,2440037,0,67492
2021-06-28,botswana,Africa,2440037,2188,69680
2021-06-29,botswana,Africa,2440037,0,69680
2021-06-30,botswana,Africa,2440037,0,69680
2021-07-01,botswana,Africa,2440037,1763,71443
2021-07-02,botswana,Africa,2440037,0,71443
2021-07-03,botswana,Africa,2440037,0,71443
2021-07-04,botswana,Africa,2440037,0,71443
2021-07-05,botswana,Africa,2440037,2534,73977
2021-07-06,botswana,Africa,2440037,0,73977
2021-07-07,botswana,Africa,2440037,0,73977
2021-07-08,botswana,Africa,2440037,1411,75388
2021-07-09,botswana,Africa,2440037,0,75388
2021-07-10,botswana,Africa,2440037,0,75388
2021-07-11,botswana,Africa,2440037,0,75388
2021-07-12,botswana,Africa,2440037,4765,80153
2021-07-13,botswana,Africa,2440037,0,80153
2021-07-14,botswana,Africa,2440037,0,80153
2021-07-15,botswana,Africa,2440037,5980,86133
2021-07-16,botswana,Africa,2440037,0,86133
2021-07-17,botswana,Africa,2440037,0,86133
2021-07-18,botswana,Africa,2440037,0,86133
2021-07-19,botswana,Africa,2440037,5769,91902
2021-07-20,botswana,Africa,2440037,0,91902
2021-07-21,botswana,Africa,2440037,0,91902
2021-07-22,botswana,Africa,2440037,5755,97657
2021-07-23,botswana,Africa,2440037,0,97657
2021-07-24,botswana,Africa,2440037,0,97657
2021-07-25,botswana,Africa,2440037,0,97657
2021-07-26,botswana,Africa,2440037,4467,102124
2021-07-27,botswana,Africa,2440037,0,102124
2021-07-28,botswana,Africa,2440037,0,102124
2021-07-29,botswana,Africa,2440037,4566,106690
2021-07-30,botswana,Africa,2440037,0,106690
2021-07-31,botswana,Africa,2440037,0,106690
2021-08-01,botswana,Africa,2440037,0,106690
2021-08-02,botswana,Africa,2440037,8530,115220
2021-08-03,botswana,Africa,2440037,0,115220
2021-08-04,botswana,Africa,2440037,0,115220
2021-08-05,botswana,Africa,2440037,7354,122574
2021-08-06,botswana,Africa,2440037,0,122574
2021-08-07,botswana,Africa,2440037,0,122574
2021-08-08,botswana,Africa,2440037,0,122574
2021-08-09,botswana,Africa,2440037,8197,130771
2021-08-10,botswana,Africa,2440037,0,130771
2021-08-11,botswana,Africa,2440037,0,130771
2021-08-12,botswana,Africa,2440037,5987,136758
2021-08-13,botswana,Africa,2440037,0,136758
2021-08-14,botswana,Africa,2440037,0,136758
2021-08-15,botswana,Africa,2440037,0,136758
2021-08-16,botswana,Africa,2440037,5622,142380
2021-08-17,botswana,Africa,2440037,0,142380
2021-08-18,botswana,Africa,2440037,0,142380
2021-08-19,botswana,Africa,2440037,4081,146461
2021-08-20,botswana,Africa,2440037,0,146461
2021-08-21,botswana,Africa,2440037,0,146461
2021-08-22,botswana,Africa,2440037,0,146461
2021-08-23,botswana,Africa,2440037,4381,150842
2021-08-24,botswana,Africa,2440037,0,150842
2021-08-25,botswana,Africa,2440037,0,150842
2021-08-26,botswana,Africa,2440037,2951,153793
2021-08-27,botswana,Africa,2440037,0,153793
2021-08-28,botswana,Africa,2440037,0,153793
2021-08-29,botswana,Africa,2440037,0,153793
2021-08-30,botswana,Africa,2440037,3134,156927
2021-08-31,botswana,Africa,2440037,0,156927
2021-09-01,botswana,Africa,2440037,0,156927
2021-09-02,botswana,Africa,2440037,2390,159317
2021-09-03,botswana,Africa,2440037,0,159317
2021-09-04,botswana,Africa,2440037,0,159317
2021-09-05,botswana,Africa,2440037,0,159317
2021-09-06,botswana,Africa,2440037,2869,162186
2021-09-07,botswana,Africa,2440037,0,162186
2021-09-08,botswana,Africa,2440037,0,162186
2021-09-09,botswana,Africa,2440037,1479,163665
2021-09-10,botswana,Africa,2440037,0,163665
2021-09-11,botswana,Africa,2440037,0,163665
2021-09-12,botswana,Africa,2440037,0,163665
2021-09-13,botswana,Africa,2440037,1979,165644
2021-09-14,botswana,Africa,2440037,0,165644
2021-09-15,botswana,Africa,2440037,0,165644
2021-09-16,botswana,Africa,2440037,6608,172252
2021-09-17,botswana,Africa,2440037,0,172252
2021-09-18,botswana,Africa,2440037,0,172252
2021-09-19,botswana,Africa,2440037,0,172252
2021-09-20,botswana,Africa,2440037,1536,173788
2021-09-21,botswana,Africa,2440037,0,173788
2021-09-22,botswana,Africa,2440037,0,173788
2021-09-23,botswana,Africa,2440037,2639,176427
2021-09-24,botswana,Africa,2440037,0,176427
2021-09-25,botswana,Africa,2440037,0,176427
2021-09-26,botswana,Africa,2440037,0,176427
2021-09-27,botswana,Africa,2440037,1623,178050
2021-09-28,botswana,Africa,2440037,0,178050
2021-09-29,botswana,Africa,2440037,0,178050
2021-09-30,botswana,Africa,2440037,1170,179220
2021-10-01,botswana,Africa,2440037,0,179220
2021-10-02,botswana,Africa,2440037,0,179220
2021-10-03,botswana,Africa,2440037,0,179220
2021-10-04,botswana,Africa,2440037,0,179220
2021-10-05,botswana,Africa,2440037,977,180197
2021-10-06,botswana,Africa,2440037,0,180197
2021-10-07,botswana,Africa,2440037,241,180438
2021-10-08,botswana,Africa,2440037,0,180438
2021-10-09,botswana,Africa,2440037,0,180438
2021-10-10,botswana,Africa,2440037,0,180438
2021-10-11,botswana,Africa,2440037,813,181251
2021-10-12,botswana,Africa,2440037,0,181251
2021-10-13,botswana,Africa,2440037,0,181251
2021-10-14,botswana,Africa,2440037,605,181856
2021-10-15,botswana,Africa,2440037,0,181856
2021-10-16,botswana,Africa,2440037,0,181856
2021-10-17,botswana,Africa,2440037,0,181856
2021-10-18,botswana,Africa,2440037,2195,184051
2021-10-19,botswana,Africa,2440037,0,184051
2021-10-20,botswana,Africa,2440037,0,184051
2021-10-21,botswana,Africa,2440037,868,184919
2021-10-22,botswana,Africa,2440037,0,184919
2021-10-23,botswana,Africa,2440037,0,184919
2021-10-24,botswana,Africa,2440037,0,184919
2021-10-25,botswana,Africa,2440037,1066,185985
2021-10-26,botswana,Africa,2440037,0,185985
2021-10-27,botswana,Africa,2440037,0,185985
2021-10-28,botswana,Africa,2440037,609,186594
2021-10-29,botswana,Africa,2440037,0,186594
2021-10-30,botswana,Africa,2440037,0,186594
2021-10-31,botswana,Africa,2440037,0,186594
2021-11-01,botswana,Africa,2440037,687,187281
2021-11-02,botswana,Africa,2440037,0,187281
2021-11-03,botswana,Africa,2440037,0,187281
2021-11-04,botswana,Africa,2440037,5654,192935
2021-11-05,botswana,Africa,2440037,0,192935
2021-11-06,botswana,Africa,2440037,0,192935
2021-11-07,botswana,Africa,2440037,0,192935
2021-11-08,botswana,Africa,2440037,514,193449
2021-11-09,botswana,Africa,2440037,0,193449
2021-11-10,botswana,Africa,2440037,0,193449
2021-11-11,botswana,Africa,2440037,252,193701
2021-11-12,botswana,Africa,2440037,0,193701
2021-11-13,botswana,Africa,2440037,0,193701
2021-11-14,botswana,Africa,2440037,0,193701
2021-11-15,botswana,Africa,2440037,428,194129
2021-11-16,botswana,Africa,2440037,0,194129
2021-11-17,botswana,Africa,2440037,0,194129
2021-11-18,botswana,Africa,2440037,316,194445
2021-11-19,botswana,Africa,2440037,0,194445
2021-11-20,botswana,Africa,2440037,0,194445
2021-11-21,botswana,Africa,2440037,0,194445
2021-11-22,botswana,Africa,2440037,207,194652
2021-11-23,botswana,Africa,2440037,0,194652
2021-11-24,botswana,Africa,2440037,0,194652
2021-11-25,botswana,Africa,2440037,257,194909
2021-11-26,botswana,Africa,2440037,0,194909
2021-11-27,botswana,Africa,2440037,0,194909
2021-11-28,botswana,Africa,2440037,0,194909
2021-11-29,botswana,Africa,2440037,159,195068
2021-11-30,botswana,Africa,2440037,0,195068
2021-12-01,botswana,Africa,2440037,0,195068
2021-12-02,botswana,Africa,2440037,234,195302
2021-12-03,botswana,Africa,2440037,0,195302
2021-12-04,botswana,Africa,2440037,0,195302
2021-12-05,botswana,Africa,2440037,0,195302
2021-12-06,botswana,Africa,2440037,250,195552
2021-12-07,botswana,Africa,2440037,0,195552
2021-12-08,botswana,Africa,2440037,0,195552
2021-12-09,botswana,Africa,2440037,538,196090
2021-12-10,botswana,Africa,2440037,0,196090
2021-12-11,botswana,Africa,2440037,0,196090
2021-12-12,botswana,Africa,2440037,0,196090
2021-12-13,botswana,Africa,2440037,0,196090
2021-12-14,botswana,Africa,2440037,1554,197644
2021-12-15,botswana,Africa,2440037,0,197644
2021-12-16,botswana,Africa,2440037,2220,199864
2021-12-17,botswana,Africa,2440037,0,199864
2021-12-18,botswana,Africa,2440037,0,199864
2021-12-19,botswana,Africa,2440037,0,199864
2021-12-20,botswana,Africa,2440037,4837,204701
2021-12-21,botswana,Africa,2440037,0,204701
2021-12-22,botswana,Africa,2440037,0,204701
2021-12-23,botswana,Africa,2440037,4293,208994
2021-12-24,botswana,Africa,2440037,0,208994
2021-12-25,botswana,Africa,2440037,0,208994
2021-12-26,botswana,Africa,2440037,0,208994
2021-12-27,botswana,Africa,2440037,3488,212482
2021-12-28,botswana,Africa,2440037,0,212482
2021-12-29,botswana,Africa,2440037,0,212482
2021-12-30,botswana,Africa,2440037,7027,219509
2021-12-31,botswana,Africa,2440037,0,219509
2022-01-01,botswana,Africa,2440037,0,219509
2022-01-02,botswana,Africa,2440037,0,219509
2022-01-03,botswana,Africa,2440037,2544,222053
2022-01-04,botswana,Africa,2440037,0,222053
2022-01-05,botswana,Africa,2440037,0,222053
2022-01-06,botswana,Africa,2440037,7802,229855
2022-01-07,botswana,Africa,2440037,0,229855
2022-01-08,botswana,Africa,2440037,0,229855
2022-01-09,botswana,Africa,2440037,0,229855
2022-01-10,botswana,Africa,2440037,2577,232432
2022-01-11,botswana,Africa,2440037,0,232432
2022-01-12,botswana,Africa,2440037,0,232432
2022-01-13,botswana,Africa,2440037,5246,237678
2022-01-14,botswana,Africa,2440037,0,237678
2022-01-15,botswana,Africa,2440037,0,237678
2022-01-16,botswana,Africa,2440037,0,237678
2022-01-17,botswana,Africa,2440037,2209,239887
2022-01-18,botswana,Africa,2440037,0,239887
2022-01-19,botswana,Africa,2440037,0,239887
2022-01-20,botswana,Africa,2440037,4059,243946
2022-01-21,botswana,Africa,2440037,0,243946
2022-01-22,botswana,Africa,2440037,0,243946
2022-01-23,botswana,Africa,2440037,0,243946
2022-01-24,botswana,Africa,2440037,1958,245904
2022-01-25,botswana,Africa,2440037,0,245904
2022-01-26,botswana,Africa,2440037,0,245904
2022-01-27,botswana,Africa,2440037,4842,250746
2022-01-28,botswana,Africa,2440037,0,250746
2022-01-29,botswana,Africa,2440037,0,250746
2022-01-30,botswana,Africa,2440037,0,250746
2022-01-31,botswana,Africa,2440037,2290,253036
2022-02-01,botswana,Africa,2440037,0,253036
2022-02-02,botswana,Africa,2440037,0,253036
2022-02-03,botswana,Africa,2440037,3005,256041
2022-02-04,botswana,Africa,2440037,0,256041
2022-02-05,botswana,Africa,2440037,0,256041
2022-02-06,botswana,Africa,2440037,0,256041
2022-02-07,botswana,Africa,2440037,1126,257167
2022-02-08,botswana,Africa,2440037,0,257167
2022-02-09,botswana,Africa,2440037,0,257167
2022-02-10,botswana,Africa,2440037,2488,259655
2022-02-11,botswana,Africa,2440037,0,259655
2022-02-12,botswana,Africa,2440037,0,259655
2022-02-13,botswana,Africa,2440037,0,259655
2022-02-14,botswana,Africa,2440037,836,260491
2022-02-15,botswana,Africa,2440037,0,260491
2022-02-16,botswana,Africa,2440037,0,260491
2022-02-17,botswana,Africa,2440037,1422,261913
2022-02-18,botswana,Africa,2440037,0,261913
2020-03-29,brunei_darussalam,Asia,445281,6,126
2020-03-30,brunei_darussalam,Asia,445281,1,127
2020-03-31,brunei_darussalam,Asia,445281,2,129
2020-04-01,brunei_darussalam,Asia,445281,2,131
2020-04-02,brunei_darussalam,Asia,445281,2,133
2020-04-03,brunei_darussalam,Asia,445281,1,134
2020-04-04,brunei_darussalam,Asia,445281,1,135
2020-04-05,brunei_darussalam,Asia,445281,0,135
2020-04-06,brunei_darussalam,Asia,445281,0,135
2020-04-07,brunei_darussalam,Asia,445281,0,135
2020-04-08,brunei_darussalam,Asia,445281,0,135
2020-04-09,brunei_darussalam,Asia,445281,0,135
2020-04-10,brunei_darussalam,Asia,445281,1,136
2020-04-11,brunei_darussalam,Asia,445281,0,136
2020-04-12,brunei_darussalam,Asia,445281,0,136
2020-04-13,brunei_darussalam,Asia,445281,0,136
2020-04-14,brunei_darussalam,Asia,445281,0,136
2020-04-15,brunei_darussalam,Asia,445281,0,136
2020-04-16,brunei_darussalam,Asia,445281,0,136
2020-04-17,brunei_darussalam,Asia,445281,0,136
2020-04-18,brunei_darussalam,Asia,445281,1,137
2020-04-19,brunei_darussalam,Asia,445281,1,138
2020-04-20,brunei_darussalam,Asia,445281,0,138
2020-04-21,brunei_darussalam,Asia,445281,0,138
2020-04-22,brunei_darussalam,Asia,445281,0,138
2020-04-23,brunei_darussalam,Asia,445281,0,138
2020-04-24,brunei_darussalam,Asia,445281,0,138
2020-04-25,brunei_darussalam,Asia,445281,0,138
2020-04-26,brunei_darussalam,Asia,445281,0,138
2020-04-27,brunei_darussalam,Asia,445281,0,138
2020-04-28,brunei_darussalam,Asia,445281,0,138
2020-04-29,brunei_darussalam,Asia,445281,0,138
2020-04-30,brunei_darussalam,Asia,445281,0,138
2020-05-01,brunei_darussalam,Asia,445281,0,138
2020-05-02,brunei_darussalam,Asia,445281,0,138
2020-05-03,brunei_darussalam,Asia,445281,0,138
2020-05-04,brunei_darussalam,Asia,445281,0,138
2020-05-05,brunei_darussalam,Asia,445281,0,138
2020-05-06,brunei_darussalam,Asia,445281,1,139
2020-05-07,brunei_darussalam,Asia,445281,2,141
2020-05-08,brunei_darussalam,Asia,445281,0,141
2020-05-09,brunei_darussalam,Asia,445281,0,141
2020-05-10,brunei_darussalam,Asia,445281,0,141
2020-05-11,brunei_darussalam,Asia,445281,0,141
2020-05-12,brunei_darussalam,Asia,445281,0,141
2020-05-13,brunei_darussalam,Asia,445281,0,141
2020-05-14,brunei_darussalam,Asia,445281,0,141
2020-05-15,brunei_darussalam,Asia,445281,0,141
2020-05-16,brunei_darussalam,Asia,445281,0,141
2020-05-17,brunei_darussalam,Asia,445281,0,141
2020-05-18,brunei_darussalam,Asia,445281,0,141
2020-05-19,brunei_darussalam,Asia,445281,0,141
2020-05-20,brunei_darussalam,Asia,445281,0,141
2020-05-21,brunei_darussalam,Asia,445281,0,141
2020-05-22,brunei_darussalam,Asia,445281,0,141
2020-05-23,brunei_darussalam,Asia,445281,0,141
2020-05-24,brunei_darussalam,Asia,445281,0,141
2020-05-25,brunei_darussalam,Asia,445281,0,141
2020-05-26,brunei_darussalam,Asia,445281,0,141
2020-05-27,brunei_darussalam,Asia,445281,0,141
2020-05-28,brunei_darussalam,Asia,445281,0,141
2020-05-29,brunei_darussalam,Asia,445281,0,141
2020-05-30,brunei_darussalam,Asia,445281,0,141
2020-05-31,brunei_darussalam,Asia,445281,0,141
2020-06-01,brunei_darussalam,Asia,445281,0,141
2020-06-02,brunei_darussalam,Asia,445281,0,141
2020-06-03,brunei_darussalam,Asia,445281,0,141
2020-06-04,brunei_darussalam,Asia,445281,0,141
2020-06-05,brunei_darussalam,Asia,445281,0,141
2020-06-06,brunei_darussalam,Asia,445281,0,141
2020-06-07,brunei_darussalam,Asia,445281,0,141
2020-06-08,brunei_darussalam,Asia,445281,0,141
2020-06-09,brunei_darussalam,Asia,445281,0,141
2020-06-10,brunei_darussalam,Asia,445281,0,141
2020-06-11,brunei_darussalam,Asia,445281,0,141
2020-06-12,brunei_darussalam,Asia,445281,0,141
2020-06-13,brunei_darussalam,Asia,445281,0,141
2020-06-14,brunei_darussalam,Asia,445281,0,141
2020-06-15,brunei_darussalam,Asia,445281,0,141
2020-06-16,brunei_darussalam,Asia,445281,0,141
2020-06-17,brunei_darussalam,Asia,445281,0,141
2020-06-18,brunei_darussalam,Asia,445281,0,141
2020-06-19,brunei_darussalam,Asia,445281,0,141
2020-06-20,brunei_darussalam,Asia,445281,0,141
2020-06-21,brunei_darussalam,Asia,445281,0,141
2020-06-22,brunei_darussalam,Asia,445281,0,141
2020-06-23,brunei_darussalam,Asia,445281,0,141
2020-06-24,brunei_darussalam,Asia,445281,0,141
2020-06-25,brunei_darussalam,Asia,445281,0,141
2020-06-26,brunei_darussalam,Asia,445281,0,141
2020-06-27,brunei_darussalam,Asia,445281,0,141
2020-06-28,brunei_darussalam,Asia,445281,0,141
2020-06-29,brunei_darussalam,Asia,445281,0,141
2020-06-30,brunei_darussalam,Asia,445281,0,141
2020-07-01,brunei_darussalam,Asia,445281,0,141
2020-07-02,brunei_darussalam,Asia,445281,0,141
2020-07-03,brunei_darussalam,Asia,445281,0,141
2020-07-04,brunei_darussalam,Asia,445281,0,141
2020-07-05,brunei_darussalam,Asia,445281,0,141
2020-07-06,brunei_darussalam,Asia,445281,0,141
2020-07-07,brunei_darussalam,Asia,445281,0,141
2020-07-08,brunei_darussalam,Asia,445281,0,141
2020-07-09,brunei_darussalam,Asia,445281,0,141
2020-07-10,brunei_darussalam,Asia,445281,0,141
2020-07-11,brunei_darussalam,Asia,445281,0,141
2020-07-12,brunei_darussalam,Asia,445281,0,141
2020-07-13,brunei_darussalam,Asia,445281,0,141
2020-03-12,bulgaria,Europe,6851060,16,23
2020-03-13,bulgaria,Europe,6851060,8,31
2020-03-14,bulgaria,Europe,6851060,10,41
2020-03-15,bulgaria,Europe,6851060,10,51
2020-03-16,bulgaria,Europe,6851060,11,62
2020-03-17,bulgaria,Europe,6851060,19,81
2020-03-18,bulgaria,Europe,6851060,11,92
2020-03-19,bulgaria,Europe,6851060,15,107
2020-03-20,bulgaria,Europe,6851060,20,127
2020-03-21,bulgaria,Europe,6851060,36,163
2020-03-22,bulgaria,Europe,6851060,24,187
2020-03-23,bulgaria,Europe,6851060,14,201
2020-03-24,bulgaria,Europe,6851060,17,218
2020-03-25,bulgaria,Europe,6851060,24,242
2020-03-26,bulgaria,Europe,6851060,22,264
2020-03-27,bulgaria,Europe,6851060,29,293
2020-03-28,bulgaria,Europe,6851060,38,331
2020-03-29,bulgaria,Europe,6851060,15,346
2020-03-30,bulgaria,Europe,6851060,13,359
2020-03-31,bulgaria,Europe,6851060,40,399
2020-04-01,bulgaria,Europe,6851060,23,422
2020-04-02,bulgaria,Europe,6851060,35,457
2020-04-03,bulgaria,Europe,6851060,28,485
2020-04-04,bulgaria,Europe,6851060,18,503
2020-04-05,bulgaria,Europe,6851060,28,531
2020-04-06,bulgaria,Europe,6851060,18,549
2020-04-07,bulgaria,Europe,6851060,28,577
2020-04-08,bulgaria,Europe,6851060,16,593
2020-04-09,bulgaria,Europe,6851060,25,618
2020-04-10,bulgaria,Europe,6851060,17,635
2020-04-11,bulgaria,Europe,6851060,26,661
2020-04-12,bulgaria,Europe,6851060,14,675
2020-04-13,bulgaria,Europe,6851060,10,685
2020-04-14,bulgaria,Europe,6851060,28,713
2020-04-15,bulgaria,Europe,6851060,34,747
2020-04-16,bulgaria,Europe,6851060,53,800
2020-04-17,bulgaria,Europe,6851060,46,846
2020-04-18,bulgaria,Europe,6851060,32,878
2020-04-19,bulgaria,Europe,6851060,16,894
2020-04-20,bulgaria,Europe,6851060,35,929
2020-04-21,bulgaria,Europe,6851060,46,975
2020-04-22,bulgaria,Europe,6851060,49,1024
2020-04-23,bulgaria,Europe,6851060,73,1097
2020-04-24,bulgaria,Europe,6851060,91,1188
2020-04-25,bulgaria,Europe,6851060,59,1247
2020-04-26,bulgaria,Europe,6851060,53,1300
2020-04-27,bulgaria,Europe,6851060,63,1363
2020-04-28,bulgaria,Europe,6851060,36,1399
2020-04-29,bulgaria,Europe,6851060,48,1447
2020-04-30,bulgaria,Europe,6851060,59,1506
2020-05-01,bulgaria,Europe,6851060,49,1555
2020-05-02,bulgaria,Europe,6851060,39,1594
2020-05-03,bulgaria,Europe,6851060,24,1618
2020-05-04,bulgaria,Europe,6851060,34,1652
2020-05-05,bulgaria,Europe,6851060,52,1704
2020-05-06,bulgaria,Europe,6851060,74,1778
2020-05-07,bulgaria,Europe,6851060,51,1829
2020-05-08,bulgaria,Europe,6851060,43,1872
2020-05-09,bulgaria,Europe,6851060,49,1921
2020-05-10,bulgaria,Europe,6851060,44,1965
2020-05-11,bulgaria,Europe,6851060,25,1990
2020-05-12,bulgaria,Europe,6851060,33,2023
2020-05-13,bulgaria,Europe,6851060,46,2069
2020-05-14,bulgaria,Europe,6851060,31,2100
2020-05-15,bulgaria,Europe,6851060,38,2138
2020-05-16,bulgaria,Europe,6851060,37,2175
2020-05-17,bulgaria,Europe,6851060,36,2211
2020-05-18,bulgaria,Europe,6851060,24,2235
2020-05-19,bulgaria,Europe,6851060,24,2259
2020-05-20,bulgaria,Europe,6851060,33,2292
2020-05-21,bulgaria,Europe,6851060,39,2331
2020-05-22,bulgaria,Europe,6851060,41,2372
2020-05-23,bulgaria,Europe,6851060,36,2408
2020-05-24,bulgaria,Europe,6851060,19,2427
2020-05-25,bulgaria,Europe,6851060,6,2433
2020-05-26,bulgaria,Europe,6851060,10,2443
2020-05-27,bulgaria,Europe,6851060,17,2460
2020-05-28,bulgaria,Europe,6851060,17,2477
2020-05-29,bulgaria,Europe,6851060,8,2485
2020-05-30,bulgaria,Europe,6851060,14,2499
2020-05-31,bulgaria,Europe,6851060,14,2513
2020-06-01,bulgaria,Europe,6851060,6,2519
2020-06-02,bulgaria,Europe,6851060,19,2538
2020-06-03,bulgaria,Europe,6851060,22,2560
2020-06-04,bulgaria,Europe,6851060,26,2586
2020-06-05,bulgaria,Europe,6851060,41,2627
2020-06-06,bulgaria,Europe,6851060,41,2668
2020-06-07,bulgaria,Europe,6851060,59,2727
2020-06-08,bulgaria,Europe,6851060,83,2810
2020-06-09,bulgaria,Europe,6851060,79,2889
2020-06-10,bulgaria,Europe,6851060,104,2993
2020-06-11,bulgaria,Europe,6851060,93,3086
2020-06-12,bulgaria,Europe,6851060,105,3191
2020-06-13,bulgaria,Europe,6851060,75,3266
2020-06-14,bulgaria,Europe,6851060,24,3290
2020-06-15,bulgaria,Europe,6851060,51,3341
2020-06-16,bulgaria,Europe,6851060,112,3453
2020-06-17,bulgaria,Europe,6851060,89,3542
2020-06-18,bulgaria,Europe,6851060,132,3674
2020-06-19,bulgaria,Europe,6851060,81,3755
2020-06-20,bulgaria,Europe,6851060,117,3872
2020-06-21,bulgaria,Europe,6851060,33,3905
2020-06-22,bulgaria,Europe,6851060,79,3984
2020-06-23,bulgaria,Europe,6851060,130,4114
2020-06-24,bulgaria,Europe,6851060,128,4242
2020-06-25,bulgaria,Europe,6851060,166,4408
2020-06-26,bulgaria,Europe,6851060,105,4513
2020-06-27,bulgaria,Europe,6851060,112,4625
2020-06-28,bulgaria,Europe,6851060,66,4691
2020-06-29,bulgaria,Europe,6851060,140,4831
2020-06-30,bulgaria,Europe,6851060,158,4989
2020-07-01,bulgaria,Europe,6851060,165,5154
2020-07-02,bulgaria,Europe,6851060,161,5315
2020-07-03,bulgaria,Europe,6851060,182,5497
2020-07-04,bulgaria,Europe,6851060,180,5677
2020-07-05,bulgaria,Europe,6851060,63,5740
2020-07-06,bulgaria,Europe,6851060,174,5914
2020-07-07,bulgaria,Europe,6851060,188,6102
2020-07-08,bulgaria,Europe,6851060,240,6342
2020-07-09,bulgaria,Europe,6851060,330,6672
2020-07-10,bulgaria,Europe,6851060,292,6964
2020-07-11,bulgaria,Europe,6851060,211,7175
2020-07-12,bulgaria,Europe,6851060,77,7252
2020-07-13,bulgaria,Europe,6851060,159,7411
2020-07-14,bulgaria,Europe,6851060,234,7645
2020-07-15,bulgaria,Europe,6851060,232,7877
2020-07-16,bulgaria,Europe,6851060,267,8144
2020-07-17,bulgaria,Europe,6851060,298,8442
2020-07-18,bulgaria,Europe,6851060,196,8638
2020-07-19,bulgaria,Europe,6851060,95,8733
2020-07-20,bulgaria,Europe,6851060,196,8929
2020-07-21,bulgaria,Europe,6851060,325,9254
2020-07-22,bulgaria,Europe,6851060,330,9584
2020-07-23,bulgaria,Europe,6851060,269,9853
2020-07-24,bulgaria,Europe,6851060,270,10123
2020-07-25,bulgaria,Europe,6851060,189,10312
2020-07-26,bulgaria,Europe,6851060,115,10427
2020-07-27,bulgaria,Europe,6851060,194,10621
2020-07-28,bulgaria,Europe,6851060,250,10871
2020-07-29,bulgaria,Europe,6851060,284,11155
2020-07-30,bulgaria,Europe,6851060,265,11420
2020-07-31,bulgaria,Europe,6851060,270,11690
2020-08-01,bulgaria,Europe,6851060,146,11836
2020-08-02,bulgaria,Europe,6851060,119,11955
2020-08-03,bulgaria,Europe,6851060,204,12159
2020-08-04,bulgaria,Europe,6851060,255,12414
2020-08-05,bulgaria,Europe,6851060,303,12717
2020-08-06,bulgaria,Europe,6851060,297,13014
2020-08-07,bulgaria,Europe,6851060,195,13209
2020-08-08,bulgaria,Europe,6851060,134,13343
2020-08-09,bulgaria,Europe,6851060,53,13396
2020-08-10,bulgaria,Europe,6851060,116,13512
2020-08-11,bulgaria,Europe,6851060,210,13722
2020-08-12,bulgaria,Europe,6851060,171,13893
2020-08-13,bulgaria,Europe,6851060,176,14069
2020-08-14,bulgaria,Europe,6851060,174,14243
2020-08-15,bulgaria,Europe,6851060,90,14333
2020-08-16,bulgaria,Europe,6851060,32,14365
2020-08-17,bulgaria,Europe,6851060,135,14500
2020-08-18,bulgaria,Europe,6851060,169,14669
2020-08-19,bulgaria,Europe,6851060,151,14820
2020-08-20,bulgaria,Europe,6851060,142,14962
2020-08-21,bulgaria,Europe,6851060,169,15131
2020-08-22,bulgaria,Europe,6851060,96,15227
2020-08-23,bulgaria,Europe,6851060,60,15287
2020-08-24,bulgaria,Europe,6851060,99,15386
2020-08-25,bulgaria,Europe,6851060,203,15589
2020-08-26,bulgaria,Europe,6851060,162,15751
2020-08-27,bulgaria,Europe,6851060,157,15908
2020-08-28,bulgaria,Europe,6851060,157,16065
2020-08-29,bulgaria,Europe,6851060,99,16164
2020-08-30,bulgaria,Europe,6851060,26,16190
2020-08-31,bulgaria,Europe,6851060,76,16266
2020-09-01,bulgaria,Europe,6851060,188,16454
2020-09-02,bulgaria,Europe,6851060,163,16617
2020-09-03,bulgaria,Europe,6851060,158,16775
2020-09-04,bulgaria,Europe,6851060,179,16954
2020-09-05,bulgaria,Europe,6851060,96,17050
2020-09-06,bulgaria,Europe,6851060,39,17089
2020-09-07,bulgaria,Europe,6851060,57,17146
2020-09-08,bulgaria,Europe,6851060,167,17313
2020-09-09,bulgaria,Europe,6851060,122,17435
2020-09-10,bulgaria,Europe,6851060,163,17598
2020-09-11,bulgaria,Europe,6851060,201,17799
2020-09-12,bulgaria,Europe,6851060,92,17891
2020-09-13,bulgaria,Europe,6851060,27,17918
2020-09-14,bulgaria,Europe,6851060,143,18061
2020-09-15,bulgaria,Europe,6851060,155,18216
2020-09-16,bulgaria,Europe,6851060,174,18390
2020-09-17,bulgaria,Europe,6851060,154,18544
2020-09-18,bulgaria,Europe,6851060,189,18733
2020-09-19,bulgaria,Europe,6851060,86,18819
2020-09-20,bulgaria,Europe,6851060,44,18863
2020-09-21,bulgaria,Europe,6851060,151,19014
2020-09-22,bulgaria,Europe,6851060,109,19123
2020-09-23,bulgaria,Europe,6851060,160,19283
2020-09-24,bulgaria,Europe,6851060,290,19573
2020-09-25,bulgaria,Europe,6851060,255,19828
2020-09-26,bulgaria,Europe,6851060,169,19997
2020-09-27,bulgaria,Europe,6851060,58,20055
2020-09-28,bulgaria,Europe,6851060,216,20271
2020-09-29,bulgaria,Europe,6851060,276,20547
2020-09-30,bulgaria,Europe,6851060,286,20833
2020-10-01,bulgaria,Europe,6851060,263,21096
2020-10-02,bulgaria,Europe,6851060,240,21336
2020-10-03,bulgaria,Europe,6851060,182,21518
2020-10-04,bulgaria,Europe,6851060,69,21587
2020-10-05,bulgaria,Europe,6851060,283,21870
2020-10-06,bulgaria,Europe,6851060,436,22306
2020-10-07,bulgaria,Europe,6851060,437,22743
2020-10-08,bulgaria,Europe,6851060,516,23259
2020-10-09,bulgaria,Europe,6851060,612,23871
2020-10-10,bulgaria,Europe,6851060,448,24319
2020-10-11,bulgaria,Europe,6851060,83,24402
2020-10-12,bulgaria,Europe,6851060,587,24989
2020-10-13,bulgaria,Europe,6851060,785,25774
2020-10-14,bulgaria,Europe,6851060,819,26593
2020-10-15,bulgaria,Europe,6851060,914,27507
2020-10-16,bulgaria,Europe,6851060,998,28505
2020-10-17,bulgaria,Europe,6851060,603,29108
2020-10-18,bulgaria,Europe,6851060,395,29503
2020-10-19,bulgaria,Europe,6851060,1024,30527
2020-10-20,bulgaria,Europe,6851060,1336,31863
2020-10-21,bulgaria,Europe,6851060,1472,33335
2020-10-22,bulgaria,Europe,6851060,1595,34930
2020-10-23,bulgaria,Europe,6851060,1589,36519
2020-10-24,bulgaria,Europe,6851060,1043,37562
2020-10-25,bulgaria,Europe,6851060,327,37889
2020-10-26,bulgaria,Europe,6851060,2243,40132
2020-10-27,bulgaria,Europe,6851060,2569,42701
2020-10-28,bulgaria,Europe,6851060,2760,45461
2020-10-29,bulgaria,Europe,6851060,2689,48150
2020-10-30,bulgaria,Europe,6851060,2891,51041
2020-10-31,bulgaria,Europe,6851060,1803,52844
2020-11-01,bulgaria,Europe,6851060,1225,54069
2020-11-02,bulgaria,Europe,6851060,2427,56496
2020-11-03,bulgaria,Europe,6851060,4041,60537
2020-11-04,bulgaria,Europe,6851060,4054,64591
2020-11-05,bulgaria,Europe,6851060,3754,68345
2020-11-06,bulgaria,Europe,6851060,3839,72184
2020-11-07,bulgaria,Europe,6851060,2301,74485
2020-11-08,bulgaria,Europe,6851060,675,75160
2020-11-09,bulgaria,Europe,6851060,3816,78976
2020-11-10,bulgaria,Europe,6851060,4390,83366
2020-11-11,bulgaria,Europe,6851060,3945,87311
2020-11-12,bulgaria,Europe,6851060,3414,90725
2020-11-13,bulgaria,Europe,6851060,4212,94937
2020-11-14,bulgaria,Europe,6851060,2498,97435
2020-11-15,bulgaria,Europe,6851060,816,98251
2020-11-16,bulgaria,Europe,6851060,3519,101770
2020-11-17,bulgaria,Europe,6851060,4828,106598
2020-11-18,bulgaria,Europe,6851060,3938,110536
2020-11-19,bulgaria,Europe,6851060,3899,114435
2020-11-20,bulgaria,Europe,6851060,3983,118418
2020-11-21,bulgaria,Europe,6851060,2279,120697
2020-11-22,bulgaria,Europe,6851060,1123,121820
2020-11-23,bulgaria,Europe,6851060,3146,124966
2020-11-24,bulgaria,Europe,6851060,4382,129348
2020-11-25,bulgaria,Europe,6851060,3712,133060
2020-11-26,bulgaria,Europe,6851060,3568,136628
2020-11-27,bulgaria,Europe,6851060,3327,139955
2020-11-28,bulgaria,Europe,6851060,1792,141747
2020-11-29,bulgaria,Europe,6851060,739,142486
2020-11-30,bulgaria,Europe,6851060,2814,145300
2020-12-01,bulgaria,Europe,6851060,3475,148775
2020-12-02,bulgaria,Europe,6851060,3138,151913
2020-12-03,bulgaria,Europe,6851060,3280,155193
2020-12-04,bulgaria,Europe,6851060,3614,158807
2020-12-05,bulgaria,Europe,6851060,2037,160844
2020-12-06,bulgaria,Europe,6851060,577,161421
2020-12-07,bulgaria,Europe,6851060,2764,164185
2020-12-08,bulgaria,Europe,6851060,3980,168165
2020-12-09,bulgaria,Europe,6851060,3328,171493
2020-12-10,bulgaria,Europe,6851060,3075,174568
2020-12-11,bulgaria,Europe,6851060,3097,177665
2020-12-12,bulgaria,Europe,6851060,1287,178952
2020-12-13,bulgaria,Europe,6851060,497,179449
2020-12-14,bulgaria,Europe,6851060,2095,181544
2020-12-15,bulgaria,Europe,6851060,2743,184287
2020-12-16,bulgaria,Europe,6851060,1959,186246
2020-12-17,bulgaria,Europe,6851060,2042,188288
2020-12-18,bulgaria,Europe,6851060,1739,190027
2020-12-19,bulgaria,Europe,6851060,1002,191029
2020-12-20,bulgaria,Europe,6851060,166,191195
2020-12-21,bulgaria,Europe,6851060,1277,192472
2020-12-22,bulgaria,Europe,6851060,1799,194271
2020-12-23,bulgaria,Europe,6851060,1615,195886
2020-12-24,bulgaria,Europe,6851060,772,196658
2020-12-25,bulgaria,Europe,6851060,257,196915
2020-12-26,bulgaria,Europe,6851060,469,197384
2020-12-27,bulgaria,Europe,6851060,332,197716
2020-12-28,bulgaria,Europe,6851060,337,198053
2020-12-29,bulgaria,Europe,6851060,1438,199491
2020-12-30,bulgaria,Europe,6851060,1729,201220
2020-12-31,bulgaria,Europe,6851060,1046,202266
2021-01-01,bulgaria,Europe,6851060,274,202540
2021-01-02,bulgaria,Europe,6851060,340,202880
2021-01-03,bulgaria,Europe,6851060,171,203051
2021-01-04,bulgaria,Europe,6851060,1029,204080
2021-01-05,bulgaria,Europe,6851060,1310,205390
2021-01-06,bulgaria,Europe,6851060,1002,206392
2021-01-07,bulgaria,Europe,6851060,867,207259
2021-01-08,bulgaria,Europe,6851060,753,208012
2021-01-09,bulgaria,Europe,6851060,394,208406
2021-01-10,bulgaria,Europe,6851060,105,208511
2021-01-11,bulgaria,Europe,6851060,620,209131
2021-01-12,bulgaria,Europe,6851060,750,209881
2021-01-13,bulgaria,Europe,6851060,535,210416
2021-01-14,bulgaria,Europe,6851060,535,210951
2021-01-15,bulgaria,Europe,6851060,552,211503
2021-01-16,bulgaria,Europe,6851060,233,211736
2021-01-17,bulgaria,Europe,6851060,77,211813
2021-01-18,bulgaria,Europe,6851060,570,212383
2021-01-19,bulgaria,Europe,6851060,544,212927
2021-01-20,bulgaria,Europe,6851060,482,213409
2021-01-21,bulgaria,Europe,6851060,455,213864
2021-01-22,bulgaria,Europe,6851060,566,214430
2021-01-23,bulgaria,Europe,6851060,266,214696
2021-01-24,bulgaria,Europe,6851060,121,214817
2021-01-25,bulgaria,Europe,6851060,772,215589
2021-01-26,bulgaria,Europe,6851060,827,216416
2021-01-27,bulgaria,Europe,6851060,598,217014
2021-01-28,bulgaria,Europe,6851060,560,217574
2021-01-29,bulgaria,Europe,6851060,695,218269
2021-01-30,bulgaria,Europe,6851060,349,218618
2021-01-31,bulgaria,Europe,6851060,130,218748
2021-02-01,bulgaria,Europe,6851060,832,219580
2021-02-02,bulgaria,Europe,6851060,967,220547
2021-02-03,bulgaria,Europe,6851060,719,221266
2021-02-04,bulgaria,Europe,6851060,883,222149
2020-03-19,burkina_faso,Africa,21970296,6,33
2020-03-20,burkina_faso,Africa,21970296,7,40
2020-03-21,burkina_faso,Africa,21970296,24,64
2020-03-22,burkina_faso,Africa,21970296,11,75
2020-03-23,burkina_faso,Africa,21970296,24,99
2020-03-24,burkina_faso,Africa,21970296,15,114
2020-03-25,burkina_faso,Africa,21970296,32,146
2020-03-26,burkina_faso,Africa,21970296,6,152
2020-03-27,burkina_faso,Africa,21970296,28,180
2020-03-28,burkina_faso,Africa,21970296,27,207
2020-03-29,burkina_faso,Africa,21970296,15,222
2020-03-30,burkina_faso,Africa,21970296,24,246
2020-03-31,burkina_faso,Africa,21970296,15,261
2020-04-01,burkina_faso,Africa,21970296,21,282
2020-04-02,burkina_faso,Africa,21970296,6,288
2020-04-03,burkina_faso,Africa,21970296,14,302
2020-04-04,burkina_faso,Africa,21970296,16,318
2020-04-05,burkina_faso,Africa,21970296,27,345
2020-04-06,burkina_faso,Africa,21970296,19,364
2020-04-07,burkina_faso,Africa,21970296,20,384
2020-04-08,burkina_faso,Africa,21970296,30,414
2020-04-09,burkina_faso,Africa,21970296,29,443
2020-04-10,burkina_faso,Africa,21970296,5,448
2020-04-11,burkina_faso,Africa,21970296,36,484
2020-04-12,burkina_faso,Africa,21970296,13,497
2020-04-13,burkina_faso,Africa,21970296,18,515
2020-04-14,burkina_faso,Africa,21970296,13,528
2020-04-15,burkina_faso,Africa,21970296,14,542
2020-04-16,burkina_faso,Africa,21970296,4,546
2020-04-17,burkina_faso,Africa,21970296,11,557
2020-04-18,burkina_faso,Africa,21970296,8,565
2020-04-19,burkina_faso,Africa,21970296,11,576
2020-04-20,burkina_faso,Africa,21970296,5,581
2020-04-21,burkina_faso,Africa,21970296,19,600
2020-04-22,burkina_faso,Africa,21970296,9,609
2020-04-23,burkina_faso,Africa,21970296,7,616
2020-04-24,burkina_faso,Africa,21970296,13,629
2020-04-25,burkina_faso,Africa,21970296,0,629
2020-04-26,burkina_faso,Africa,21970296,3,632
2020-04-27,burkina_faso,Africa,21970296,3,635
2020-04-28,burkina_faso,Africa,21970296,3,638
2020-04-29,burkina_faso,Africa,21970296,3,641
2020-04-30,burkina_faso,Africa,21970296,4,645
2020-05-01,burkina_faso,Africa,21970296,4,649
2020-05-02,burkina_faso,Africa,21970296,3,652
2020-05-03,burkina_faso,Africa,21970296,10,662
2020-05-04,burkina_faso,Africa,21970296,10,672
2020-05-05,burkina_faso,Africa,21970296,16,688
2020-05-06,burkina_faso,Africa,21970296,41,729
2020-05-07,burkina_faso,Africa,21970296,7,736
2020-05-08,burkina_faso,Africa,21970296,8,744
2020-05-09,burkina_faso,Africa,21970296,4,748
2020-05-10,burkina_faso,Africa,21970296,3,751
2020-05-11,burkina_faso,Africa,21970296,9,760
2020-05-12,burkina_faso,Africa,21970296,6,766
2020-05-13,burkina_faso,Africa,21970296,7,773
2020-05-14,burkina_faso,Africa,21970296,0,773
2020-05-15,burkina_faso,Africa,21970296,7,780
2020-05-16,burkina_faso,Africa,21970296,2,782
2020-05-17,burkina_faso,Africa,21970296,14,796
2020-05-18,burkina_faso,Africa,21970296,0,796
2020-05-19,burkina_faso,Africa,21970296,0,796
2020-05-20,burkina_faso,Africa,21970296,13,809
2020-05-21,burkina_faso,Africa,21970296,3,812
2020-05-22,burkina_faso,Africa,21970296,2,814
2020-05-23,burkina_faso,Africa,21970296,0,814
2020-05-24,burkina_faso,Africa,21970296,0,814
2020-05-25,burkina_faso,Africa,21970296,18,832
2020-05-26,burkina_faso,Africa,21970296,0,832
2020-05-27,burkina_faso,Africa,21970296,13,845
2020-05-28,burkina_faso,Africa,21970296,2,847
2020-05-29,burkina_faso,Africa,21970296,0,847
2020-05-30,burkina_faso,Africa,21970296,0,847
2020-05-31,burkina_faso,Africa,21970296,0,847
2020-06-01,burkina_faso,Africa,21970296,0,847
2020-06-02,burkina_faso,Africa,21970296,34,881
2020-06-03,burkina_faso,Africa,21970296,3,884
2020-06-04,burkina_faso,Africa,21970296,1,885
2020-06-05,burkina_faso,Africa,21970296,3,888
2020-06-06,burkina_faso,Africa,21970296,0,888
2020-06-07,burkina_faso,Africa,21970296,1,889
2020-06-08,burkina_faso,Africa,21970296,1,890
2020-06-09,burkina_faso,Africa,21970296,1,891
2020-06-10,burkina_faso,Africa,21970296,0,891
2020-06-11,burkina_faso,Africa,21970296,1,892
2020-06-12,burkina_faso,Africa,21970296,0,892
2020-06-13,burkina_faso,Africa,21970296,0,892
2020-06-14,burkina_faso,Africa,21970296,2,894
2020-06-15,burkina_faso,Africa,21970296,0,894
2020-06-16,burkina_faso,Africa,21970296,1,895
2020-06-17,burkina_faso,Africa,21970296,4,899
2020-06-18,burkina_faso,Africa,21970296,0,899
2020-06-19,burkina_faso,Africa,21970296,1,900
2020-06-20,burkina_faso,Africa,21970296,1,901
2020-06-21,burkina_faso,Africa,21970296,2,903
2020-06-22,burkina_faso,Africa,21970296,0,903
2020-06-23,burkina_faso,Africa,21970296,4,907
2020-06-24,burkina_faso,Africa,21970296,12,919
2020-06-25,burkina_faso,Africa,21970296,15,934
2020-06-26,burkina_faso,Africa,21970296,7,941
2020-06-27,burkina_faso,Africa,21970296,0,941
2020-06-28,burkina_faso,Africa,21970296,18,959
2020-06-29,burkina_faso,Africa,21970296,0,959
2020-06-30,burkina_faso,Africa,21970296,3,962
2020-07-01,burkina_faso,Africa,21970296,0,962
2020-07-02,burkina_faso,Africa,21970296,5,967
2020-07-03,burkina_faso,Africa,21970296,13,980
2020-07-04,burkina_faso,Africa,21970296,7,987
2020-07-05,burkina_faso,Africa,21970296,0,987
2020-07-06,burkina_faso,Africa,21970296,13,1000
2020-07-07,burkina_faso,Africa,21970296,3,1003
2020-07-08,burkina_faso,Africa,21970296,0,1003
2020-07-09,burkina_faso,Africa,21970296,2,1005
2020-07-10,burkina_faso,Africa,21970296,15,1020
2020-07-11,burkina_faso,Africa,21970296,13,1033
2020-07-12,burkina_faso,Africa,21970296,3,1036
2020-07-13,burkina_faso,Africa,21970296,0,1036
2020-07-14,burkina_faso,Africa,21970296,1,1037
2020-07-15,burkina_faso,Africa,21970296,1,1038
2020-07-16,burkina_faso,Africa,21970296,0,1038
2020-07-17,burkina_faso,Africa,21970296,7,1045
2020-07-18,burkina_faso,Africa,21970296,2,1047
2020-07-19,burkina_faso,Africa,21970296,5,1052
2020-07-20,burkina_faso,Africa,21970296,13,1065
2020-07-21,burkina_faso,Africa,21970296,0,1065
2020-07-22,burkina_faso,Africa,21970296,1,1066
2020-07-23,burkina_faso,Africa,21970296,4,1070
2020-07-24,burkina_faso,Africa,21970296,5,1075
2020-07-25,burkina_faso,Africa,21970296,11,1086
2020-07-26,burkina_faso,Africa,21970296,0,1086
2020-07-27,burkina_faso,Africa,21970296,14,1100
2020-07-28,burkina_faso,Africa,21970296,5,1105
2020-07-29,burkina_faso,Africa,21970296,0,1105
2020-07-30,burkina_faso,Africa,21970296,1,1106
2020-07-31,burkina_faso,Africa,21970296,0,1106
2020-08-01,burkina_faso,Africa,21970296,37,1143
2020-08-02,burkina_faso,Africa,21970296,0,1143
2020-08-03,burkina_faso,Africa,21970296,7,1150
2020-08-04,burkina_faso,Africa,21970296,3,1153
2020-08-05,burkina_faso,Africa,21970296,0,1153
2020-08-06,burkina_faso,Africa,21970296,5,1158
2020-08-07,burkina_faso,Africa,21970296,0,1158
2020-08-08,burkina_faso,Africa,21970296,17,1175
2020-08-09,burkina_faso,Africa,21970296,0,1175
2020-08-10,burkina_faso,Africa,21970296,29,1204
2020-08-11,burkina_faso,Africa,21970296,7,1211
2020-08-12,burkina_faso,Africa,21970296,2,1213
2020-08-13,burkina_faso,Africa,21970296,15,1228
2020-08-14,burkina_faso,Africa,21970296,10,1238
2020-08-15,burkina_faso,Africa,21970296,2,1240
2020-08-16,burkina_faso,Africa,21970296,27,1267
2020-08-17,burkina_faso,Africa,21970296,13,1280
2020-08-18,burkina_faso,Africa,21970296,0,1280
2020-08-19,burkina_faso,Africa,21970296,5,1285
2020-08-20,burkina_faso,Africa,21970296,12,1297
2020-08-21,burkina_faso,Africa,21970296,0,1297
2020-08-22,burkina_faso,Africa,21970296,0,1297
2020-08-23,burkina_faso,Africa,21970296,23,1320
2020-08-24,burkina_faso,Africa,21970296,18,1338
2020-08-25,burkina_faso,Africa,21970296,0,1338
2020-08-26,burkina_faso,Africa,21970296,14,1352
2020-08-27,burkina_faso,Africa,21970296,0,1352
2020-08-28,burkina_faso,Africa,21970296,0,1352
2020-08-29,burkina_faso,Africa,21970296,0,1352
2020-08-30,burkina_faso,Africa,21970296,5,1357
2020-08-31,burkina_faso,Africa,21970296,11,1368
2020-09-01,burkina_faso,Africa,21970296,2,1370
2020-09-02,burkina_faso,Africa,21970296,0,1370
2020-09-03,burkina_faso,Africa,21970296,5,1375
2020-09-04,burkina_faso,Africa,21970296,33,1408
2020-09-05,burkina_faso,Africa,21970296,39,1447
2020-09-06,burkina_faso,Africa,21970296,5,1452
2020-09-07,burkina_faso,Africa,21970296,11,1463
2020-09-08,burkina_faso,Africa,21970296,3,1466
2020-09-09,burkina_faso,Africa,21970296,10,1476
2020-09-10,burkina_faso,Africa,21970296,10,1486
2020-09-11,burkina_faso,Africa,21970296,13,1499
2020-09-12,burkina_faso,Africa,21970296,15,1514
2020-09-13,burkina_faso,Africa,21970296,193,1707
2020-09-14,burkina_faso,Africa,21970296,10,1717
2020-09-15,burkina_faso,Africa,21970296,16,1733
2020-09-16,burkina_faso,Africa,21970296,15,1748
2020-09-17,burkina_faso,Africa,21970296,19,1767
2020-09-18,burkina_faso,Africa,21970296,30,1797
2020-09-19,burkina_faso,Africa,21970296,19,1816
2020-09-20,burkina_faso,Africa,21970296,30,1846
2020-09-21,burkina_faso,Africa,21970296,50,1896
2020-09-22,burkina_faso,Africa,21970296,11,1907
2020-09-23,burkina_faso,Africa,21970296,22,1929
2020-09-24,burkina_faso,Africa,21970296,21,1950
2020-09-25,burkina_faso,Africa,21970296,12,1962
2020-09-26,burkina_faso,Africa,21970296,11,1973
2020-09-27,burkina_faso,Africa,21970296,35,2008
2020-09-28,burkina_faso,Africa,21970296,20,2028
2020-09-29,burkina_faso,Africa,21970296,4,2032
2020-09-30,burkina_faso,Africa,21970296,24,2056
2020-10-01,burkina_faso,Africa,21970296,32,2088
2020-10-02,burkina_faso,Africa,21970296,35,2123
2020-10-03,burkina_faso,Africa,21970296,31,2154
2020-10-04,burkina_faso,Africa,21970296,13,2167
2020-10-05,burkina_faso,Africa,21970296,17,2184
2020-10-06,burkina_faso,Africa,21970296,13,2197
2020-10-07,burkina_faso,Africa,21970296,25,2222
2020-10-08,burkina_faso,Africa,21970296,19,2241
2020-10-09,burkina_faso,Africa,21970296,13,2254
2020-10-10,burkina_faso,Africa,21970296,17,2271
2020-10-11,burkina_faso,Africa,21970296,0,2271
2020-10-12,burkina_faso,Africa,21970296,23,2294
2020-10-13,burkina_faso,Africa,21970296,11,2305
2020-10-14,burkina_faso,Africa,21970296,0,2305
2020-10-15,burkina_faso,Africa,21970296,30,2335
2020-10-16,burkina_faso,Africa,21970296,8,2343
2020-10-17,burkina_faso,Africa,21970296,0,2343
2020-10-18,burkina_faso,Africa,21970296,38,2381
2020-10-19,burkina_faso,Africa,21970296,6,2387
2020-10-20,burkina_faso,Africa,21970296,19,2406
2020-10-21,burkina_faso,Africa,21970296,0,2406
2020-10-22,burkina_faso,Africa,21970296,8,2414
2020-10-23,burkina_faso,Africa,21970296,19,2433
2020-10-24,burkina_faso,Africa,21970296,11,2444
2020-10-25,burkina_faso,Africa,21970296,7,2451
2020-10-26,burkina_faso,Africa,21970296,8,2459
2020-10-27,burkina_faso,Africa,21970296,7,2466
2020-10-28,burkina_faso,Africa,21970296,0,2466
2020-10-29,burkina_faso,Africa,21970296,5,2471
2020-10-30,burkina_faso,Africa,21970296,6,2477
2020-10-31,burkina_faso,Africa,21970296,23,2500
2020-11-01,burkina_faso,Africa,21970296,0,2500
2020-11-02,burkina_faso,Africa,21970296,17,2517
2020-11-03,burkina_faso,Africa,21970296,13,2530
2020-11-04,burkina_faso,Africa,21970296,9,2539
2020-11-05,burkina_faso,Africa,21970296,11,2550
2020-11-06,burkina_faso,Africa,21970296,12,2562
2020-11-07,burkina_faso,Africa,21970296,3,2565
2020-11-08,burkina_faso,Africa,21970296,4,2569
2020-11-09,burkina_faso,Africa,21970296,12,2581
2020-11-10,burkina_faso,Africa,21970296,1,2582
2020-11-11,burkina_faso,Africa,21970296,4,2586
2020-11-12,burkina_faso,Africa,21970296,0,2586
2020-11-13,burkina_faso,Africa,21970296,23,2609
2020-11-14,burkina_faso,Africa,21970296,26,2635
2020-11-15,burkina_faso,Africa,21970296,6,2641
2020-11-16,burkina_faso,Africa,21970296,11,2652
2020-11-17,burkina_faso,Africa,21970296,0,2652
2020-11-18,burkina_faso,Africa,21970296,18,2670
2020-11-19,burkina_faso,Africa,21970296,16,2686
2020-11-20,burkina_faso,Africa,21970296,0,2686
2020-11-21,burkina_faso,Africa,21970296,17,2703
2020-11-22,burkina_faso,Africa,21970296,32,2735
2020-11-23,burkina_faso,Africa,21970296,19,2754
2020-11-24,burkina_faso,Africa,21970296,3,2757
2020-11-25,burkina_faso,Africa,21970296,20,2777
2020-11-26,burkina_faso,Africa,21970296,24,2801
2020-11-27,burkina_faso,Africa,21970296,15,2816
2020-11-28,burkina_faso,Africa,21970296,0,2816
2020-11-29,burkina_faso,Africa,21970296,40,2856
2020-11-30,burkina_faso,Africa,21970296,30,2886
2020-12-01,burkina_faso,Africa,21970296,45,2931
2020-12-02,burkina_faso,Africa,21970296,79,3010
2020-12-03,burkina_faso,Africa,21970296,52,3062
2020-12-04,burkina_faso,Africa,21970296,29,3091
2020-12-05,burkina_faso,Africa,21970296,65,3156
2020-12-06,burkina_faso,Africa,21970296,56,3212
2020-12-07,burkina_faso,Africa,21970296,103,3315
2020-12-08,burkina_faso,Africa,21970296,154,3469
2020-12-09,burkina_faso,Africa,21970296,0,3469
2020-12-10,burkina_faso,Africa,21970296,110,3579
2020-12-11,burkina_faso,Africa,21970296,0,3579
2020-12-12,burkina_faso,Africa,21970296,315,3894
2020-12-13,burkina_faso,Africa,21970296,136,4030
2020-12-14,burkina_faso,Africa,21970296,179,4209
2020-12-15,burkina_faso,Africa,21970296,91,4300
2020-12-16,burkina_faso,Africa,21970296,149,4449
2020-12-17,burkina_faso,Africa,21970296,162,4611
2020-12-18,burkina_faso,Africa,21970296,221,4832
2020-12-19,burkina_faso,Africa,21970296,122,4954
2020-12-20,burkina_faso,Africa,21970296,206,5160
2020-12-21,burkina_faso,Africa,21970296,141,5301
2020-12-22,burkina_faso,Africa,21970296,160,5461
2020-12-23,burkina_faso,Africa,21970296,188,5649
2020-12-24,burkina_faso,Africa,21970296,292,5941
2020-12-25,burkina_faso,Africa,21970296,193,6134
2020-12-26,burkina_faso,Africa,21970296,121,6255
2020-12-27,burkina_faso,Africa,21970296,89,6344
2020-12-28,burkina_faso,Africa,21970296,0,6344
2020-12-29,burkina_faso,Africa,21970296,193,6537
2020-12-30,burkina_faso,Africa,21970296,94,6631
2020-12-31,burkina_faso,Africa,21970296,76,6707
2021-01-01,burkina_faso,Africa,21970296,121,6828
2021-01-02,burkina_faso,Africa,21970296,112,6940
2021-01-03,burkina_faso,Africa,21970296,111,7051
2021-01-04,burkina_faso,Africa,21970296,75,7126
2021-01-05,burkina_faso,Africa,21970296,216,7342
2021-01-06,burkina_faso,Africa,21970296,221,7563
2021-01-07,burkina_faso,Africa,21970296,150,7713
2021-01-08,burkina_faso,Africa,21970296,153,7866
2021-01-09,burkina_faso,Africa,21970296,0,7866
2021-01-10,burkina_faso,Africa,21970296,216,8082
2021-01-11,burkina_faso,Africa,21970296,197,8279
2021-01-12,burkina_faso,Africa,21970296,184,8463
2021-01-13,burkina_faso,Africa,21970296,83,8546
2021-01-14,burkina_faso,Africa,21970296,263,8809
2021-01-15,burkina_faso,Africa,21970296,73,8882
2021-01-16,burkina_faso,Africa,21970296,118,9000
2021-01-17,burkina_faso,Africa,21970296,188,9188
2021-01-18,burkina_faso,Africa,21970296,164,9352
2021-01-19,burkina_faso,Africa,21970296,62,9414
2021-01-20,burkina_faso,Africa,21970296,139,9553
2021-01-21,burkina_faso,Africa,21970296,166,9719
2021-01-22,burkina_faso,Africa,21970296,138,9857
2021-01-23,burkina_faso,Africa,21970296,110,9967
2021-01-24,burkina_faso,Africa,21970296,71,10038
2021-01-25,burkina_faso,Africa,21970296,65,10103
2021-01-26,burkina_faso,Africa,21970296,54,10157
2021-01-27,burkina_faso,Africa,21970296,60,10217
2021-01-28,burkina_faso,Africa,21970296,160,10377
2021-01-29,burkina_faso,Africa,21970296,46,10423
2021-01-30,burkina_faso,Africa,21970296,157,10580
2021-01-31,burkina_faso,Africa,21970296,102,10682
2021-02-01,burkina_faso,Africa,21970296,86,10768
2021-02-02,burkina_faso,Africa,21970296,136,10904
2021-02-03,burkina_faso,Africa,21970296,54,10958
2021-02-04,burkina_faso,Africa,21970296,95,11053
2021-02-05,burkina_faso,Africa,21970296,90,11143
2021-02-06,burkina_faso,Africa,21970296,84,11227
2021-02-07,burkina_faso,Africa,21970296,58,11285
2021-02-08,burkina_faso,Africa,21970296,24,11309
2021-02-09,burkina_faso,Africa,21970296,58,11367
2021-02-10,burkina_faso,Africa,21970296,59,11426
2021-02-11,burkina_faso,Africa,21970296,49,11475
2021-02-12,burkina_faso,Africa,21970296,63,11538
2021-02-13,burkina_faso,Africa,21970296,50,11588
2021-02-14,burkina_faso,Africa,21970296,0,11588
2021-02-15,burkina_faso,Africa,21970296,42,11630
2021-02-16,burkina_faso,Africa,21970296,0,11630
2021-02-17,burkina_faso,Africa,21970296,42,11672
2021-02-18,burkina_faso,Africa,21970296,31,11703
2021-02-19,burkina_faso,Africa,21970296,60,11763
2021-02-20,burkina_faso,Africa,21970296,20,11783
2021-02-21,burkina_faso,Africa,21970296,14,11797
2021-02-22,burkina_faso,Africa,21970296,50,11847
2021-02-23,burkina_faso,Africa,21970296,21,11868
2021-02-24,burkina_faso,Africa,21970296,19,11887
2021-02-25,burkina_faso,Africa,21970296,27,11914
2021-02-26,burkina_faso,Africa,21970296,25,11939
2021-02-27,burkina_faso,Africa,21970296,43,11982
2021-02-28,burkina_faso,Africa,21970296,0,11982
2021-03-01,burkina_faso,Africa,21970296,48,12030
2021-03-02,burkina_faso,Africa,21970296,17,12047
2021-03-03,burkina_faso,Africa,21970296,24,12071
2021-03-04,burkina_faso,Africa,21970296,32,12103
2021-03-05,burkina_faso,Africa,21970296,20,12123
2021-03-06,burkina_faso,Africa,21970296,30,12153
2021-03-07,burkina_faso,Africa,21970296,28,12181
2021-03-08,burkina_faso,Africa,21970296,0,12181
2021-03-09,burkina_faso,Africa,21970296,26,12207
2021-03-10,burkina_faso,Africa,21970296,23,12230
2021-03-11,burkina_faso,Africa,21970296,45,12275
2021-03-12,burkina_faso,Africa,21970296,30,12305
2021-03-13,burkina_faso,Africa,21970296,45,12350
2021-03-14,burkina_faso,Africa,21970296,22,12372
2021-03-15,burkina_faso,Africa,21970296,6,12378
2021-03-16,burkina_faso,Africa,21970296,21,12399
2021-03-17,burkina_faso,Africa,21970296,27,12426
2021-03-18,burkina_faso,Africa,21970296,24,12450
2021-03-19,burkina_faso,Africa,21970296,0,12450
2021-03-20,burkina_faso,Africa,21970296,66,12516
2021-03-21,burkina_faso,Africa,21970296,19,12535
2021-03-22,burkina_faso,Africa,21970296,24,12559
2021-03-23,burkina_faso,Africa,21970296,13,12572
2021-03-24,burkina_faso,Africa,21970296,24,12596
2021-03-25,burkina_faso,Africa,21970296,23,12619
2021-03-26,burkina_faso,Africa,21970296,31,12650
2021-03-27,burkina_faso,Africa,21970296,23,12673
2021-03-28,burkina_faso,Africa,21970296,19,12692
2021-03-29,burkina_faso,Africa,21970296,10,12702
2021-03-30,burkina_faso,Africa,21970296,15,12717
2021-03-31,burkina_faso,Africa,21970296,0,12717
2021-04-01,burkina_faso,Africa,21970296,57,12774
2021-04-02,burkina_faso,Africa,21970296,17,12791
2021-04-03,burkina_faso,Africa,21970296,12,12803
2021-04-04,burkina_faso,Africa,21970296,14,12817
2021-04-05,burkina_faso,Africa,21970296,8,12825
2021-04-06,burkina_faso,Africa,21970296,20,12845
2021-04-07,burkina_faso,Africa,21970296,28,12873
2021-04-08,burkina_faso,Africa,21970296,31,12904
2021-04-09,burkina_faso,Africa,21970296,20,12924
2021-04-10,burkina_faso,Africa,21970296,32,12956
2021-04-11,burkina_faso,Africa,21970296,0,12956
2021-04-12,burkina_faso,Africa,21970296,33,12989
2021-04-13,burkina_faso,Africa,21970296,0,12989
2021-04-14,burkina_faso,Africa,21970296,61,13050
2021-04-15,burkina_faso,Africa,21970296,14,13064
2021-04-16,burkina_faso,Africa,21970296,19,13083
2021-04-17,burkina_faso,Africa,21970296,31,13114
2021-04-18,burkina_faso,Africa,21970296,15,13129
2021-04-19,burkina_faso,Africa,21970296,19,13148
2021-04-20,burkina_faso,Africa,21970296,19,13167
2021-04-21,burkina_faso,Africa,21970296,0,13167
2021-04-22,burkina_faso,Africa,21970296,45,13212
2021-04-23,burkina_faso,Africa,21970296,19,13231
2021-04-24,burkina_faso,Africa,21970296,0,13231
2021-04-25,burkina_faso,Africa,21970296,32,13263
2021-04-26,burkina_faso,Africa,21970296,0,13263
2021-04-27,burkina_faso,Africa,21970296,4,13267
2021-04-28,burkina_faso,Africa,21970296,19,13286
2021-04-29,burkina_faso,Africa,21970296,23,13309
2021-04-30,burkina_faso,Africa,21970296,1,13310
2021-05-01,burkina_faso,Africa,21970296,9,13319
2021-05-02,burkina_faso,Africa,21970296,0,13319
2021-05-03,burkina_faso,Africa,21970296,5,13324
2021-05-04,burkina_faso,Africa,21970296,15,13339
2021-05-05,burkina_faso,Africa,21970296,6,13345
2021-05-06,burkina_faso,Africa,21970296,8,13353
2021-05-07,burkina_faso,Africa,21970296,0,13353
2021-05-08,burkina_faso,Africa,21970296,24,13377
2021-05-09,burkina_faso,Africa,21970296,2,13379
2021-05-10,burkina_faso,Africa,21970296,3,13382
2021-05-11,burkina_faso,Africa,21970296,2,13384
2021-05-12,burkina_faso,Africa,21970296,3,13387
2021-05-13,burkina_faso,Africa,21970296,0,13387
2021-05-14,burkina_faso,Africa,21970296,7,13394
2021-05-15,burkina_faso,Africa,21970296,1,13395
2021-05-16,burkina_faso,Africa,21970296,2,13397
2021-05-17,burkina_faso,Africa,21970296,0,13397
2021-05-18,burkina_faso,Africa,21970296,7,13404
2021-05-19,burkina_faso,Africa,21970296,3,13407
2021-05-20,burkina_faso,Africa,21970296,1,13408
2021-05-21,burkina_faso,Africa,21970296,2,13410
2021-05-22,burkina_faso,Africa,21970296,4,13414
2021-05-23,burkina_faso,Africa,21970296,1,13415
2021-05-24,burkina_faso,Africa,21970296,0,13415
2021-05-25,burkina_faso,Africa,21970296,1,13416
2021-05-26,burkina_faso,Africa,21970296,3,13419
2021-05-27,burkina_faso,Africa,21970296,2,13421
2021-05-28,burkina_faso,Africa,21970296,3,13424
2021-05-29,burkina_faso,Africa,21970296,6,13430
2021-05-30,burkina_faso,Africa,21970296,0,13430
2021-05-31,burkina_faso,Africa,21970296,4,13434
2021-06-01,burkina_faso,Africa,21970296,1,13435
2021-06-02,burkina_faso,Africa,21970296,5,13440
2021-06-03,burkina_faso,Africa,21970296,6,13446
2021-06-04,burkina_faso,Africa,21970296,1,13447
2021-06-05,burkina_faso,Africa,21970296,5,13452
2021-06-06,burkina_faso,Africa,21970296,1,13453
2021-06-07,burkina_faso,Africa,21970296,0,13453
2021-06-08,burkina_faso,Africa,21970296,1,13454
2021-06-09,burkina_faso,Africa,21970296,0,13454
2021-06-10,burkina_faso,Africa,21970296,2,13456
2021-06-11,burkina_faso,Africa,21970296,0,13456
2021-06-12,burkina_faso,Africa,21970296,3,13459
2021-06-13,burkina_faso,Africa,21970296,0,13459
2021-06-14,burkina_faso,Africa,21970296,0,13459
2021-06-15,burkina_faso,Africa,21970296,0,13459
2021-06-16,burkina_faso,Africa,21970296,1,13460
2021-06-17,burkina_faso,Africa,21970296,0,13460
2021-06-18,burkina_faso,Africa,21970296,2,13462
2021-06-19,burkina_faso,Africa,21970296,6,13468
2021-06-20,burkina_faso,Africa,21970296,1,13469
2021-06-21,burkina_faso,Africa,21970296,0,13469
2021-06-22,burkina_faso,Africa,21970296,0,13469
2021-06-23,burkina_faso,Africa,21970296,4,13473
2021-06-24,burkina_faso,Africa,21970296,1,13474
2021-06-25,burkina_faso,Africa,21970296,3,13477
2021-06-26,burkina_faso,Africa,21970296,1,13478
2021-06-27,burkina_faso,Africa,21970296,0,13478
2021-06-28,burkina_faso,Africa,21970296,1,13479
2021-06-29,burkina_faso,Africa,21970296,0,13479
2021-06-30,burkina_faso,Africa,21970296,0,13479
2021-07-01,burkina_faso,Africa,21970296,6,13485
2021-07-02,burkina_faso,Africa,21970296,3,13488
2021-07-03,burkina_faso,Africa,21970296,6,13494
2021-07-04,burkina_faso,Africa,21970296,0,13494
2021-07-05,burkina_faso,Africa,21970296,0,13494
2021-07-06,burkina_faso,Africa,21970296,0,13494
2021-07-07,burkina_faso,Africa,21970296,10,13504
2021-07-08,burkina_faso,Africa,21970296,1,13505
2021-07-09,burkina_faso,Africa,21970296,1,13506
2021-07-10,burkina_faso,Africa,21970296,0,13506
2021-07-11,burkina_faso,Africa,21970296,3,13509
2021-07-12,burkina_faso,Africa,21970296,11,13520
2021-07-13,burkina_faso,Africa,21970296,3,13523
2021-07-14,burkina_faso,Africa,21970296,4,13527
2021-07-15,burkina_faso,Africa,21970296,3,13530
2021-07-16,burkina_faso,Africa,21970296,2,13532
2021-07-17,burkina_faso,Africa,21970296,4,13536
2021-07-18,burkina_faso,Africa,21970296,0,13536
2021-07-19,burkina_faso,Africa,21970296,0,13536
2021-07-20,burkina_faso,Africa,21970296,1,13537
2021-07-21,burkina_faso,Africa,21970296,0,13537
2021-07-22,burkina_faso,Africa,21970296,0,13537
2021-07-23,burkina_faso,Africa,21970296,0,13537
2021-07-24,burkina_faso,Africa,21970296,1,13538
2021-07-25,burkina_faso,Africa,21970296,0,13538
2021-07-26,burkina_faso,Africa,21970296,12,13550
2021-07-27,burkina_faso,Africa,21970296,6,13556
2021-07-28,burkina_faso,Africa,21970296,4,13560
2021-07-29,burkina_faso,Africa,21970296,6,13566
2021-07-30,burkina_faso,Africa,21970296,7,13573
2021-07-31,burkina_faso,Africa,21970296,0,13573
2021-08-01,burkina_faso,Africa,21970296,15,13588
2021-08-02,burkina_faso,Africa,21970296,3,13591
2021-08-03,burkina_faso,Africa,21970296,0,13591
2021-08-04,burkina_faso,Africa,21970296,8,13599
2021-08-05,burkina_faso,Africa,21970296,0,13599
2021-08-06,burkina_faso,Africa,21970296,8,13607
2021-08-07,burkina_faso,Africa,21970296,3,13610
2021-08-08,burkina_faso,Africa,21970296,11,13621
2021-08-09,burkina_faso,Africa,21970296,4,13625
2021-08-10,burkina_faso,Africa,21970296,1,13626
2021-08-11,burkina_faso,Africa,21970296,6,13632
2021-08-12,burkina_faso,Africa,21970296,3,13635
2021-08-13,burkina_faso,Africa,21970296,33,13668
2021-08-14,burkina_faso,Africa,21970296,3,13671
2021-08-15,burkina_faso,Africa,21970296,4,13675
2021-08-16,burkina_faso,Africa,21970296,2,13677
2021-08-17,burkina_faso,Africa,21970296,0,13677
2021-08-18,burkina_faso,Africa,21970296,3,13680
2021-08-19,burkina_faso,Africa,21970296,12,13692
2021-08-20,burkina_faso,Africa,21970296,3,13695
2021-08-21,burkina_faso,Africa,21970296,4,13699
2021-08-22,burkina_faso,Africa,21970296,14,13713
2021-08-23,burkina_faso,Africa,21970296,2,13715
2021-08-24,burkina_faso,Africa,21970296,10,13725
2021-08-25,burkina_faso,Africa,21970296,12,13737
2021-08-26,burkina_faso,Africa,21970296,12,13749
2021-08-27,burkina_faso,Africa,21970296,5,13754
2021-08-28,burkina_faso,Africa,21970296,5,13759
2021-08-29,burkina_faso,Africa,21970296,3,13762
2021-08-30,burkina_faso,Africa,21970296,6,13768
2021-08-31,burkina_faso,Africa,21970296,9,13777
2021-09-01,burkina_faso,Africa,21970296,0,13777
2021-09-02,burkina_faso,Africa,21970296,21,13798
2021-09-03,burkina_faso,Africa,21970296,18,13816
2021-09-04,burkina_faso,Africa,21970296,11,13827
2021-09-05,burkina_faso,Africa,21970296,14,13841
2020-03-25,cabo_verde,Africa,567234,1,4
2020-03-26,cabo_verde,Africa,567234,1,5
2020-03-27,cabo_verde,Africa,567234,0,5
2020-03-28,cabo_verde,Africa,567234,1,6
2020-03-29,cabo_verde,Africa,567234,0,6
2020-03-30,cabo_verde,Africa,567234,0,6
2020-03-31,cabo_verde,Africa,567234,0,6
2020-04-01,cabo_verde,Africa,567234,0,6
2020-04-02,cabo_verde,Africa,567234,0,6
2020-04-03,cabo_verde,Africa,567234,0,6
2020-04-04,cabo_verde,Africa,567234,1,7
2020-04-05,cabo_verde,Africa,567234,0,7
2020-04-06,cabo_verde,Africa,567234,0,7
2020-04-07,cabo_verde,Africa,567234,0,7
2020-04-08,cabo_verde,Africa,567234,0,7
2020-04-09,cabo_verde,Africa,567234,0,7
2020-04-10,cabo_verde,Africa,567234,0,7
2020-04-11,cabo_verde,Africa,567234,1,8
2020-04-12,cabo_verde,Africa,567234,0,8
2020-04-13,cabo_verde,Africa,567234,2,10
2020-04-14,cabo_verde,Africa,567234,1,11
2020-04-15,cabo_verde,Africa,567234,45,56
2020-04-16,cabo_verde,Africa,567234,0,56
2020-04-17,cabo_verde,Africa,567234,0,56
2020-04-18,cabo_verde,Africa,567234,2,58
2020-04-19,cabo_verde,Africa,567234,3,61
2020-04-20,cabo_verde,Africa,567234,6,67
2020-04-21,cabo_verde,Africa,567234,1,68
2020-04-22,cabo_verde,Africa,567234,5,73
2020-04-23,cabo_verde,Africa,567234,9,82
2020-04-24,cabo_verde,Africa,567234,6,88
2020-04-25,cabo_verde,Africa,567234,2,90
2020-04-26,cabo_verde,Africa,567234,16,106
2020-04-27,cabo_verde,Africa,567234,3,109
2020-04-28,cabo_verde,Africa,567234,4,113
2020-04-29,cabo_verde,Africa,567234,0,113
2020-04-30,cabo_verde,Africa,567234,8,121
2020-05-01,cabo_verde,Africa,567234,1,122
2020-05-02,cabo_verde,Africa,567234,30,152
2020-05-03,cabo_verde,Africa,567234,13,165
2020-05-04,cabo_verde,Africa,567234,10,175
2020-05-05,cabo_verde,Africa,567234,11,186
2020-05-06,cabo_verde,Africa,567234,5,191
2020-05-07,cabo_verde,Africa,567234,27,218
2020-05-08,cabo_verde,Africa,567234,12,230
2020-05-09,cabo_verde,Africa,567234,6,236
2020-05-10,cabo_verde,Africa,567234,10,246
2020-05-11,cabo_verde,Africa,567234,14,260
2020-05-12,cabo_verde,Africa,567234,7,267
2020-05-13,cabo_verde,Africa,567234,22,289
2020-05-14,cabo_verde,Africa,567234,26,315
2020-05-15,cabo_verde,Africa,567234,11,326
2020-05-16,cabo_verde,Africa,567234,2,328
2020-05-17,cabo_verde,Africa,567234,0,328
2020-05-18,cabo_verde,Africa,567234,0,328
2020-05-19,cabo_verde,Africa,567234,7,335
2020-05-20,cabo_verde,Africa,567234,14,349
2020-05-21,cabo_verde,Africa,567234,7,356
2020-05-22,cabo_verde,Africa,567234,6,362
2020-05-23,cabo_verde,Africa,567234,9,371
2020-05-24,cabo_verde,Africa,567234,9,380
2020-05-25,cabo_verde,Africa,567234,10,390
2020-05-26,cabo_verde,Africa,567234,0,390
2020-05-27,cabo_verde,Africa,567234,0,390
2020-05-28,cabo_verde,Africa,567234,0,390
2020-05-29,cabo_verde,Africa,567234,15,405
2020-05-30,cabo_verde,Africa,567234,16,421
2020-05-31,cabo_verde,Africa,567234,14,435
2020-06-01,cabo_verde,Africa,567234,23,458
2020-06-02,cabo_verde,Africa,567234,8,466
2020-06-03,cabo_verde,Africa,567234,11,477
2020-06-04,cabo_verde,Africa,567234,25,502
2020-06-05,cabo_verde,Africa,567234,34,536
2020-06-06,cabo_verde,Africa,567234,6,542
2020-06-07,cabo_verde,Africa,567234,12,554
2020-06-08,cabo_verde,Africa,567234,13,567
2020-06-09,cabo_verde,Africa,567234,18,585
2020-06-10,cabo_verde,Africa,567234,30,615
2020-06-11,cabo_verde,Africa,567234,42,657
2020-06-12,cabo_verde,Africa,567234,40,697
2020-06-13,cabo_verde,Africa,567234,29,726
2020-06-14,cabo_verde,Africa,567234,24,750
2020-06-15,cabo_verde,Africa,567234,10,760
2020-06-16,cabo_verde,Africa,567234,21,781
2020-06-17,cabo_verde,Africa,567234,11,792
2020-06-18,cabo_verde,Africa,567234,31,823
2020-06-19,cabo_verde,Africa,567234,25,848
2020-06-20,cabo_verde,Africa,567234,15,863
2020-06-21,cabo_verde,Africa,567234,27,890
2020-06-22,cabo_verde,Africa,567234,54,944
2020-06-23,cabo_verde,Africa,567234,38,982
2020-06-24,cabo_verde,Africa,567234,17,999
2020-06-25,cabo_verde,Africa,567234,4,1003
2020-06-26,cabo_verde,Africa,567234,24,1027
2020-06-27,cabo_verde,Africa,567234,64,1091
2020-06-28,cabo_verde,Africa,567234,64,1155
2020-06-29,cabo_verde,Africa,567234,10,1165
2020-06-30,cabo_verde,Africa,567234,62,1227
2020-07-01,cabo_verde,Africa,567234,40,1267
2020-07-02,cabo_verde,Africa,567234,34,1301
2020-07-03,cabo_verde,Africa,567234,81,1382
2020-07-04,cabo_verde,Africa,567234,39,1421
2020-07-05,cabo_verde,Africa,567234,30,1451
2020-07-06,cabo_verde,Africa,567234,12,1463
2020-07-07,cabo_verde,Africa,567234,36,1499
2020-07-08,cabo_verde,Africa,567234,43,1542
2020-07-09,cabo_verde,Africa,567234,10,1552
2020-07-10,cabo_verde,Africa,567234,39,1591
2020-07-11,cabo_verde,Africa,567234,32,1623
2020-07-12,cabo_verde,Africa,567234,0,1623
2020-07-13,cabo_verde,Africa,567234,75,1698
2020-07-14,cabo_verde,Africa,567234,24,1722
2020-07-15,cabo_verde,Africa,567234,58,1780
2020-07-16,cabo_verde,Africa,567234,114,1894
2020-07-17,cabo_verde,Africa,567234,45,1939
2020-07-18,cabo_verde,Africa,567234,75,2014
2020-07-19,cabo_verde,Africa,567234,31,2045
2020-07-20,cabo_verde,Africa,567234,26,2071
2020-07-21,cabo_verde,Africa,567234,36,2107
2020-07-22,cabo_verde,Africa,567234,47,2154
2020-07-23,cabo_verde,Africa,567234,36,2190
2020-07-24,cabo_verde,Africa,567234,30,2220
2020-07-25,cabo_verde,Africa,567234,38,2258
2020-07-26,cabo_verde,Africa,567234,49,2307
2020-07-27,cabo_verde,Africa,567234,21,2328
2020-07-28,cabo_verde,Africa,567234,26,2354
2020-07-29,cabo_verde,Africa,567234,19,2373
2020-07-30,cabo_verde,Africa,567234,45,2418
2020-07-31,cabo_verde,Africa,567234,33,2451
2020-08-01,cabo_verde,Africa,567234,29,2480
2020-08-02,cabo_verde,Africa,567234,67,2547
2020-08-03,cabo_verde,Africa,567234,36,2583
2020-08-04,cabo_verde,Africa,567234,48,2631
2020-08-05,cabo_verde,Africa,567234,58,2689
2020-08-06,cabo_verde,Africa,567234,45,2734
2020-08-07,cabo_verde,Africa,567234,46,2780
2020-08-08,cabo_verde,Africa,567234,55,2835
2020-08-09,cabo_verde,Africa,567234,23,2858
2020-08-10,cabo_verde,Africa,567234,25,2883
2020-08-11,cabo_verde,Africa,567234,37,2920
2020-08-12,cabo_verde,Africa,567234,80,3000
2020-08-13,cabo_verde,Africa,567234,73,3073
2020-08-14,cabo_verde,Africa,567234,63,3136
2020-08-15,cabo_verde,Africa,567234,27,3163
2020-08-16,cabo_verde,Africa,567234,16,3179
2020-08-17,cabo_verde,Africa,567234,24,3203
2020-08-18,cabo_verde,Africa,567234,50,3253
2020-08-19,cabo_verde,Africa,567234,68,3321
2020-08-20,cabo_verde,Africa,567234,47,3368
2020-08-21,cabo_verde,Africa,567234,44,3412
2020-08-22,cabo_verde,Africa,567234,43,3455
2020-08-23,cabo_verde,Africa,567234,54,3509
2020-08-24,cabo_verde,Africa,567234,23,3532
2020-08-25,cabo_verde,Africa,567234,36,3568
2020-08-26,cabo_verde,Africa,567234,62,3630
2020-08-27,cabo_verde,Africa,567234,69,3699
2020-08-28,cabo_verde,Africa,567234,46,3745
2020-08-29,cabo_verde,Africa,567234,33,3778
2020-08-30,cabo_verde,Africa,567234,74,3852
2020-08-31,cabo_verde,Africa,567234,32,3884
2020-09-01,cabo_verde,Africa,567234,86,3970
2020-09-02,cabo_verde,Africa,567234,78,4048
2020-09-03,cabo_verde,Africa,567234,77,4125
2020-09-04,cabo_verde,Africa,567234,75,4200
2020-09-05,cabo_verde,Africa,567234,75,4275
2020-09-06,cabo_verde,Africa,567234,55,4330
2020-09-07,cabo_verde,Africa,567234,28,4358
2020-09-08,cabo_verde,Africa,567234,42,4400
2020-09-09,cabo_verde,Africa,567234,73,4473
2020-09-10,cabo_verde,Africa,567234,84,4557
2020-09-11,cabo_verde,Africa,567234,94,4651
2020-09-12,cabo_verde,Africa,567234,60,4711
2020-09-13,cabo_verde,Africa,567234,102,4813
2020-09-14,cabo_verde,Africa,567234,26,4839
2020-09-15,cabo_verde,Africa,567234,65,4904
2020-09-16,cabo_verde,Africa,567234,74,4978
2020-09-17,cabo_verde,Africa,567234,85,5063
2020-09-18,cabo_verde,Africa,567234,78,5141
2020-09-19,cabo_verde,Africa,567234,45,5186
2020-09-20,cabo_verde,Africa,567234,71,5257
2020-09-21,cabo_verde,Africa,567234,24,5281
2020-09-22,cabo_verde,Africa,567234,56,5337
2020-09-23,cabo_verde,Africa,567234,75,5412
2020-09-24,cabo_verde,Africa,567234,67,5479
2020-09-25,cabo_verde,Africa,567234,149,5628
2020-09-26,cabo_verde,Africa,567234,73,5701
2020-09-27,cabo_verde,Africa,567234,70,5771
2020-09-28,cabo_verde,Africa,567234,46,5817
2020-09-29,cabo_verde,Africa,567234,83,5900
2020-09-30,cabo_verde,Africa,567234,124,6024
2020-10-01,cabo_verde,Africa,567234,102,6126
2020-10-02,cabo_verde,Africa,567234,79,6205
2020-10-03,cabo_verde,Africa,567234,91,6296
2020-10-04,cabo_verde,Africa,567234,64,6360
2020-10-05,cabo_verde,Africa,567234,73,6433
2020-10-06,cabo_verde,Africa,567234,85,6518
2020-10-07,cabo_verde,Africa,567234,106,6624
2020-10-08,cabo_verde,Africa,567234,93,6717
2020-10-09,cabo_verde,Africa,567234,92,6809
2020-10-10,cabo_verde,Africa,567234,104,6913
2020-10-11,cabo_verde,Africa,567234,159,7072
2020-10-12,cabo_verde,Africa,567234,83,7155
2020-10-13,cabo_verde,Africa,567234,99,7254
2020-10-14,cabo_verde,Africa,567234,117,7371
2020-10-15,cabo_verde,Africa,567234,73,7444
2020-10-16,cabo_verde,Africa,567234,82,7526
2020-10-17,cabo_verde,Africa,567234,112,7638
2020-10-18,cabo_verde,Africa,567234,114,7752
2020-10-19,cabo_verde,Africa,567234,48,7800
2020-10-20,cabo_verde,Africa,567234,101,7901
2020-10-21,cabo_verde,Africa,567234,132,8033
2020-10-22,cabo_verde,Africa,567234,89,8122
2020-10-23,cabo_verde,Africa,567234,76,8198
2020-10-24,cabo_verde,Africa,567234,124,8322
2020-10-25,cabo_verde,Africa,567234,74,8396
2020-10-26,cabo_verde,Africa,567234,27,8423
2020-10-27,cabo_verde,Africa,567234,49,8472
2020-10-28,cabo_verde,Africa,567234,76,8548
2020-10-29,cabo_verde,Africa,567234,55,8603
2020-10-30,cabo_verde,Africa,567234,91,8694
2020-10-31,cabo_verde,Africa,567234,99,8793
2020-11-01,cabo_verde,Africa,567234,55,8848
2020-11-02,cabo_verde,Africa,567234,34,8882
2020-11-03,cabo_verde,Africa,567234,62,8944
2020-11-04,cabo_verde,Africa,567234,109,9053
2020-11-05,cabo_verde,Africa,567234,96,9149
2020-11-06,cabo_verde,Africa,567234,75,9224
2020-11-07,cabo_verde,Africa,567234,67,9291
2020-11-08,cabo_verde,Africa,567234,78,9369
2020-11-09,cabo_verde,Africa,567234,50,9419
2020-11-10,cabo_verde,Africa,567234,80,9499
2020-11-11,cabo_verde,Africa,567234,61,9560
2020-11-12,cabo_verde,Africa,567234,134,9694
2020-11-13,cabo_verde,Africa,567234,47,9741
2020-11-14,cabo_verde,Africa,567234,39,9780
2020-11-15,cabo_verde,Africa,567234,42,9822
2020-11-16,cabo_verde,Africa,567234,18,9840
2020-11-17,cabo_verde,Africa,567234,120,9960
2020-11-18,cabo_verde,Africa,567234,40,10000
2020-11-19,cabo_verde,Africa,567234,82,10082
2020-11-20,cabo_verde,Africa,567234,70,10152
2020-11-21,cabo_verde,Africa,567234,82,10234
2020-11-22,cabo_verde,Africa,567234,42,10276
2020-11-23,cabo_verde,Africa,567234,26,10302
2020-11-24,cabo_verde,Africa,567234,98,10400
2020-11-25,cabo_verde,Africa,567234,126,10526
2020-11-26,cabo_verde,Africa,567234,44,10570
2020-11-27,cabo_verde,Africa,567234,56,10626
2020-11-28,cabo_verde,Africa,567234,74,10700
2020-11-29,cabo_verde,Africa,567234,47,10747
2020-11-30,cabo_verde,Africa,567234,14,10761
2020-12-01,cabo_verde,Africa,567234,55,10816
2020-12-02,cabo_verde,Africa,567234,51,10867
2020-12-03,cabo_verde,Africa,567234,71,10938
2020-12-04,cabo_verde,Africa,567234,58,10996
2020-12-05,cabo_verde,Africa,567234,40,11036
2020-12-06,cabo_verde,Africa,567234,27,11063
2020-12-07,cabo_verde,Africa,567234,35,11098
2020-12-08,cabo_verde,Africa,567234,20,11118
2020-12-09,cabo_verde,Africa,567234,74,11192
2020-12-10,cabo_verde,Africa,567234,11,11203
2020-12-11,cabo_verde,Africa,567234,59,11262
2020-12-12,cabo_verde,Africa,567234,40,11302
2020-12-13,cabo_verde,Africa,567234,55,11357
2020-12-14,cabo_verde,Africa,567234,4,11361
2020-12-15,cabo_verde,Africa,567234,34,11395
2020-12-16,cabo_verde,Africa,567234,63,11458
2020-12-17,cabo_verde,Africa,567234,44,11502
2020-12-18,cabo_verde,Africa,567234,24,11526
2020-12-19,cabo_verde,Africa,567234,41,11567
2020-12-20,cabo_verde,Africa,567234,12,11579
2020-12-21,cabo_verde,Africa,567234,21,11600
2020-12-22,cabo_verde,Africa,567234,36,11636
2020-12-23,cabo_verde,Africa,567234,32,11668
2020-12-24,cabo_verde,Africa,567234,20,11688
2020-12-25,cabo_verde,Africa,567234,8,11696
2020-12-26,cabo_verde,Africa,567234,2,11698
2020-12-27,cabo_verde,Africa,567234,16,11714
2020-12-28,cabo_verde,Africa,567234,9,11723
2020-12-29,cabo_verde,Africa,567234,29,11752
2020-12-30,cabo_verde,Africa,567234,41,11793
2020-12-31,cabo_verde,Africa,567234,47,11840
2021-01-01,cabo_verde,Africa,567234,32,11872
2021-01-02,cabo_verde,Africa,567234,11,11883
2021-01-03,cabo_verde,Africa,567234,37,11920
2021-01-04,cabo_verde,Africa,567234,29,11949
2021-01-05,cabo_verde,Africa,567234,34,11983
2021-01-06,cabo_verde,Africa,567234,69,12052
2021-01-07,cabo_verde,Africa,567234,94,12146
2021-01-08,cabo_verde,Africa,567234,91,12237
2021-01-09,cabo_verde,Africa,567234,79,12316
2021-01-10,cabo_verde,Africa,567234,76,12392
2021-01-11,cabo_verde,Africa,567234,41,12433
2021-01-12,cabo_verde,Africa,567234,73,12506
2021-01-13,cabo_verde,Africa,567234,86,12592
2021-01-14,cabo_verde,Africa,567234,72,12664
2021-01-15,cabo_verde,Africa,567234,112,12776
2021-01-16,cabo_verde,Africa,567234,125,12901
2021-01-17,cabo_verde,Africa,567234,92,12993
2021-01-18,cabo_verde,Africa,567234,53,13046
2021-01-19,cabo_verde,Africa,567234,93,13139
2021-01-20,cabo_verde,Africa,567234,85,13224
2021-01-21,cabo_verde,Africa,567234,83,13307
2021-01-22,cabo_verde,Africa,567234,74,13381
2021-01-23,cabo_verde,Africa,567234,33,13414
2021-01-24,cabo_verde,Africa,567234,75,13489
2021-01-25,cabo_verde,Africa,567234,68,13557
2021-01-26,cabo_verde,Africa,567234,62,13619
2021-01-27,cabo_verde,Africa,567234,103,13722
2021-01-28,cabo_verde,Africa,567234,62,13784
2021-01-29,cabo_verde,Africa,567234,113,13897
2021-01-30,cabo_verde,Africa,567234,84,13981
2021-01-31,cabo_verde,Africa,567234,89,14070
2021-02-01,cabo_verde,Africa,567234,28,14098
2021-02-02,cabo_verde,Africa,567234,54,14152
2021-02-03,cabo_verde,Africa,567234,62,14214
2021-02-04,cabo_verde,Africa,567234,76,14290
2021-02-05,cabo_verde,Africa,567234,16,14306
2021-02-06,cabo_verde,Africa,567234,74,14380
2021-02-07,cabo_verde,Africa,567234,43,14423
2021-02-08,cabo_verde,Africa,567234,28,14451
2021-02-09,cabo_verde,Africa,567234,28,14479
2021-02-10,cabo_verde,Africa,567234,64,14543
2021-02-11,cabo_verde,Africa,567234,58,14601
2021-02-12,cabo_verde,Africa,567234,46,14647
2021-02-13,cabo_verde,Africa,567234,53,14700
2021-02-14,cabo_verde,Africa,567234,41,14741
2021-02-15,cabo_verde,Africa,567234,20,14761
2021-02-16,cabo_verde,Africa,567234,24,14785
2021-02-17,cabo_verde,Africa,567234,63,14848
2021-02-18,cabo_verde,Africa,567234,37,14885
2021-02-19,cabo_verde,Africa,567234,63,14948
2021-02-20,cabo_verde,Africa,567234,51,14999
2021-02-21,cabo_verde,Africa,567234,49,15048
2021-02-22,cabo_verde,Africa,567234,24,15072
2021-02-23,cabo_verde,Africa,567234,17,15089
2021-02-24,cabo_verde,Africa,567234,72,15161
2021-02-25,cabo_verde,Africa,567234,40,15201
2021-02-26,cabo_verde,Africa,567234,52,15253
2021-02-27,cabo_verde,Africa,567234,71,15324
2021-02-28,cabo_verde,Africa,567234,76,15400
2021-03-01,cabo_verde,Africa,567234,32,15432
2021-03-02,cabo_verde,Africa,567234,51,15483
2021-03-03,cabo_verde,Africa,567234,75,15558
2021-03-04,cabo_verde,Africa,567234,63,15621
2021-03-05,cabo_verde,Africa,567234,62,15683
2021-03-06,cabo_verde,Africa,567234,41,15724
2021-03-07,cabo_verde,Africa,567234,58,15782
2021-03-08,cabo_verde,Africa,567234,24,15806
2021-03-09,cabo_verde,Africa,567234,20,15826
2021-03-10,cabo_verde,Africa,567234,66,15892
2021-03-11,cabo_verde,Africa,567234,40,15932
2021-03-12,cabo_verde,Africa,567234,54,15986
2021-03-13,cabo_verde,Africa,567234,49,16035
2021-03-14,cabo_verde,Africa,567234,66,16101
2021-03-15,cabo_verde,Africa,567234,19,16120
2021-03-16,cabo_verde,Africa,567234,34,16154
2021-03-17,cabo_verde,Africa,567234,96,16250
2021-03-18,cabo_verde,Africa,567234,48,16298
2021-03-19,cabo_verde,Africa,567234,76,16374
2021-03-20,cabo_verde,Africa,567234,66,16440
2021-03-21,cabo_verde,Africa,567234,51,16491
2021-03-22,cabo_verde,Africa,567234,26,16517
2021-03-23,cabo_verde,Africa,567234,38,16555
2021-03-24,cabo_verde,Africa,567234,106,16661
2021-03-25,cabo_verde,Africa,567234,126,16787
2021-03-26,cabo_verde,Africa,567234,124,16911
2021-03-27,cabo_verde,Africa,567234,107,17018
2021-03-28,cabo_verde,Africa,567234,107,17125
2021-03-29,cabo_verde,Africa,567234,65,17190
2021-03-30,cabo_verde,Africa,567234,89,17279
2021-03-31,cabo_verde,Africa,567234,191,17470
2021-04-01,cabo_verde,Africa,567234,117,17587
2021-04-02,cabo_verde,Africa,567234,130,17717
2021-04-03,cabo_verde,Africa,567234,104,17821
2021-04-04,cabo_verde,Africa,567234,50,17871
2021-04-05,cabo_verde,Africa,567234,68,17939
2021-04-06,cabo_verde,Africa,567234,84,18023
2021-04-07,cabo_verde,Africa,567234,191,18214
2021-04-08,cabo_verde,Africa,567234,208,18422
2021-04-09,cabo_verde,Africa,567234,207,18629
2021-04-10,cabo_verde,Africa,567234,0,18629
2021-04-11,cabo_verde,Africa,567234,376,19005
2021-04-12,cabo_verde,Africa,567234,105,19110
2021-04-13,cabo_verde,Africa,567234,121,19231
2021-04-14,cabo_verde,Africa,567234,294,19525
2021-04-15,cabo_verde,Africa,567234,255,19780
2021-04-16,cabo_verde,Africa,567234,195,19975
2021-04-17,cabo_verde,Africa,567234,279,20254
2021-04-18,cabo_verde,Africa,567234,212,20466
2021-04-19,cabo_verde,Africa,567234,161,20627
2021-04-20,cabo_verde,Africa,567234,154,20781
2021-04-21,cabo_verde,Africa,567234,398,21179
2021-04-22,cabo_verde,Africa,567234,321,21500
2021-04-23,cabo_verde,Africa,567234,284,21784
2021-04-24,cabo_verde,Africa,567234,310,22094
2021-04-25,cabo_verde,Africa,567234,255,22349
2021-04-26,cabo_verde,Africa,567234,237,22586
2021-04-27,cabo_verde,Africa,567234,186,22772
2021-04-28,cabo_verde,Africa,567234,409,23181
2021-04-29,cabo_verde,Africa,567234,373,23554
2021-04-30,cabo_verde,Africa,567234,328,23882
2021-05-01,cabo_verde,Africa,567234,245,24127
2021-05-02,cabo_verde,Africa,567234,241,24368
2021-05-03,cabo_verde,Africa,567234,180,24548
2021-05-04,cabo_verde,Africa,567234,194,24742
2021-05-05,cabo_verde,Africa,567234,417,25159
2021-05-06,cabo_verde,Africa,567234,367,25526
2021-05-07,cabo_verde,Africa,567234,311,25837
2021-05-08,cabo_verde,Africa,567234,274,26111
2021-05-09,cabo_verde,Africa,567234,330,26441
2021-05-10,cabo_verde,Africa,567234,137,26578
2021-05-11,cabo_verde,Africa,567234,131,26709
2021-05-12,cabo_verde,Africa,567234,320,27029
2021-05-13,cabo_verde,Africa,567234,357,27386
2021-05-14,cabo_verde,Africa,567234,286,27672
2021-05-15,cabo_verde,Africa,567234,279,27951
2021-05-16,cabo_verde,Africa,567234,217,28168
2021-05-17,cabo_verde,Africa,567234,113,28281
2021-05-18,cabo_verde,Africa,567234,129,28410
2021-05-19,cabo_verde,Africa,567234,289,28699
2021-05-20,cabo_verde,Africa,567234,199,28898
2021-05-21,cabo_verde,Africa,567234,135,29033
2021-05-22,cabo_verde,Africa,567234,165,29198
2021-05-23,cabo_verde,Africa,567234,136,29334
2021-05-24,cabo_verde,Africa,567234,77,29411
2021-05-25,cabo_verde,Africa,567234,138,29549
2021-05-26,cabo_verde,Africa,567234,214,29763
2021-05-27,cabo_verde,Africa,567234,176,29939
2021-05-28,cabo_verde,Africa,567234,183,30122
2021-05-29,cabo_verde,Africa,567234,151,30273
2021-05-30,cabo_verde,Africa,567234,86,30359
2021-05-31,cabo_verde,Africa,567234,80,30439
2021-06-01,cabo_verde,Africa,567234,84,30523
2021-06-02,cabo_verde,Africa,567234,171,30694
2021-06-03,cabo_verde,Africa,567234,80,30774
2021-06-04,cabo_verde,Africa,567234,133,30907
2021-06-05,cabo_verde,Africa,567234,96,31003
2021-06-06,cabo_verde,Africa,567234,94,31097
2021-06-07,cabo_verde,Africa,567234,50,31147
2021-06-08,cabo_verde,Africa,567234,78,31225
2021-06-09,cabo_verde,Africa,567234,114,31339
2021-06-10,cabo_verde,Africa,567234,94,31433
2021-06-11,cabo_verde,Africa,567234,79,31512
2021-06-12,cabo_verde,Africa,567234,59,31571
2021-06-13,cabo_verde,Africa,567234,44,31615
2021-06-14,cabo_verde,Africa,567234,32,31647
2021-06-15,cabo_verde,Africa,567234,57,31704
2021-06-16,cabo_verde,Africa,567234,79,31783
2021-06-17,cabo_verde,Africa,567234,75,31858
2021-06-18,cabo_verde,Africa,567234,52,31910
2021-06-19,cabo_verde,Africa,567234,54,31964
2021-06-20,cabo_verde,Africa,567234,38,32002
2021-06-21,cabo_verde,Africa,567234,37,32039
2021-06-22,cabo_verde,Africa,567234,72,32111
2021-06-23,cabo_verde,Africa,567234,81,32192
2021-06-24,cabo_verde,Africa,567234,65,32257
2021-06-25,cabo_verde,Africa,567234,56,32313
2021-06-26,cabo_verde,Africa,567234,31,32344
2021-06-27,cabo_verde,Africa,567234,28,32372
2021-06-28,cabo_verde,Africa,567234,27,32399
2021-06-29,cabo_verde,Africa,567234,58,32457
2021-06-30,cabo_verde,Africa,567234,67,32524
2021-07-01,cabo_verde,Africa,567234,70,32594
2021-07-02,cabo_verde,Africa,567234,72,32666
2021-07-03,cabo_verde,Africa,567234,39,32705
2021-07-04,cabo_verde,Africa,567234,30,32735
2021-07-05,cabo_verde,Africa,567234,10,32745
2021-07-06,cabo_verde,Africa,567234,43,32788
2021-07-07,cabo_verde,Africa,567234,39,32827
2021-07-08,cabo_verde,Africa,567234,56,32883
2021-07-09,cabo_verde,Africa,567234,45,32928
2021-07-10,cabo_verde,Africa,567234,41,32969
2021-07-11,cabo_verde,Africa,567234,37,33006
2021-07-12,cabo_verde,Africa,567234,20,33026
2021-07-13,cabo_verde,Africa,567234,27,33053
2021-07-14,cabo_verde,Africa,567234,74,33127
2021-07-15,cabo_verde,Africa,567234,53,33180
2021-07-16,cabo_verde,Africa,567234,54,33234
2021-07-17,cabo_verde,Africa,567234,36,33270
2021-07-18,cabo_verde,Africa,567234,32,33302
2021-07-19,cabo_verde,Africa,567234,15,33317
2021-07-20,cabo_verde,Africa,567234,39,33356
2021-07-21,cabo_verde,Africa,567234,39,33395
2021-07-22,cabo_verde,Africa,567234,57,33452
2021-07-23,cabo_verde,Africa,567234,52,33504
2021-07-24,cabo_verde,Africa,567234,37,33541
2021-07-25,cabo_verde,Africa,567234,36,33577
2021-07-26,cabo_verde,Africa,567234,15,33592
2021-07-27,cabo_verde,Africa,567234,34,33626
2021-07-28,cabo_verde,Africa,567234,56,33682
2021-07-29,cabo_verde,Africa,567234,39,33721
2021-07-30,cabo_verde,Africa,567234,42,33763
2021-07-31,cabo_verde,Africa,567234,28,33791
2021-08-01,cabo_verde,Africa,567234,31,33822
2021-08-02,cabo_verde,Africa,567234,8,33830
2021-08-03,cabo_verde,Africa,567234,28,33858
2021-08-04,cabo_verde,Africa,567234,48,33906
2021-08-05,cabo_verde,Africa,567234,35,33941
2021-08-06,cabo_verde,Africa,567234,35,33976
2021-08-07,cabo_verde,Africa,567234,34,34010
2021-08-08,cabo_verde,Africa,567234,42,34052
2021-08-09,cabo_verde,Africa,567234,26,34078
2021-08-10,cabo_verde,Africa,567234,34,34112
2021-08-11,cabo_verde,Africa,567234,59,34171
2021-08-12,cabo_verde,Africa,567234,64,34235
2021-08-13,cabo_verde,Africa,567234,51,34286
2021-08-14,cabo_verde,Africa,567234,58,34344
2021-08-15,cabo_verde,Africa,567234,53,34397
2021-08-16,cabo_verde,Africa,567234,10,34407
2021-08-17,cabo_verde,Africa,567234,38,34445
2021-08-18,cabo_verde,Africa,567234,84,34529
2021-08-19,cabo_verde,Africa,567234,69,34598
2021-08-20,cabo_verde,Africa,567234,47,34645
2021-08-21,cabo_verde,Africa,567234,41,34686
2021-08-22,cabo_verde,Africa,567234,52,34738
2021-08-23,cabo_verde,Africa,567234,35,34773
2021-08-24,cabo_verde,Africa,567234,52,34825
2021-08-25,cabo_verde,Africa,567234,94,34919
2021-08-26,cabo_verde,Africa,567234,73,34992
2021-08-27,cabo_verde,Africa,567234,87,35079
2021-08-28,cabo_verde,Africa,567234,68,35147
2021-08-29,cabo_verde,Africa,567234,80,35227
2021-08-30,cabo_verde,Africa,567234,56,35283
2021-08-31,cabo_verde,Africa,567234,71,35354
2021-09-01,cabo_verde,Africa,567234,152,35506
2021-09-02,cabo_verde,Africa,567234,118,35624
2021-09-03,cabo_verde,Africa,567234,115,35739
2021-09-04,cabo_verde,Africa,567234,117,35856
2021-09-05,cabo_verde,Africa,567234,72,35928
2021-09-06,cabo_verde,Africa,567234,84,36012
2021-09-07,cabo_verde,Africa,567234,74,36086
2021-09-08,cabo_verde,Africa,567234,116,36202
2021-09-09,cabo_verde,Africa,567234,125,36327
2021-09-10,cabo_verde,Africa,567234,100,36427
2021-09-11,cabo_verde,Africa,567234,92,36519
2021-09-12,cabo_verde,Africa,567234,69,36588
2021-09-13,cabo_verde,Africa,567234,52,36640
2021-09-14,cabo_verde,Africa,567234,54,36694
2021-09-15,cabo_verde,Africa,567234,122,36816
2021-09-16,cabo_verde,Africa,567234,75,36891
2021-09-17,cabo_verde,Africa,567234,79,36970
2021-09-18,cabo_verde,Africa,567234,82,37052
2021-09-19,cabo_verde,Africa,567234,56,37108
2021-09-20,cabo_verde,Africa,567234,49,37157
2021-09-21,cabo_verde,Africa,567234,22,37179
2021-09-22,cabo_verde,Africa,567234,61,37240
2021-09-23,cabo_verde,Africa,567234,50,37290
2021-09-24,cabo_verde,Africa,567234,65,37355
2021-09-25,cabo_verde,Africa,567234,45,37400
2021-09-26,cabo_verde,Africa,567234,48,37448
2021-09-27,cabo_verde,Africa,567234,24,37472
2021-09-28,cabo_verde,Africa,567234,29,37501
2021-09-29,cabo_verde,Africa,567234,34,37535
2021-09-30,cabo_verde,Africa,567234,41,37576
2021-10-01,cabo_verde,Africa,567234,28,37604
2021-10-02,cabo_verde,Africa,567234,31,37635
2021-10-03,cabo_verde,Africa,567234,23,37658
2021-10-04,cabo_verde,Africa,567234,0,37658
2021-10-05,cabo_verde,Africa,567234,60,37718
2021-10-06,cabo_verde,Africa,567234,52,37770
2021-10-07,cabo_verde,Africa,567234,38,37808
2021-10-08,cabo_verde,Africa,567234,37,37845
2021-10-09,cabo_verde,Africa,567234,25,37870
2021-10-10,cabo_verde,Africa,567234,18,37888
2021-10-11,cabo_verde,Africa,567234,14,37902
2021-10-12,cabo_verde,Africa,567234,18,37920
2021-10-13,cabo_verde,Africa,567234,31,37951
2021-10-14,cabo_verde,Africa,567234,25,37976
2021-10-15,cabo_verde,Africa,567234,30,38006
2021-10-16,cabo_verde,Africa,567234,29,38035
2021-10-17,cabo_verde,Africa,567234,5,38040
2021-10-18,cabo_verde,Africa,567234,9,38049
2021-10-19,cabo_verde,Africa,567234,3,38052
2021-10-20,cabo_verde,Africa,567234,30,38082
2021-10-21,cabo_verde,Africa,567234,16,38098
2021-10-22,cabo_verde,Africa,567234,0,38098
2021-10-23,cabo_verde,Africa,567234,32,38130
2021-10-24,cabo_verde,Africa,567234,10,38140
2021-10-25,cabo_verde,Africa,567234,8,38148
2021-10-26,cabo_verde,Africa,567234,3,38151
2021-10-27,cabo_verde,Africa,567234,18,38169
2021-10-28,cabo_verde,Africa,567234,12,38181
2021-10-29,cabo_verde,Africa,567234,16,38197
2021-10-30,cabo_verde,Africa,567234,10,38207
2021-10-31,cabo_verde,Africa,567234,8,38215
2021-11-01,cabo_verde,Africa,567234,3,38218
2021-11-02,cabo_verde,Africa,567234,1,38219
2021-11-03,cabo_verde,Africa,567234,9,38228
2021-11-04,cabo_verde,Africa,567234,5,38233
2021-11-05,cabo_verde,Africa,567234,9,38242
2021-11-06,cabo_verde,Africa,567234,11,38253
2021-11-07,cabo_verde,Africa,567234,3,38256
2021-11-08,cabo_verde,Africa,567234,7,38263
2021-11-09,cabo_verde,Africa,567234,1,38264
2021-11-10,cabo_verde,Africa,567234,14,38278
2021-11-11,cabo_verde,Africa,567234,9,38287
2021-11-12,cabo_verde,Africa,567234,6,38293
2021-11-13,cabo_verde,Africa,567234,0,38293
2021-11-14,cabo_verde,Africa,567234,3,38296
2021-11-15,cabo_verde,Africa,567234,3,38299
2021-11-16,cabo_verde,Africa,567234,3,38302
2021-11-17,cabo_verde,Africa,567234,7,38309
2021-11-18,cabo_verde,Africa,567234,4,38313
2021-11-19,cabo_verde,Africa,567234,8,38321
2021-11-20,cabo_verde,Africa,567234,3,38324
2021-11-21,cabo_verde,Africa,567234,3,38327
2021-11-22,cabo_verde,Africa,567234,4,38331
2021-11-23,cabo_verde,Africa,567234,5,38336
2021-11-24,cabo_verde,Africa,567234,9,38345
2021-11-25,cabo_verde,Africa,567234,2,38347
2021-11-26,cabo_verde,Africa,567234,6,38353
2021-11-27,cabo_verde,Africa,567234,5,38358
2021-11-28,cabo_verde,Africa,567234,4,38362
2021-11-29,cabo_verde,Africa,567234,5,38367
2021-11-30,cabo_verde,Africa,567234,3,38370
2021-12-01,cabo_verde,Africa,567234,23,38393
2021-12-02,cabo_verde,Africa,567234,12,38405
2021-12-03,cabo_verde,Africa,567234,21,38426
2021-12-04,cabo_verde,Africa,567234,13,38439
2021-12-05,cabo_verde,Africa,567234,11,38450
2021-12-06,cabo_verde,Africa,567234,3,38453
2021-12-07,cabo_verde,Africa,567234,7,38460
2021-12-08,cabo_verde,Africa,567234,10,38470
2021-12-09,cabo_verde,Africa,567234,12,38482
2021-12-10,cabo_verde,Africa,567234,7,38489
2021-12-11,cabo_verde,Africa,567234,7,38496
2021-12-12,cabo_verde,Africa,567234,7,38503
2021-12-13,cabo_verde,Africa,567234,0,38503
2021-12-14,cabo_verde,Africa,567234,6,38509
2021-12-15,cabo_verde,Africa,567234,18,38527
2021-12-16,cabo_verde,Africa,567234,14,38541
2021-12-17,cabo_verde,Africa,567234,16,38557
2021-12-18,cabo_verde,Africa,567234,16,38573
2021-12-19,cabo_verde,Africa,567234,16,38589
2021-12-20,cabo_verde,Africa,567234,7,38596
2021-12-21,cabo_verde,Africa,567234,23,38619
2021-12-22,cabo_verde,Africa,567234,36,38655
2021-12-23,cabo_verde,Africa,567234,96,38751
2021-12-24,cabo_verde,Africa,567234,114,38865
2021-12-25,cabo_verde,Africa,567234,148,39013
2021-12-26,cabo_verde,Africa,567234,59,39072
2021-12-27,cabo_verde,Africa,567234,101,39173
2021-12-28,cabo_verde,Africa,567234,172,39345
2021-12-29,cabo_verde,Africa,567234,602,39947
2021-12-30,cabo_verde,Africa,567234,791,40738
2021-12-31,cabo_verde,Africa,567234,994,41732
2022-01-01,cabo_verde,Africa,567234,731,42463
2022-01-02,cabo_verde,Africa,567234,348,42811
2022-01-03,cabo_verde,Africa,567234,756,43567
2022-01-04,cabo_verde,Africa,567234,1025,44592
2022-01-05,cabo_verde,Africa,567234,1397,45989
2022-01-06,cabo_verde,Africa,567234,1387,47376
2022-01-07,cabo_verde,Africa,567234,1469,48845
2022-01-08,cabo_verde,Africa,567234,1005,49850
2022-01-09,cabo_verde,Africa,567234,400,50250
2022-01-10,cabo_verde,Africa,567234,709,50959
2022-01-11,cabo_verde,Africa,567234,1048,52007
2022-01-12,cabo_verde,Africa,567234,722,52729
2022-01-13,cabo_verde,Africa,567234,0,52729
2022-01-14,cabo_verde,Africa,567234,1055,53784
2022-01-15,cabo_verde,Africa,567234,203,53987
2022-01-16,cabo_verde,Africa,567234,213,54200
2022-01-17,cabo_verde,Africa,567234,167,54367
2022-01-18,cabo_verde,Africa,567234,270,54637
2022-01-19,cabo_verde,Africa,567234,254,54891
2022-01-20,cabo_verde,Africa,567234,132,55023
2022-01-21,cabo_verde,Africa,567234,155,55178
2022-01-22,cabo_verde,Africa,567234,78,55256
2022-01-23,cabo_verde,Africa,567234,50,55306
2022-01-24,cabo_verde,Africa,567234,95,55401
2022-01-25,cabo_verde,Africa,567234,70,55471
2022-01-26,cabo_verde,Africa,567234,72,55543
2022-01-27,cabo_verde,Africa,567234,52,55595
2022-01-28,cabo_verde,Africa,567234,40,55635
2022-01-29,cabo_verde,Africa,567234,23,55658
2022-01-30,cabo_verde,Africa,567234,19,55677
2022-01-31,cabo_verde,Africa,567234,18,55695
2022-02-01,cabo_verde,Africa,567234,26,55721
2022-02-02,cabo_verde,Africa,567234,18,55739
2022-02-03,cabo_verde,Africa,567234,15,55754
2022-02-04,cabo_verde,Africa,567234,15,55769
2022-02-05,cabo_verde,Africa,567234,3,55772
2022-02-06,cabo_verde,Africa,567234,13,55785
2022-02-07,cabo_verde,Africa,567234,17,55802
2022-02-08,cabo_verde,Africa,567234,9,55811
2022-02-09,cabo_verde,Africa,567234,9,55820
2022-02-10,cabo_verde,Africa,567234,7,55827
2022-02-11,cabo_verde,Africa,567234,6,55833
2022-02-12,cabo_verde,Africa,567234,7,55840
2022-02-13,cabo_verde,Africa,567234,2,55842
2022-02-14,cabo_verde,Africa,567234,2,55844
2022-02-15,cabo_verde,Africa,567234,2,55846
2022-02-16,cabo_verde,Africa,567234,10,55856
2022-02-17,cabo_verde,Africa,567234,0,55856
2022-02-18,cabo_verde,Africa,567234,2,55858
2022-02-19,cabo_verde,Africa,567234,2,55860
2022-02-20,cabo_verde,Africa,567234,0,55860
2022-02-21,cabo_verde,Africa,567234,3,55863
2022-02-22,cabo_verde,Africa,567234,1,55864
2022-02-23,cabo_verde,Africa,567234,6,55870
2022-02-24,cabo_verde,Africa,567234,6,55876
2022-02-25,cabo_verde,Africa,567234,4,55880
2022-02-26,cabo_verde,Africa,567234,1,55881
2022-02-27,cabo_verde,Africa,567234,1,55882
2022-02-28,cabo_verde,Africa,567234,4,55886
2022-03-01,cabo_verde,Africa,567234,1,55887
2022-03-02,cabo_verde,Africa,567234,2,55889
2022-03-03,cabo_verde,Africa,567234,0,55889
2022-03-04,cabo_verde,Africa,567234,1,55890
2022-03-05,cabo_verde,Africa,567234,2,55892
2022-03-06,cabo_verde,Africa,567234,3,55895
2022-03-07,cabo_verde,Africa,567234,3,55898
2022-03-08,cabo_verde,Africa,567234,5,55903
2022-03-09,cabo_verde,Africa,567234,1,55904
2022-03-10,cabo_verde,Africa,567234,2,55906
2022-03-11,cabo_verde,Africa,567234,0,55906
2022-03-12,cabo_verde,Africa,567234,0,55906
2022-03-13,cabo_verde,Africa,567234,0,55906
2022-03-14,cabo_verde,Africa,567234,1,55907
2022-03-15,cabo_verde,Africa,567234,4,55911
2022-03-16,cabo_verde,Africa,567234,3,55914
2022-03-17,cabo_verde,Africa,567234,3,55917
2022-03-18,cabo_verde,Africa,567234,4,55921
2022-03-19,cabo_verde,Africa,567234,4,55925
2022-03-20,cabo_verde,Africa,567234,0,55925
2022-03-21,cabo_verde,Africa,567234,2,55927
2022-03-22,cabo_verde,Africa,567234,4,55931
2022-03-23,cabo_verde,Africa,567234,3,55934
2022-03-24,cabo_verde,Africa,567234,7,55941
2022-03-25,cabo_verde,Africa,567234,4,55945
2022-03-26,cabo_verde,Africa,567234,2,55947
2022-03-27,cabo_verde,Africa,567234,1,55948
2022-03-28,cabo_verde,Africa,567234,1,55949
2022-03-29,cabo_verde,Africa,567234,1,55950
2022-03-30,cabo_verde,Africa,567234,0,55950
2022-03-31,cabo_verde,Africa,567234,2,55952
2022-04-01,cabo_verde,Africa,567234,5,55957
2022-04-02,cabo_verde,Africa,567234,1,55958
2022-04-03,cabo_verde,Africa,567234,2,55960
2022-04-04,cabo_verde,Africa,567234,1,55961
2022-04-05,cabo_verde,Africa,567234,0,55961
2022-04-06,cabo_verde,Africa,567234,2,55963
2022-04-07,cabo_verde,Africa,567234,0,55963
2022-04-08,cabo_verde,Africa,567234,7,55970
2022-04-09,cabo_verde,Africa,567234,1,55971
2022-04-10,cabo_verde,Africa,567234,1,55972
2022-04-11,cabo_verde,Africa,567234,1,55973
2022-04-12,cabo_verde,Africa,567234,1,55974
2020-03-25,cameroon,Africa,27776053,9,75
2020-03-26,cameroon,Africa,27776053,0,75
2020-03-27,cameroon,Africa,27776053,16,91
2020-03-28,cameroon,Africa,27776053,0,91
2020-03-29,cameroon,Africa,27776053,48,139
2020-03-30,cameroon,Africa,27776053,0,139
2020-03-31,cameroon,Africa,27776053,54,193
2020-04-01,cameroon,Africa,27776053,40,233
2020-04-02,cameroon,Africa,27776053,73,306
2020-04-03,cameroon,Africa,27776053,203,509
2020-04-04,cameroon,Africa,27776053,46,555
2020-04-05,cameroon,Africa,27776053,95,650
2020-04-06,cameroon,Africa,27776053,8,658
2020-04-07,cameroon,Africa,27776053,27,685
2020-04-08,cameroon,Africa,27776053,45,730
2020-04-09,cameroon,Africa,27776053,73,803
2020-04-10,cameroon,Africa,27776053,17,820
2020-04-11,cameroon,Africa,27776053,0,820
2020-04-12,cameroon,Africa,27776053,0,820
2020-04-13,cameroon,Africa,27776053,28,848
2020-04-14,cameroon,Africa,27776053,0,848
2020-04-15,cameroon,Africa,27776053,0,848
2020-04-16,cameroon,Africa,27776053,148,996
2020-04-17,cameroon,Africa,27776053,0,996
2020-04-18,cameroon,Africa,27776053,21,1017
2020-04-19,cameroon,Africa,27776053,0,1017
2020-04-20,cameroon,Africa,27776053,146,1163
2020-04-21,cameroon,Africa,27776053,0,1163
2020-04-22,cameroon,Africa,27776053,0,1163
2020-04-23,cameroon,Africa,27776053,171,1334
2020-04-24,cameroon,Africa,27776053,96,1430
2020-04-25,cameroon,Africa,27776053,88,1518
2020-04-26,cameroon,Africa,27776053,103,1621
2020-04-27,cameroon,Africa,27776053,84,1705
2020-04-28,cameroon,Africa,27776053,0,1705
2020-04-29,cameroon,Africa,27776053,127,1832
2020-04-30,cameroon,Africa,27776053,0,1832
2020-05-01,cameroon,Africa,27776053,0,1832
2020-05-02,cameroon,Africa,27776053,245,2077
2020-05-03,cameroon,Africa,27776053,0,2077
2020-05-04,cameroon,Africa,27776053,27,2104
2020-05-05,cameroon,Africa,27776053,0,2104
2020-05-06,cameroon,Africa,27776053,161,2265
2020-05-07,cameroon,Africa,27776053,2,2267
2020-05-08,cameroon,Africa,27776053,0,2267
2020-05-09,cameroon,Africa,27776053,7,2274
2020-05-10,cameroon,Africa,27776053,305,2579
2020-05-11,cameroon,Africa,27776053,110,2689
2020-05-12,cameroon,Africa,27776053,0,2689
2020-05-13,cameroon,Africa,27776053,111,2800
2020-05-14,cameroon,Africa,27776053,154,2954
2020-05-15,cameroon,Africa,27776053,0,2954
2020-05-16,cameroon,Africa,27776053,151,3105
2020-05-17,cameroon,Africa,27776053,0,3105
2020-05-18,cameroon,Africa,27776053,424,3529
2020-05-19,cameroon,Africa,27776053,0,3529
2020-05-20,cameroon,Africa,27776053,204,3733
2020-05-21,cameroon,Africa,27776053,555,4288
2020-05-22,cameroon,Africa,27776053,112,4400
2020-05-23,cameroon,Africa,27776053,0,4400
2020-05-24,cameroon,Africa,27776053,490,4890
2020-05-25,cameroon,Africa,27776053,0,4890
2020-05-26,cameroon,Africa,27776053,546,5436
2020-05-27,cameroon,Africa,27776053,0,5436
2020-05-28,cameroon,Africa,27776053,0,5436
2020-05-29,cameroon,Africa,27776053,0,5436
2020-05-30,cameroon,Africa,27776053,468,5904
2020-05-31,cameroon,Africa,27776053,0,5904
2020-06-01,cameroon,Africa,27776053,493,6397
2020-06-02,cameroon,Africa,27776053,188,6585
2020-06-03,cameroon,Africa,27776053,0,6585
2020-06-04,cameroon,Africa,27776053,204,6789
2020-06-05,cameroon,Africa,27776053,603,7392
2020-06-06,cameroon,Africa,27776053,207,7599
2020-06-07,cameroon,Africa,27776053,309,7908
2020-06-08,cameroon,Africa,27776053,152,8060
2020-06-09,cameroon,Africa,27776053,252,8312
2020-06-10,cameroon,Africa,27776053,369,8681
2020-06-11,cameroon,Africa,27776053,0,8681
2020-06-12,cameroon,Africa,27776053,0,8681
2020-06-13,cameroon,Africa,27776053,0,8681
2020-06-14,cameroon,Africa,27776053,0,8681
2020-06-15,cameroon,Africa,27776053,1183,9864
2020-06-16,cameroon,Africa,27776053,0,9864
2020-06-17,cameroon,Africa,27776053,0,9864
2020-06-18,cameroon,Africa,27776053,774,10638
2020-06-19,cameroon,Africa,27776053,643,11281
2020-06-20,cameroon,Africa,27776053,329,11610
2020-06-21,cameroon,Africa,27776053,282,11892
2020-06-22,cameroon,Africa,27776053,149,12041
2020-06-23,cameroon,Africa,27776053,229,12270
2020-06-24,cameroon,Africa,27776053,322,12592
2020-06-25,cameroon,Africa,27776053,0,12592
2020-06-26,cameroon,Africa,27776053,0,12592
2020-06-27,cameroon,Africa,27776053,0,12592
2020-06-28,cameroon,Africa,27776053,0,12592
2020-06-29,cameroon,Africa,27776053,0,12592
2020-06-30,cameroon,Africa,27776053,0,12592
2020-07-01,cameroon,Africa,27776053,0,12592
2020-07-02,cameroon,Africa,27776053,0,12592
2020-07-03,cameroon,Africa,27776053,0,12592
2020-07-04,cameroon,Africa,27776053,0,12592
2020-07-05,cameroon,Africa,27776053,0,12592
2020-07-06,cameroon,Africa,27776053,0,12592
2020-07-07,cameroon,Africa,27776053,2324,14916
2020-07-08,cameroon,Africa,27776053,0,14916
2020-07-09,cameroon,Africa,27776053,0,14916
2020-07-10,cameroon,Africa,27776053,0,14916
2020-07-11,cameroon,Africa,27776053,257,15173
2020-07-12,cameroon,Africa,27776053,0,15173
2020-07-13,cameroon,Africa,27776053,0,15173
2020-07-14,cameroon,Africa,27776053,0,15173
2020-07-15,cameroon,Africa,27776053,0,15173
2020-07-16,cameroon,Africa,27776053,984,16157
2020-07-17,cameroon,Africa,27776053,0,16157
2020-07-18,cameroon,Africa,27776053,0,16157
2020-07-19,cameroon,Africa,27776053,0,16157
2020-07-20,cameroon,Africa,27776053,0,16157
2020-07-21,cameroon,Africa,27776053,365,16522
2020-07-22,cameroon,Africa,27776053,0,16522
2020-07-23,cameroon,Africa,27776053,0,16522
2020-07-24,cameroon,Africa,27776053,186,16708
2020-07-25,cameroon,Africa,27776053,0,16708
2020-07-26,cameroon,Africa,27776053,0,16708
2020-07-27,cameroon,Africa,27776053,402,17110
2020-07-28,cameroon,Africa,27776053,69,17179
2020-07-29,cameroon,Africa,27776053,76,17255
2020-07-30,cameroon,Africa,27776053,0,17255
2020-07-31,cameroon,Africa,27776053,0,17255
2020-08-01,cameroon,Africa,27776053,0,17255
2020-08-02,cameroon,Africa,27776053,0,17255
2020-08-03,cameroon,Africa,27776053,0,17255
2020-08-04,cameroon,Africa,27776053,463,17718
2020-08-05,cameroon,Africa,27776053,0,17718
2020-08-06,cameroon,Africa,27776053,0,17718
2020-08-07,cameroon,Africa,27776053,0,17718
2020-08-08,cameroon,Africa,27776053,324,18042
2020-08-09,cameroon,Africa,27776053,0,18042
2020-08-10,cameroon,Africa,27776053,0,18042
2020-08-11,cameroon,Africa,27776053,171,18213
2020-08-12,cameroon,Africa,27776053,50,18263
2020-08-13,cameroon,Africa,27776053,45,18308
2020-08-14,cameroon,Africa,27776053,161,18469
2020-08-15,cameroon,Africa,27776053,0,18469
2020-08-16,cameroon,Africa,27776053,0,18469
2020-08-17,cameroon,Africa,27776053,113,18582
2020-08-18,cameroon,Africa,27776053,17,18599
2020-08-19,cameroon,Africa,27776053,25,18624
2020-08-20,cameroon,Africa,27776053,138,18762
2020-08-21,cameroon,Africa,27776053,0,18762
2020-08-22,cameroon,Africa,27776053,0,18762
2020-08-23,cameroon,Africa,27776053,0,18762
2020-08-24,cameroon,Africa,27776053,0,18762
2020-02-20,canada,North America,38358465,0,8
2020-02-21,canada,North America,38358465,1,9
2020-02-22,canada,North America,38358465,0,9
2020-02-23,canada,North America,38358465,1,10
2020-02-24,canada,North America,38358465,1,11
2020-02-25,canada,North America,38358465,0,11
2020-02-26,canada,North America,38358465,1,12
2020-02-27,canada,North America,38358465,2,14
2020-02-28,canada,North America,38358465,1,15
2020-02-29,canada,North America,38358465,5,20
2020-03-01,canada,North America,38358465,4,24
2020-03-02,canada,North America,38358465,3,27
2020-03-03,canada,North America,38358465,3,30
2020-03-04,canada,North America,38358465,4,34
2020-03-05,canada,North America,38358465,3,37
2020-03-06,canada,North America,38358465,17,54
2020-03-07,canada,North America,38358465,6,60
2020-03-08,canada,North America,38358465,6,66
2020-03-09,canada,North America,38358465,11,77
2020-03-10,canada,North America,38358465,18,95
2020-03-11,canada,North America,38358465,15,110
2020-03-12,canada,North America,38358465,32,142
2020-03-13,canada,North America,38358465,56,198
2020-03-14,canada,North America,38358465,54,252
2020-03-15,canada,North America,38358465,89,341
2020-03-16,canada,North America,38358465,100,441
2020-03-17,canada,North America,38358465,157,598
2020-03-18,canada,North America,38358465,129,727
2020-03-19,canada,North America,38358465,146,873
2020-03-20,canada,North America,38358465,214,1087
2020-03-21,canada,North America,38358465,241,1328
2020-03-22,canada,North America,38358465,142,1470
2020-03-23,canada,North America,38358465,621,2091
2020-03-24,canada,North America,38358465,701,2792
2020-03-25,canada,North America,38358465,617,3409
2020-03-26,canada,North America,38358465,634,4043
2020-03-27,canada,North America,38358465,714,4757
2020-03-28,canada,North America,38358465,898,5655
2020-03-29,canada,North America,38358465,665,6320
2020-03-30,canada,North America,38358465,1128,7448
2020-03-31,canada,North America,38358465,1164,8612
2020-04-01,canada,North America,38358465,1119,9731
2020-04-02,canada,North America,38358465,1552,11283
2020-04-03,canada,North America,38358465,1092,12375
2020-04-04,canada,North America,38358465,1537,13912
2020-04-05,canada,North America,38358465,1600,15512
2020-04-06,canada,North America,38358465,1155,16667
2020-04-07,canada,North America,38358465,1230,17897
2020-04-08,canada,North America,38358465,1541,19438
2020-04-09,canada,North America,38358465,1327,20765
2020-04-10,canada,North America,38358465,1383,22148
2020-04-11,canada,North America,38358465,1170,23318
2020-04-12,canada,North America,38358465,1065,24383
2020-04-13,canada,North America,38358465,1297,25680
2020-04-14,canada,North America,38358465,1383,27063
2020-04-15,canada,North America,38358465,1316,28379
2020-04-16,canada,North America,38358465,1727,30106
2020-04-17,canada,North America,38358465,1821,31927
2020-04-18,canada,North America,38358465,1456,33383
2020-04-19,canada,North America,38358465,1673,35056
2020-04-20,canada,North America,38358465,1773,36829
2020-04-21,canada,North America,38358465,1593,38422
2020-04-22,canada,North America,38358465,1768,40190
2020-04-23,canada,North America,38358465,1920,42110
2020-04-24,canada,North America,38358465,1778,43888
2020-04-25,canada,North America,38358465,1466,45354
2020-04-26,canada,North America,38358465,1541,46895
2020-04-27,canada,North America,38358465,1605,48500
2020-04-28,canada,North America,38358465,1526,50026
2020-04-29,canada,North America,38358465,1571,51597
2020-04-30,canada,North America,38358465,1639,53236
2020-05-01,canada,North America,38358465,1825,55061
2020-05-02,canada,North America,38358465,1653,56714
2020-05-03,canada,North America,38358465,2760,59474
2020-05-04,canada,North America,38358465,1298,60772
2020-05-05,canada,North America,38358465,1274,62046
2020-05-06,canada,North America,38358465,1450,63496
2020-05-07,canada,North America,38358465,1426,64922
2020-05-08,canada,North America,38358465,1512,66434
2020-05-09,canada,North America,38358465,1268,67702
2020-05-10,canada,North America,38358465,1146,68848
2020-05-11,canada,North America,38358465,1133,69981
2020-05-12,canada,North America,38358465,1176,71157
2020-05-13,canada,North America,38358465,1121,72278
2020-05-14,canada,North America,38358465,1123,73401
2020-05-15,canada,North America,38358465,1212,74613
2020-05-16,canada,North America,38358465,1251,75864
2020-05-17,canada,North America,38358465,1138,77002
2020-05-18,canada,North America,38358465,1070,78072
2020-05-19,canada,North America,38358465,1040,79112
2020-05-20,canada,North America,38358465,1030,80142
2020-05-21,canada,North America,38358465,1182,81324
2020-05-22,canada,North America,38358465,1156,82480
2020-05-23,canada,North America,38358465,1141,83621
2020-05-24,canada,North America,38358465,1078,84699
2020-05-25,canada,North America,38358465,1012,85711
2020-05-26,canada,North America,38358465,936,86647
2020-05-27,canada,North America,38358465,872,87519
2020-05-28,canada,North America,38358465,993,88512
2020-05-29,canada,North America,38358465,906,89418
2020-05-30,canada,North America,38358465,772,90190
2020-05-31,canada,North America,38358465,757,90947
2020-06-01,canada,North America,38358465,758,91705
2020-06-02,canada,North America,38358465,705,92410
2020-06-03,canada,North America,38358465,675,93085
2020-06-04,canada,North America,38358465,641,93726
2020-06-05,canada,North America,38358465,609,94335
2020-06-06,canada,North America,38358465,722,95057
2020-06-07,canada,North America,38358465,642,95699
2020-06-08,canada,North America,38358465,545,96244
2020-06-09,canada,North America,38358465,409,96653
2020-06-10,canada,North America,38358465,472,97125
2020-06-11,canada,North America,38358465,405,97530
2020-06-12,canada,North America,38358465,413,97943
2020-06-13,canada,North America,38358465,467,98410
2020-06-14,canada,North America,38358465,377,98787
2020-06-15,canada,North America,38358465,360,99147
2020-06-16,canada,North America,38358465,320,99467
2020-06-17,canada,North America,38358465,386,99853
2020-06-18,canada,North America,38358465,367,100220
2020-06-19,canada,North America,38358465,409,100629
2020-06-20,canada,North America,38358465,390,101019
2020-06-21,canada,North America,38358465,318,101337
2020-06-22,canada,North America,38358465,300,101637
2020-06-23,canada,North America,38358465,326,101963
2020-06-24,canada,North America,38358465,279,102242
2020-06-25,canada,North America,38358465,380,102622
2020-06-26,canada,North America,38358465,172,102794
2020-06-27,canada,North America,38358465,238,103032
2020-06-28,canada,North America,38358465,218,103250
2020-06-29,canada,North America,38358465,668,103918
2020-06-30,canada,North America,38358465,286,104204
2020-07-01,canada,North America,38358465,67,104271
2020-07-02,canada,North America,38358465,501,104772
2020-07-03,canada,North America,38358465,319,105091
2020-07-04,canada,North America,38358465,226,105317
2020-07-05,canada,North America,38358465,219,105536
2020-07-06,canada,North America,38358465,399,105935
2020-07-07,canada,North America,38358465,232,106167
2020-07-08,canada,North America,38358465,267,106434
2020-07-09,canada,North America,38358465,371,106805
2020-07-10,canada,North America,38358465,321,107126
2020-07-11,canada,North America,38358465,221,107347
2020-07-12,canada,North America,38358465,243,107590
2020-07-13,canada,North America,38358465,565,108155
2020-07-14,canada,North America,38358465,331,108486
2020-07-15,canada,North America,38358465,343,108829
2020-07-16,canada,North America,38358465,435,109264
2020-07-17,canada,North America,38358465,405,109669
2020-07-18,canada,North America,38358465,330,109999
2020-07-19,canada,North America,38358465,339,110338
2020-07-20,canada,North America,38358465,786,111124
2020-07-21,canada,North America,38358465,573,111697
2020-07-22,canada,North America,38358465,543,112240
2020-07-23,canada,North America,38358465,432,112672
2020-07-24,canada,North America,38358465,534,113206
2020-07-25,canada,North America,38358465,350,113556
2020-07-26,canada,North America,38358465,355,113911
2020-07-27,canada,North America,38358465,686,114597
2020-07-28,canada,North America,38358465,397,114994
2020-07-29,canada,North America,38358465,476,115470
2020-07-30,canada,North America,38358465,329,115799
2020-07-31,canada,North America,38358465,513,116312
2020-08-01,canada,North America,38358465,287,116599
2020-08-02,canada,North America,38358465,285,116884
2020-08-03,canada,North America,38358465,147,117031
2020-08-04,canada,North America,38358465,761,117792
2020-08-05,canada,North America,38358465,395,118187
2020-08-06,canada,North America,38358465,374,118561
2020-08-07,canada,North America,38358465,424,118985
2020-08-08,canada,North America,38358465,236,119221
2020-08-09,canada,North America,38358465,230,119451
2020-08-10,canada,North America,38358465,681,120132
2020-08-11,canada,North America,38358465,289,120421
2020-08-12,canada,North America,38358465,423,120844
2020-08-13,canada,North America,38358465,390,121234
2020-08-14,canada,North America,38358465,418,121652
2020-08-15,canada,North America,38358465,237,121889
2020-08-16,canada,North America,38358465,198,122087
2020-08-17,canada,North America,38358465,785,122872
2020-08-18,canada,North America,38358465,282,123154
2020-08-19,canada,North America,38358465,336,123490
2020-08-20,canada,North America,38358465,383,123873
2020-08-21,canada,North America,38358465,499,124372
2020-08-22,canada,North America,38358465,257,124629
2020-08-23,canada,North America,38358465,267,124896
2020-08-24,canada,North America,38358465,751,125647
2020-08-25,canada,North America,38358465,322,125969
2020-08-26,canada,North America,38358465,448,126417
2020-08-27,canada,North America,38358465,431,126848
2020-08-28,canada,North America,38358465,510,127358
2020-08-29,canada,North America,38358465,315,127673
2020-08-30,canada,North America,38358465,267,127940
2020-08-31,canada,North America,38358465,1008,128948
2020-09-01,canada,North America,38358465,477,129425
2020-09-02,canada,North America,38358465,498,129923
2020-09-03,canada,North America,38358465,570,130493
2020-09-04,canada,North America,38358465,631,131124
2020-09-05,canada,North America,38358465,371,131495
2020-09-06,canada,North America,38358465,400,131895
2020-09-07,canada,North America,38358465,247,132142
2020-09-08,canada,North America,38358465,1606,133748
2020-09-09,canada,North America,38358465,546,134294
2020-09-10,canada,North America,38358465,630,134924
2020-09-11,canada,North America,38358465,702,135626
2020-09-12,canada,North America,38358465,515,136141
2020-09-13,canada,North America,38358465,518,136659
2020-09-14,canada,North America,38358465,1351,138010
2020-09-15,canada,North America,38358465,793,138803
2020-09-16,canada,North America,38358465,944,139747
2020-09-17,canada,North America,38358465,1120,140867
2020-09-18,canada,North America,38358465,1044,141911
2020-09-19,canada,North America,38358465,863,142774
2020-09-20,canada,North America,38358465,875,143649
2020-09-21,canada,North America,38358465,1766,145415
2020-09-22,canada,North America,38358465,1248,146663
2020-09-23,canada,North America,38358465,1090,147753
2020-09-24,canada,North America,38358465,1341,149094
2020-09-25,canada,North America,38358465,1362,150456
2020-09-26,canada,North America,38358465,1215,151671
2020-09-27,canada,North America,38358465,1454,153125
2020-09-28,canada,North America,38358465,2176,155301
2020-09-29,canada,North America,38358465,1660,156961
2020-09-30,canada,North America,38358465,1797,158758
2020-10-01,canada,North America,38358465,1777,160535
2020-10-02,canada,North America,38358465,2124,162659
2020-10-03,canada,North America,38358465,1812,164471
2020-10-04,canada,North America,38358465,1685,166156
2020-10-05,canada,North America,38358465,2804,168960
2020-10-06,canada,North America,38358465,2363,171323
2020-10-07,canada,North America,38358465,1800,173123
2020-10-08,canada,North America,38358465,2436,175559
2020-10-09,canada,North America,38358465,2558,178117
2020-10-10,canada,North America,38358465,2062,180179
2020-10-11,canada,North America,38358465,1685,181864
2020-10-12,canada,North America,38358465,975,182839
2020-10-13,canada,North America,38358465,4042,186881
2020-10-14,canada,North America,38358465,2506,189387
2020-10-15,canada,North America,38358465,2345,191732
2020-10-16,canada,North America,38358465,2374,194106
2020-10-17,canada,North America,38358465,2215,196321
2020-10-18,canada,North America,38358465,1827,198148
2020-10-19,canada,North America,38358465,3289,201437
2020-10-20,canada,North America,38358465,2251,203688
2020-10-21,canada,North America,38358465,2266,205954
2020-10-22,canada,North America,38358465,3194,209148
2020-10-23,canada,North America,38358465,2584,211732
2020-10-24,canada,North America,38358465,2227,213959
2020-10-25,canada,North America,38358465,2145,216104
2020-10-26,canada,North America,38358465,4109,220213
2020-10-27,canada,North America,38358465,2674,222887
2020-10-28,canada,North America,38358465,2699,225586
2020-10-29,canada,North America,38358465,2956,228542
2020-10-30,canada,North America,38358465,3457,231999
2020-10-31,canada,North America,38358465,2512,234511
2020-11-01,canada,North America,38358465,2330,236841
2020-11-02,canada,North America,38358465,3422,240263
2020-11-03,canada,North America,38358465,4672,244935
2020-11-04,canada,North America,38358465,2768,247703
2020-11-05,canada,North America,38358465,3635,251338
2020-11-06,canada,North America,38358465,4471,255809
2020-11-07,canada,North America,38358465,4246,260055
2020-11-08,canada,North America,38358465,4058,264113
2020-11-09,canada,North America,38358465,4622,268735
2020-11-10,canada,North America,38358465,4302,273037
2020-11-11,canada,North America,38358465,4024,277061
2020-11-12,canada,North America,38358465,5516,282577
2020-11-13,canada,North America,38358465,4741,287318
2020-11-14,canada,North America,38358465,4613,291931
2020-11-15,canada,North America,38358465,4146,296077
2020-11-16,canada,North America,38358465,6115,302192
2020-11-17,canada,North America,38358465,4276,306468
2020-11-18,canada,North America,38358465,4641,311109
2020-11-19,canada,North America,38358465,4645,315754
2020-11-20,canada,North America,38358465,4965,320719
2020-11-21,canada,North America,38358465,4992,325711
2020-11-22,canada,North America,38358465,6131,331842
2020-11-23,canada,North America,38358465,5713,337555
2020-11-24,canada,North America,38358465,4889,342444
2020-11-25,canada,North America,38358465,5022,347466
2020-11-26,canada,North America,38358465,5631,353097
2020-11-27,canada,North America,38358465,5967,359064
2020-11-28,canada,North America,38358465,6495,365559
2020-11-29,canada,North America,38358465,6477,372036
2020-11-30,canada,North America,38358465,6103,378139
2020-12-01,canada,North America,38358465,5329,383468
2020-12-02,canada,North America,38358465,6307,389775
2020-12-03,canada,North America,38358465,6495,396270
2020-12-04,canada,North America,38358465,6299,402569
2020-12-05,canada,North America,38358465,6352,408921
2020-12-06,canada,North America,38358465,6261,415182
2020-12-07,canada,North America,38358465,7872,423054
2020-12-08,canada,North America,38358465,5981,429035
2020-12-09,canada,North America,38358465,6295,435330
2020-12-10,canada,North America,38358465,6739,442069
2020-12-11,canada,North America,38358465,6772,448841
2020-12-12,canada,North America,38358465,6011,454852
2020-12-13,canada,North America,38358465,5891,460743
2020-12-14,canada,North America,38358465,8119,468862
2020-12-15,canada,North America,38358465,6352,475214
2020-12-16,canada,North America,38358465,6416,481630
2020-12-17,canada,North America,38358465,7008,488638
2020-12-18,canada,North America,38358465,6708,495346
2020-12-19,canada,North America,38358465,6248,501594
2020-12-20,canada,North America,38358465,6201,507795
2020-12-21,canada,North America,38358465,7519,515314
2020-12-22,canada,North America,38358465,6195,521509
2020-12-23,canada,North America,38358465,6845,528354
2020-12-24,canada,North America,38358465,6858,535212
2020-12-25,canada,North America,38358465,1,535213
2020-12-26,canada,North America,38358465,6403,541616
2020-12-27,canada,North America,38358465,10404,552020
2020-12-28,canada,North America,38358465,3187,555207
2020-12-29,canada,North America,38358465,10299,565506
2020-12-30,canada,North America,38358465,7476,572982
2020-12-31,canada,North America,38358465,8413,581395
2021-01-01,canada,North America,38358465,1302,582697
2021-01-02,canada,North America,38358465,7583,590280
2021-01-03,canada,North America,38358465,11383,601663
2021-01-04,canada,North America,38358465,9761,611424
2021-01-05,canada,North America,38358465,7222,618646
2021-01-06,canada,North America,38358465,8154,626800
2021-01-07,canada,North America,38358465,8334,635134
2021-01-08,canada,North America,38358465,9214,644348
2021-01-09,canada,North America,38358465,8125,652473
2021-01-10,canada,North America,38358465,7816,660289
2021-01-11,canada,North America,38358465,7892,668181
2021-01-12,canada,North America,38358465,6292,674473
2021-01-13,canada,North America,38358465,6855,681328
2021-01-14,canada,North America,38358465,7563,688891
2021-01-15,canada,North America,38358465,6816,695707
2021-01-16,canada,North America,38358465,6476,702183
2021-01-17,canada,North America,38358465,6436,708619
2021-01-18,canada,North America,38358465,6453,715072
2021-01-19,canada,North America,38358465,4679,719751
2021-01-20,canada,North America,38358465,5744,725495
2021-01-21,canada,North America,38358465,5955,731450
2021-01-22,canada,North America,38358465,5957,737407
2021-01-23,canada,North America,38358465,5124,742531
2021-01-24,canada,North America,38358465,4852,747383
2021-01-25,canada,North America,38358465,5628,753011
2021-01-26,canada,North America,38358465,4011,757022
2021-01-27,canada,North America,38358465,4205,761227
2021-01-28,canada,North America,38358465,4876,766103
2021-01-29,canada,North America,38358465,4690,770793
2021-01-30,canada,North America,38358465,4255,775048
2021-01-31,canada,North America,38358465,3924,778972
2021-02-01,canada,North America,38358465,4617,783589
2021-02-02,canada,North America,38358465,2831,786420
2021-02-03,canada,North America,38358465,3231,789651
2021-02-04,canada,North America,38358465,4083,793734
2021-02-05,canada,North America,38358465,4022,797756
2021-02-06,canada,North America,38358465,3301,801057
2021-02-07,canada,North America,38358465,3203,804260
2021-02-08,canada,North America,38358465,3860,808120
2021-02-09,canada,North America,38358465,2677,810797
2021-02-10,canada,North America,38358465,3185,813982
2021-02-11,canada,North America,38358465,3181,817163
2021-02-12,canada,North America,38358465,3143,820306
2021-02-13,canada,North America,38358465,3047,823353
2021-02-14,canada,North America,38358465,2432,825785
2021-02-15,canada,North America,38358465,1139,826924
2021-02-16,canada,North America,38358465,4653,831577
2021-02-17,canada,North America,38358465,2605,834182
2021-02-18,canada,North America,38358465,3315,837497
2021-02-19,canada,North America,38358465,3089,840586
2021-02-20,canada,North America,38358465,2715,843301
2021-02-21,canada,North America,38358465,2351,845652
2021-02-22,canada,North America,38358465,3865,849517
2021-02-23,canada,North America,38358465,2752,852269
2021-02-24,canada,North America,38358465,2857,855126
2021-02-25,canada,North America,38358465,3094,858220
2020-09-12,caribbean_netherlands,North America,26677,0,25
2020-09-13,caribbean_netherlands,North America,26677,0,25
2020-09-14,caribbean_netherlands,North America,26677,0,25
2020-09-15,caribbean_netherlands,North America,26677,3,28
2020-09-16,caribbean_netherlands,North America,26677,0,28
2020-09-17,caribbean_netherlands,North America,26677,4,32
2020-09-18,caribbean_netherlands,North America,26677,4,36
2020-09-19,caribbean_netherlands,North America,26677,0,36
2020-09-20,caribbean_netherlands,North America,26677,0,36
2020-09-21,caribbean_netherlands,North America,26677,0,36
2020-09-22,caribbean_netherlands,North America,26677,18,54
2020-09-23,caribbean_netherlands,North America,26677,15,69
2020-09-24,caribbean_netherlands,North America,26677,0,69
2020-09-25,caribbean_netherlands,North America,26677,16,85
2020-09-26,caribbean_netherlands,North America,26677,0,85
2020-09-27,caribbean_netherlands,North America,26677,0,85
2020-09-28,caribbean_netherlands,North America,26677,3,88
2020-09-29,caribbean_netherlands,North America,26677,18,106
2020-09-30,caribbean_netherlands,North America,26677,15,121
2020-10-01,caribbean_netherlands,North America,26677,0,121
2020-10-02,caribbean_netherlands,North America,26677,0,121
2020-10-03,caribbean_netherlands,North America,26677,3,124
2020-10-04,caribbean_netherlands,North America,26677,0,124
2020-10-05,caribbean_netherlands,North America,26677,0,124
2020-10-06,caribbean_netherlands,North America,26677,17,141
2020-10-07,caribbean_netherlands,North America,26677,0,141
2020-10-08,caribbean_netherlands,North America,26677,0,141
2020-10-09,caribbean_netherlands,North America,26677,7,148
2020-10-10,caribbean_netherlands,North America,26677,0,148
2020-10-11,caribbean_netherlands,North America,26677,0,148
2020-10-12,caribbean_netherlands,North America,26677,0,148
2020-10-13,caribbean_netherlands,North America,26677,0,148
2020-10-14,caribbean_netherlands,North America,26677,2,150
2020-10-15,caribbean_netherlands,North America,26677,0,150
2020-10-16,caribbean_netherlands,North America,26677,0,150
2020-10-17,caribbean_netherlands,North America,26677,0,150
2020-10-18,caribbean_netherlands,North America,26677,0,150
2020-10-19,caribbean_netherlands,North America,26677,0,150
2020-10-20,caribbean_netherlands,North America,26677,0,150
2020-10-21,caribbean_netherlands,North America,26677,0,150
2020-10-22,caribbean_netherlands,North America,26677,0,150
2020-10-23,caribbean_netherlands,North America,26677,0,150
2020-10-24,caribbean_netherlands,North America,26677,0,150
2020-10-25,caribbean_netherlands,North America,26677,0,150
2020-10-26,caribbean_netherlands,North America,26677,0,150
2020-10-27,caribbean_netherlands,North America,26677,0,150
2020-10-28,caribbean_netherlands,North America,26677,0,150
2020-10-29,caribbean_netherlands,North America,26677,3,153
2020-10-30,caribbean_netherlands,North America,26677,0,153
2020-10-31,caribbean_netherlands,North America,26677,0,153
2020-11-01,caribbean_netherlands,North America,26677,0,153
2020-11-02,caribbean_netherlands,North America,26677,0,153
2020-11-03,caribbean_netherlands,North America,26677,0,153
2020-11-04,caribbean_netherlands,North America,26677,0,153
2020-11-05,caribbean_netherlands,North America,26677,0,153
2020-11-06,caribbean_netherlands,North America,26677,1,154
2020-11-07,caribbean_netherlands,North America,26677,0,154
2020-11-08,caribbean_netherlands,North America,26677,0,154
2020-11-09,caribbean_netherlands,North America,26677,0,154
2020-11-10,caribbean_netherlands,North America,26677,0,154
2020-11-11,caribbean_netherlands,North America,26677,1,155
2020-11-12,caribbean_netherlands,North America,26677,0,155
2020-11-13,caribbean_netherlands,North America,26677,0,155
2020-11-14,caribbean_netherlands,North America,26677,0,155
2020-11-15,caribbean_netherlands,North America,26677,0,155
2020-11-16,caribbean_netherlands,North America,26677,0,155
2020-11-17,caribbean_netherlands,North America,26677,2,157
2020-11-18,caribbean_netherlands,North America,26677,0,157
2020-11-19,caribbean_netherlands,North America,26677,0,157
2020-11-20,caribbean_netherlands,North America,26677,1,158
2020-11-21,caribbean_netherlands,North America,26677,0,158
2020-11-22,caribbean_netherlands,North America,26677,0,158
2020-11-23,caribbean_netherlands,North America,26677,3,161
2020-11-24,caribbean_netherlands,North America,26677,0,161
2020-11-25,caribbean_netherlands,North America,26677,0,161
2020-11-26,caribbean_netherlands,North America,26677,0,161
2020-11-27,caribbean_netherlands,North America,26677,0,161
2020-11-28,caribbean_netherlands,North America,26677,0,161
2020-11-29,caribbean_netherlands,North America,26677,1,162
2020-11-30,caribbean_netherlands,North America,26677,0,162
2020-12-01,caribbean_netherlands,North America,26677,0,162
2020-12-02,caribbean_netherlands,North America,26677,0,162
2020-12-03,caribbean_netherlands,North America,26677,2,164
2020-12-04,caribbean_netherlands,North America,26677,0,164
2020-12-05,caribbean_netherlands,North America,26677,0,164
2020-12-06,caribbean_netherlands,North America,26677,0,164
2020-12-07,caribbean_netherlands,North America,26677,0,164
2020-12-08,caribbean_netherlands,North America,26677,5,169
2020-12-09,caribbean_netherlands,North America,26677,3,172
2020-12-10,caribbean_netherlands,North America,26677,0,172
2020-12-11,caribbean_netherlands,North America,26677,0,172
2020-12-12,caribbean_netherlands,North America,26677,3,175
2020-12-13,caribbean_netherlands,North America,26677,0,175
2020-12-14,caribbean_netherlands,North America,26677,0,175
2020-12-15,caribbean_netherlands,North America,26677,2,177
2020-12-16,caribbean_netherlands,North America,26677,0,177
2020-12-17,caribbean_netherlands,North America,26677,0,177
2020-12-18,caribbean_netherlands,North America,26677,0,177
2020-12-19,caribbean_netherlands,North America,26677,2,179
2020-12-20,caribbean_netherlands,North America,26677,0,179
2020-12-21,caribbean_netherlands,North America,26677,0,179
2020-12-22,caribbean_netherlands,North America,26677,0,179
2020-12-23,caribbean_netherlands,North America,26677,3,182
2020-12-24,caribbean_netherlands,North America,26677,0,182
2020-12-25,caribbean_netherlands,North America,26677,0,182
2020-12-26,caribbean_netherlands,North America,26677,0,182
2020-12-27,caribbean_netherlands,North America,26677,0,182
2020-12-28,caribbean_netherlands,North America,26677,0,182
2020-12-29,caribbean_netherlands,North America,26677,0,182
2020-12-30,caribbean_netherlands,North America,26677,4,186
2020-12-31,caribbean_netherlands,North America,26677,10,196
2021-01-01,caribbean_netherlands,North America,26677,0,196
2021-01-02,caribbean_netherlands,North America,26677,16,212
2021-01-03,caribbean_netherlands,North America,26677,17,229
2021-01-04,caribbean_netherlands,North America,26677,12,241
2021-01-05,caribbean_netherlands,North America,26677,8,249
2021-01-06,caribbean_netherlands,North America,26677,24,273
2021-01-07,caribbean_netherlands,North America,26677,5,278
2021-01-08,caribbean_netherlands,North America,26677,26,304
2021-01-09,caribbean_netherlands,North America,26677,1,305
2021-01-10,caribbean_netherlands,North America,26677,4,309
2021-01-11,caribbean_netherlands,North America,26677,25,334
2021-01-12,caribbean_netherlands,North America,26677,5,339
2021-01-13,caribbean_netherlands,North America,26677,3,342
2021-01-14,caribbean_netherlands,North America,26677,11,353
2021-01-15,caribbean_netherlands,North America,26677,7,360
2021-01-16,caribbean_netherlands,North America,26677,0,360
2021-01-17,caribbean_netherlands,North America,26677,0,360
2021-01-18,caribbean_netherlands,North America,26677,0,360
2021-01-19,caribbean_netherlands,North America,26677,0,360
2021-01-20,caribbean_netherlands,North America,26677,0,360
2021-01-21,caribbean_netherlands,North America,26677,0,360
2021-01-22,caribbean_netherlands,North America,26677,0,360
2021-01-23,caribbean_netherlands,North America,26677,0,360
2021-01-24,caribbean_netherlands,North America,26677,0,360
2021-01-25,caribbean_netherlands,North America,26677,0,360
2021-01-26,caribbean_netherlands,North America,26677,0,360
2021-01-27,caribbean_netherlands,North America,26677,0,360
2021-01-28,caribbean_netherlands,North America,26677,0,360
2021-01-29,caribbean_netherlands,North America,26677,0,360
2021-01-30,caribbean_netherlands,North America,26677,0,360
2021-01-31,caribbean_netherlands,North America,26677,0,360
2021-02-01,caribbean_netherlands,North America,26677,0,360
2021-02-02,caribbean_netherlands,North America,26677,0,360
2021-02-03,caribbean_netherlands,North America,26677,0,360
2021-02-04,caribbean_netherlands,North America,26677,0,360
2021-02-05,caribbean_netherlands,North America,26677,0,360
2021-02-06,caribbean_netherlands,North America,26677,0,360
2021-02-07,caribbean_netherlands,North America,26677,0,360
2021-02-08,caribbean_netherlands,North America,26677,0,360
2021-02-09,caribbean_netherlands,North America,26677,0,360
2021-02-10,caribbean_netherlands,North America,26677,0,360
2021-02-11,caribbean_netherlands,North America,26677,0,360
2021-02-12,caribbean_netherlands,North America,26677,0,360
2021-02-13,caribbean_netherlands,North America,26677,0,360
2021-02-14,caribbean_netherlands,North America,26677,0,360
2021-02-15,caribbean_netherlands,North America,26677,0,360
2021-02-16,caribbean_netherlands,North America,26677,0,360
2021-02-17,caribbean_netherlands,North America,26677,0,360
2021-02-18,caribbean_netherlands,North America,26677,0,360
2021-02-19,caribbean_netherlands,North America,26677,0,360
2021-02-20,caribbean_netherlands,North America,26677,0,360
2021-02-21,caribbean_netherlands,North America,26677,0,360
2021-02-22,caribbean_netherlands,North America,26677,69,429
2021-02-23,caribbean_netherlands,North America,26677,0,429
2021-02-24,caribbean_netherlands,North America,26677,0,429
2021-02-25,caribbean_netherlands,North America,26677,0,429
2021-02-26,caribbean_netherlands,North America,26677,0,429
2021-02-27,caribbean_netherlands,North America,26677,0,429
2021-02-28,caribbean_netherlands,North America,26677,0,429
2021-03-01,caribbean_netherlands,North America,26677,0,429
2021-03-02,caribbean_netherlands,North America,26677,0,429
2021-03-03,caribbean_netherlands,North America,26677,0,429
2021-03-04,caribbean_netherlands,North America,26677,0,429
2021-03-05,caribbean_netherlands,North America,26677,69,498
2021-03-06,caribbean_netherlands,North America,26677,20,518
2021-03-07,caribbean_netherlands,North America,26677,0,518
2021-03-08,caribbean_netherlands,North America,26677,22,540
2021-03-09,caribbean_netherlands,North America,26677,47,587
2021-03-10,caribbean_netherlands,North America,26677,35,622
2021-03-11,caribbean_netherlands,North America,26677,37,659
2021-03-12,caribbean_netherlands,North America,26677,30,689
2021-03-13,caribbean_netherlands,North America,26677,43,732
2021-03-14,caribbean_netherlands,North America,26677,31,763
2021-03-15,caribbean_netherlands,North America,26677,41,804
2021-03-16,caribbean_netherlands,North America,26677,62,866
2021-03-17,caribbean_netherlands,North America,26677,39,905
2021-03-18,caribbean_netherlands,North America,26677,40,945
2021-03-19,caribbean_netherlands,North America,26677,42,987
2021-03-20,caribbean_netherlands,North America,26677,57,1044
2021-03-21,caribbean_netherlands,North America,26677,27,1071
2021-03-22,caribbean_netherlands,North America,26677,47,1118
2021-03-23,caribbean_netherlands,North America,26677,1,1119
2021-03-24,caribbean_netherlands,North America,26677,73,1192
2021-03-25,caribbean_netherlands,North America,26677,55,1247
2021-03-26,caribbean_netherlands,North America,26677,17,1264
2021-03-27,caribbean_netherlands,North America,26677,36,1300
2021-03-28,caribbean_netherlands,North America,26677,25,1325
2021-03-29,caribbean_netherlands,North America,26677,0,1325
2021-03-30,caribbean_netherlands,North America,26677,43,1368
2021-03-31,caribbean_netherlands,North America,26677,25,1393
2021-04-01,caribbean_netherlands,North America,26677,18,1411
2021-04-02,caribbean_netherlands,North America,26677,18,1429
2021-04-03,caribbean_netherlands,North America,26677,24,1453
2021-04-04,caribbean_netherlands,North America,26677,9,1462
2021-04-05,caribbean_netherlands,North America,26677,6,1468
2021-04-06,caribbean_netherlands,North America,26677,10,1478
2021-04-07,caribbean_netherlands,North America,26677,0,1478
2021-04-08,caribbean_netherlands,North America,26677,23,1501
2021-04-09,caribbean_netherlands,North America,26677,10,1511
2021-04-10,caribbean_netherlands,North America,26677,5,1516
2021-04-11,caribbean_netherlands,North America,26677,3,1519
2021-04-12,caribbean_netherlands,North America,26677,0,1519
2021-04-13,caribbean_netherlands,North America,26677,7,1526
2021-04-14,caribbean_netherlands,North America,26677,0,1526
2021-04-15,caribbean_netherlands,North America,26677,3,1529
2021-04-16,caribbean_netherlands,North America,26677,12,1541
2021-04-17,caribbean_netherlands,North America,26677,5,1546
2021-04-18,caribbean_netherlands,North America,26677,1,1547
2021-04-19,caribbean_netherlands,North America,26677,1,1548
2021-04-20,caribbean_netherlands,North America,26677,0,1548
2021-04-21,caribbean_netherlands,North America,26677,5,1553
2021-04-22,caribbean_netherlands,North America,26677,0,1553
2021-04-23,caribbean_netherlands,North America,26677,0,1553
2021-04-24,caribbean_netherlands,North America,26677,1,1554
2021-04-25,caribbean_netherlands,North America,26677,0,1554
2021-04-26,caribbean_netherlands,North America,26677,0,1554
2021-04-27,caribbean_netherlands,North America,26677,2,1556
2021-04-28,caribbean_netherlands,North America,26677,0,1556
2021-04-29,caribbean_netherlands,North America,26677,1,1557
2021-04-30,caribbean_netherlands,North America,26677,1,1558
2021-05-01,caribbean_netherlands,North America,26677,1,1559
2021-05-02,caribbean_netherlands,North America,26677,0,1559
2021-05-03,caribbean_netherlands,North America,26677,1,1560
2021-05-04,caribbean_netherlands,North America,26677,0,1560
2021-05-05,caribbean_netherlands,North America,26677,7,1567
2021-05-06,caribbean_netherlands,North America,26677,6,1573
2021-05-07,caribbean_netherlands,North America,26677,4,1577
2021-05-08,caribbean_netherlands,North America,26677,3,1580
2021-05-09,caribbean_netherlands,North America,26677,1,1581
2021-05-10,caribbean_netherlands,North America,26677,1,1582
2021-05-11,caribbean_netherlands,North America,26677,1,1583
2021-05-12,caribbean_netherlands,North America,26677,0,1583
2021-05-13,caribbean_netherlands,North America,26677,7,1590
2021-05-14,caribbean_netherlands,North America,26677,1,1591
2021-05-15,caribbean_netherlands,North America,26677,3,1594
2021-05-16,caribbean_netherlands,North America,26677,3,1597
2021-05-17,caribbean_netherlands,North America,26677,2,1599
2021-05-18,caribbean_netherlands,North America,26677,5,1604
2021-05-19,caribbean_netherlands,North America,26677,1,1605
2021-05-20,caribbean_netherlands,North America,26677,1,1606
2021-05-21,caribbean_netherlands,North America,26677,1,1607
2021-05-22,caribbean_netherlands,North America,26677,1,1608
2021-05-23,caribbean_netherlands,North America,26677,1,1609
2021-05-24,caribbean_netherlands,North America,26677,0,1609
2021-05-25,caribbean_netherlands,North America,26677,1,1610
2021-05-26,caribbean_netherlands,North America,26677,0,1610
2021-05-27,caribbean_netherlands,North America,26677,0,1610
2021-05-28,caribbean_netherlands,North America,26677,2,1612
2021-05-29,caribbean_netherlands,North America,26677,0,1612
2021-05-30,caribbean_netherlands,North America,26677,0,1612
2021-05-31,caribbean_netherlands,North America,26677,1,1613
2021-06-01,caribbean_netherlands,North America,26677,1,1614
2021-06-02,caribbean_netherlands,North America,26677,1,1615
2021-06-03,caribbean_netherlands,North America,26677,0,1615
2021-06-04,caribbean_netherlands,North America,26677,0,1615
2021-06-05,caribbean_netherlands,North America,26677,0,1615
2021-06-06,caribbean_netherlands,North America,26677,1,1616
2021-06-07,caribbean_netherlands,North America,26677,0,1616
2021-06-08,caribbean_netherlands,North America,26677,0,1616
2021-06-09,caribbean_netherlands,North America,26677,0,1616
2021-06-10,caribbean_netherlands,North America,26677,1,1617
2021-06-11,caribbean_netherlands,North America,26677,1,1618
2021-06-12,caribbean_netherlands,North America,26677,2,1620
2021-06-13,caribbean_netherlands,North America,26677,0,1620
2021-06-14,caribbean_netherlands,North America,26677,0,1620
2021-06-15,caribbean_netherlands,North America,26677,4,1624
2021-06-16,caribbean_netherlands,North America,26677,4,1628
2021-06-17,caribbean_netherlands,North America,26677,2,1630
2021-06-18,caribbean_netherlands,North America,26677,0,1630
2021-06-19,caribbean_netherlands,North America,26677,1,1631
2021-06-20,caribbean_netherlands,North America,26677,2,1633
2021-06-21,caribbean_netherlands,North America,26677,1,1634
2021-06-22,caribbean_netherlands,North America,26677,1,1635
2021-06-23,caribbean_netherlands,North America,26677,0,1635
2021-06-24,caribbean_netherlands,North America,26677,0,1635
2021-06-25,caribbean_netherlands,North America,26677,1,1636
2021-06-26,caribbean_netherlands,North America,26677,3,1639
2021-06-27,caribbean_netherlands,North America,26677,1,1640
2021-06-28,caribbean_netherlands,North America,26677,0,1640
2021-06-29,caribbean_netherlands,North America,26677,6,1646
2021-06-30,caribbean_netherlands,North America,26677,3,1649
2021-07-01,caribbean_netherlands,North America,26677,1,1650
2021-07-02,caribbean_netherlands,North America,26677,1,1651
2021-07-03,caribbean_netherlands,North America,26677,0,1651
2021-07-04,caribbean_netherlands,North America,26677,0,1651
2021-07-05,caribbean_netherlands,North America,26677,1,1652
2021-07-06,caribbean_netherlands,North America,26677,0,1652
2021-07-07,caribbean_netherlands,North America,26677,0,1652
2021-07-08,caribbean_netherlands,North America,26677,2,1654
2021-07-09,caribbean_netherlands,North America,26677,2,1656
2021-07-10,caribbean_netherlands,North America,26677,2,1658
2021-07-11,caribbean_netherlands,North America,26677,1,1659
2021-07-12,caribbean_netherlands,North America,26677,1,1660
2021-07-13,caribbean_netherlands,North America,26677,1,1661
2021-07-14,caribbean_netherlands,North America,26677,0,1661
2021-07-15,caribbean_netherlands,North America,26677,0,1661
2021-07-16,caribbean_netherlands,North America,26677,3,1664
2021-07-17,caribbean_netherlands,North America,26677,4,1668
2021-07-18,caribbean_netherlands,North America,26677,4,1672
2021-07-19,caribbean_netherlands,North America,26677,7,1679
2021-07-20,caribbean_netherlands,North America,26677,4,1683
2021-07-21,caribbean_netherlands,North America,26677,3,1686
2021-07-22,caribbean_netherlands,North America,26677,4,1690
2021-07-23,caribbean_netherlands,North America,26677,1,1691
2021-07-24,caribbean_netherlands,North America,26677,1,1692
2021-07-25,caribbean_netherlands,North America,26677,1,1693
2021-07-26,caribbean_netherlands,North America,26677,0,1693
2021-07-27,caribbean_netherlands,North America,26677,4,1697
2021-07-28,caribbean_netherlands,North America,26677,6,1703
2021-07-29,caribbean_netherlands,North America,26677,2,1705
2021-07-30,caribbean_netherlands,North America,26677,2,1707
2021-07-31,caribbean_netherlands,North America,26677,0,1707
2021-08-01,caribbean_netherlands,North America,26677,3,1710
2021-08-02,caribbean_netherlands,North America,26677,0,1710
2021-08-03,caribbean_netherlands,North America,26677,0,1710
2021-08-04,caribbean_netherlands,North America,26677,0,1710
2021-08-05,caribbean_netherlands,North America,26677,3,1713
2021-08-06,caribbean_netherlands,North America,26677,2,1715
2021-08-07,caribbean_netherlands,North America,26677,5,1720
2021-08-08,caribbean_netherlands,North America,26677,4,1724
2021-08-09,caribbean_netherlands,North America,26677,1,1725
2021-08-10,caribbean_netherlands,North America,26677,4,1729
2021-08-11,caribbean_netherlands,North America,26677,8,1737
2021-08-12,caribbean_netherlands,North America,26677,1,1738
2021-08-13,caribbean_netherlands,North America,26677,3,1741
2021-08-14,caribbean_netherlands,North America,26677,0,1741
2021-08-15,caribbean_netherlands,North America,26677,13,1754
2021-08-16,caribbean_netherlands,North America,26677,2,1756
2021-08-17,caribbean_netherlands,North America,26677,0,1756
2021-08-18,caribbean_netherlands,North America,26677,5,1761
2021-08-19,caribbean_netherlands,North America,26677,4,1765
2021-08-20,caribbean_netherlands,North America,26677,2,1767
2021-08-21,caribbean_netherlands,North America,26677,1,1768
2021-08-22,caribbean_netherlands,North America,26677,6,1774
2021-08-23,caribbean_netherlands,North America,26677,2,1776
2021-08-24,caribbean_netherlands,North America,26677,3,1779
2021-08-25,caribbean_netherlands,North America,26677,1,1780
2021-08-26,caribbean_netherlands,North America,26677,3,1783
2021-08-27,caribbean_netherlands,North America,26677,2,1785
2021-08-28,caribbean_netherlands,North America,26677,1,1786
2021-08-29,caribbean_netherlands,North America,26677,1,1787
2021-08-30,caribbean_netherlands,North America,26677,4,1791
2021-08-31,caribbean_netherlands,North America,26677,0,1791
2021-09-01,caribbean_netherlands,North America,26677,2,1793
2021-09-02,caribbean_netherlands,North America,26677,7,1800
2021-09-03,caribbean_netherlands,North America,26677,8,1808
2021-09-04,caribbean_netherlands,North America,26677,11,1819
2021-09-05,caribbean_netherlands,North America,26677,18,1837
2021-09-06,caribbean_netherlands,North America,26677,13,1850
2021-09-07,caribbean_netherlands,North America,26677,13,1863
2021-09-08,caribbean_netherlands,North America,26677,22,1885
2021-09-09,caribbean_netherlands,North America,26677,10,1895
2021-09-10,caribbean_netherlands,North America,26677,13,1908
2021-09-11,caribbean_netherlands,North America,26677,20,1928
2021-09-12,caribbean_netherlands,North America,26677,4,1932
2021-09-13,caribbean_netherlands,North America,26677,0,1932
2021-09-14,caribbean_netherlands,North America,26677,13,1945
2021-09-15,caribbean_netherlands,North America,26677,4,1949
2021-09-16,caribbean_netherlands,North America,26677,7,1956
2021-09-17,caribbean_netherlands,North America,26677,6,1962
2021-09-18,caribbean_netherlands,North America,26677,7,1969
2021-09-19,caribbean_netherlands,North America,26677,3,1972
2021-09-20,caribbean_netherlands,North America,26677,2,1974
2021-09-21,caribbean_netherlands,North America,26677,6,1980
2021-09-22,caribbean_netherlands,North America,26677,8,1988
2021-09-23,caribbean_netherlands,North America,26677,10,1998
2021-09-24,caribbean_netherlands,North America,26677,5,2003
2021-09-25,caribbean_netherlands,North America,26677,7,2010
2021-09-26,caribbean_netherlands,North America,26677,9,2019
2021-09-27,caribbean_netherlands,North America,26677,26,2045
2021-09-28,caribbean_netherlands,North America,26677,23,2068
2021-09-29,caribbean_netherlands,North America,26677,15,2083
2021-09-30,caribbean_netherlands,North America,26677,13,2096
2021-10-01,caribbean_netherlands,North America,26677,20,2116
2021-10-02,caribbean_netherlands,North America,26677,10,2126
2021-10-03,caribbean_netherlands,North America,26677,15,2141
2021-10-04,caribbean_netherlands,North America,26677,16,2157
2021-10-05,caribbean_netherlands,North America,26677,11,2168
2021-10-06,caribbean_netherlands,North America,26677,16,2184
2021-10-07,caribbean_netherlands,North America,26677,20,2204
2021-10-08,caribbean_netherlands,North America,26677,13,2217
2021-10-09,caribbean_netherlands,North America,26677,13,2230
2021-10-10,caribbean_netherlands,North America,26677,5,2235
2021-10-11,caribbean_netherlands,North America,26677,22,2257
2021-10-12,caribbean_netherlands,North America,26677,17,2274
2021-10-13,caribbean_netherlands,North America,26677,16,2290
2021-10-14,caribbean_netherlands,North America,26677,16,2306
2021-10-15,caribbean_netherlands,North America,26677,6,2312
2021-10-16,caribbean_netherlands,North America,26677,13,2325
2021-10-17,caribbean_netherlands,North America,26677,10,2335
2021-10-18,caribbean_netherlands,North America,26677,6,2341
2021-10-19,caribbean_netherlands,North America,26677,12,2353
2021-10-20,caribbean_netherlands,North America,26677,12,2365
2021-10-21,caribbean_netherlands,North America,26677,8,2373
2021-10-22,caribbean_netherlands,North America,26677,6,2379
2021-10-23,caribbean_netherlands,North America,26677,4,2383
2021-10-24,caribbean_netherlands,North America,26677,5,2388
2021-10-25,caribbean_netherlands,North America,26677,2,2390
2021-10-26,caribbean_netherlands,North America,26677,12,2402
2021-10-27,caribbean_netherlands,North America,26677,5,2407
2021-10-28,caribbean_netherlands,North America,26677,4,2411
2021-10-29,caribbean_netherlands,North America,26677,6,2417
2021-10-30,caribbean_netherlands,North America,26677,15,2432
2021-10-31,caribbean_netherlands,North America,26677,3,2435
2021-11-01,caribbean_netherlands,North America,26677,9,2444
2021-11-02,caribbean_netherlands,North America,26677,11,2455
2021-11-03,caribbean_netherlands,North America,26677,0,2455
2021-11-04,caribbean_netherlands,North America,26677,13,2468
2021-11-05,caribbean_netherlands,North America,26677,17,2485
2021-11-06,caribbean_netherlands,North America,26677,9,2494
2021-11-07,caribbean_netherlands,North America,26677,7,2501
2021-11-08,caribbean_netherlands,North America,26677,10,2511
2021-11-09,caribbean_netherlands,North America,26677,35,2546
2021-11-10,caribbean_netherlands,North America,26677,26,2572
2021-11-11,caribbean_netherlands,North America,26677,12,2584
2021-11-12,caribbean_netherlands,North America,26677,13,2597
2021-11-13,caribbean_netherlands,North America,26677,19,2616
2021-11-14,caribbean_netherlands,North America,26677,12,2628
2021-11-15,caribbean_netherlands,North America,26677,5,2633
2021-11-16,caribbean_netherlands,North America,26677,0,2633
2021-11-17,caribbean_netherlands,North America,26677,10,2643
2021-11-18,caribbean_netherlands,North America,26677,17,2660
2021-11-19,caribbean_netherlands,North America,26677,19,2679
2021-11-20,caribbean_netherlands,North America,26677,19,2698
2021-11-21,caribbean_netherlands,North America,26677,16,2714
2021-11-22,caribbean_netherlands,North America,26677,0,2714
2021-11-23,caribbean_netherlands,North America,26677,49,2763
2021-11-24,caribbean_netherlands,North America,26677,39,2802
2021-11-25,caribbean_netherlands,North America,26677,23,2825
2021-11-26,caribbean_netherlands,North America,26677,33,2858
2021-11-27,caribbean_netherlands,North America,26677,11,2869
2021-11-28,caribbean_netherlands,North America,26677,20,2889
2021-11-29,caribbean_netherlands,North America,26677,16,2905
2021-11-30,caribbean_netherlands,North America,26677,33,2938
2021-12-01,caribbean_netherlands,North America,26677,32,2970
2021-12-02,caribbean_netherlands,North America,26677,27,2997
2021-12-03,caribbean_netherlands,North America,26677,29,3026
2021-12-04,caribbean_netherlands,North America,26677,0,3026
2021-12-05,caribbean_netherlands,North America,26677,14,3040
2021-12-06,caribbean_netherlands,North America,26677,17,3057
2021-12-07,caribbean_netherlands,North America,26677,16,3073
2021-12-08,caribbean_netherlands,North America,26677,9,3082
2021-12-09,caribbean_netherlands,North America,26677,27,3109
2021-12-10,caribbean_netherlands,North America,26677,10,3119
2021-12-11,caribbean_netherlands,North America,26677,10,3129
2021-12-12,caribbean_netherlands,North America,26677,9,3138
2021-12-13,caribbean_netherlands,North America,26677,6,3144
2021-12-14,caribbean_netherlands,North America,26677,12,3156
2021-12-15,caribbean_netherlands,North America,26677,6,3162
2021-12-16,caribbean_netherlands,North America,26677,13,3175
2021-12-17,caribbean_netherlands,North America,26677,4,3179
2021-12-18,caribbean_netherlands,North America,26677,14,3193
2021-12-19,caribbean_netherlands,North America,26677,11,3204
2021-12-20,caribbean_netherlands,North America,26677,9,3213
2021-12-21,caribbean_netherlands,North America,26677,5,3218
2021-12-22,caribbean_netherlands,North America,26677,18,3236
2021-12-23,caribbean_netherlands,North America,26677,9,3245
2021-12-24,caribbean_netherlands,North America,26677,9,3254
2021-12-25,caribbean_netherlands,North America,26677,18,3272
2021-12-26,caribbean_netherlands,North America,26677,5,3277
2021-12-27,caribbean_netherlands,North America,26677,11,3288
2021-12-28,caribbean_netherlands,North America,26677,16,3304
2021-12-29,caribbean_netherlands,North America,26677,32,3336
2021-12-30,caribbean_netherlands,North America,26677,32,3368
2021-12-31,caribbean_netherlands,North America,26677,38,3406
2022-01-01,caribbean_netherlands,North America,26677,23,3429
2022-01-02,caribbean_netherlands,North America,26677,59,3488
2022-01-03,caribbean_netherlands,North America,26677,43,3531
2022-01-04,caribbean_netherlands,North America,26677,159,3690
2022-01-05,caribbean_netherlands,North America,26677,228,3918
2022-01-06,caribbean_netherlands,North America,26677,163,4081
2022-01-07,caribbean_netherlands,North America,26677,215,4296
2022-01-08,caribbean_netherlands,North America,26677,99,4395
2022-01-09,caribbean_netherlands,North America,26677,0,4395
2022-01-10,caribbean_netherlands,North America,26677,256,4651
2022-01-11,caribbean_netherlands,North America,26677,104,4755
2022-01-12,caribbean_netherlands,North America,26677,153,4908
2022-01-13,caribbean_netherlands,North America,26677,156,5064
2022-01-14,caribbean_netherlands,North America,26677,261,5325
2022-01-15,caribbean_netherlands,North America,26677,113,5438
2022-01-16,caribbean_netherlands,North America,26677,123,5561
2022-01-17,caribbean_netherlands,North America,26677,88,5649
2022-01-18,caribbean_netherlands,North America,26677,67,5716
2022-01-19,caribbean_netherlands,North America,26677,108,5824
2022-01-20,caribbean_netherlands,North America,26677,122,5946
2022-01-21,caribbean_netherlands,North America,26677,234,6180
2022-01-22,caribbean_netherlands,North America,26677,100,6280
2022-01-23,caribbean_netherlands,North America,26677,139,6419
2022-01-24,caribbean_netherlands,North America,26677,88,6507
2022-01-25,caribbean_netherlands,North America,26677,63,6570
2022-01-26,caribbean_netherlands,North America,26677,115,6685
2022-01-27,caribbean_netherlands,North America,26677,144,6829
2022-01-28,caribbean_netherlands,North America,26677,47,6876
2022-01-29,caribbean_netherlands,North America,26677,46,6922
2022-01-30,caribbean_netherlands,North America,26677,35,6957
2022-01-31,caribbean_netherlands,North America,26677,44,7001
2022-02-01,caribbean_netherlands,North America,26677,76,7077
2022-02-02,caribbean_netherlands,North America,26677,26,7103
2022-02-03,caribbean_netherlands,North America,26677,20,7123
2022-02-04,caribbean_netherlands,North America,26677,32,7155
2022-02-05,caribbean_netherlands,North America,26677,29,7184
2022-02-06,caribbean_netherlands,North America,26677,25,7209
2022-02-07,caribbean_netherlands,North America,26677,28,7237
2022-02-08,caribbean_netherlands,North America,26677,34,7271
2022-02-09,caribbean_netherlands,North America,26677,43,7314
2022-02-10,caribbean_netherlands,North America,26677,33,7347
2022-02-11,caribbean_netherlands,North America,26677,20,7367
2022-02-12,caribbean_netherlands,North America,26677,26,7393
2022-02-13,caribbean_netherlands,North America,26677,13,7406
2022-02-14,caribbean_netherlands,North America,26677,18,7424
2022-02-15,caribbean_netherlands,North America,26677,20,7444
2022-02-16,caribbean_netherlands,North America,26677,11,7455
2022-02-17,caribbean_netherlands,North America,26677,17,7472
2022-02-18,caribbean_netherlands,North America,26677,17,7489
2022-02-19,caribbean_netherlands,North America,26677,19,7508
2022-02-20,caribbean_netherlands,North America,26677,6,7514
2022-02-21,caribbean_netherlands,North America,26677,14,7528
2022-02-22,caribbean_netherlands,North America,26677,14,7542
2022-02-23,caribbean_netherlands,North America,26677,6,7548
2022-02-24,caribbean_netherlands,North America,26677,13,7561
2022-02-25,caribbean_netherlands,North America,26677,3,7564
2022-02-26,caribbean_netherlands,North America,26677,0,7564
2022-02-27,caribbean_netherlands,North America,26677,0,7564
2022-02-28,caribbean_netherlands,North America,26677,11,7575
2022-03-01,caribbean_netherlands,North America,26677,18,7593
2022-03-02,caribbean_netherlands,North America,26677,6,7599
2022-03-03,caribbean_netherlands,North America,26677,6,7605
2022-03-04,caribbean_netherlands,North America,26677,4,7609
2022-03-05,caribbean_netherlands,North America,26677,3,7612
2022-03-06,caribbean_netherlands,North America,26677,0,7612
2022-03-07,caribbean_netherlands,North America,26677,2,7614
2022-03-08,caribbean_netherlands,North America,26677,0,7614
2022-03-09,caribbean_netherlands,North America,26677,0,7614
2022-03-10,caribbean_netherlands,North America,26677,0,7614
2022-03-11,caribbean_netherlands,North America,26677,0,7614
2022-03-12,caribbean_netherlands,North America,26677,0,7614
2022-03-13,caribbean_netherlands,North America,26677,0,7614
2022-03-14,caribbean_netherlands,North America,26677,39,7653
2022-03-15,caribbean_netherlands,North America,26677,86,7739
2022-03-16,caribbean_netherlands,North America,26677,0,7739
2022-03-17,caribbean_netherlands,North America,26677,0,7739
2022-03-18,caribbean_netherlands,North America,26677,0,7739
2022-03-19,caribbean_netherlands,North America,26677,0,7739
2022-03-20,caribbean_netherlands,North America,26677,0,7739
2022-03-21,caribbean_netherlands,North America,26677,300,8039
2022-03-22,caribbean_netherlands,North America,26677,0,8039
2020-05-24,central_african_republic,Africa,4986136,52,604
2020-05-25,central_african_republic,Africa,4986136,48,652
2020-05-26,central_african_republic,Africa,4986136,19,671
2020-05-27,central_african_republic,Africa,4986136,31,702
2020-05-28,central_african_republic,Africa,4986136,53,755
2020-05-29,central_african_republic,Africa,4986136,119,874
2020-05-30,central_african_republic,Africa,4986136,88,962
2020-05-31,central_african_republic,Africa,4986136,49,1011
2020-06-01,central_african_republic,Africa,4986136,58,1069
2020-06-02,central_african_republic,Africa,4986136,0,1069
2020-06-03,central_african_republic,Africa,4986136,104,1173
2020-06-04,central_african_republic,Africa,4986136,115,1288
2020-06-05,central_african_republic,Africa,4986136,163,1451
2020-06-06,central_african_republic,Africa,4986136,119,1570
2020-06-07,central_african_republic,Africa,4986136,64,1634
2020-06-08,central_african_republic,Africa,4986136,216,1850
2020-06-09,central_african_republic,Africa,4986136,0,1850
2020-06-10,central_african_republic,Africa,4986136,38,1888
2020-06-11,central_african_republic,Africa,4986136,64,1952
2020-06-12,central_african_republic,Africa,4986136,92,2044
2020-06-13,central_african_republic,Africa,4986136,13,2057
2020-06-14,central_african_republic,Africa,4986136,0,2057
2020-06-15,central_african_republic,Africa,4986136,165,2222
2020-06-16,central_african_republic,Africa,4986136,188,2410
2020-06-17,central_african_republic,Africa,4986136,154,2564
2020-06-18,central_african_republic,Africa,4986136,41,2605
2020-06-19,central_african_republic,Africa,4986136,0,2605
2020-06-20,central_african_republic,Africa,4986136,81,2686
2020-06-21,central_african_republic,Africa,4986136,122,2808
2020-06-22,central_african_republic,Africa,4986136,155,2963
2020-06-23,central_african_republic,Africa,4986136,88,3051
2020-06-24,central_african_republic,Africa,4986136,48,3099
2020-06-25,central_african_republic,Africa,4986136,145,3244
2020-06-26,central_african_republic,Africa,4986136,96,3340
2020-06-27,central_african_republic,Africa,4986136,89,3429
2020-06-28,central_african_republic,Africa,4986136,102,3531
2020-06-29,central_african_republic,Africa,4986136,82,3613
2020-06-30,central_african_republic,Africa,4986136,132,3745
2020-07-01,central_african_republic,Africa,4986136,0,3745
2020-07-02,central_african_republic,Africa,4986136,43,3788
2020-07-03,central_african_republic,Africa,4986136,130,3918
2020-07-04,central_african_republic,Africa,4986136,51,3969
2020-07-05,central_african_republic,Africa,4986136,0,3969
2020-07-06,central_african_republic,Africa,4986136,64,4033
2020-07-07,central_african_republic,Africa,4986136,38,4071
2020-07-08,central_african_republic,Africa,4986136,38,4109
2020-07-09,central_african_republic,Africa,4986136,91,4200
2020-07-10,central_african_republic,Africa,4986136,59,4259
2020-07-11,central_african_republic,Africa,4986136,29,4288
2020-07-12,central_african_republic,Africa,4986136,0,4288
2020-07-13,central_african_republic,Africa,4986136,33,4321
2020-07-14,central_african_republic,Africa,4986136,35,4356
2020-07-15,central_african_republic,Africa,4986136,6,4362
2020-07-16,central_african_republic,Africa,4986136,11,4373
2020-07-17,central_african_republic,Africa,4986136,16,4389
2020-07-18,central_african_republic,Africa,4986136,96,4485
2020-07-19,central_african_republic,Africa,4986136,0,4485
2020-07-20,central_african_republic,Africa,4986136,63,4548
2020-07-21,central_african_republic,Africa,4986136,13,4561
2020-07-22,central_african_republic,Africa,4986136,13,4574
2020-07-23,central_african_republic,Africa,4986136,16,4590
2020-07-24,central_african_republic,Africa,4986136,3,4593
2020-07-25,central_african_republic,Africa,4986136,5,4598
2020-07-26,central_african_republic,Africa,4986136,1,4599
2020-07-27,central_african_republic,Africa,4986136,0,4599
2020-07-28,central_african_republic,Africa,4986136,0,4599
2020-07-29,central_african_republic,Africa,4986136,6,4605
2020-07-30,central_african_republic,Africa,4986136,0,4605
2020-07-31,central_african_republic,Africa,4986136,3,4608
2020-08-01,central_african_republic,Africa,4986136,6,4614
2020-08-02,central_african_republic,Africa,4986136,0,4614
2020-08-03,central_african_republic,Africa,4986136,0,4614
2020-08-04,central_african_republic,Africa,4986136,4,4618
2020-08-05,central_african_republic,Africa,4986136,0,4618
2020-08-06,central_african_republic,Africa,4986136,2,4620
2020-08-07,central_african_republic,Africa,4986136,21,4641
2020-08-08,central_african_republic,Africa,4986136,0,4641
2020-08-09,central_african_republic,Africa,4986136,0,4641
2020-08-10,central_african_republic,Africa,4986136,0,4641
2020-08-11,central_african_republic,Africa,4986136,4,4645
2020-08-12,central_african_republic,Africa,4986136,7,4652
2020-08-13,central_african_republic,Africa,4986136,0,4652
2020-08-14,central_african_republic,Africa,4986136,0,4652
2020-08-15,central_african_republic,Africa,4986136,0,4652
2020-08-16,central_african_republic,Africa,4986136,0,4652
2020-08-17,central_african_republic,Africa,4986136,15,4667
2020-08-18,central_african_republic,Africa,4986136,12,4679
2020-08-19,central_african_republic,Africa,4986136,0,4679
2020-08-20,central_african_republic,Africa,4986136,0,4679
2020-08-21,central_african_republic,Africa,4986136,0,4679
2020-08-22,central_african_republic,Africa,4986136,0,4679
2020-08-23,central_african_republic,Africa,4986136,0,4679
2020-08-24,central_african_republic,Africa,4986136,0,4679
2020-08-25,central_african_republic,Africa,4986136,12,4691
2020-08-26,central_african_republic,Africa,4986136,7,4698
2020-08-27,central_african_republic,Africa,4986136,0,4698
2020-08-28,central_african_republic,Africa,4986136,2,4700
2020-08-29,central_african_republic,Africa,4986136,0,4700
2020-08-30,central_african_republic,Africa,4986136,0,4700
2020-08-31,central_african_republic,Africa,4986136,11,4711
2020-09-01,central_african_republic,Africa,4986136,0,4711
2020-09-02,central_african_republic,Africa,4986136,1,4712
2020-09-03,central_african_republic,Africa,4986136,17,4729
2020-09-04,central_african_republic,Africa,4986136,0,4729
2020-09-05,central_african_republic,Africa,4986136,0,4729
2020-09-06,central_african_republic,Africa,4986136,0,4729
2020-09-07,central_african_republic,Africa,4986136,0,4729
2020-09-08,central_african_republic,Africa,4986136,6,4735
2020-09-09,central_african_republic,Africa,4986136,1,4736
2020-09-10,central_african_republic,Africa,4986136,11,4747
2020-09-11,central_african_republic,Africa,4986136,2,4749
2020-09-12,central_african_republic,Africa,4986136,0,4749
2020-09-13,central_african_republic,Africa,4986136,0,4749
2020-09-14,central_african_republic,Africa,4986136,23,4772
2020-09-15,central_african_republic,Africa,4986136,3,4775
2020-09-16,central_african_republic,Africa,4986136,7,4782
2020-09-17,central_african_republic,Africa,4986136,0,4782
2020-09-18,central_african_republic,Africa,4986136,4,4786
2020-09-19,central_african_republic,Africa,4986136,0,4786
2020-09-20,central_african_republic,Africa,4986136,0,4786
2020-09-21,central_african_republic,Africa,4986136,0,4786
2020-09-22,central_african_republic,Africa,4986136,16,4802
2020-09-23,central_african_republic,Africa,4986136,0,4802
2020-09-24,central_african_republic,Africa,4986136,2,4804
2020-09-25,central_african_republic,Africa,4986136,2,4806
2020-09-26,central_african_republic,Africa,4986136,0,4806
2020-09-27,central_african_republic,Africa,4986136,0,4806
2020-09-28,central_african_republic,Africa,4986136,0,4806
2020-09-29,central_african_republic,Africa,4986136,0,4806
2020-09-30,central_african_republic,Africa,4986136,23,4829
2020-10-01,central_african_republic,Africa,4986136,0,4829
2020-10-02,central_african_republic,Africa,4986136,0,4829
2020-10-03,central_african_republic,Africa,4986136,16,4845
2020-10-04,central_african_republic,Africa,4986136,0,4845
2020-10-05,central_african_republic,Africa,4986136,0,4845
2020-10-06,central_african_republic,Africa,4986136,7,4852
2020-10-07,central_african_republic,Africa,4986136,0,4852
2020-10-08,central_african_republic,Africa,4986136,1,4853
2020-10-09,central_african_republic,Africa,4986136,0,4853
2020-10-10,central_african_republic,Africa,4986136,1,4854
2020-10-11,central_african_republic,Africa,4986136,0,4854
2020-10-12,central_african_republic,Africa,4986136,0,4854
2020-10-13,central_african_republic,Africa,4986136,0,4854
2020-10-14,central_african_republic,Africa,4986136,1,4855
2020-10-15,central_african_republic,Africa,4986136,0,4855
2020-10-16,central_african_republic,Africa,4986136,0,4855
2020-10-17,central_african_republic,Africa,4986136,0,4855
2020-10-18,central_african_republic,Africa,4986136,0,4855
2020-10-19,central_african_republic,Africa,4986136,1,4856
2020-10-20,central_african_republic,Africa,4986136,2,4858
2020-10-21,central_african_republic,Africa,4986136,0,4858
2020-10-22,central_african_republic,Africa,4986136,4,4862
2020-10-23,central_african_republic,Africa,4986136,0,4862
2020-10-24,central_african_republic,Africa,4986136,0,4862
2020-10-25,central_african_republic,Africa,4986136,0,4862
2020-10-26,central_african_republic,Africa,4986136,1,4863
2020-10-27,central_african_republic,Africa,4986136,0,4863
2020-10-28,central_african_republic,Africa,4986136,0,4863
2020-04-29,chad,Africa,17303260,0,52
2020-04-30,chad,Africa,17303260,21,73
2020-05-01,chad,Africa,17303260,0,73
2020-05-02,chad,Africa,17303260,44,117
2020-05-03,chad,Africa,17303260,0,117
2020-05-04,chad,Africa,17303260,0,117
2020-05-05,chad,Africa,17303260,53,170
2020-05-06,chad,Africa,17303260,0,170
2020-05-07,chad,Africa,17303260,83,253
2020-05-08,chad,Africa,17303260,7,260
2020-05-09,chad,Africa,17303260,62,322
2020-05-10,chad,Africa,17303260,0,322
2020-05-11,chad,Africa,17303260,0,322
2020-05-12,chad,Africa,17303260,35,357
2020-05-13,chad,Africa,17303260,15,372
2020-05-14,chad,Africa,17303260,27,399
2020-05-15,chad,Africa,17303260,29,428
2020-05-16,chad,Africa,17303260,46,474
2020-05-17,chad,Africa,17303260,29,503
2020-05-18,chad,Africa,17303260,16,519
2020-05-19,chad,Africa,17303260,26,545
2020-05-20,chad,Africa,17303260,20,565
2020-05-21,chad,Africa,17303260,23,588
2020-05-22,chad,Africa,17303260,23,611
2020-05-23,chad,Africa,17303260,37,648
2020-05-24,chad,Africa,17303260,27,675
2020-05-25,chad,Africa,17303260,12,687
2020-05-26,chad,Africa,17303260,13,700
2020-05-27,chad,Africa,17303260,15,715
2020-05-28,chad,Africa,17303260,11,726
2020-05-29,chad,Africa,17303260,33,759
2020-05-30,chad,Africa,17303260,0,759
2020-05-31,chad,Africa,17303260,19,778
2020-06-01,chad,Africa,17303260,12,790
2020-06-02,chad,Africa,17303260,13,803
2020-06-03,chad,Africa,17303260,17,820
2020-06-04,chad,Africa,17303260,8,828
2020-06-05,chad,Africa,17303260,8,836
2020-06-06,chad,Africa,17303260,0,836
2020-06-07,chad,Africa,17303260,1,837
2020-06-08,chad,Africa,17303260,2,839
2020-06-09,chad,Africa,17303260,5,844
2020-06-10,chad,Africa,17303260,2,846
2020-06-11,chad,Africa,17303260,2,848
2020-06-12,chad,Africa,17303260,0,848
2020-06-13,chad,Africa,17303260,0,848
2020-06-14,chad,Africa,17303260,2,850
2020-06-15,chad,Africa,17303260,0,850
2020-06-16,chad,Africa,17303260,3,853
2020-06-17,chad,Africa,17303260,1,854
2020-06-18,chad,Africa,17303260,0,854
2020-06-19,chad,Africa,17303260,4,858
2020-06-20,chad,Africa,17303260,0,858
2020-06-21,chad,Africa,17303260,0,858
2020-06-22,chad,Africa,17303260,0,858
2020-06-23,chad,Africa,17303260,2,860
2020-06-24,chad,Africa,17303260,0,860
2020-06-25,chad,Africa,17303260,3,863
2020-06-26,chad,Africa,17303260,2,865
2020-06-27,chad,Africa,17303260,0,865
2020-06-28,chad,Africa,17303260,1,866
2020-06-29,chad,Africa,17303260,0,866
2020-06-30,chad,Africa,17303260,0,866
2020-07-01,chad,Africa,17303260,0,866
2020-07-02,chad,Africa,17303260,2,868
2020-07-03,chad,Africa,17303260,3,871
2020-07-04,chad,Africa,17303260,0,871
2020-07-05,chad,Africa,17303260,1,872
2020-07-06,chad,Africa,17303260,0,872
2020-07-07,chad,Africa,17303260,1,873
2020-07-08,chad,Africa,17303260,0,873
2020-07-09,chad,Africa,17303260,0,873
2020-07-10,chad,Africa,17303260,1,874
2020-07-11,chad,Africa,17303260,0,874
2020-07-12,chad,Africa,17303260,6,880
2020-07-13,chad,Africa,17303260,0,880
2020-07-14,chad,Africa,17303260,4,884
2020-07-15,chad,Africa,17303260,1,885
2020-07-16,chad,Africa,17303260,1,886
2020-07-17,chad,Africa,17303260,1,887
2020-07-18,chad,Africa,17303260,2,889
2020-07-19,chad,Africa,17303260,0,889
2020-07-20,chad,Africa,17303260,0,889
2020-07-21,chad,Africa,17303260,0,889
2020-07-22,chad,Africa,17303260,0,889
2020-07-23,chad,Africa,17303260,26,915
2020-07-24,chad,Africa,17303260,0,915
2020-07-25,chad,Africa,17303260,0,915
2020-07-26,chad,Africa,17303260,0,915
2020-07-27,chad,Africa,17303260,7,922
2020-07-28,chad,Africa,17303260,4,926
2020-07-29,chad,Africa,17303260,0,926
2020-07-30,chad,Africa,17303260,9,935
2020-07-31,chad,Africa,17303260,1,936
2020-08-01,chad,Africa,17303260,0,936
2020-08-02,chad,Africa,17303260,0,936
2020-08-03,chad,Africa,17303260,0,936
2020-08-04,chad,Africa,17303260,2,938
2020-08-05,chad,Africa,17303260,1,939
2020-08-06,chad,Africa,17303260,3,942
2020-08-07,chad,Africa,17303260,0,942
2020-08-08,chad,Africa,17303260,0,942
2020-08-09,chad,Africa,17303260,2,944
2020-08-10,chad,Africa,17303260,1,945
2020-08-11,chad,Africa,17303260,1,946
2020-08-12,chad,Africa,17303260,3,949
2020-08-13,chad,Africa,17303260,0,949
2020-08-14,chad,Africa,17303260,2,951
2020-08-15,chad,Africa,17303260,1,952
2020-08-16,chad,Africa,17303260,4,956
2020-08-17,chad,Africa,17303260,3,959
2020-08-18,chad,Africa,17303260,11,970
2020-08-19,chad,Africa,17303260,1,971
2020-08-20,chad,Africa,17303260,1,972
2020-08-21,chad,Africa,17303260,9,981
2020-08-22,chad,Africa,17303260,1,982
2020-08-23,chad,Africa,17303260,4,986
2020-08-24,chad,Africa,17303260,1,987
2020-08-25,chad,Africa,17303260,8,995
2020-08-26,chad,Africa,17303260,3,998
2020-08-27,chad,Africa,17303260,6,1004
2020-08-28,chad,Africa,17303260,4,1008
2020-08-29,chad,Africa,17303260,0,1008
2020-08-30,chad,Africa,17303260,4,1012
2020-08-31,chad,Africa,17303260,1,1013
2020-09-01,chad,Africa,17303260,4,1017
2020-09-02,chad,Africa,17303260,0,1017
2020-09-03,chad,Africa,17303260,1,1018
2020-09-04,chad,Africa,17303260,5,1023
2020-09-05,chad,Africa,17303260,11,1034
2020-09-06,chad,Africa,17303260,5,1039
2020-09-07,chad,Africa,17303260,1,1040
2020-09-08,chad,Africa,17303260,5,1045
2020-09-09,chad,Africa,17303260,3,1048
2020-09-10,chad,Africa,17303260,3,1051
2020-09-11,chad,Africa,17303260,30,1081
2020-09-12,chad,Africa,17303260,2,1083
2020-09-13,chad,Africa,17303260,1,1084
2020-09-14,chad,Africa,17303260,1,1085
2020-09-15,chad,Africa,17303260,2,1087
2020-09-16,chad,Africa,17303260,3,1090
2020-09-17,chad,Africa,17303260,25,1115
2020-09-18,chad,Africa,17303260,32,1147
2020-09-19,chad,Africa,17303260,2,1149
2020-09-20,chad,Africa,17303260,2,1151
2020-09-21,chad,Africa,17303260,2,1153
2020-09-22,chad,Africa,17303260,2,1155
2020-09-23,chad,Africa,17303260,9,1164
2020-09-24,chad,Africa,17303260,7,1171
2020-09-25,chad,Africa,17303260,4,1175
2020-09-26,chad,Africa,17303260,2,1177
2020-09-27,chad,Africa,17303260,1,1178
2020-09-28,chad,Africa,17303260,7,1185
2020-09-29,chad,Africa,17303260,8,1193
2020-09-30,chad,Africa,17303260,7,1200
2020-10-01,chad,Africa,17303260,3,1203
2020-10-02,chad,Africa,17303260,8,1211
2020-10-03,chad,Africa,17303260,3,1214
2020-10-04,chad,Africa,17303260,3,1217
2020-10-05,chad,Africa,17303260,6,1223
2020-10-06,chad,Africa,17303260,15,1238
2020-10-07,chad,Africa,17303260,13,1251
2020-10-08,chad,Africa,17303260,11,1262
2020-10-09,chad,Africa,17303260,12,1274
2020-10-10,chad,Africa,17303260,17,1291
2020-10-11,chad,Africa,17303260,13,1304
2020-10-12,chad,Africa,17303260,4,1308
2020-10-13,chad,Africa,17303260,13,1321
2020-10-14,chad,Africa,17303260,8,1329
2020-10-15,chad,Africa,17303260,21,1350
2020-10-16,chad,Africa,17303260,11,1361
2020-10-17,chad,Africa,17303260,4,1365
2020-10-18,chad,Africa,17303260,14,1379
2020-10-19,chad,Africa,17303260,11,1390
2020-10-20,chad,Africa,17303260,9,1399
2020-10-21,chad,Africa,17303260,5,1404
2020-10-22,chad,Africa,17303260,6,1410
2020-10-23,chad,Africa,17303260,13,1423
2020-10-24,chad,Africa,17303260,11,1434
2020-10-25,chad,Africa,17303260,3,1437
2020-10-26,chad,Africa,17303260,4,1441
2020-10-27,chad,Africa,17303260,19,1460
2020-10-28,chad,Africa,17303260,8,1468
2020-10-29,chad,Africa,17303260,5,1473
2020-10-30,chad,Africa,17303260,10,1483
2020-10-31,chad,Africa,17303260,0,1483
2020-11-01,chad,Africa,17303260,15,1498
2020-11-02,chad,Africa,17303260,1,1499
2020-11-03,chad,Africa,17303260,14,1513
2020-11-04,chad,Africa,17303260,4,1517
2020-11-05,chad,Africa,17303260,12,1529
2020-11-06,chad,Africa,17303260,9,1538
2020-11-07,chad,Africa,17303260,5,1543
2020-11-08,chad,Africa,17303260,4,1547
2020-11-09,chad,Africa,17303260,4,1551
2020-11-10,chad,Africa,17303260,10,1561
2020-11-11,chad,Africa,17303260,4,1565
2020-11-12,chad,Africa,17303260,13,1578
2020-11-13,chad,Africa,17303260,11,1589
2020-11-14,chad,Africa,17303260,2,1591
2020-11-15,chad,Africa,17303260,6,1597
2020-11-16,chad,Africa,17303260,6,1603
2020-11-17,chad,Africa,17303260,5,1608
2020-11-18,chad,Africa,17303260,8,1616
2020-11-19,chad,Africa,17303260,4,1620
2020-11-20,chad,Africa,17303260,6,1626
2020-11-21,chad,Africa,17303260,7,1633
2020-11-22,chad,Africa,17303260,9,1642
2020-11-23,chad,Africa,17303260,6,1648
2020-11-24,chad,Africa,17303260,1,1649
2020-11-25,chad,Africa,17303260,6,1655
2020-11-26,chad,Africa,17303260,6,1661
2020-11-27,chad,Africa,17303260,2,1663
2020-11-28,chad,Africa,17303260,0,1663
2020-11-29,chad,Africa,17303260,19,1682
2020-11-30,chad,Africa,17303260,6,1688
2020-12-01,chad,Africa,17303260,12,1700
2020-12-02,chad,Africa,17303260,5,1705
2020-12-03,chad,Africa,17303260,3,1708
2020-12-04,chad,Africa,17303260,11,1719
2020-12-05,chad,Africa,17303260,3,1722
2020-12-06,chad,Africa,17303260,3,1725
2020-12-07,chad,Africa,17303260,3,1728
2020-12-08,chad,Africa,17303260,1,1729
2020-12-09,chad,Africa,17303260,3,1732
2020-12-10,chad,Africa,17303260,7,1739
2020-12-11,chad,Africa,17303260,6,1745
2020-12-12,chad,Africa,17303260,6,1751
2020-12-13,chad,Africa,17303260,19,1770
2020-12-14,chad,Africa,17303260,1,1771
2020-12-15,chad,Africa,17303260,13,1784
2020-12-16,chad,Africa,17303260,16,1800
2020-12-17,chad,Africa,17303260,18,1818
2020-12-18,chad,Africa,17303260,21,1839
2020-12-19,chad,Africa,17303260,28,1867
2020-12-20,chad,Africa,17303260,23,1890
2020-12-21,chad,Africa,17303260,12,1902
2020-12-22,chad,Africa,17303260,14,1916
2020-12-23,chad,Africa,17303260,22,1938
2020-12-24,chad,Africa,17303260,20,1958
2020-12-25,chad,Africa,17303260,13,1971
2020-12-26,chad,Africa,17303260,15,1986
2020-12-27,chad,Africa,17303260,19,2005
2020-12-28,chad,Africa,17303260,10,2015
2020-12-29,chad,Africa,17303260,33,2048
2020-12-30,chad,Africa,17303260,29,2077
2020-12-31,chad,Africa,17303260,36,2113
2021-01-01,chad,Africa,17303260,28,2141
2021-01-02,chad,Africa,17303260,28,2169
2021-01-03,chad,Africa,17303260,44,2213
2021-01-04,chad,Africa,17303260,16,2229
2021-01-05,chad,Africa,17303260,60,2289
2021-01-06,chad,Africa,17303260,39,2328
2021-01-07,chad,Africa,17303260,30,2358
2021-01-08,chad,Africa,17303260,61,2419
2021-01-09,chad,Africa,17303260,91,2510
2021-01-10,chad,Africa,17303260,27,2537
2021-01-11,chad,Africa,17303260,52,2589
2021-01-12,chad,Africa,17303260,79,2668
2021-01-13,chad,Africa,17303260,41,2709
2021-01-14,chad,Africa,17303260,64,2773
2021-01-15,chad,Africa,17303260,34,2807
2021-01-16,chad,Africa,17303260,48,2855
2021-01-17,chad,Africa,17303260,40,2895
2021-01-18,chad,Africa,17303260,24,2919
2021-01-19,chad,Africa,17303260,58,2977
2021-01-20,chad,Africa,17303260,35,3012
2021-01-21,chad,Africa,17303260,53,3065
2021-01-22,chad,Africa,17303260,39,3104
2021-01-23,chad,Africa,17303260,33,3137
2021-01-24,chad,Africa,17303260,24,3161
2021-01-25,chad,Africa,17303260,21,3182
2021-01-26,chad,Africa,17303260,43,3225
2021-01-27,chad,Africa,17303260,44,3269
2021-01-28,chad,Africa,17303260,27,3296
2021-01-29,chad,Africa,17303260,25,3321
2021-01-30,chad,Africa,17303260,26,3347
2021-01-31,chad,Africa,17303260,29,3376
2021-02-01,chad,Africa,17303260,9,3385
2021-02-02,chad,Africa,17303260,19,3404
2021-02-03,chad,Africa,17303260,15,3419
2021-02-04,chad,Africa,17303260,14,3433
2021-02-05,chad,Africa,17303260,17,3450
2021-02-06,chad,Africa,17303260,23,3473
2021-02-07,chad,Africa,17303260,24,3497
2021-02-08,chad,Africa,17303260,11,3508
2021-02-09,chad,Africa,17303260,31,3539
2021-02-10,chad,Africa,17303260,29,3568
2021-02-11,chad,Africa,17303260,13,3581
2021-02-12,chad,Africa,17303260,16,3597
2021-02-13,chad,Africa,17303260,25,3622
2021-02-14,chad,Africa,17303260,23,3645
2021-02-15,chad,Africa,17303260,19,3664
2021-02-16,chad,Africa,17303260,25,3689
2021-02-17,chad,Africa,17303260,35,3724
2021-02-18,chad,Africa,17303260,27,3751
2021-02-19,chad,Africa,17303260,25,3776
2021-02-20,chad,Africa,17303260,18,3794
2021-02-21,chad,Africa,17303260,55,3849
2021-02-22,chad,Africa,17303260,19,3868
2021-02-23,chad,Africa,17303260,14,3882
2021-02-24,chad,Africa,17303260,22,3904
2021-02-25,chad,Africa,17303260,30,3934
2021-02-26,chad,Africa,17303260,23,3957
2021-02-27,chad,Africa,17303260,16,3973
2021-02-28,chad,Africa,17303260,0,3973
2021-03-01,chad,Africa,17303260,13,3986
2021-03-02,chad,Africa,17303260,34,4020
2021-03-03,chad,Africa,17303260,36,4056
2021-03-04,chad,Africa,17303260,33,4089
2021-03-05,chad,Africa,17303260,22,4111
2021-03-06,chad,Africa,17303260,50,4161
2021-03-07,chad,Africa,17303260,16,4177
2021-03-08,chad,Africa,17303260,16,4193
2021-03-09,chad,Africa,17303260,21,4214
2021-03-10,chad,Africa,17303260,17,4231
2021-03-11,chad,Africa,17303260,15,4246
2021-03-12,chad,Africa,17303260,28,4274
2021-03-13,chad,Africa,17303260,14,4288
2021-03-14,chad,Africa,17303260,21,4309
2021-03-15,chad,Africa,17303260,19,4328
2021-03-16,chad,Africa,17303260,16,4344
2021-03-17,chad,Africa,17303260,13,4357
2021-03-18,chad,Africa,17303260,23,4380
2021-03-19,chad,Africa,17303260,15,4395
2021-03-20,chad,Africa,17303260,15,4410
2021-03-21,chad,Africa,17303260,10,4420
2021-03-22,chad,Africa,17303260,7,4427
2021-03-23,chad,Africa,17303260,13,4440
2021-03-24,chad,Africa,17303260,13,4453
2021-03-25,chad,Africa,17303260,12,4465
2021-03-26,chad,Africa,17303260,15,4480
2021-03-27,chad,Africa,17303260,21,4501
2021-03-28,chad,Africa,17303260,5,4506
2021-03-29,chad,Africa,17303260,4,4510
2021-03-30,chad,Africa,17303260,13,4523
2021-03-31,chad,Africa,17303260,10,4533
2021-04-01,chad,Africa,17303260,19,4552
2021-04-02,chad,Africa,17303260,21,4573
2021-04-03,chad,Africa,17303260,16,4589
2021-04-04,chad,Africa,17303260,6,4595
2021-04-05,chad,Africa,17303260,0,4595
2021-04-06,chad,Africa,17303260,8,4603
2021-04-07,chad,Africa,17303260,3,4606
2021-04-08,chad,Africa,17303260,10,4616
2021-04-09,chad,Africa,17303260,3,4619
2021-04-10,chad,Africa,17303260,6,4625
2021-04-11,chad,Africa,17303260,11,4636
2021-04-12,chad,Africa,17303260,5,4641
2021-04-13,chad,Africa,17303260,11,4652
2021-04-14,chad,Africa,17303260,10,4662
2021-04-15,chad,Africa,17303260,11,4673
2021-04-16,chad,Africa,17303260,13,4686
2021-04-17,chad,Africa,17303260,5,4691
2021-04-18,chad,Africa,17303260,15,4706
2021-04-19,chad,Africa,17303260,2,4708
2021-04-20,chad,Africa,17303260,15,4723
2021-04-21,chad,Africa,17303260,8,4731
2021-04-22,chad,Africa,17303260,4,4735
2021-04-23,chad,Africa,17303260,12,4747
2021-04-24,chad,Africa,17303260,5,4752
2021-04-25,chad,Africa,17303260,18,4770
2021-04-26,chad,Africa,17303260,2,4772
2021-04-27,chad,Africa,17303260,7,4779
2021-04-28,chad,Africa,17303260,10,4789
2021-04-29,chad,Africa,17303260,21,4810
2021-04-30,chad,Africa,17303260,7,4817
2021-05-01,chad,Africa,17303260,7,4824
2021-05-02,chad,Africa,17303260,4,4828
2021-05-03,chad,Africa,17303260,0,4828
2021-05-04,chad,Africa,17303260,7,4835
2021-05-05,chad,Africa,17303260,12,4847
2021-05-06,chad,Africa,17303260,7,4854
2021-05-07,chad,Africa,17303260,8,4862
2021-05-08,chad,Africa,17303260,12,4874
2021-05-09,chad,Africa,17303260,3,4877
2021-05-10,chad,Africa,17303260,5,4882
2021-05-11,chad,Africa,17303260,6,4888
2021-05-12,chad,Africa,17303260,3,4891
2021-05-13,chad,Africa,17303260,4,4895
2021-05-14,chad,Africa,17303260,2,4897
2021-05-15,chad,Africa,17303260,4,4901
2021-05-16,chad,Africa,17303260,3,4904
2021-05-17,chad,Africa,17303260,0,4904
2021-05-18,chad,Africa,17303260,1,4905
2021-05-19,chad,Africa,17303260,9,4914
2021-05-20,chad,Africa,17303260,4,4918
2021-05-21,chad,Africa,17303260,1,4919
2021-05-22,chad,Africa,17303260,4,4923
2021-05-23,chad,Africa,17303260,1,4924
2021-05-24,chad,Africa,17303260,0,4924
2021-05-25,chad,Africa,17303260,0,4924
2021-05-26,chad,Africa,17303260,1,4925
2021-05-27,chad,Africa,17303260,1,4926
2021-05-28,chad,Africa,17303260,1,4927
2021-05-29,chad,Africa,17303260,1,4928
2021-05-30,chad,Africa,17303260,1,4929
2021-05-31,chad,Africa,17303260,2,4931
2021-06-01,chad,Africa,17303260,3,4934
2021-06-02,chad,Africa,17303260,1,4935
2021-06-03,chad,Africa,17303260,0,4935
2021-06-04,chad,Africa,17303260,3,4938
2021-06-05,chad,Africa,17303260,1,4939
2021-06-06,chad,Africa,17303260,0,4939
2021-06-07,chad,Africa,17303260,1,4940
2021-06-08,chad,Africa,17303260,2,4942
2021-06-09,chad,Africa,17303260,0,4942
2021-06-10,chad,Africa,17303260,0,4942
2021-06-11,chad,Africa,17303260,0,4942
2021-06-12,chad,Africa,17303260,0,4942
2021-06-13,chad,Africa,17303260,0,4942
2021-06-14,chad,Africa,17303260,1,4943
2021-06-15,chad,Africa,17303260,0,4943
2021-06-16,chad,Africa,17303260,0,4943
2021-06-17,chad,Africa,17303260,1,4944
2021-06-18,chad,Africa,17303260,1,4945
2021-06-19,chad,Africa,17303260,1,4946
2021-06-20,chad,Africa,17303260,0,4946
2021-06-21,chad,Africa,17303260,1,4947
2021-06-22,chad,Africa,17303260,1,4948
2021-06-23,chad,Africa,17303260,3,4951
2021-06-24,chad,Africa,17303260,0,4951
2021-06-25,chad,Africa,17303260,0,4951
2021-06-26,chad,Africa,17303260,0,4951
2021-06-27,chad,Africa,17303260,0,4951
2021-06-28,chad,Africa,17303260,0,4951
2021-06-29,chad,Africa,17303260,0,4951
2021-06-30,chad,Africa,17303260,0,4951
2021-07-01,chad,Africa,17303260,0,4951
2021-07-02,chad,Africa,17303260,0,4951
2021-07-03,chad,Africa,17303260,0,4951
2021-07-04,chad,Africa,17303260,0,4951
2021-07-05,chad,Africa,17303260,1,4952
2021-07-06,chad,Africa,17303260,0,4952
2021-07-07,chad,Africa,17303260,0,4952
2021-07-08,chad,Africa,17303260,1,4953
2021-07-09,chad,Africa,17303260,0,4953
2020-03-27,channel_islands,Europe,176848,22,88
2020-03-28,channel_islands,Europe,176848,9,97
2020-03-29,channel_islands,Europe,176848,11,108
2020-03-30,channel_islands,Europe,176848,33,141
2020-03-31,channel_islands,Europe,176848,0,141
2020-04-01,channel_islands,Europe,176848,31,172
2020-04-02,channel_islands,Europe,176848,21,193
2020-04-03,channel_islands,Europe,176848,39,232
2020-04-04,channel_islands,Europe,176848,30,262
2020-04-05,channel_islands,Europe,176848,47,309
2020-04-06,channel_islands,Europe,176848,14,323
2020-04-07,channel_islands,Europe,176848,12,335
2020-04-08,channel_islands,Europe,176848,16,351
2020-04-09,channel_islands,Europe,176848,10,361
2020-04-10,channel_islands,Europe,176848,37,398
2020-04-11,channel_islands,Europe,176848,9,407
2020-04-12,channel_islands,Europe,176848,24,431
2020-04-13,channel_islands,Europe,176848,5,436
2020-04-14,channel_islands,Europe,176848,4,440
2020-04-15,channel_islands,Europe,176848,7,447
2020-04-16,channel_islands,Europe,176848,10,457
2020-04-17,channel_islands,Europe,176848,13,470
2020-04-18,channel_islands,Europe,176848,14,484
2020-04-19,channel_islands,Europe,176848,4,488
2020-04-20,channel_islands,Europe,176848,0,488
2020-04-21,channel_islands,Europe,176848,8,496
2020-04-22,channel_islands,Europe,176848,2,498
2020-04-23,channel_islands,Europe,176848,23,521
2020-04-24,channel_islands,Europe,176848,2,523
2020-04-25,channel_islands,Europe,176848,2,525
2020-04-26,channel_islands,Europe,176848,0,525
2020-04-27,channel_islands,Europe,176848,0,525
2020-04-28,channel_islands,Europe,176848,5,530
2020-04-29,channel_islands,Europe,176848,7,537
2020-04-30,channel_islands,Europe,176848,0,537
2020-05-01,channel_islands,Europe,176848,1,538
2020-05-02,channel_islands,Europe,176848,6,544
2020-05-03,channel_islands,Europe,176848,0,544
2020-05-04,channel_islands,Europe,176848,0,544
2020-05-05,channel_islands,Europe,176848,1,545
2020-05-06,channel_islands,Europe,176848,0,545
2020-05-07,channel_islands,Europe,176848,0,545
2020-05-08,channel_islands,Europe,176848,0,545
2020-05-09,channel_islands,Europe,176848,0,545
2020-05-10,channel_islands,Europe,176848,0,545
2020-05-11,channel_islands,Europe,176848,1,546
2020-05-12,channel_islands,Europe,176848,1,547
2020-05-13,channel_islands,Europe,176848,1,548
2020-05-14,channel_islands,Europe,176848,1,549
2020-05-15,channel_islands,Europe,176848,0,549
2020-05-16,channel_islands,Europe,176848,5,554
2020-05-17,channel_islands,Europe,176848,0,554
2020-05-18,channel_islands,Europe,176848,1,555
2020-05-19,channel_islands,Europe,176848,0,555
2020-05-20,channel_islands,Europe,176848,3,558
2020-05-21,channel_islands,Europe,176848,0,558
2020-05-22,channel_islands,Europe,176848,0,558
2020-05-23,channel_islands,Europe,176848,0,558
2020-05-24,channel_islands,Europe,176848,0,558
2020-05-25,channel_islands,Europe,176848,1,559
2020-05-26,channel_islands,Europe,176848,0,559
2020-05-27,channel_islands,Europe,176848,1,560
2020-05-28,channel_islands,Europe,176848,0,560
2020-05-29,channel_islands,Europe,176848,0,560
2020-05-30,channel_islands,Europe,176848,0,560
2020-05-31,channel_islands,Europe,176848,0,560
2020-06-01,channel_islands,Europe,176848,0,560
2020-06-02,channel_islands,Europe,176848,0,560
2020-06-03,channel_islands,Europe,176848,1,561
2020-06-04,channel_islands,Europe,176848,0,561
2020-06-05,channel_islands,Europe,176848,0,561
2020-06-06,channel_islands,Europe,176848,2,563
2020-06-07,channel_islands,Europe,176848,0,563
2020-06-08,channel_islands,Europe,176848,1,564
2020-06-09,channel_islands,Europe,176848,1,565
2020-06-10,channel_islands,Europe,176848,0,565
2020-06-11,channel_islands,Europe,176848,0,565
2020-06-12,channel_islands,Europe,176848,0,565
2020-06-13,channel_islands,Europe,176848,0,565
2020-06-14,channel_islands,Europe,176848,0,565
2020-06-15,channel_islands,Europe,176848,3,568
2020-06-16,channel_islands,Europe,176848,0,568
2020-06-17,channel_islands,Europe,176848,2,570
2020-06-18,channel_islands,Europe,176848,0,570
2020-06-19,channel_islands,Europe,176848,0,570
2020-06-20,channel_islands,Europe,176848,0,570
2020-06-21,channel_islands,Europe,176848,0,570
2020-06-22,channel_islands,Europe,176848,0,570
2020-06-23,channel_islands,Europe,176848,0,570
2020-06-24,channel_islands,Europe,176848,1,571
2020-06-25,channel_islands,Europe,176848,0,571
2020-06-26,channel_islands,Europe,176848,0,571
2020-06-27,channel_islands,Europe,176848,0,571
2020-06-28,channel_islands,Europe,176848,0,571
2020-06-29,channel_islands,Europe,176848,0,571
2020-06-30,channel_islands,Europe,176848,0,571
2020-07-01,channel_islands,Europe,176848,0,571
2020-07-02,channel_islands,Europe,176848,0,571
2020-07-03,channel_islands,Europe,176848,0,571
2020-07-04,channel_islands,Europe,176848,0,571
2020-07-05,channel_islands,Europe,176848,0,571
2020-07-06,channel_islands,Europe,176848,6,577
2020-07-07,channel_islands,Europe,176848,0,577
2020-07-08,channel_islands,Europe,176848,0,577
2020-07-09,channel_islands,Europe,176848,0,577
2020-07-10,channel_islands,Europe,176848,0,577
2020-07-11,channel_islands,Europe,176848,0,577
2020-07-12,channel_islands,Europe,176848,0,577
2020-07-13,channel_islands,Europe,176848,4,581
2020-07-14,channel_islands,Europe,176848,0,581
2020-07-15,channel_islands,Europe,176848,0,581
2020-07-16,channel_islands,Europe,176848,2,583
2020-07-17,channel_islands,Europe,176848,0,583
2020-07-18,channel_islands,Europe,176848,0,583
2020-07-19,channel_islands,Europe,176848,0,583
2020-07-20,channel_islands,Europe,176848,0,583
2020-07-21,channel_islands,Europe,176848,0,583
2020-07-22,channel_islands,Europe,176848,0,583
2020-07-23,channel_islands,Europe,176848,0,583
2020-07-24,channel_islands,Europe,176848,1,584
2020-07-25,channel_islands,Europe,176848,0,584
2020-07-26,channel_islands,Europe,176848,0,584
2020-07-27,channel_islands,Europe,176848,0,584
2020-07-28,channel_islands,Europe,176848,3,587
2020-07-29,channel_islands,Europe,176848,0,587
2020-07-30,channel_islands,Europe,176848,0,587
2020-07-31,channel_islands,Europe,176848,0,587
2020-08-01,channel_islands,Europe,176848,0,587
2020-08-02,channel_islands,Europe,176848,0,587
2020-08-03,channel_islands,Europe,176848,4,591
2020-08-04,channel_islands,Europe,176848,4,595
2020-08-05,channel_islands,Europe,176848,1,596
2020-08-06,channel_islands,Europe,176848,1,597
2020-08-07,channel_islands,Europe,176848,0,597
2020-08-08,channel_islands,Europe,176848,0,597
2020-08-09,channel_islands,Europe,176848,0,597
2020-08-10,channel_islands,Europe,176848,2,599
2020-08-11,channel_islands,Europe,176848,0,599
2020-08-12,channel_islands,Europe,176848,4,603
2020-08-13,channel_islands,Europe,176848,0,603
2020-08-14,channel_islands,Europe,176848,4,607
2020-08-15,channel_islands,Europe,176848,0,607
2020-08-16,channel_islands,Europe,176848,0,607
2020-08-17,channel_islands,Europe,176848,2,609
2020-08-18,channel_islands,Europe,176848,0,609
2020-08-19,channel_islands,Europe,176848,4,613
2020-08-20,channel_islands,Europe,176848,0,613
2020-08-21,channel_islands,Europe,176848,1,614
2020-08-22,channel_islands,Europe,176848,0,614
2020-08-23,channel_islands,Europe,176848,0,614
2020-08-24,channel_islands,Europe,176848,2,616
2020-08-25,channel_islands,Europe,176848,4,620
2020-08-26,channel_islands,Europe,176848,3,623
2020-08-27,channel_islands,Europe,176848,0,623
2020-08-28,channel_islands,Europe,176848,2,625
2020-08-29,channel_islands,Europe,176848,0,625
2020-08-30,channel_islands,Europe,176848,0,625
2020-08-31,channel_islands,Europe,176848,0,625
2020-09-01,channel_islands,Europe,176848,1,626
2020-09-02,channel_islands,Europe,176848,0,626
2020-09-03,channel_islands,Europe,176848,0,626
2020-09-04,channel_islands,Europe,176848,0,626
2020-09-05,channel_islands,Europe,176848,0,626
2020-09-06,channel_islands,Europe,176848,0,626
2020-09-07,channel_islands,Europe,176848,2,628
2020-09-08,channel_islands,Europe,176848,1,629
2020-09-09,channel_islands,Europe,176848,2,631
2020-09-10,channel_islands,Europe,176848,0,631
2020-09-11,channel_islands,Europe,176848,2,633
2020-09-12,channel_islands,Europe,176848,0,633
2020-09-13,channel_islands,Europe,176848,0,633
2020-09-14,channel_islands,Europe,176848,0,633
2020-09-15,channel_islands,Europe,176848,6,639
2020-09-16,channel_islands,Europe,176848,0,639
2020-09-17,channel_islands,Europe,176848,5,644
2020-09-18,channel_islands,Europe,176848,0,644
2020-09-19,channel_islands,Europe,176848,0,644
2020-09-20,channel_islands,Europe,176848,0,644
2020-09-21,channel_islands,Europe,176848,8,652
2020-09-22,channel_islands,Europe,176848,0,652
2020-09-23,channel_islands,Europe,176848,2,654
2020-09-24,channel_islands,Europe,176848,1,655
2020-09-25,channel_islands,Europe,176848,1,656
2020-09-26,channel_islands,Europe,176848,0,656
2020-09-27,channel_islands,Europe,176848,0,656
2020-09-28,channel_islands,Europe,176848,8,664
2020-09-29,channel_islands,Europe,176848,0,664
2020-09-30,channel_islands,Europe,176848,1,665
2020-10-01,channel_islands,Europe,176848,0,665
2020-10-02,channel_islands,Europe,176848,12,677
2020-10-03,channel_islands,Europe,176848,1,678
2020-10-04,channel_islands,Europe,176848,0,678
2020-10-05,channel_islands,Europe,176848,8,686
2020-10-06,channel_islands,Europe,176848,9,695
2020-10-07,channel_islands,Europe,176848,3,698
2020-10-08,channel_islands,Europe,176848,1,699
2020-10-09,channel_islands,Europe,176848,0,699
2020-10-10,channel_islands,Europe,176848,0,699
2020-10-11,channel_islands,Europe,176848,0,699
2020-10-12,channel_islands,Europe,176848,38,737
2020-10-13,channel_islands,Europe,176848,4,741
2020-10-14,channel_islands,Europe,176848,4,745
2020-10-15,channel_islands,Europe,176848,3,748
2020-10-16,channel_islands,Europe,176848,0,748
2020-10-17,channel_islands,Europe,176848,0,748
2020-10-18,channel_islands,Europe,176848,0,748
2020-10-19,channel_islands,Europe,176848,19,767
2020-10-20,channel_islands,Europe,176848,1,768
2020-10-21,channel_islands,Europe,176848,7,775
2020-10-22,channel_islands,Europe,176848,9,784
2020-10-23,channel_islands,Europe,176848,11,795
2020-10-24,channel_islands,Europe,176848,0,795
2020-10-25,channel_islands,Europe,176848,0,795
2020-10-26,channel_islands,Europe,176848,1,796
2020-10-27,channel_islands,Europe,176848,26,822
2020-10-28,channel_islands,Europe,176848,11,833
2020-10-29,channel_islands,Europe,176848,3,836
2020-10-30,channel_islands,Europe,176848,5,841
2020-10-31,channel_islands,Europe,176848,0,841
2020-11-01,channel_islands,Europe,176848,0,841
2020-11-02,channel_islands,Europe,176848,4,845
2020-11-03,channel_islands,Europe,176848,34,879
2020-11-04,channel_islands,Europe,176848,14,893
2020-11-05,channel_islands,Europe,176848,12,905
2020-11-06,channel_islands,Europe,176848,16,921
2020-11-07,channel_islands,Europe,176848,0,921
2020-11-08,channel_islands,Europe,176848,0,921
2020-11-09,channel_islands,Europe,176848,30,951
2020-11-10,channel_islands,Europe,176848,21,972
2020-11-11,channel_islands,Europe,176848,14,986
2020-11-12,channel_islands,Europe,176848,17,1003
2020-11-13,channel_islands,Europe,176848,0,1003
2020-11-14,channel_islands,Europe,176848,0,1003
2020-11-15,channel_islands,Europe,176848,0,1003
2020-11-16,channel_islands,Europe,176848,43,1046
2020-11-17,channel_islands,Europe,176848,0,1046
2020-11-18,channel_islands,Europe,176848,22,1068
2020-11-19,channel_islands,Europe,176848,11,1079
2020-11-20,channel_islands,Europe,176848,1,1080
2020-11-21,channel_islands,Europe,176848,14,1094
2020-11-22,channel_islands,Europe,176848,0,1094
2020-11-23,channel_islands,Europe,176848,0,1094
2020-11-24,channel_islands,Europe,176848,30,1124
2020-11-25,channel_islands,Europe,176848,23,1147
2020-11-26,channel_islands,Europe,176848,35,1182
2020-11-27,channel_islands,Europe,176848,36,1218
2020-11-28,channel_islands,Europe,176848,0,1218
2020-11-29,channel_islands,Europe,176848,0,1218
2020-11-30,channel_islands,Europe,176848,81,1299
2020-12-01,channel_islands,Europe,176848,42,1341
2020-12-02,channel_islands,Europe,176848,56,1397
2020-12-03,channel_islands,Europe,176848,61,1458
2020-12-04,channel_islands,Europe,176848,68,1526
2020-12-05,channel_islands,Europe,176848,23,1549
2020-12-06,channel_islands,Europe,176848,96,1645
2020-12-07,channel_islands,Europe,176848,31,1676
2020-12-08,channel_islands,Europe,176848,72,1748
2020-12-09,channel_islands,Europe,176848,38,1786
2020-12-10,channel_islands,Europe,176848,58,1844
2020-12-11,channel_islands,Europe,176848,82,1926
2020-12-12,channel_islands,Europe,176848,51,1977
2020-12-13,channel_islands,Europe,176848,91,2068
2020-12-14,channel_islands,Europe,176848,64,2132
2020-12-15,channel_islands,Europe,176848,60,2192
2020-12-16,channel_islands,Europe,176848,100,2292
2020-12-17,channel_islands,Europe,176848,97,2389
2020-12-18,channel_islands,Europe,176848,0,2389
2020-12-19,channel_islands,Europe,176848,137,2526
2020-12-20,channel_islands,Europe,176848,103,2629
2020-12-21,channel_islands,Europe,176848,109,2738
2020-12-22,channel_islands,Europe,176848,38,2776
2020-12-23,channel_islands,Europe,176848,81,2857
2020-12-24,channel_islands,Europe,176848,23,2880
2020-12-25,channel_islands,Europe,176848,0,2880
2020-12-26,channel_islands,Europe,176848,0,2880
2020-12-27,channel_islands,Europe,176848,80,2960
2020-12-28,channel_islands,Europe,176848,29,2989
2020-12-29,channel_islands,Europe,176848,15,3004
2020-12-30,channel_islands,Europe,176848,20,3024
2020-12-31,channel_islands,Europe,176848,34,3058
2021-01-01,channel_islands,Europe,176848,1,3059
2021-01-02,channel_islands,Europe,176848,0,3059
2021-01-03,channel_islands,Europe,176848,62,3121
2021-01-04,channel_islands,Europe,176848,21,3142
2021-01-05,channel_islands,Europe,176848,22,3164
2021-01-06,channel_islands,Europe,176848,30,3194
2021-01-07,channel_islands,Europe,176848,16,3210
2021-01-08,channel_islands,Europe,176848,13,3223
2021-01-09,channel_islands,Europe,176848,37,3260
2021-01-10,channel_islands,Europe,176848,17,3277
2021-01-11,channel_islands,Europe,176848,22,3299
2021-01-12,channel_islands,Europe,176848,11,3310
2021-01-13,channel_islands,Europe,176848,14,3324
2021-01-14,channel_islands,Europe,176848,13,3337
2021-01-15,channel_islands,Europe,176848,16,3353
2021-01-16,channel_islands,Europe,176848,3,3356
2021-01-17,channel_islands,Europe,176848,7,3363
2021-01-18,channel_islands,Europe,176848,7,3370
2021-01-19,channel_islands,Europe,176848,16,3386
2021-01-20,channel_islands,Europe,176848,12,3398
2021-01-21,channel_islands,Europe,176848,9,3407
2021-01-22,channel_islands,Europe,176848,7,3414
2021-01-23,channel_islands,Europe,176848,16,3430
2021-01-24,channel_islands,Europe,176848,33,3463
2021-01-25,channel_islands,Europe,176848,23,3486
2021-01-26,channel_islands,Europe,176848,13,3499
2021-01-27,channel_islands,Europe,176848,26,3525
2021-01-28,channel_islands,Europe,176848,29,3554
2021-01-29,channel_islands,Europe,176848,38,3592
2021-01-30,channel_islands,Europe,176848,47,3639
2021-01-31,channel_islands,Europe,176848,52,3691
2021-02-01,channel_islands,Europe,176848,46,3737
2021-02-02,channel_islands,Europe,176848,39,3776
2021-02-03,channel_islands,Europe,176848,40,3816
2021-02-04,channel_islands,Europe,176848,27,3843
2021-02-05,channel_islands,Europe,176848,19,3862
2021-02-06,channel_islands,Europe,176848,23,3885
2021-02-07,channel_islands,Europe,176848,11,3896
2021-02-08,channel_islands,Europe,176848,22,3918
2021-02-09,channel_islands,Europe,176848,21,3939
2021-02-10,channel_islands,Europe,176848,11,3950
2021-02-11,channel_islands,Europe,176848,11,3961
2021-02-12,channel_islands,Europe,176848,19,3980
2021-02-13,channel_islands,Europe,176848,9,3989
2021-02-14,channel_islands,Europe,176848,10,3999
2021-02-15,channel_islands,Europe,176848,5,4004
2021-02-16,channel_islands,Europe,176848,5,4009
2021-02-17,channel_islands,Europe,176848,4,4013
2021-02-18,channel_islands,Europe,176848,3,4016
2021-02-19,channel_islands,Europe,176848,7,4023
2021-02-20,channel_islands,Europe,176848,2,4025
2021-02-21,channel_islands,Europe,176848,1,4026
2021-02-22,channel_islands,Europe,176848,4,4030
2021-02-23,channel_islands,Europe,176848,0,4030
2021-02-24,channel_islands,Europe,176848,1,4031
2021-02-25,channel_islands,Europe,176848,1,4032
2021-02-26,channel_islands,Europe,176848,1,4033
2021-02-27,channel_islands,Europe,176848,1,4034
2021-02-28,channel_islands,Europe,176848,4,4038
2021-03-01,channel_islands,Europe,176848,0,4038
2021-03-02,channel_islands,Europe,176848,1,4039
2021-03-03,channel_islands,Europe,176848,1,4040
2021-03-04,channel_islands,Europe,176848,1,4041
2021-03-05,channel_islands,Europe,176848,0,4041
2021-03-06,channel_islands,Europe,176848,0,4041
2021-03-07,channel_islands,Europe,176848,0,4041
2021-03-08,channel_islands,Europe,176848,1,4042
2021-03-09,channel_islands,Europe,176848,1,4043
2021-03-10,channel_islands,Europe,176848,0,4043
2021-03-11,channel_islands,Europe,176848,0,4043
2021-03-12,channel_islands,Europe,176848,0,4043
2021-03-13,channel_islands,Europe,176848,0,4043
2021-03-14,channel_islands,Europe,176848,0,4043
2021-03-15,channel_islands,Europe,176848,1,4044
2021-03-16,channel_islands,Europe,176848,1,4045
2021-03-17,channel_islands,Europe,176848,0,4045
2021-03-18,channel_islands,Europe,176848,0,4045
2021-03-19,channel_islands,Europe,176848,0,4045
2021-03-20,channel_islands,Europe,176848,0,4045
2021-03-21,channel_islands,Europe,176848,0,4045
2021-03-22,channel_islands,Europe,176848,0,4045
2021-03-23,channel_islands,Europe,176848,1,4046
2021-03-24,channel_islands,Europe,176848,0,4046
2021-03-25,channel_islands,Europe,176848,0,4046
2021-03-26,channel_islands,Europe,176848,0,4046
2021-03-27,channel_islands,Europe,176848,0,4046
2021-03-28,channel_islands,Europe,176848,0,4046
2021-03-29,channel_islands,Europe,176848,0,4046
2021-03-30,channel_islands,Europe,176848,3,4049
2021-03-31,channel_islands,Europe,176848,0,4049
2021-04-01,channel_islands,Europe,176848,1,4050
2021-04-02,channel_islands,Europe,176848,0,4050
2021-04-03,channel_islands,Europe,176848,0,4050
2021-04-04,channel_islands,Europe,176848,0,4050
2021-04-05,channel_islands,Europe,176848,0,4050
2021-04-06,channel_islands,Europe,176848,1,4051
2021-04-07,channel_islands,Europe,176848,0,4051
2021-04-08,channel_islands,Europe,176848,0,4051
2021-04-09,channel_islands,Europe,176848,0,4051
2021-04-10,channel_islands,Europe,176848,0,4051
2021-04-11,channel_islands,Europe,176848,0,4051
2021-04-12,channel_islands,Europe,176848,0,4051
2021-04-13,channel_islands,Europe,176848,2,4053
2021-04-14,channel_islands,Europe,176848,0,4053
2021-04-15,channel_islands,Europe,176848,0,4053
2021-04-16,channel_islands,Europe,176848,0,4053
2021-04-17,channel_islands,Europe,176848,0,4053
2021-04-18,channel_islands,Europe,176848,0,4053
2021-04-19,channel_islands,Europe,176848,0,4053
2021-04-20,channel_islands,Europe,176848,0,4053
2021-04-21,channel_islands,Europe,176848,2,4055
2021-04-22,channel_islands,Europe,176848,0,4055
2021-04-23,channel_islands,Europe,176848,0,4055
2021-04-24,channel_islands,Europe,176848,0,4055
2021-04-25,channel_islands,Europe,176848,0,4055
2021-04-26,channel_islands,Europe,176848,0,4055
2021-04-27,channel_islands,Europe,176848,0,4055
2021-04-28,channel_islands,Europe,176848,0,4055
2021-04-29,channel_islands,Europe,176848,0,4055
2021-04-30,channel_islands,Europe,176848,0,4055
2021-05-01,channel_islands,Europe,176848,0,4055
2021-05-02,channel_islands,Europe,176848,0,4055
2021-05-03,channel_islands,Europe,176848,0,4055
2021-05-04,channel_islands,Europe,176848,1,4056
2021-05-05,channel_islands,Europe,176848,0,4056
2021-05-06,channel_islands,Europe,176848,0,4056
2021-05-07,channel_islands,Europe,176848,0,4056
2021-05-08,channel_islands,Europe,176848,0,4056
2021-05-09,channel_islands,Europe,176848,0,4056
2021-05-10,channel_islands,Europe,176848,1,4057
2021-05-11,channel_islands,Europe,176848,0,4057
2021-05-12,channel_islands,Europe,176848,0,4057
2021-05-13,channel_islands,Europe,176848,0,4057
2021-05-14,channel_islands,Europe,176848,0,4057
2021-05-15,channel_islands,Europe,176848,0,4057
2021-05-16,channel_islands,Europe,176848,0,4057
2021-05-17,channel_islands,Europe,176848,2,4059
2021-05-18,channel_islands,Europe,176848,0,4059
2021-05-19,channel_islands,Europe,176848,0,4059
2021-05-20,channel_islands,Europe,176848,0,4059
2021-05-21,channel_islands,Europe,176848,0,4059
2021-05-22,channel_islands,Europe,176848,0,4059
2021-05-23,channel_islands,Europe,176848,0,4059
2021-05-24,channel_islands,Europe,176848,6,4065
2021-05-25,channel_islands,Europe,176848,0,4065
2021-05-26,channel_islands,Europe,176848,0,4065
2021-05-27,channel_islands,Europe,176848,0,4065
2021-05-28,channel_islands,Europe,176848,0,4065
2021-05-29,channel_islands,Europe,176848,0,4065
2021-05-30,channel_islands,Europe,176848,0,4065
2021-05-31,channel_islands,Europe,176848,1,4066
2021-06-01,channel_islands,Europe,176848,0,4066
2021-06-02,channel_islands,Europe,176848,0,4066
2021-06-03,channel_islands,Europe,176848,0,4066
2021-06-04,channel_islands,Europe,176848,0,4066
2021-06-05,channel_islands,Europe,176848,0,4066
2021-06-06,channel_islands,Europe,176848,0,4066
2021-06-07,channel_islands,Europe,176848,10,4076
2021-06-08,channel_islands,Europe,176848,0,4076
2021-06-09,channel_islands,Europe,176848,7,4083
2021-06-10,channel_islands,Europe,176848,5,4088
2021-06-11,channel_islands,Europe,176848,0,4088
2021-06-12,channel_islands,Europe,176848,0,4088
2021-06-13,channel_islands,Europe,176848,11,4099
2021-06-14,channel_islands,Europe,176848,13,4112
2021-06-15,channel_islands,Europe,176848,0,4112
2021-06-16,channel_islands,Europe,176848,0,4112
2021-06-17,channel_islands,Europe,176848,12,4124
2021-06-18,channel_islands,Europe,176848,2,4126
2021-06-19,channel_islands,Europe,176848,0,4126
2021-06-20,channel_islands,Europe,176848,2,4128
2021-06-21,channel_islands,Europe,176848,0,4128
2021-06-22,channel_islands,Europe,176848,22,4150
2021-06-23,channel_islands,Europe,176848,0,4150
2021-06-24,channel_islands,Europe,176848,0,4150
2021-06-25,channel_islands,Europe,176848,68,4218
2021-06-26,channel_islands,Europe,176848,1,4219
2021-06-27,channel_islands,Europe,176848,1,4220
2021-06-28,channel_islands,Europe,176848,73,4293
2021-06-29,channel_islands,Europe,176848,29,4322
2021-06-30,channel_islands,Europe,176848,61,4383
2021-07-01,channel_islands,Europe,176848,65,4448
2021-07-02,channel_islands,Europe,176848,67,4515
2021-07-03,channel_islands,Europe,176848,0,4515
2021-07-04,channel_islands,Europe,176848,6,4521
2021-07-05,channel_islands,Europe,176848,211,4732
2021-07-06,channel_islands,Europe,176848,66,4798
2021-07-07,channel_islands,Europe,176848,0,4798
2021-07-08,channel_islands,Europe,176848,103,4901
2021-07-09,channel_islands,Europe,176848,304,5205
2021-07-10,channel_islands,Europe,176848,0,5205
2021-07-11,channel_islands,Europe,176848,0,5205
2021-07-12,channel_islands,Europe,176848,457,5662
2021-07-13,channel_islands,Europe,176848,227,5889
2021-07-14,channel_islands,Europe,176848,212,6101
2021-07-15,channel_islands,Europe,176848,282,6383
2021-07-16,channel_islands,Europe,176848,212,6595
2021-07-17,channel_islands,Europe,176848,11,6606
2021-07-18,channel_islands,Europe,176848,0,6606
2021-07-19,channel_islands,Europe,176848,856,7462
2021-07-20,channel_islands,Europe,176848,304,7766
2021-07-21,channel_islands,Europe,176848,219,7985
2021-07-22,channel_islands,Europe,176848,255,8240
2021-07-23,channel_islands,Europe,176848,187,8427
2021-07-24,channel_islands,Europe,176848,6,8433
2021-07-25,channel_islands,Europe,176848,4,8437
2021-07-26,channel_islands,Europe,176848,355,8792
2021-07-27,channel_islands,Europe,176848,134,8926
2021-07-28,channel_islands,Europe,176848,110,9036
2021-07-29,channel_islands,Europe,176848,91,9127
2021-07-30,channel_islands,Europe,176848,81,9208
2021-07-31,channel_islands,Europe,176848,6,9214
2021-08-01,channel_islands,Europe,176848,2,9216
2021-08-02,channel_islands,Europe,176848,179,9395
2021-08-03,channel_islands,Europe,176848,48,9443
2021-08-04,channel_islands,Europe,176848,64,9507
2021-08-05,channel_islands,Europe,176848,48,9555
2021-08-06,channel_islands,Europe,176848,40,9595
2021-08-07,channel_islands,Europe,176848,4,9599
2021-08-08,channel_islands,Europe,176848,7,9606
2021-08-09,channel_islands,Europe,176848,81,9687
2021-08-10,channel_islands,Europe,176848,42,9729
2021-08-11,channel_islands,Europe,176848,29,9758
2021-08-12,channel_islands,Europe,176848,57,9815
2021-08-13,channel_islands,Europe,176848,64,9879
2021-08-14,channel_islands,Europe,176848,10,9889
2021-08-15,channel_islands,Europe,176848,14,9903
2021-08-16,channel_islands,Europe,176848,102,10005
2021-08-17,channel_islands,Europe,176848,0,10005
2021-08-18,channel_islands,Europe,176848,105,10110
2021-08-19,channel_islands,Europe,176848,43,10153
2021-08-20,channel_islands,Europe,176848,51,10204
2021-08-21,channel_islands,Europe,176848,0,10204
2021-08-22,channel_islands,Europe,176848,0,10204
2021-08-23,channel_islands,Europe,176848,123,10327
2021-08-24,channel_islands,Europe,176848,34,10361
2021-08-25,channel_islands,Europe,176848,37,10398
2021-08-26,channel_islands,Europe,176848,40,10438
2021-08-27,channel_islands,Europe,176848,48,10486
2021-08-28,channel_islands,Europe,176848,0,10486
2021-08-29,channel_islands,Europe,176848,0,10486
2021-08-30,channel_islands,Europe,176848,0,10486
2021-08-31,channel_islands,Europe,176848,122,10608
2021-09-01,channel_islands,Europe,176848,41,10649
2021-09-02,channel_islands,Europe,176848,40,10689
2021-09-03,channel_islands,Europe,176848,49,10738
2021-09-04,channel_islands,Europe,176848,0,10738
2021-09-05,channel_islands,Europe,176848,0,10738
2021-09-06,channel_islands,Europe,176848,137,10875
2021-09-07,channel_islands,Europe,176848,46,10921
2021-09-08,channel_islands,Europe,176848,24,10945
2021-09-09,channel_islands,Europe,176848,41,10986
2021-09-10,channel_islands,Europe,176848,43,11029
2021-09-11,channel_islands,Europe,176848,0,11029
2021-09-12,channel_islands,Europe,176848,0,11029
2021-09-13,channel_islands,Europe,176848,102,11131
2021-09-14,channel_islands,Europe,176848,37,11168
2021-09-15,channel_islands,Europe,176848,6,11174
2021-09-16,channel_islands,Europe,176848,49,11223
2021-09-17,channel_islands,Europe,176848,46,11269
2021-09-18,channel_islands,Europe,176848,0,11269
2021-09-19,channel_islands,Europe,176848,0,11269
2021-09-20,channel_islands,Europe,176848,66,11335
2021-09-21,channel_islands,Europe,176848,33,11368
2021-09-22,channel_islands,Europe,176848,25,11393
2021-09-23,channel_islands,Europe,176848,34,11427
2021-09-24,channel_islands,Europe,176848,39,11466
2021-09-25,channel_islands,Europe,176848,0,11466
2021-09-26,channel_islands,Europe,176848,0,11466
2021-09-27,channel_islands,Europe,176848,25,11491
2021-09-28,channel_islands,Europe,176848,84,11575
2021-09-29,channel_islands,Europe,176848,30,11605
2021-09-30,channel_islands,Europe,176848,31,11636
2021-10-01,channel_islands,Europe,176848,21,11657
2021-10-02,channel_islands,Europe,176848,0,11657
2021-10-03,channel_islands,Europe,176848,0,11657
2021-10-04,channel_islands,Europe,176848,50,11707
2021-10-05,channel_islands,Europe,176848,30,11737
2021-10-06,channel_islands,Europe,176848,38,11775
2021-10-07,channel_islands,Europe,176848,37,11812
2021-10-08,channel_islands,Europe,176848,31,11843
2021-10-09,channel_islands,Europe,176848,0,11843
2021-10-10,channel_islands,Europe,176848,0,11843
2021-10-11,channel_islands,Europe,176848,125,11968
2021-10-12,channel_islands,Europe,176848,49,12017
2021-10-13,channel_islands,Europe,176848,55,12072
2021-10-14,channel_islands,Europe,176848,63,12135
2021-10-15,channel_islands,Europe,176848,39,12174
2021-10-16,channel_islands,Europe,176848,0,12174
2021-10-17,channel_islands,Europe,176848,0,12174
2021-10-18,channel_islands,Europe,176848,152,12326
2021-10-19,channel_islands,Europe,176848,87,12413
2021-10-20,channel_islands,Europe,176848,54,12467
2021-10-21,channel_islands,Europe,176848,64,12531
2021-10-22,channel_islands,Europe,176848,63,12594
2021-10-23,channel_islands,Europe,176848,0,12594
2021-10-24,channel_islands,Europe,176848,0,12594
2021-10-25,channel_islands,Europe,176848,183,12777
2021-10-26,channel_islands,Europe,176848,50,12827
2021-10-27,channel_islands,Europe,176848,78,12905
2021-10-28,channel_islands,Europe,176848,85,12990
2021-10-29,channel_islands,Europe,176848,80,13070
2021-10-30,channel_islands,Europe,176848,0,13070
2021-10-31,channel_islands,Europe,176848,0,13070
2021-11-01,channel_islands,Europe,176848,253,13323
2021-11-02,channel_islands,Europe,176848,69,13392
2021-11-03,channel_islands,Europe,176848,0,13392
2021-11-04,channel_islands,Europe,176848,179,13571
2021-11-05,channel_islands,Europe,176848,113,13684
2021-11-06,channel_islands,Europe,176848,0,13684
2021-11-07,channel_islands,Europe,176848,0,13684
2021-11-08,channel_islands,Europe,176848,284,13968
2021-11-09,channel_islands,Europe,176848,105,14073
2021-11-10,channel_islands,Europe,176848,117,14190
2021-11-11,channel_islands,Europe,176848,189,14379
2021-11-12,channel_islands,Europe,176848,140,14519
2021-11-13,channel_islands,Europe,176848,0,14519
2021-11-14,channel_islands,Europe,176848,0,14519
2021-11-15,channel_islands,Europe,176848,526,15045
2021-11-16,channel_islands,Europe,176848,135,15180
2021-11-17,channel_islands,Europe,176848,205,15385
2021-11-18,channel_islands,Europe,176848,133,15518
2021-11-19,channel_islands,Europe,176848,174,15692
2021-11-20,channel_islands,Europe,176848,0,15692
2021-11-21,channel_islands,Europe,176848,0,15692
2021-11-22,channel_islands,Europe,176848,587,16279
2021-11-23,channel_islands,Europe,176848,350,16629
2021-11-24,channel_islands,Europe,176848,186,16815
2021-11-25,channel_islands,Europe,176848,301,17116
2021-11-26,channel_islands,Europe,176848,210,17326
2021-11-27,channel_islands,Europe,176848,0,17326
2021-11-28,channel_islands,Europe,176848,0,17326
2021-11-29,channel_islands,Europe,176848,558,17884
2021-11-30,channel_islands,Europe,176848,298,18182
2021-12-01,channel_islands,Europe,176848,219,18401
2021-12-02,channel_islands,Europe,176848,255,18656
2021-12-03,channel_islands,Europe,176848,237,18893
2021-12-04,channel_islands,Europe,176848,0,18893
2021-12-05,channel_islands,Europe,176848,0,18893
2021-12-06,channel_islands,Europe,176848,582,19475
2021-12-07,channel_islands,Europe,176848,231,19706
2021-12-08,channel_islands,Europe,176848,194,19900
2021-12-09,channel_islands,Europe,176848,259,20159
2021-12-10,channel_islands,Europe,176848,168,20327
2021-12-11,channel_islands,Europe,176848,0,20327
2021-12-12,channel_islands,Europe,176848,0,20327
2021-12-13,channel_islands,Europe,176848,516,20843
2021-12-14,channel_islands,Europe,176848,153,20996
2021-12-15,channel_islands,Europe,176848,225,21221
2021-12-16,channel_islands,Europe,176848,236,21457
2021-12-17,channel_islands,Europe,176848,210,21667
2021-12-18,channel_islands,Europe,176848,0,21667
2021-12-19,channel_islands,Europe,176848,0,21667
2021-12-20,channel_islands,Europe,176848,637,22304
2021-12-21,channel_islands,Europe,176848,276,22580
2021-12-22,channel_islands,Europe,176848,296,22876
2021-12-23,channel_islands,Europe,176848,312,23188
2021-12-24,channel_islands,Europe,176848,439,23627
2021-12-25,channel_islands,Europe,176848,0,23627
2021-12-26,channel_islands,Europe,176848,0,23627
2021-12-27,channel_islands,Europe,176848,0,23627
2021-12-28,channel_islands,Europe,176848,0,23627
2021-12-29,channel_islands,Europe,176848,2371,25998
2021-12-30,channel_islands,Europe,176848,801,26799
2021-12-31,channel_islands,Europe,176848,708,27507
2022-01-01,channel_islands,Europe,176848,0,27507
2022-01-02,channel_islands,Europe,176848,0,27507
2022-01-03,channel_islands,Europe,176848,0,27507
2022-01-04,channel_islands,Europe,176848,2517,30024
2022-01-05,channel_islands,Europe,176848,801,30825
2022-01-06,channel_islands,Europe,176848,879,31704
2022-01-07,channel_islands,Europe,176848,705,32409
2022-01-08,channel_islands,Europe,176848,0,32409
2022-01-09,channel_islands,Europe,176848,0,32409
2022-01-10,channel_islands,Europe,176848,1745,34154
2022-01-11,channel_islands,Europe,176848,536,34690
2022-01-12,channel_islands,Europe,176848,436,35126
2022-01-13,channel_islands,Europe,176848,406,35532
2022-01-14,channel_islands,Europe,176848,371,35903
2022-01-15,channel_islands,Europe,176848,0,35903
2022-01-16,channel_islands,Europe,176848,0,35903
2022-01-17,channel_islands,Europe,176848,949,36852
2022-01-18,channel_islands,Europe,176848,392,37244
2022-01-19,channel_islands,Europe,176848,369,37613
2022-01-20,channel_islands,Europe,176848,339,37952
2022-01-21,channel_islands,Europe,176848,280,38232
2022-01-22,channel_islands,Europe,176848,0,38232
2022-01-23,channel_islands,Europe,176848,0,38232
2022-01-24,channel_islands,Europe,176848,920,39152
2022-01-25,channel_islands,Europe,176848,476,39628
2022-01-26,channel_islands,Europe,176848,473,40101
2022-01-27,channel_islands,Europe,176848,442,40543
2022-01-28,channel_islands,Europe,176848,404,40947
2022-01-29,channel_islands,Europe,176848,0,40947
2022-01-30,channel_islands,Europe,176848,0,40947
2022-01-31,channel_islands,Europe,176848,1105,42052
2022-02-01,channel_islands,Europe,176848,415,42467
2022-02-02,channel_islands,Europe,176848,565,43032
2022-02-03,channel_islands,Europe,176848,420,43452
2022-02-04,channel_islands,Europe,176848,287,43739
2022-02-05,channel_islands,Europe,176848,0,43739
2022-02-06,channel_islands,Europe,176848,0,43739
2022-02-07,channel_islands,Europe,176848,1015,44754
2022-02-08,channel_islands,Europe,176848,463,45217
2022-02-09,channel_islands,Europe,176848,361,45578
2022-02-10,channel_islands,Europe,176848,440,46018
2022-02-11,channel_islands,Europe,176848,348,46366
2022-02-12,channel_islands,Europe,176848,0,46366
2022-02-13,channel_islands,Europe,176848,0,46366
2022-02-14,channel_islands,Europe,176848,862,47228
2022-02-15,channel_islands,Europe,176848,336,47564
2020-01-23,china,Asia,1439323776,259,830
2020-01-24,china,Asia,1439323776,457,1287
2020-01-25,china,Asia,1439323776,688,1975
2020-01-26,china,Asia,1439323776,769,2744
2020-01-27,china,Asia,1439323776,1771,4515
2020-01-28,china,Asia,1439323776,1459,5974
2020-01-29,china,Asia,1439323776,1737,7711
2020-01-30,china,Asia,1439323776,1981,9692
2020-01-31,china,Asia,1439323776,2099,11791
2020-02-01,china,Asia,1439323776,2589,14380
2020-02-02,china,Asia,1439323776,2825,17205
2020-02-03,china,Asia,1439323776,3235,20440
2020-02-04,china,Asia,1439323776,3884,24324
2020-02-05,china,Asia,1439323776,3694,28018
2020-02-06,china,Asia,1439323776,3143,31161
2020-02-07,china,Asia,1439323776,3385,34546
2020-02-08,china,Asia,1439323776,2652,37198
2020-02-09,china,Asia,1439323776,2973,40171
2020-02-10,china,Asia,1439323776,2467,42638
2020-02-11,china,Asia,1439323776,2015,44653
2020-02-12,china,Asia,1439323776,14108,58761
2020-02-13,china,Asia,1439323776,5090,63851
2020-02-14,china,Asia,1439323776,2641,66492
2020-02-15,china,Asia,1439323776,2008,68500
2020-02-16,china,Asia,1439323776,2048,70548
2020-02-17,china,Asia,1439323776,1888,72436
2020-02-18,china,Asia,1439323776,1749,74185
2020-02-19,china,Asia,1439323776,391,74576
2020-02-20,china,Asia,1439323776,889,75465
2020-02-21,china,Asia,1439323776,823,76288
2020-02-22,china,Asia,1439323776,648,76936
2020-02-23,china,Asia,1439323776,214,77150
2020-02-24,china,Asia,1439323776,508,77658
2020-02-25,china,Asia,1439323776,406,78064
2020-02-26,china,Asia,1439323776,433,78497
2020-02-27,china,Asia,1439323776,327,78824
2020-02-28,china,Asia,1439323776,427,79251
2020-02-29,china,Asia,1439323776,573,79824
2020-03-01,china,Asia,1439323776,202,80026
2020-03-02,china,Asia,1439323776,125,80151
2020-03-03,china,Asia,1439323776,119,80270
2020-03-04,china,Asia,1439323776,139,80409
2020-03-05,china,Asia,1439323776,143,80552
2020-03-06,china,Asia,1439323776,99,80651
2020-03-07,china,Asia,1439323776,44,80695
2020-03-08,china,Asia,1439323776,40,80735
2020-03-09,china,Asia,1439323776,19,80754
2020-03-10,china,Asia,1439323776,24,80778
2020-03-11,china,Asia,1439323776,15,80793
2020-03-12,china,Asia,1439323776,20,80813
2020-03-13,china,Asia,1439323776,11,80824
2020-03-14,china,Asia,1439323776,20,80844
2020-03-15,china,Asia,1439323776,16,80860
2020-03-16,china,Asia,1439323776,21,80881
2020-03-17,china,Asia,1439323776,13,80894
2020-03-18,china,Asia,1439323776,34,80928
2020-03-19,china,Asia,1439323776,39,80967
2020-03-20,china,Asia,1439323776,41,81008
2020-03-21,china,Asia,1439323776,46,81054
2020-03-22,china,Asia,1439323776,39,81093
2020-03-23,china,Asia,1439323776,78,81171
2020-03-24,china,Asia,1439323776,47,81218
2020-03-25,china,Asia,1439323776,67,81285
2020-03-26,china,Asia,1439323776,55,81340
2020-03-27,china,Asia,1439323776,54,81394
2020-03-28,china,Asia,1439323776,45,81439
2020-03-29,china,Asia,1439323776,0,81439
2020-03-30,china,Asia,1439323776,79,81518
2020-03-31,china,Asia,1439323776,36,81554
2020-04-01,china,Asia,1439323776,35,81589
2020-04-02,china,Asia,1439323776,31,81620
2020-04-03,china,Asia,1439323776,19,81639
2020-04-04,china,Asia,1439323776,30,81669
2020-04-05,china,Asia,1439323776,39,81708
2020-04-06,china,Asia,1439323776,32,81740
2020-04-07,china,Asia,1439323776,62,81802
2020-04-08,china,Asia,1439323776,63,81865
2020-04-09,china,Asia,1439323776,42,81907
2020-04-10,china,Asia,1439323776,46,81953
2020-04-11,china,Asia,1439323776,99,82052
2020-04-12,china,Asia,1439323776,108,82160
2020-04-13,china,Asia,1439323776,89,82249
2020-04-14,china,Asia,1439323776,46,82295
2020-04-15,china,Asia,1439323776,46,82341
2020-04-16,china,Asia,1439323776,26,82367
2020-04-17,china,Asia,1439323776,325,82692
2020-04-18,china,Asia,1439323776,27,82719
2020-04-19,china,Asia,1439323776,16,82735
2020-04-20,china,Asia,1439323776,12,82747
2020-04-21,china,Asia,1439323776,11,82758
2020-04-22,china,Asia,1439323776,30,82788
2020-04-23,china,Asia,1439323776,10,82798
2020-04-24,china,Asia,1439323776,6,82804
2020-04-25,china,Asia,1439323776,12,82816
2020-04-26,china,Asia,1439323776,11,82827
2020-04-27,china,Asia,1439323776,3,82830
2020-04-28,china,Asia,1439323776,6,82836
2020-04-29,china,Asia,1439323776,22,82858
2020-04-30,china,Asia,1439323776,4,82862
2020-05-01,china,Asia,1439323776,12,82874
2020-05-02,china,Asia,1439323776,1,82875
2020-05-03,china,Asia,1439323776,2,82877
2020-05-04,china,Asia,1439323776,3,82880
2020-05-05,china,Asia,1439323776,1,82881
2020-05-06,china,Asia,1439323776,2,82883
2020-05-07,china,Asia,1439323776,2,82885
2020-05-08,china,Asia,1439323776,1,82886
2020-05-09,china,Asia,1439323776,1,82887
2020-05-10,china,Asia,1439323776,14,82901
2020-05-11,china,Asia,1439323776,17,82918
2020-05-12,china,Asia,1439323776,1,82919
2020-05-13,china,Asia,1439323776,7,82926
2020-05-14,china,Asia,1439323776,3,82929
2020-05-15,china,Asia,1439323776,4,82933
2020-05-16,china,Asia,1439323776,8,82941
2020-05-17,china,Asia,1439323776,6,82947
2020-05-18,china,Asia,1439323776,7,82954
2020-05-19,china,Asia,1439323776,6,82960
2020-05-20,china,Asia,1439323776,5,82965
2020-05-21,china,Asia,1439323776,2,82967
2020-05-22,china,Asia,1439323776,4,82971
2020-05-23,china,Asia,1439323776,0,82971
2020-05-24,china,Asia,1439323776,3,82974
2020-05-25,china,Asia,1439323776,11,82985
2020-05-26,china,Asia,1439323776,7,82992
2020-05-27,china,Asia,1439323776,1,82993
2020-05-28,china,Asia,1439323776,2,82995
2020-05-29,china,Asia,1439323776,0,82995
2020-03-23,colombia,South America,51892950,46,277
2020-03-24,colombia,South America,51892950,101,378
2020-03-25,colombia,South America,51892950,92,470
2020-03-26,colombia,South America,51892950,21,491
2020-03-27,colombia,South America,51892950,48,539
2020-03-28,colombia,South America,51892950,69,608
2020-03-29,colombia,South America,51892950,94,702
2020-03-30,colombia,South America,51892950,96,798
2020-03-31,colombia,South America,51892950,108,906
2020-04-01,colombia,South America,51892950,159,1065
2020-04-02,colombia,South America,51892950,96,1161
2020-04-03,colombia,South America,51892950,106,1267
2020-04-04,colombia,South America,51892950,139,1406
2020-04-05,colombia,South America,51892950,79,1485
2020-04-06,colombia,South America,51892950,94,1579
2020-04-07,colombia,South America,51892950,201,1780
2020-04-08,colombia,South America,51892950,274,2054
2020-04-09,colombia,South America,51892950,169,2223
2020-04-10,colombia,South America,51892950,250,2473
2020-04-11,colombia,South America,51892950,236,2709
2020-04-12,colombia,South America,51892950,67,2776
2020-04-13,colombia,South America,51892950,76,2852
2020-04-14,colombia,South America,51892950,127,2979
2020-04-15,colombia,South America,51892950,126,3105
2020-04-16,colombia,South America,51892950,128,3233
2020-04-17,colombia,South America,51892950,206,3439
2020-04-18,colombia,South America,51892950,182,3621
2020-04-19,colombia,South America,51892950,171,3792
2020-04-20,colombia,South America,51892950,185,3977
2020-04-21,colombia,South America,51892950,172,4149
2020-04-22,colombia,South America,51892950,207,4356
2020-04-23,colombia,South America,51892950,205,4561
2020-04-24,colombia,South America,51892950,320,4881
2020-04-25,colombia,South America,51892950,261,5142
2020-04-26,colombia,South America,51892950,237,5379
2020-04-27,colombia,South America,51892950,218,5597
2020-04-28,colombia,South America,51892950,352,5949
2020-04-29,colombia,South America,51892950,258,6207
2020-04-30,colombia,South America,51892950,300,6507
2020-05-01,colombia,South America,51892950,499,7006
2020-05-02,colombia,South America,51892950,279,7285
2020-05-03,colombia,South America,51892950,383,7668
2020-05-04,colombia,South America,51892950,305,7973
2020-05-05,colombia,South America,51892950,640,8613
2020-05-06,colombia,South America,51892950,346,8959
2020-05-07,colombia,South America,51892950,497,9456
2020-05-08,colombia,South America,51892950,595,10051
2020-05-09,colombia,South America,51892950,444,10495
2020-05-10,colombia,South America,51892950,568,11063
2020-05-11,colombia,South America,51892950,550,11613
2020-05-12,colombia,South America,51892950,659,12272
2020-05-13,colombia,South America,51892950,658,12930
2020-05-14,colombia,South America,51892950,680,13610
2020-05-15,colombia,South America,51892950,606,14216
2020-05-16,colombia,South America,51892950,723,14939
2020-05-17,colombia,South America,51892950,635,15574
2020-05-18,colombia,South America,51892950,721,16295
2020-05-19,colombia,South America,51892950,640,16935
2020-05-20,colombia,South America,51892950,752,17687
2020-05-21,colombia,South America,51892950,643,18330
2020-05-22,colombia,South America,51892950,801,19131
2020-05-23,colombia,South America,51892950,1046,20177
2020-05-24,colombia,South America,51892950,998,21175
2020-05-25,colombia,South America,51892950,806,21981
2020-05-26,colombia,South America,51892950,1022,23003
2020-05-27,colombia,South America,51892950,1101,24104
2020-05-28,colombia,South America,51892950,1262,25366
2020-05-29,colombia,South America,51892950,1322,26688
2020-05-30,colombia,South America,51892950,1548,28236
2020-05-31,colombia,South America,51892950,1147,29383
2020-06-01,colombia,South America,51892950,1110,30493
2020-06-02,colombia,South America,51892950,1340,31833
2020-06-03,colombia,South America,51892950,1521,33354
2020-06-04,colombia,South America,51892950,1766,35120
2020-06-05,colombia,South America,51892950,1515,36635
2020-06-06,colombia,South America,51892950,1392,38027
2020-06-07,colombia,South America,51892950,1209,39236
2020-06-08,colombia,South America,51892950,1483,40719
2020-06-09,colombia,South America,51892950,1359,42078
2020-06-10,colombia,South America,51892950,1604,43682
2020-06-11,colombia,South America,51892950,1530,45212
2020-06-12,colombia,South America,51892950,1646,46858
2020-06-13,colombia,South America,51892950,1888,48746
2020-06-14,colombia,South America,51892950,2193,50939
2020-06-15,colombia,South America,51892950,2124,53063
2020-06-16,colombia,South America,51892950,1868,54931
2020-06-17,colombia,South America,51892950,2115,57046
2020-06-18,colombia,South America,51892950,3171,60217
2020-06-19,colombia,South America,51892950,3059,63276
2020-06-20,colombia,South America,51892950,2357,65633
2020-06-21,colombia,South America,51892950,3019,68652
2020-06-22,colombia,South America,51892950,2531,71183
2020-06-23,colombia,South America,51892950,2389,73572
2020-06-24,colombia,South America,51892950,3541,77113
2020-06-25,colombia,South America,51892950,3486,80599
2020-06-26,colombia,South America,51892950,3843,84442
2020-06-27,colombia,South America,51892950,4149,88591
2020-06-28,colombia,South America,51892950,3178,91769
2020-06-29,colombia,South America,51892950,3274,95043
2020-06-30,colombia,South America,51892950,2803,97846
2020-07-01,colombia,South America,51892950,4163,102009
2020-07-02,colombia,South America,51892950,4101,106110
2020-07-03,colombia,South America,51892950,3395,109505
2020-07-04,colombia,South America,51892950,3884,113389
2020-07-05,colombia,South America,51892950,3721,117110
2020-07-06,colombia,South America,51892950,3171,120281
2020-07-07,colombia,South America,51892950,4213,124494
2020-07-08,colombia,South America,51892950,4144,128638
2020-07-09,colombia,South America,51892950,5335,133973
2020-07-10,colombia,South America,51892950,6803,140776
2020-07-11,colombia,South America,51892950,4586,145362
2020-07-12,colombia,South America,51892950,5083,150445
2020-07-13,colombia,South America,51892950,3832,154277
2020-07-14,colombia,South America,51892950,5621,159898
2020-07-15,colombia,South America,51892950,5271,165169
2020-07-16,colombia,South America,51892950,8037,173206
2020-07-17,colombia,South America,51892950,8934,182140
2020-07-18,colombia,South America,51892950,8560,190700
2020-07-19,colombia,South America,51892950,6578,197278
2020-07-20,colombia,South America,51892950,6727,204005
2020-07-21,colombia,South America,51892950,7033,211038
2020-07-22,colombia,South America,51892950,7390,218428
2020-07-23,colombia,South America,51892950,7945,226373
2020-07-24,colombia,South America,51892950,7168,233541
2020-07-25,colombia,South America,51892950,7254,240795
2020-07-26,colombia,South America,51892950,8181,248976
2020-07-27,colombia,South America,51892950,8125,257101
2020-07-28,colombia,South America,51892950,10284,267385
2020-07-29,colombia,South America,51892950,8670,276055
2020-07-30,colombia,South America,51892950,9965,286020
2020-07-31,colombia,South America,51892950,9488,295508
2020-08-01,colombia,South America,51892950,10673,306181
2020-08-02,colombia,South America,51892950,11470,317651
2020-08-03,colombia,South America,51892950,10199,327850
2020-08-04,colombia,South America,51892950,7129,334979
2020-08-05,colombia,South America,51892950,10735,345714
2020-08-06,colombia,South America,51892950,11996,357710
2020-08-07,colombia,South America,51892950,9486,367196
2020-08-08,colombia,South America,51892950,9674,376870
2020-08-09,colombia,South America,51892950,10611,387481
2020-08-10,colombia,South America,51892950,10142,397623
2020-08-11,colombia,South America,51892950,12830,410453
2020-08-12,colombia,South America,51892950,12066,422519
2020-08-13,colombia,South America,51892950,11286,433805
2020-08-14,colombia,South America,51892950,11306,445111
2020-08-15,colombia,South America,51892950,11578,456689
2020-08-16,colombia,South America,51892950,11643,468332
2020-08-17,colombia,South America,51892950,8328,476660
2020-08-18,colombia,South America,51892950,12462,489122
2020-08-19,colombia,South America,51892950,13056,502178
2020-08-20,colombia,South America,51892950,11541,513719
2020-08-21,colombia,South America,51892950,8419,522138
2020-08-22,colombia,South America,51892950,10965,533103
2020-08-23,colombia,South America,51892950,8044,541147
2020-08-24,colombia,South America,51892950,10549,551696
2020-08-25,colombia,South America,51892950,10432,562128
2020-08-26,colombia,South America,51892950,10142,572270
2020-08-27,colombia,South America,51892950,9752,582022
2020-08-28,colombia,South America,51892950,8498,590520
2020-08-29,colombia,South America,51892950,9394,599914
2020-08-30,colombia,South America,51892950,8024,607938
2020-08-31,colombia,South America,51892950,7230,615168
2020-09-01,colombia,South America,51892950,8901,624069
2020-09-02,colombia,South America,51892950,9270,633339
2020-09-03,colombia,South America,51892950,8235,641574
2020-09-04,colombia,South America,51892950,8488,650062
2020-09-05,colombia,South America,51892950,8394,658456
2020-09-06,colombia,South America,51892950,8065,666521
2020-09-07,colombia,South America,51892950,5327,671848
2020-09-08,colombia,South America,51892950,7665,679513
2020-09-09,colombia,South America,51892950,7343,686856
2020-09-10,colombia,South America,51892950,7808,694664
2020-09-11,colombia,South America,51892950,7424,702088
2020-09-12,colombia,South America,51892950,6876,708964
2020-09-13,colombia,South America,51892950,7355,716319
2020-09-14,colombia,South America,51892950,5573,721892
2020-09-15,colombia,South America,51892950,6698,728590
2020-09-16,colombia,South America,51892950,7787,736377
2020-09-17,colombia,South America,51892950,7568,743945
2020-09-18,colombia,South America,51892950,6526,750471
2020-09-19,colombia,South America,51892950,7927,758398
2020-09-20,colombia,South America,51892950,6678,765076
2020-09-21,colombia,South America,51892950,5359,770435
2020-09-22,colombia,South America,51892950,7102,777537
2020-09-23,colombia,South America,51892950,6731,784268
2020-09-24,colombia,South America,51892950,6555,790823
2020-09-25,colombia,South America,51892950,7494,798317
2020-09-26,colombia,South America,51892950,7721,806038
2020-09-27,colombia,South America,51892950,7018,813056
2020-09-28,colombia,South America,51892950,5147,818203
2020-09-29,colombia,South America,51892950,5839,824042
2020-09-30,colombia,South America,51892950,5637,829679
2020-10-01,colombia,South America,51892950,5660,835339
2020-10-02,colombia,South America,51892950,6192,841531
2020-10-03,colombia,South America,51892950,6616,848147
2020-10-04,colombia,South America,51892950,6905,855052
2020-10-05,colombia,South America,51892950,7106,862158
2020-10-06,colombia,South America,51892950,7650,869808
2020-10-07,colombia,South America,51892950,7875,877683
2020-10-08,colombia,South America,51892950,8496,886179
2020-10-09,colombia,South America,51892950,8121,894300
2020-10-10,colombia,South America,51892950,8447,902747
2020-10-11,colombia,South America,51892950,8569,911316
2020-10-12,colombia,South America,51892950,7767,919083
2020-10-13,colombia,South America,51892950,5015,924098
2020-10-14,colombia,South America,51892950,6061,930159
2020-10-15,colombia,South America,51892950,6823,936982
2020-10-16,colombia,South America,51892950,8372,945354
2020-10-17,colombia,South America,51892950,7017,952371
2020-10-18,colombia,South America,51892950,7201,959572
2020-10-19,colombia,South America,51892950,6311,965883
2020-10-20,colombia,South America,51892950,8256,974139
2020-10-21,colombia,South America,51892950,7561,981700
2020-10-22,colombia,South America,51892950,8570,990270
2020-10-23,colombia,South America,51892950,8672,998942
2020-10-24,colombia,South America,51892950,8769,1007711
2020-10-25,colombia,South America,51892950,8174,1015885
2020-10-26,colombia,South America,51892950,9167,1025052
2020-10-27,colombia,South America,51892950,8166,1033218
2020-10-28,colombia,South America,51892950,8717,1041935
2020-10-29,colombia,South America,51892950,11187,1053122
2020-10-30,colombia,South America,51892950,10029,1063151
2020-10-31,colombia,South America,51892950,11033,1074184
2020-11-01,colombia,South America,51892950,9137,1083321
2020-11-02,colombia,South America,51892950,9935,1093256
2020-11-03,colombia,South America,51892950,6136,1099392
2020-11-04,colombia,South America,51892950,8692,1108084
2020-11-05,colombia,South America,51892950,9893,1117977
2020-11-06,colombia,South America,51892950,9756,1127733
2020-11-07,colombia,South America,51892950,8714,1136447
2020-11-08,colombia,South America,51892950,7440,1143887
2020-11-09,colombia,South America,51892950,5176,1149063
2020-11-10,colombia,South America,51892950,7612,1156675
2020-11-11,colombia,South America,51892950,8651,1165326
2020-11-12,colombia,South America,51892950,8686,1174012
2020-11-13,colombia,South America,51892950,8685,1182697
2020-11-14,colombia,South America,51892950,8307,1191004
2020-11-15,colombia,South America,51892950,7742,1198746
2020-11-16,colombia,South America,51892950,6471,1205217
2020-11-17,colombia,South America,51892950,5911,1211128
2020-11-18,colombia,South America,51892950,6875,1218003
2020-11-19,colombia,South America,51892950,7487,1225490
2020-11-20,colombia,South America,51892950,7954,1233444
2020-11-21,colombia,South America,51892950,7049,1240493
2020-11-22,colombia,South America,51892950,7924,1248417
2020-11-23,colombia,South America,51892950,6562,1254979
2020-11-24,colombia,South America,51892950,7515,1262494
2020-11-25,colombia,South America,51892950,8497,1270991
2020-11-26,colombia,South America,51892950,9496,1280487
2020-11-27,colombia,South America,51892950,10023,1290510
2020-11-28,colombia,South America,51892950,9103,1299613
2020-11-29,colombia,South America,51892950,8763,1308376
2020-11-30,colombia,South America,51892950,8430,1316806
2020-12-01,colombia,South America,51892950,7986,1324792
2020-12-02,colombia,South America,51892950,9297,1334089
2020-12-03,colombia,South America,51892950,9233,1343322
2020-12-04,colombia,South America,51892950,9285,1352607
2020-12-05,colombia,South America,51892950,9642,1362249
2020-12-06,colombia,South America,51892950,8854,1371103
2020-12-07,colombia,South America,51892950,5997,1377100
2020-12-08,colombia,South America,51892950,7510,1384610
2020-12-09,colombia,South America,51892950,7523,1392133
2020-12-10,colombia,South America,51892950,7778,1399911
2020-12-11,colombia,South America,51892950,8998,1408909
2020-12-12,colombia,South America,51892950,8163,1417072
2020-12-13,colombia,South America,51892950,8702,1425774
2020-12-14,colombia,South America,51892950,8742,1434516
2020-12-15,colombia,South America,51892950,10130,1444646
2020-12-16,colombia,South America,51892950,11953,1456599
2020-12-17,colombia,South America,51892950,12196,1468795
2020-12-18,colombia,South America,51892950,13277,1482072
2020-12-19,colombia,South America,51892950,13990,1496062
2020-12-20,colombia,South America,51892950,11160,1507222
2020-12-21,colombia,South America,51892950,10845,1518067
2020-12-22,colombia,South America,51892950,12526,1530593
2020-12-23,colombia,South America,51892950,14233,1544826
2020-12-24,colombia,South America,51892950,14940,1559766
2020-12-25,colombia,South America,51892950,14941,1574707
2020-12-26,colombia,South America,51892950,10196,1584903
2020-12-27,colombia,South America,51892950,9594,1594497
2020-12-28,colombia,South America,51892950,9310,1603807
2020-12-29,colombia,South America,51892950,11015,1614822
2020-12-30,colombia,South America,51892950,11639,1626461
2020-12-31,colombia,South America,51892950,16314,1642775
2021-01-01,colombia,South America,51892950,12105,1654880
2020-05-07,comoros,Africa,904091,0,8
2020-05-08,comoros,Africa,904091,0,8
2020-05-09,comoros,Africa,904091,3,11
2020-05-10,comoros,Africa,904091,0,11
2020-05-11,comoros,Africa,904091,0,11
2020-05-12,comoros,Africa,904091,0,11
2020-05-13,comoros,Africa,904091,0,11
2020-05-14,comoros,Africa,904091,0,11
2020-05-15,comoros,Africa,904091,0,11
2020-05-16,comoros,Africa,904091,0,11
2020-05-17,comoros,Africa,904091,0,11
2020-05-18,comoros,Africa,904091,0,11
2020-05-19,comoros,Africa,904091,0,11
2020-05-20,comoros,Africa,904091,23,34
2020-05-21,comoros,Africa,904091,0,34
2020-05-22,comoros,Africa,904091,44,78
2020-05-23,comoros,Africa,904091,0,78
2020-05-24,comoros,Africa,904091,9,87
2020-05-25,comoros,Africa,904091,0,87
2020-05-26,comoros,Africa,904091,0,87
2020-05-27,comoros,Africa,904091,0,87
2020-05-28,comoros,Africa,904091,0,87
2020-05-29,comoros,Africa,904091,0,87
2020-05-30,comoros,Africa,904091,19,106
2020-05-31,comoros,Africa,904091,0,106
2020-06-01,comoros,Africa,904091,0,106
2020-06-02,comoros,Africa,904091,26,132
2020-06-03,comoros,Africa,904091,0,132
2020-06-04,comoros,Africa,904091,0,132
2020-06-05,comoros,Africa,904091,0,132
2020-06-06,comoros,Africa,904091,9,141
2020-06-07,comoros,Africa,904091,0,141
2020-06-08,comoros,Africa,904091,0,141
2020-06-09,comoros,Africa,904091,0,141
2020-06-10,comoros,Africa,904091,21,162
2020-06-11,comoros,Africa,904091,0,162
2020-06-12,comoros,Africa,904091,1,163
2020-06-13,comoros,Africa,904091,13,176
2020-06-14,comoros,Africa,904091,0,176
2020-06-15,comoros,Africa,904091,0,176
2020-06-16,comoros,Africa,904091,21,197
2020-06-17,comoros,Africa,904091,0,197
2020-06-18,comoros,Africa,904091,13,210
2020-06-19,comoros,Africa,904091,0,210
2020-06-20,comoros,Africa,904091,37,247
2020-06-21,comoros,Africa,904091,0,247
2020-06-22,comoros,Africa,904091,0,247
2020-06-23,comoros,Africa,904091,18,265
2020-06-24,comoros,Africa,904091,0,265
2020-06-25,comoros,Africa,904091,7,272
2020-06-26,comoros,Africa,904091,0,272
2020-06-27,comoros,Africa,904091,0,272
2020-06-28,comoros,Africa,904091,0,272
2020-06-29,comoros,Africa,904091,0,272
2020-06-30,comoros,Africa,904091,31,303
2020-07-01,comoros,Africa,904091,0,303
2020-07-02,comoros,Africa,904091,0,303
2020-07-03,comoros,Africa,904091,6,309
2020-07-04,comoros,Africa,904091,0,309
2020-07-05,comoros,Africa,904091,2,311
2020-07-06,comoros,Africa,904091,0,311
2020-07-07,comoros,Africa,904091,0,311
2020-07-08,comoros,Africa,904091,2,313
2020-07-09,comoros,Africa,904091,1,314
2020-07-10,comoros,Africa,904091,0,314
2020-07-11,comoros,Africa,904091,3,317
2020-07-12,comoros,Africa,904091,0,317
2020-07-13,comoros,Africa,904091,0,317
2020-07-14,comoros,Africa,904091,4,321
2020-07-15,comoros,Africa,904091,0,321
2020-07-16,comoros,Africa,904091,7,328
2020-07-17,comoros,Africa,904091,0,328
2020-07-18,comoros,Africa,904091,0,328
2020-07-19,comoros,Africa,904091,6,334
2020-07-20,comoros,Africa,904091,0,334
2020-07-21,comoros,Africa,904091,3,337
2020-07-22,comoros,Africa,904091,0,337
2020-07-23,comoros,Africa,904091,3,340
2020-07-24,comoros,Africa,904091,0,340
2020-07-25,comoros,Africa,904091,14,354
2020-07-26,comoros,Africa,904091,0,354
2020-07-27,comoros,Africa,904091,0,354
2020-07-28,comoros,Africa,904091,0,354
2020-07-29,comoros,Africa,904091,24,378
2020-07-30,comoros,Africa,904091,0,378
2020-07-31,comoros,Africa,904091,0,378
2020-08-01,comoros,Africa,904091,8,386
2020-08-02,comoros,Africa,904091,0,386
2020-08-03,comoros,Africa,904091,0,386
2020-08-04,comoros,Africa,904091,2,388
2020-08-05,comoros,Africa,904091,0,388
2020-08-06,comoros,Africa,904091,8,396
2020-08-07,comoros,Africa,904091,0,396
2020-08-08,comoros,Africa,904091,3,399
2020-08-09,comoros,Africa,904091,0,399
2020-08-10,comoros,Africa,904091,0,399
2020-08-11,comoros,Africa,904091,0,399
2020-08-12,comoros,Africa,904091,0,399
2020-08-13,comoros,Africa,904091,0,399
2020-08-14,comoros,Africa,904091,4,403
2020-08-15,comoros,Africa,904091,0,403
2020-08-16,comoros,Africa,904091,2,405
2020-08-17,comoros,Africa,904091,0,405
2020-08-18,comoros,Africa,904091,1,406
2020-08-19,comoros,Africa,904091,0,406
2020-08-20,comoros,Africa,904091,11,417
2020-08-21,comoros,Africa,904091,0,417
2020-08-22,comoros,Africa,904091,0,417
2020-08-23,comoros,Africa,904091,0,417
2020-08-24,comoros,Africa,904091,0,417
2020-08-25,comoros,Africa,904091,0,417
2020-08-26,comoros,Africa,904091,0,417
2020-08-27,comoros,Africa,904091,5,422
2020-08-28,comoros,Africa,904091,0,422
2020-08-29,comoros,Africa,904091,1,423
2020-08-30,comoros,Africa,904091,0,423
2020-08-31,comoros,Africa,904091,0,423
2020-09-01,comoros,Africa,904091,4,427
2020-09-02,comoros,Africa,904091,0,427
2020-09-03,comoros,Africa,904091,21,448
2020-09-04,comoros,Africa,904091,0,448
2020-09-05,comoros,Africa,904091,4,452
2020-09-06,comoros,Africa,904091,0,452
2020-09-07,comoros,Africa,904091,0,452
2020-09-08,comoros,Africa,904091,4,456
2020-09-09,comoros,Africa,904091,0,456
2020-09-10,comoros,Africa,904091,0,456
2020-09-11,comoros,Africa,904091,0,456
2020-09-12,comoros,Africa,904091,0,456
2020-09-13,comoros,Africa,904091,0,456
2020-09-14,comoros,Africa,904091,1,457
2020-09-15,comoros,Africa,904091,10,467
2020-09-16,comoros,Africa,904091,0,467
2020-09-17,comoros,Africa,904091,3,470
2020-09-18,comoros,Africa,904091,0,470
2020-09-19,comoros,Africa,904091,0,470
2020-09-20,comoros,Africa,904091,0,470
2020-09-21,comoros,Africa,904091,0,470
2020-09-22,comoros,Africa,904091,0,470
2020-09-23,comoros,Africa,904091,0,470
2020-09-24,comoros,Africa,904091,4,474
2020-09-25,comoros,Africa,904091,0,474
2020-09-26,comoros,Africa,904091,4,478
2020-09-27,comoros,Africa,904091,0,478
2020-09-28,comoros,Africa,904091,0,478
2020-09-29,comoros,Africa,904091,1,479
2020-09-30,comoros,Africa,904091,0,479
2020-10-01,comoros,Africa,904091,5,484
2020-10-02,comoros,Africa,904091,0,484
2020-10-03,comoros,Africa,904091,3,487
2020-10-04,comoros,Africa,904091,0,487
2020-10-05,comoros,Africa,904091,0,487
2020-10-06,comoros,Africa,904091,4,491
2020-10-07,comoros,Africa,904091,0,491
2020-10-08,comoros,Africa,904091,4,495
2020-10-09,comoros,Africa,904091,0,495
2020-10-10,comoros,Africa,904091,0,495
2020-10-11,comoros,Africa,904091,0,495
2020-10-12,comoros,Africa,904091,0,495
2020-10-13,comoros,Africa,904091,1,496
2020-10-14,comoros,Africa,904091,0,496
2020-10-15,comoros,Africa,904091,0,496
2020-10-16,comoros,Africa,904091,6,502
2020-10-17,comoros,Africa,904091,0,502
2020-10-18,comoros,Africa,904091,0,502
2020-10-19,comoros,Africa,904091,0,502
2020-10-20,comoros,Africa,904091,2,504
2020-10-21,comoros,Africa,904091,0,504
2020-10-22,comoros,Africa,904091,13,517
2020-10-23,comoros,Africa,904091,0,517
2020-10-24,comoros,Africa,904091,0,517
2020-10-25,comoros,Africa,904091,0,517
2020-10-26,comoros,Africa,904091,0,517
2020-10-27,comoros,Africa,904091,0,517
2020-10-28,comoros,Africa,904091,0,517
2020-10-29,comoros,Africa,904091,0,517
2020-10-30,comoros,Africa,904091,20,537
2020-10-31,comoros,Africa,904091,8,545
2020-11-01,comoros,Africa,904091,0,545
2020-11-02,comoros,Africa,904091,0,545
2020-11-03,comoros,Africa,904091,0,545
2020-11-04,comoros,Africa,904091,9,554
2020-11-05,comoros,Africa,904091,3,557
2020-11-06,comoros,Africa,904091,0,557
2020-11-07,comoros,Africa,904091,6,563
2020-11-08,comoros,Africa,904091,0,563
2020-11-09,comoros,Africa,904091,0,563
2020-11-10,comoros,Africa,904091,6,569
2020-11-11,comoros,Africa,904091,0,569
2020-11-12,comoros,Africa,904091,5,574
2020-11-13,comoros,Africa,904091,0,574
2020-11-14,comoros,Africa,904091,5,579
2020-11-15,comoros,Africa,904091,0,579
2020-11-16,comoros,Africa,904091,0,579
2020-11-17,comoros,Africa,904091,12,591
2020-11-18,comoros,Africa,904091,0,591
2020-11-19,comoros,Africa,904091,1,592
2020-11-20,comoros,Africa,904091,0,592
2020-11-21,comoros,Africa,904091,4,596
2020-11-22,comoros,Africa,904091,0,596
2020-11-23,comoros,Africa,904091,0,596
2020-11-24,comoros,Africa,904091,11,607
2020-11-25,comoros,Africa,904091,0,607
2020-11-26,comoros,Africa,904091,3,610
2020-11-27,comoros,Africa,904091,0,610
2020-11-28,comoros,Africa,904091,1,611
2020-11-29,comoros,Africa,904091,0,611
2020-11-30,comoros,Africa,904091,0,611
2020-12-01,comoros,Africa,904091,2,613
2020-12-02,comoros,Africa,904091,0,613
2020-12-03,comoros,Africa,904091,2,615
2020-12-04,comoros,Africa,904091,0,615
2020-12-05,comoros,Africa,904091,1,616
2020-12-06,comoros,Africa,904091,0,616
2020-12-07,comoros,Africa,904091,0,616
2020-12-08,comoros,Africa,904091,1,617
2020-12-09,comoros,Africa,904091,0,617
2020-12-10,comoros,Africa,904091,0,617
2020-12-11,comoros,Africa,904091,0,617
2020-12-12,comoros,Africa,904091,11,628
2020-12-13,comoros,Africa,904091,0,628
2020-12-14,comoros,Africa,904091,0,628
2020-12-15,comoros,Africa,904091,5,633
2020-12-16,comoros,Africa,904091,0,633
2020-12-17,comoros,Africa,904091,10,643
2020-12-18,comoros,Africa,904091,0,643
2020-12-19,comoros,Africa,904091,0,643
2020-12-20,comoros,Africa,904091,23,666
2020-12-21,comoros,Africa,904091,0,666
2020-12-22,comoros,Africa,904091,27,693
2020-12-23,comoros,Africa,904091,0,693
2020-12-24,comoros,Africa,904091,22,715
2020-12-25,comoros,Africa,904091,0,715
2020-12-26,comoros,Africa,904091,0,715
2020-12-27,comoros,Africa,904091,0,715
2020-12-28,comoros,Africa,904091,16,731
2020-12-29,comoros,Africa,904091,34,765
2020-12-30,comoros,Africa,904091,0,765
2020-12-31,comoros,Africa,904091,58,823
2021-01-01,comoros,Africa,904091,0,823
2021-01-02,comoros,Africa,904091,41,864
2021-01-03,comoros,Africa,904091,0,864
2021-01-04,comoros,Africa,904091,0,864
2021-01-05,comoros,Africa,904091,131,995
2021-01-06,comoros,Africa,904091,0,995
2021-01-07,comoros,Africa,904091,55,1050
2021-01-08,comoros,Africa,904091,0,1050
2021-01-09,comoros,Africa,904091,100,1150
2021-01-10,comoros,Africa,904091,0,1150
2021-01-11,comoros,Africa,904091,10,1160
2021-01-12,comoros,Africa,904091,6,1166
2021-01-13,comoros,Africa,904091,175,1341
2021-01-14,comoros,Africa,904091,62,1403
2021-01-15,comoros,Africa,904091,66,1469
2021-01-16,comoros,Africa,904091,108,1577
2021-01-17,comoros,Africa,904091,15,1592
2021-01-18,comoros,Africa,904091,177,1769
2021-01-19,comoros,Africa,904091,95,1864
2021-01-20,comoros,Africa,904091,69,1933
2021-01-21,comoros,Africa,904091,0,1933
2021-01-22,comoros,Africa,904091,227,2160
2021-01-23,comoros,Africa,904091,100,2260
2021-01-24,comoros,Africa,904091,8,2268
2021-01-25,comoros,Africa,904091,82,2350
2021-01-26,comoros,Africa,904091,75,2425
2021-01-27,comoros,Africa,904091,67,2492
2021-01-28,comoros,Africa,904091,106,2598
2021-01-29,comoros,Africa,904091,48,2646
2021-01-30,comoros,Africa,904091,72,2718
2021-01-31,comoros,Africa,904091,8,2726
2021-02-01,comoros,Africa,904091,85,2811
2021-02-02,comoros,Africa,904091,37,2848
2021-02-03,comoros,Africa,904091,44,2892
2021-02-04,comoros,Africa,904091,83,2975
2021-02-05,comoros,Africa,904091,26,3001
2021-02-06,comoros,Africa,904091,85,3086
2021-02-07,comoros,Africa,904091,2,3088
2021-02-08,comoros,Africa,904091,0,3088
2021-02-09,comoros,Africa,904091,91,3179
2021-02-10,comoros,Africa,904091,30,3209
2021-02-11,comoros,Africa,904091,67,3276
2021-02-12,comoros,Africa,904091,14,3290
2021-02-13,comoros,Africa,904091,42,3332
2021-02-14,comoros,Africa,904091,2,3334
2021-02-15,comoros,Africa,904091,24,3358
2021-02-16,comoros,Africa,904091,35,3393
2021-02-17,comoros,Africa,904091,20,3413
2021-02-18,comoros,Africa,904091,45,3458
2021-02-19,comoros,Africa,904091,15,3473
2021-02-20,comoros,Africa,904091,17,3490
2021-02-21,comoros,Africa,904091,12,3502
2021-02-22,comoros,Africa,904091,16,3518
2021-02-23,comoros,Africa,904091,4,3522
2021-02-24,comoros,Africa,904091,17,3539
2021-02-25,comoros,Africa,904091,13,3552
2021-02-26,comoros,Africa,904091,6,3558
2021-02-27,comoros,Africa,904091,13,3571
2021-02-28,comoros,Africa,904091,0,3571
2021-03-01,comoros,Africa,904091,7,3578
2021-03-02,comoros,Africa,904091,0,3578
2021-03-03,comoros,Africa,904091,2,3580
2021-03-04,comoros,Africa,904091,0,3580
2021-03-05,comoros,Africa,904091,7,3587
2021-03-06,comoros,Africa,904091,9,3596
2021-03-07,comoros,Africa,904091,0,3596
2021-03-08,comoros,Africa,904091,10,3606
2021-03-09,comoros,Africa,904091,0,3606
2021-03-10,comoros,Africa,904091,5,3611
2021-03-11,comoros,Africa,904091,4,3615
2021-03-12,comoros,Africa,904091,3,3618
2021-03-13,comoros,Africa,904091,8,3626
2021-03-14,comoros,Africa,904091,9,3635
2021-03-15,comoros,Africa,904091,11,3646
2021-03-16,comoros,Africa,904091,1,3647
2021-03-17,comoros,Africa,904091,5,3652
2021-03-18,comoros,Africa,904091,5,3657
2021-03-19,comoros,Africa,904091,8,3665
2021-03-20,comoros,Africa,904091,1,3666
2021-03-21,comoros,Africa,904091,0,3666
2021-03-22,comoros,Africa,904091,0,3666
2021-03-23,comoros,Africa,904091,15,3681
2021-03-24,comoros,Africa,904091,1,3682
2021-03-25,comoros,Africa,904091,5,3687
2021-03-26,comoros,Africa,904091,2,3689
2021-03-27,comoros,Africa,904091,1,3690
2021-03-28,comoros,Africa,904091,0,3690
2021-03-29,comoros,Africa,904091,6,3696
2021-03-30,comoros,Africa,904091,0,3696
2021-03-31,comoros,Africa,904091,0,3696
2021-04-01,comoros,Africa,904091,8,3704
2021-04-02,comoros,Africa,904091,8,3712
2021-04-03,comoros,Africa,904091,0,3712
2021-04-04,comoros,Africa,904091,7,3719
2021-04-05,comoros,Africa,904091,6,3725
2021-04-06,comoros,Africa,904091,13,3738
2021-04-07,comoros,Africa,904091,20,3758
2021-04-08,comoros,Africa,904091,0,3758
2021-04-09,comoros,Africa,904091,0,3758
2021-04-10,comoros,Africa,904091,31,3789
2021-04-11,comoros,Africa,904091,0,3789
2021-04-12,comoros,Africa,904091,0,3789
2021-04-13,comoros,Africa,904091,7,3796
2021-04-14,comoros,Africa,904091,7,3803
2021-04-15,comoros,Africa,904091,6,3809
2021-04-16,comoros,Africa,904091,6,3815
2021-04-17,comoros,Africa,904091,0,3815
2021-04-18,comoros,Africa,904091,4,3819
2021-04-19,comoros,Africa,904091,0,3819
2021-04-20,comoros,Africa,904091,1,3820
2021-04-21,comoros,Africa,904091,2,3822
2021-04-22,comoros,Africa,904091,2,3824
2021-04-23,comoros,Africa,904091,2,3826
2021-04-24,comoros,Africa,904091,3,3829
2021-04-25,comoros,Africa,904091,0,3829
2021-04-26,comoros,Africa,904091,0,3829
2021-04-27,comoros,Africa,904091,2,3831
2021-04-28,comoros,Africa,904091,2,3833
2021-04-29,comoros,Africa,904091,1,3834
2021-04-30,comoros,Africa,904091,0,3834
2021-05-01,comoros,Africa,904091,4,3838
2021-05-02,comoros,Africa,904091,2,3840
2021-05-03,comoros,Africa,904091,5,3845
2021-05-04,comoros,Africa,904091,1,3846
2021-05-05,comoros,Africa,904091,1,3847
2021-05-06,comoros,Africa,904091,5,3852
2021-05-07,comoros,Africa,904091,2,3854
2021-05-08,comoros,Africa,904091,0,3854
2021-05-09,comoros,Africa,904091,0,3854
2021-05-10,comoros,Africa,904091,6,3860
2021-05-11,comoros,Africa,904091,0,3860
2021-05-12,comoros,Africa,904091,0,3860
2021-05-13,comoros,Africa,904091,0,3860
2021-05-14,comoros,Africa,904091,0,3860
2021-05-15,comoros,Africa,904091,3,3863
2021-05-16,comoros,Africa,904091,0,3863
2021-05-17,comoros,Africa,904091,1,3864
2021-05-18,comoros,Africa,904091,0,3864
2021-05-19,comoros,Africa,904091,0,3864
2021-05-20,comoros,Africa,904091,0,3864
2021-05-21,comoros,Africa,904091,4,3868
2021-05-22,comoros,Africa,904091,2,3870
2021-05-23,comoros,Africa,904091,2,3872
2021-05-24,comoros,Africa,904091,0,3872
2021-05-25,comoros,Africa,904091,3,3875
2021-05-26,comoros,Africa,904091,4,3879
2021-05-27,comoros,Africa,904091,0,3879
2021-05-28,comoros,Africa,904091,0,3879
2021-05-29,comoros,Africa,904091,2,3881
2021-05-30,comoros,Africa,904091,0,3881
2021-05-31,comoros,Africa,904091,0,3881
2021-06-01,comoros,Africa,904091,0,3881
2021-06-02,comoros,Africa,904091,1,3882
2021-06-03,comoros,Africa,904091,0,3882
2021-06-04,comoros,Africa,904091,4,3886
2021-06-05,comoros,Africa,904091,0,3886
2021-06-06,comoros,Africa,904091,2,3888
2021-06-07,comoros,Africa,904091,2,3890
2021-06-08,comoros,Africa,904091,0,3890
2021-06-09,comoros,Africa,904091,0,3890
2021-06-10,comoros,Africa,904091,4,3894
2021-06-11,comoros,Africa,904091,0,3894
2021-06-12,comoros,Africa,904091,5,3899
2021-06-13,comoros,Africa,904091,0,3899
2021-06-14,comoros,Africa,904091,2,3901
2021-06-15,comoros,Africa,904091,0,3901
2021-06-16,comoros,Africa,904091,4,3905
2021-06-17,comoros,Africa,904091,0,3905
2021-06-18,comoros,Africa,904091,0,3905
2021-06-19,comoros,Africa,904091,3,3908
2021-06-20,comoros,Africa,904091,0,3908
2021-06-21,comoros,Africa,904091,4,3912
2021-06-22,comoros,Africa,904091,0,3912
2021-06-23,comoros,Africa,904091,0,3912
2021-06-24,comoros,Africa,904091,0,3912
2021-06-25,comoros,Africa,904091,0,3912
2021-06-26,comoros,Africa,904091,0,3912
2021-06-27,comoros,Africa,904091,0,3912
2021-06-28,comoros,Africa,904091,0,3912
2021-06-29,comoros,Africa,904091,22,3934
2021-06-30,comoros,Africa,904091,2,3936
2021-07-01,comoros,Africa,904091,7,3943
2021-07-02,comoros,Africa,904091,14,3957
2021-07-03,comoros,Africa,904091,0,3957
2021-07-04,comoros,Africa,904091,1,3958
2021-07-05,comoros,Africa,904091,0,3958
2021-07-06,comoros,Africa,904091,0,3958
2021-07-07,comoros,Africa,904091,8,3966
2021-07-08,comoros,Africa,904091,10,3976
2021-07-09,comoros,Africa,904091,3,3979
2021-07-10,comoros,Africa,904091,4,3983
2021-07-11,comoros,Africa,904091,13,3996
2021-07-12,comoros,Africa,904091,0,3996
2021-07-13,comoros,Africa,904091,0,3996
2021-07-14,comoros,Africa,904091,5,4001
2021-07-15,comoros,Africa,904091,1,4002
2021-07-16,comoros,Africa,904091,7,4009
2021-07-17,comoros,Africa,904091,0,4009
2021-07-18,comoros,Africa,904091,2,4011
2021-07-19,comoros,Africa,904091,0,4011
2021-07-20,comoros,Africa,904091,0,4011
2021-07-21,comoros,Africa,904091,0,4011
2021-07-22,comoros,Africa,904091,3,4014
2021-07-23,comoros,Africa,904091,0,4014
2021-07-24,comoros,Africa,904091,4,4018
2021-07-25,comoros,Africa,904091,3,4021
2021-07-26,comoros,Africa,904091,3,4024
2021-07-27,comoros,Africa,904091,0,4024
2021-07-28,comoros,Africa,904091,0,4024
2021-07-29,comoros,Africa,904091,1,4025
2021-07-30,comoros,Africa,904091,1,4026
2021-07-31,comoros,Africa,904091,2,4028
2021-08-01,comoros,Africa,904091,0,4028
2021-08-02,comoros,Africa,904091,0,4028
2021-08-03,comoros,Africa,904091,0,4028
2021-08-04,comoros,Africa,904091,1,4029
2021-08-05,comoros,Africa,904091,1,4030
2021-08-06,comoros,Africa,904091,0,4030
2021-08-07,comoros,Africa,904091,1,4031
2021-08-08,comoros,Africa,904091,0,4031
2021-08-09,comoros,Africa,904091,0,4031
2021-08-10,comoros,Africa,904091,0,4031
2021-08-11,comoros,Africa,904091,0,4031
2021-08-12,comoros,Africa,904091,4,4035
2021-08-13,comoros,Africa,904091,1,4036
2021-08-14,comoros,Africa,904091,2,4038
2021-08-15,comoros,Africa,904091,0,4038
2021-08-16,comoros,Africa,904091,0,4038
2021-08-17,comoros,Africa,904091,1,4039
2021-08-18,comoros,Africa,904091,0,4039
2021-08-19,comoros,Africa,904091,5,4044
2021-08-20,comoros,Africa,904091,4,4048
2021-08-21,comoros,Africa,904091,0,4048
2021-08-22,comoros,Africa,904091,2,4050
2021-08-23,comoros,Africa,904091,1,4051
2021-08-24,comoros,Africa,904091,3,4054
2021-08-25,comoros,Africa,904091,1,4055
2021-08-26,comoros,Africa,904091,3,4058
2021-08-27,comoros,Africa,904091,2,4060
2021-08-28,comoros,Africa,904091,2,4062
2021-08-29,comoros,Africa,904091,0,4062
2021-08-30,comoros,Africa,904091,3,4065
2021-08-31,comoros,Africa,904091,3,4068
2021-09-01,comoros,Africa,904091,4,4072
2021-09-02,comoros,Africa,904091,4,4076
2021-09-03,comoros,Africa,904091,7,4083
2021-09-04,comoros,Africa,904091,1,4084
2021-09-05,comoros,Africa,904091,2,4086
2021-09-06,comoros,Africa,904091,0,4086
2021-09-07,comoros,Africa,904091,4,4090
2021-09-08,comoros,Africa,904091,3,4093
2021-09-09,comoros,Africa,904091,0,4093
2021-09-10,comoros,Africa,904091,0,4093
2021-09-11,comoros,Africa,904091,1,4094
2021-09-12,comoros,Africa,904091,3,4097
2021-09-13,comoros,Africa,904091,3,4100
2021-09-14,comoros,Africa,904091,0,4100
2021-09-15,comoros,Africa,904091,0,4100
2021-09-16,comoros,Africa,904091,1,4101
2021-09-17,comoros,Africa,904091,3,4104
2021-09-18,comoros,Africa,904091,0,4104
2021-09-19,comoros,Africa,904091,2,4106
2021-09-20,comoros,Africa,904091,3,4109
2020-04-02,congo,Africa,5770949,0,22
2020-04-03,congo,Africa,5770949,0,22
2020-04-04,congo,Africa,5770949,0,22
2020-04-05,congo,Africa,5770949,23,45
2020-04-06,congo,Africa,5770949,0,45
2020-04-07,congo,Africa,5770949,0,45
2020-04-08,congo,Africa,5770949,0,45
2020-04-09,congo,Africa,5770949,15,60
2020-04-10,congo,Africa,5770949,0,60
2020-04-11,congo,Africa,5770949,0,60
2020-04-12,congo,Africa,5770949,0,60
2020-04-13,congo,Africa,5770949,0,60
2020-04-14,congo,Africa,5770949,14,74
2020-04-15,congo,Africa,5770949,43,117
2020-04-16,congo,Africa,5770949,0,117
2020-04-17,congo,Africa,5770949,26,143
2020-04-18,congo,Africa,5770949,0,143
2020-04-19,congo,Africa,5770949,0,143
2020-04-20,congo,Africa,5770949,17,160
2020-04-21,congo,Africa,5770949,5,165
2020-04-22,congo,Africa,5770949,21,186
2020-04-23,congo,Africa,5770949,0,186
2020-04-24,congo,Africa,5770949,14,200
2020-04-25,congo,Africa,5770949,0,200
2020-04-26,congo,Africa,5770949,0,200
2020-04-27,congo,Africa,5770949,7,207
2020-04-28,congo,Africa,5770949,0,207
2020-04-29,congo,Africa,5770949,0,207
2020-04-30,congo,Africa,5770949,13,220
2020-05-01,congo,Africa,5770949,9,229
2020-05-02,congo,Africa,5770949,0,229
2020-05-03,congo,Africa,5770949,0,229
2020-05-04,congo,Africa,5770949,7,236
2020-05-05,congo,Africa,5770949,0,236
2020-05-06,congo,Africa,5770949,28,264
2020-05-07,congo,Africa,5770949,0,264
2020-05-08,congo,Africa,5770949,10,274
2020-05-09,congo,Africa,5770949,0,274
2020-05-10,congo,Africa,5770949,0,274
2020-05-11,congo,Africa,5770949,59,333
2020-05-12,congo,Africa,5770949,0,333
2020-05-13,congo,Africa,5770949,0,333
2020-05-14,congo,Africa,5770949,58,391
2020-05-15,congo,Africa,5770949,0,391
2020-05-16,congo,Africa,5770949,0,391
2020-05-17,congo,Africa,5770949,0,391
2020-05-18,congo,Africa,5770949,21,412
2020-05-19,congo,Africa,5770949,8,420
2020-05-20,congo,Africa,5770949,0,420
2020-05-21,congo,Africa,5770949,49,469
2020-05-22,congo,Africa,5770949,0,469
2020-05-23,congo,Africa,5770949,18,487
2020-05-24,congo,Africa,5770949,0,487
2020-05-25,congo,Africa,5770949,0,487
2020-05-26,congo,Africa,5770949,0,487
2020-05-27,congo,Africa,5770949,84,571
2020-05-28,congo,Africa,5770949,0,571
2020-05-29,congo,Africa,5770949,0,571
2020-05-30,congo,Africa,5770949,0,571
2020-05-31,congo,Africa,5770949,40,611
2020-06-01,congo,Africa,5770949,0,611
2020-06-02,congo,Africa,5770949,0,611
2020-06-03,congo,Africa,5770949,0,611
2020-06-04,congo,Africa,5770949,0,611
2020-06-05,congo,Africa,5770949,24,635
2020-06-06,congo,Africa,5770949,48,683
2020-06-07,congo,Africa,5770949,0,683
2020-06-08,congo,Africa,5770949,0,683
2020-06-09,congo,Africa,5770949,45,728
2020-06-10,congo,Africa,5770949,0,728
2020-06-11,congo,Africa,5770949,0,728
2020-06-12,congo,Africa,5770949,0,728
2020-06-13,congo,Africa,5770949,0,728
2020-06-14,congo,Africa,5770949,0,728
2020-06-15,congo,Africa,5770949,155,883
2020-06-16,congo,Africa,5770949,0,883
2020-06-17,congo,Africa,5770949,0,883
2020-06-18,congo,Africa,5770949,0,883
2020-06-19,congo,Africa,5770949,0,883
2020-06-20,congo,Africa,5770949,0,883
2020-06-21,congo,Africa,5770949,0,883
2020-06-22,congo,Africa,5770949,204,1087
2020-06-23,congo,Africa,5770949,0,1087
2020-06-24,congo,Africa,5770949,0,1087
2020-06-25,congo,Africa,5770949,0,1087
2020-06-26,congo,Africa,5770949,0,1087
2020-06-27,congo,Africa,5770949,0,1087
2020-06-28,congo,Africa,5770949,0,1087
2020-06-29,congo,Africa,5770949,0,1087
2020-06-30,congo,Africa,5770949,0,1087
2020-07-01,congo,Africa,5770949,295,1382
2020-07-02,congo,Africa,5770949,0,1382
2020-07-03,congo,Africa,5770949,175,1557
2020-07-04,congo,Africa,5770949,0,1557
2020-07-05,congo,Africa,5770949,0,1557
2020-07-06,congo,Africa,5770949,0,1557
2020-07-07,congo,Africa,5770949,0,1557
2020-07-08,congo,Africa,5770949,264,1821
2020-07-09,congo,Africa,5770949,0,1821
2020-07-10,congo,Africa,5770949,207,2028
2020-07-11,congo,Africa,5770949,0,2028
2020-07-12,congo,Africa,5770949,0,2028
2020-07-13,congo,Africa,5770949,0,2028
2020-07-14,congo,Africa,5770949,0,2028
2020-07-15,congo,Africa,5770949,194,2222
2020-07-16,congo,Africa,5770949,136,2358
2020-07-17,congo,Africa,5770949,275,2633
2020-07-18,congo,Africa,5770949,0,2633
2020-07-19,congo,Africa,5770949,0,2633
2020-07-20,congo,Africa,5770949,218,2851
2020-07-21,congo,Africa,5770949,0,2851
2020-07-22,congo,Africa,5770949,0,2851
2020-07-23,congo,Africa,5770949,0,2851
2020-07-24,congo,Africa,5770949,187,3038
2020-07-25,congo,Africa,5770949,0,3038
2020-07-26,congo,Africa,5770949,0,3038
2020-07-27,congo,Africa,5770949,162,3200
2020-07-28,congo,Africa,5770949,0,3200
2020-07-29,congo,Africa,5770949,0,3200
2020-07-30,congo,Africa,5770949,0,3200
2020-07-31,congo,Africa,5770949,0,3200
2020-08-01,congo,Africa,5770949,0,3200
2020-08-02,congo,Africa,5770949,0,3200
2020-08-03,congo,Africa,5770949,346,3546
2020-08-04,congo,Africa,5770949,0,3546
2020-08-05,congo,Africa,5770949,0,3546
2020-08-06,congo,Africa,5770949,0,3546
2020-08-07,congo,Africa,5770949,91,3637
2020-08-08,congo,Africa,5770949,27,3664
2020-08-09,congo,Africa,5770949,0,3664
2020-08-10,congo,Africa,5770949,0,3664
2020-08-11,congo,Africa,5770949,81,3745
2020-08-12,congo,Africa,5770949,0,3745
2020-08-13,congo,Africa,5770949,0,3745
2020-08-14,congo,Africa,5770949,0,3745
2020-08-15,congo,Africa,5770949,0,3745
2020-08-16,congo,Africa,5770949,86,3831
2020-08-17,congo,Africa,5770949,0,3831
2020-08-18,congo,Africa,5770949,0,3831
2020-08-19,congo,Africa,5770949,19,3850
2020-08-20,congo,Africa,5770949,0,3850
2020-08-21,congo,Africa,5770949,0,3850
2020-08-22,congo,Africa,5770949,0,3850
2020-08-23,congo,Africa,5770949,0,3850
2020-08-24,congo,Africa,5770949,129,3979
2020-08-25,congo,Africa,5770949,0,3979
2020-08-26,congo,Africa,5770949,0,3979
2020-08-27,congo,Africa,5770949,0,3979
2020-08-28,congo,Africa,5770949,0,3979
2020-08-29,congo,Africa,5770949,0,3979
2020-08-30,congo,Africa,5770949,0,3979
2020-08-31,congo,Africa,5770949,0,3979
2020-09-01,congo,Africa,5770949,0,3979
2020-09-02,congo,Africa,5770949,649,4628
2020-09-03,congo,Africa,5770949,0,4628
2020-09-04,congo,Africa,5770949,0,4628
2020-09-05,congo,Africa,5770949,0,4628
2020-09-06,congo,Africa,5770949,0,4628
2020-09-07,congo,Africa,5770949,263,4891
2020-09-08,congo,Africa,5770949,0,4891
2020-09-09,congo,Africa,5770949,0,4891
2020-09-10,congo,Africa,5770949,0,4891
2020-09-11,congo,Africa,5770949,37,4928
2020-09-12,congo,Africa,5770949,0,4928
2020-09-13,congo,Africa,5770949,0,4928
2020-09-14,congo,Africa,5770949,6,4934
2020-09-15,congo,Africa,5770949,0,4934
2020-09-16,congo,Africa,5770949,0,4934
2020-09-17,congo,Africa,5770949,0,4934
2020-09-18,congo,Africa,5770949,46,4980
2020-09-19,congo,Africa,5770949,6,4986
2020-09-20,congo,Africa,5770949,0,4986
2020-09-21,congo,Africa,5770949,16,5002
2020-09-22,congo,Africa,5770949,0,5002
2020-09-23,congo,Africa,5770949,3,5005
2020-09-24,congo,Africa,5770949,0,5005
2020-09-25,congo,Africa,5770949,0,5005
2020-09-26,congo,Africa,5770949,0,5005
2020-09-27,congo,Africa,5770949,3,5008
2020-09-28,congo,Africa,5770949,0,5008
2020-09-29,congo,Africa,5770949,0,5008
2020-09-30,congo,Africa,5770949,81,5089
2020-10-01,congo,Africa,5770949,0,5089
2020-10-02,congo,Africa,5770949,0,5089
2020-10-03,congo,Africa,5770949,0,5089
2020-10-04,congo,Africa,5770949,0,5089
2020-10-05,congo,Africa,5770949,0,5089
2020-10-06,congo,Africa,5770949,0,5089
2020-10-07,congo,Africa,5770949,0,5089
2020-10-08,congo,Africa,5770949,0,5089
2020-10-09,congo,Africa,5770949,29,5118
2020-10-10,congo,Africa,5770949,0,5118
2020-10-11,congo,Africa,5770949,0,5118
2020-10-12,congo,Africa,5770949,0,5118
2020-10-13,congo,Africa,5770949,0,5118
2020-10-14,congo,Africa,5770949,38,5156
2020-10-15,congo,Africa,5770949,0,5156
2020-10-16,congo,Africa,5770949,0,5156
2020-10-17,congo,Africa,5770949,0,5156
2020-10-18,congo,Africa,5770949,0,5156
2020-10-19,congo,Africa,5770949,0,5156
2020-10-20,congo,Africa,5770949,0,5156
2020-10-21,congo,Africa,5770949,0,5156
2020-10-22,congo,Africa,5770949,0,5156
2020-10-23,congo,Africa,5770949,0,5156
2020-10-24,congo,Africa,5770949,97,5253
2020-10-25,congo,Africa,5770949,0,5253
2020-10-26,congo,Africa,5770949,0,5253
2020-10-27,congo,Africa,5770949,0,5253
2020-10-28,congo,Africa,5770949,0,5253
2020-10-29,congo,Africa,5770949,37,5290
2020-10-30,congo,Africa,5770949,0,5290
2020-10-31,congo,Africa,5770949,0,5290
2020-11-01,congo,Africa,5770949,0,5290
2020-11-02,congo,Africa,5770949,0,5290
2020-11-03,congo,Africa,5770949,58,5348
2020-11-04,congo,Africa,5770949,0,5348
2020-11-05,congo,Africa,5770949,0,5348
2020-11-06,congo,Africa,5770949,31,5379
2020-11-07,congo,Africa,5770949,0,5379
2020-11-08,congo,Africa,5770949,0,5379
2020-11-09,congo,Africa,5770949,0,5379
2020-11-10,congo,Africa,5770949,0,5379
2020-11-11,congo,Africa,5770949,0,5379
2020-11-12,congo,Africa,5770949,0,5379
2020-11-13,congo,Africa,5770949,136,5515
2020-11-14,congo,Africa,5770949,0,5515
2020-11-15,congo,Africa,5770949,0,5515
2020-11-16,congo,Africa,5770949,0,5515
2020-11-17,congo,Africa,5770949,0,5515
2020-11-18,congo,Africa,5770949,0,5515
2020-11-19,congo,Africa,5770949,117,5632
2020-11-20,congo,Africa,5770949,0,5632
2020-11-21,congo,Africa,5770949,0,5632
2020-11-22,congo,Africa,5770949,0,5632
2020-11-23,congo,Africa,5770949,0,5632
2020-11-24,congo,Africa,5770949,0,5632
2020-11-25,congo,Africa,5770949,0,5632
2020-11-26,congo,Africa,5770949,0,5632
2020-11-27,congo,Africa,5770949,142,5774
2020-11-28,congo,Africa,5770949,0,5774
2020-11-29,congo,Africa,5770949,0,5774
2020-11-30,congo,Africa,5770949,0,5774
2020-12-01,congo,Africa,5770949,0,5774
2020-12-02,congo,Africa,5770949,0,5774
2020-12-03,congo,Africa,5770949,0,5774
2020-12-04,congo,Africa,5770949,0,5774
2020-12-05,congo,Africa,5770949,0,5774
2020-12-06,congo,Africa,5770949,0,5774
2020-12-07,congo,Africa,5770949,0,5774
2020-12-08,congo,Africa,5770949,0,5774
2020-12-09,congo,Africa,5770949,275,6049
2020-12-10,congo,Africa,5770949,0,6049
2020-12-11,congo,Africa,5770949,0,6049
2020-12-12,congo,Africa,5770949,0,6049
2020-12-13,congo,Africa,5770949,0,6049
2020-12-14,congo,Africa,5770949,151,6200
2020-12-15,congo,Africa,5770949,0,6200
2020-12-16,congo,Africa,5770949,0,6200
2020-12-17,congo,Africa,5770949,0,6200
2020-12-18,congo,Africa,5770949,0,6200
2020-12-19,congo,Africa,5770949,0,6200
2020-12-20,congo,Africa,5770949,0,6200
2020-12-21,congo,Africa,5770949,0,6200
2020-12-22,congo,Africa,5770949,371,6571
2020-12-23,congo,Africa,5770949,0,6571
2020-12-24,congo,Africa,5770949,0,6571
2020-12-25,congo,Africa,5770949,0,6571
2020-12-26,congo,Africa,5770949,337,6908
2020-12-27,congo,Africa,5770949,0,6908
2020-12-28,congo,Africa,5770949,0,6908
2020-12-29,congo,Africa,5770949,0,6908
2020-12-30,congo,Africa,5770949,0,6908
2020-12-31,congo,Africa,5770949,199,7107
2021-01-01,congo,Africa,5770949,0,7107
2021-01-02,congo,Africa,5770949,0,7107
2021-01-03,congo,Africa,5770949,0,7107
2021-01-04,congo,Africa,5770949,0,7107
2021-01-05,congo,Africa,5770949,0,7107
2021-01-06,congo,Africa,5770949,20,7127
2021-01-07,congo,Africa,5770949,0,7127
2021-01-08,congo,Africa,5770949,0,7127
2021-01-09,congo,Africa,5770949,0,7127
2021-01-10,congo,Africa,5770949,0,7127
2021-01-11,congo,Africa,5770949,0,7127
2021-01-12,congo,Africa,5770949,33,7160
2021-01-13,congo,Africa,5770949,0,7160
2021-01-14,congo,Africa,5770949,0,7160
2021-01-15,congo,Africa,5770949,549,7709
2021-01-16,congo,Africa,5770949,0,7709
2021-01-17,congo,Africa,5770949,0,7709
2021-01-18,congo,Africa,5770949,0,7709
2021-01-19,congo,Africa,5770949,0,7709
2021-01-20,congo,Africa,5770949,0,7709
2021-01-21,congo,Africa,5770949,85,7794
2021-01-22,congo,Africa,5770949,0,7794
2021-01-23,congo,Africa,5770949,0,7794
2021-01-24,congo,Africa,5770949,0,7794
2021-01-25,congo,Africa,5770949,93,7887
2021-01-26,congo,Africa,5770949,0,7887
2021-01-27,congo,Africa,5770949,0,7887
2021-01-28,congo,Africa,5770949,0,7887
2021-01-29,congo,Africa,5770949,0,7887
2021-01-30,congo,Africa,5770949,0,7887
2021-01-31,congo,Africa,5770949,0,7887
2021-02-01,congo,Africa,5770949,0,7887
2021-02-02,congo,Africa,5770949,0,7887
2021-02-03,congo,Africa,5770949,0,7887
2021-02-04,congo,Africa,5770949,173,8060
2021-02-05,congo,Africa,5770949,0,8060
2021-02-06,congo,Africa,5770949,0,8060
2021-02-07,congo,Africa,5770949,0,8060
2021-02-08,congo,Africa,5770949,0,8060
2021-02-09,congo,Africa,5770949,0,8060
2021-02-10,congo,Africa,5770949,294,8354
2021-02-11,congo,Africa,5770949,0,8354
2021-02-12,congo,Africa,5770949,65,8419
2021-02-13,congo,Africa,5770949,0,8419
2021-02-14,congo,Africa,5770949,0,8419
2021-02-15,congo,Africa,5770949,0,8419
2021-02-16,congo,Africa,5770949,0,8419
2021-02-17,congo,Africa,5770949,0,8419
2021-02-18,congo,Africa,5770949,0,8419
2021-02-19,congo,Africa,5770949,0,8419
2021-02-20,congo,Africa,5770949,0,8419
2021-02-21,congo,Africa,5770949,206,8625
2021-02-22,congo,Africa,5770949,0,8625
2021-02-23,congo,Africa,5770949,0,8625
2021-02-24,congo,Africa,5770949,195,8820
2021-02-25,congo,Africa,5770949,0,8820
2021-02-26,congo,Africa,5770949,0,8820
2021-02-27,congo,Africa,5770949,0,8820
2021-02-28,congo,Africa,5770949,0,8820
2021-03-01,congo,Africa,5770949,0,8820
2021-03-02,congo,Africa,5770949,0,8820
2021-03-03,congo,Africa,5770949,0,8820
2021-03-04,congo,Africa,5770949,359,9179
2021-03-05,congo,Africa,5770949,0,9179
2021-03-06,congo,Africa,5770949,0,9179
2021-03-07,congo,Africa,5770949,0,9179
2021-03-08,congo,Africa,5770949,0,9179
2021-03-09,congo,Africa,5770949,0,9179
2021-03-10,congo,Africa,5770949,150,9329
2021-03-11,congo,Africa,5770949,0,9329
2021-03-12,congo,Africa,5770949,0,9329
2021-03-13,congo,Africa,5770949,0,9329
2021-03-14,congo,Africa,5770949,0,9329
2021-03-15,congo,Africa,5770949,0,9329
2021-03-16,congo,Africa,5770949,0,9329
2021-03-17,congo,Africa,5770949,0,9329
2021-03-18,congo,Africa,5770949,235,9564
2021-03-19,congo,Africa,5770949,0,9564
2021-03-20,congo,Africa,5770949,0,9564
2021-03-21,congo,Africa,5770949,0,9564
2021-03-22,congo,Africa,5770949,0,9564
2021-03-23,congo,Africa,5770949,0,9564
2021-03-24,congo,Africa,5770949,117,9681
2021-03-25,congo,Africa,5770949,0,9681
2021-03-26,congo,Africa,5770949,0,9681
2021-03-27,congo,Africa,5770949,0,9681
2021-03-28,congo,Africa,5770949,0,9681
2021-03-29,congo,Africa,5770949,0,9681
2021-03-30,congo,Africa,5770949,0,9681
2021-03-31,congo,Africa,5770949,0,9681
2021-04-01,congo,Africa,5770949,0,9681
2021-04-02,congo,Africa,5770949,0,9681
2021-04-03,congo,Africa,5770949,0,9681
2021-04-04,congo,Africa,5770949,0,9681
2021-04-05,congo,Africa,5770949,0,9681
2021-04-06,congo,Africa,5770949,403,10084
2021-04-07,congo,Africa,5770949,0,10084
2021-04-08,congo,Africa,5770949,0,10084
2021-04-09,congo,Africa,5770949,0,10084
2021-04-10,congo,Africa,5770949,0,10084
2021-04-11,congo,Africa,5770949,0,10084
2021-04-12,congo,Africa,5770949,0,10084
2021-04-13,congo,Africa,5770949,0,10084
2021-04-14,congo,Africa,5770949,0,10084
2021-04-15,congo,Africa,5770949,0,10084
2021-04-16,congo,Africa,5770949,0,10084
2021-04-17,congo,Africa,5770949,0,10084
2021-04-18,congo,Africa,5770949,0,10084
2021-04-19,congo,Africa,5770949,0,10084
2021-04-20,congo,Africa,5770949,0,10084
2021-04-21,congo,Africa,5770949,0,10084
2021-04-22,congo,Africa,5770949,0,10084
2021-04-23,congo,Africa,5770949,0,10084
2021-04-24,congo,Africa,5770949,594,10678
2021-04-25,congo,Africa,5770949,0,10678
2021-04-26,congo,Africa,5770949,0,10678
2021-04-27,congo,Africa,5770949,0,10678
2021-04-28,congo,Africa,5770949,0,10678
2021-04-29,congo,Africa,5770949,0,10678
2021-04-30,congo,Africa,5770949,0,10678
2021-05-01,congo,Africa,5770949,0,10678
2021-05-02,congo,Africa,5770949,0,10678
2021-05-03,congo,Africa,5770949,338,11016
2021-05-04,congo,Africa,5770949,0,11016
2021-05-05,congo,Africa,5770949,0,11016
2021-05-06,congo,Africa,5770949,0,11016
2021-05-07,congo,Africa,5770949,131,11147
2021-05-08,congo,Africa,5770949,0,11147
2021-05-09,congo,Africa,5770949,0,11147
2021-05-10,congo,Africa,5770949,196,11343
2021-05-11,congo,Africa,5770949,0,11343
2021-05-12,congo,Africa,5770949,0,11343
2021-05-13,congo,Africa,5770949,0,11343
2021-05-14,congo,Africa,5770949,0,11343
2021-05-15,congo,Africa,5770949,0,11343
2021-05-16,congo,Africa,5770949,0,11343
2021-05-17,congo,Africa,5770949,0,11343
2021-05-18,congo,Africa,5770949,0,11343
2021-05-19,congo,Africa,5770949,133,11476
2021-05-20,congo,Africa,5770949,0,11476
2021-05-21,congo,Africa,5770949,0,11476
2021-05-22,congo,Africa,5770949,0,11476
2021-05-23,congo,Africa,5770949,0,11476
2021-05-24,congo,Africa,5770949,0,11476
2021-05-25,congo,Africa,5770949,182,11658
2021-05-26,congo,Africa,5770949,0,11658
2021-05-27,congo,Africa,5770949,0,11658
2021-05-28,congo,Africa,5770949,0,11658
2021-05-29,congo,Africa,5770949,0,11658
2021-05-30,congo,Africa,5770949,0,11658
2021-05-31,congo,Africa,5770949,0,11658
2021-06-01,congo,Africa,5770949,0,11658
2021-06-02,congo,Africa,5770949,187,11845
2021-06-03,congo,Africa,5770949,0,11845
2021-06-04,congo,Africa,5770949,75,11920
2021-06-05,congo,Africa,5770949,0,11920
2021-06-06,congo,Africa,5770949,0,11920
2021-06-07,congo,Africa,5770949,106,12026
2021-06-08,congo,Africa,5770949,0,12026
2021-06-09,congo,Africa,5770949,0,12026
2021-06-10,congo,Africa,5770949,0,12026
2021-06-11,congo,Africa,5770949,0,12026
2021-06-12,congo,Africa,5770949,95,12121
2021-06-13,congo,Africa,5770949,0,12121
2021-06-14,congo,Africa,5770949,0,12121
2021-06-15,congo,Africa,5770949,0,12121
2021-06-16,congo,Africa,5770949,0,12121
2021-06-17,congo,Africa,5770949,177,12298
2021-06-18,congo,Africa,5770949,0,12298
2021-06-19,congo,Africa,5770949,0,12298
2021-06-20,congo,Africa,5770949,0,12298
2021-06-21,congo,Africa,5770949,0,12298
2021-06-22,congo,Africa,5770949,106,12404
2021-06-23,congo,Africa,5770949,0,12404
2021-06-24,congo,Africa,5770949,0,12404
2021-06-25,congo,Africa,5770949,81,12485
2021-06-26,congo,Africa,5770949,0,12485
2021-06-27,congo,Africa,5770949,0,12485
2021-06-28,congo,Africa,5770949,0,12485
2021-06-29,congo,Africa,5770949,111,12596
2021-06-30,congo,Africa,5770949,0,12596
2021-07-01,congo,Africa,5770949,99,12695
2021-07-02,congo,Africa,5770949,0,12695
2021-07-03,congo,Africa,5770949,0,12695
2021-07-04,congo,Africa,5770949,0,12695
2021-07-05,congo,Africa,5770949,95,12790
2021-07-06,congo,Africa,5770949,0,12790
2021-07-07,congo,Africa,5770949,0,12790
2021-07-08,congo,Africa,5770949,0,12790
2021-07-09,congo,Africa,5770949,0,12790
2021-07-10,congo,Africa,5770949,0,12790
2021-07-11,congo,Africa,5770949,0,12790
2021-07-12,congo,Africa,5770949,0,12790
2021-07-13,congo,Africa,5770949,0,12790
2021-07-14,congo,Africa,5770949,0,12790
2021-07-15,congo,Africa,5770949,143,12933
2021-07-16,congo,Africa,5770949,0,12933
2021-07-17,congo,Africa,5770949,0,12933
2021-07-18,congo,Africa,5770949,0,12933
2021-07-19,congo,Africa,5770949,65,12998
2021-07-20,congo,Africa,5770949,52,13050
2021-07-21,congo,Africa,5770949,0,13050
2021-07-22,congo,Africa,5770949,0,13050
2021-07-23,congo,Africa,5770949,67,13117
2021-07-24,congo,Africa,5770949,0,13117
2021-07-25,congo,Africa,5770949,0,13117
2021-07-26,congo,Africa,5770949,39,13156
2021-07-27,congo,Africa,5770949,0,13156
2021-07-28,congo,Africa,5770949,0,13156
2021-07-29,congo,Africa,5770949,30,13186
2021-07-30,congo,Africa,5770949,0,13186
2021-07-31,congo,Africa,5770949,0,13186
2021-08-01,congo,Africa,5770949,0,13186
2021-08-02,congo,Africa,5770949,30,13216
2021-08-03,congo,Africa,5770949,0,13216
2021-08-04,congo,Africa,5770949,0,13216
2021-08-05,congo,Africa,5770949,0,13216
2021-08-06,congo,Africa,5770949,0,13216
2021-08-07,congo,Africa,5770949,0,13216
2021-08-08,congo,Africa,5770949,41,13257
2021-08-09,congo,Africa,5770949,36,13293
2021-08-10,congo,Africa,5770949,0,13293
2021-08-11,congo,Africa,5770949,0,13293
2021-08-12,congo,Africa,5770949,63,13356
2021-08-13,congo,Africa,5770949,0,13356
2021-08-14,congo,Africa,5770949,0,13356
2021-08-15,congo,Africa,5770949,0,13356
2021-08-16,congo,Africa,5770949,42,13398
2021-08-17,congo,Africa,5770949,0,13398
2021-08-18,congo,Africa,5770949,0,13398
2021-08-19,congo,Africa,5770949,0,13398
2021-08-20,congo,Africa,5770949,0,13398
2021-08-21,congo,Africa,5770949,0,13398
2021-08-22,congo,Africa,5770949,0,13398
2021-08-23,congo,Africa,5770949,95,13493
2021-08-24,congo,Africa,5770949,0,13493
2021-08-25,congo,Africa,5770949,0,13493
2021-08-26,congo,Africa,5770949,40,13533
2021-08-27,congo,Africa,5770949,0,13533
2021-08-28,congo,Africa,5770949,0,13533
2021-08-29,congo,Africa,5770949,0,13533
2021-08-30,congo,Africa,5770949,55,13588
2021-08-31,congo,Africa,5770949,0,13588
2021-09-01,congo,Africa,5770949,0,13588
2021-09-02,congo,Africa,5770949,0,13588
2021-09-03,congo,Africa,5770949,0,13588
2021-09-04,congo,Africa,5770949,0,13588
2021-09-05,congo,Africa,5770949,0,13588
2021-09-06,congo,Africa,5770949,0,13588
2021-09-07,congo,Africa,5770949,0,13588
2021-09-08,congo,Africa,5770949,0,13588
2021-09-09,congo,Africa,5770949,113,13701
2021-09-10,congo,Africa,5770949,0,13701
2021-09-11,congo,Africa,5770949,0,13701
2021-09-12,congo,Africa,5770949,0,13701
2021-09-13,congo,Africa,5770949,0,13701
2021-09-14,congo,Africa,5770949,0,13701
2021-09-15,congo,Africa,5770949,0,13701
2021-09-16,congo,Africa,5770949,0,13701
2021-09-17,congo,Africa,5770949,0,13701
2021-09-18,congo,Africa,5770949,0,13701
2021-09-19,congo,Africa,5770949,0,13701
2021-09-20,congo,Africa,5770949,0,13701
2021-09-21,congo,Africa,5770949,313,14014
2021-09-22,congo,Africa,5770949,0,14014
2021-09-23,congo,Africa,5770949,0,14014
2021-09-24,congo,Africa,5770949,99,14113
2021-09-25,congo,Africa,5770949,0,14113
2021-09-26,congo,Africa,5770949,0,14113
2021-09-27,congo,Africa,5770949,131,14244
2021-09-28,congo,Africa,5770949,0,14244
2021-09-29,congo,Africa,5770949,0,14244
2021-09-30,congo,Africa,5770949,0,14244
2021-10-01,congo,Africa,5770949,115,14359
2021-10-02,congo,Africa,5770949,0,14359
2021-10-03,congo,Africa,5770949,0,14359
2021-10-04,congo,Africa,5770949,202,14561
2021-10-05,congo,Africa,5770949,0,14561
2021-10-06,congo,Africa,5770949,0,14561
2021-10-07,congo,Africa,5770949,272,14833
2021-10-08,congo,Africa,5770949,0,14833
2021-10-09,congo,Africa,5770949,0,14833
2021-10-10,congo,Africa,5770949,0,14833
2021-10-11,congo,Africa,5770949,0,14833
2021-10-12,congo,Africa,5770949,422,15255
2021-10-13,congo,Africa,5770949,0,15255
2021-10-14,congo,Africa,5770949,0,15255
2021-10-15,congo,Africa,5770949,259,15514
2021-10-16,congo,Africa,5770949,0,15514
2021-10-17,congo,Africa,5770949,0,15514
2021-10-18,congo,Africa,5770949,448,15962
2021-10-19,congo,Africa,5770949,0,15962
2021-10-20,congo,Africa,5770949,0,15962
2021-10-21,congo,Africa,5770949,446,16408
2021-10-22,congo,Africa,5770949,0,16408
2021-10-23,congo,Africa,5770949,0,16408
2021-10-24,congo,Africa,5770949,0,16408
2021-10-25,congo,Africa,5770949,460,16868
2021-10-26,congo,Africa,5770949,0,16868
2021-10-27,congo,Africa,5770949,0,16868
2021-10-28,congo,Africa,5770949,455,17323
2021-10-29,congo,Africa,5770949,0,17323
2021-10-30,congo,Africa,5770949,0,17323
2021-10-31,congo,Africa,5770949,0,17323
2021-11-01,congo,Africa,5770949,347,17670
2021-11-02,congo,Africa,5770949,0,17670
2021-11-03,congo,Africa,5770949,0,17670
2021-11-04,congo,Africa,5770949,274,17944
2021-11-05,congo,Africa,5770949,0,17944
2021-11-06,congo,Africa,5770949,0,17944
2021-11-07,congo,Africa,5770949,0,17944
2021-11-08,congo,Africa,5770949,209,18153
2021-11-09,congo,Africa,5770949,0,18153
2021-11-10,congo,Africa,5770949,0,18153
2021-11-11,congo,Africa,5770949,0,18153
2021-11-12,congo,Africa,5770949,0,18153
2021-11-13,congo,Africa,5770949,0,18153
2021-11-14,congo,Africa,5770949,0,18153
2021-11-15,congo,Africa,5770949,237,18390
2021-11-16,congo,Africa,5770949,149,18539
2021-11-17,congo,Africa,5770949,0,18539
2021-11-18,congo,Africa,5770949,0,18539
2021-11-19,congo,Africa,5770949,178,18717
2021-11-20,congo,Africa,5770949,0,18717
2021-11-21,congo,Africa,5770949,0,18717
2021-11-22,congo,Africa,5770949,0,18717
2021-11-23,congo,Africa,5770949,120,18837
2021-11-24,congo,Africa,5770949,0,18837
2021-11-25,congo,Africa,5770949,0,18837
2021-11-26,congo,Africa,5770949,0,18837
2021-11-27,congo,Africa,5770949,0,18837
2021-11-28,congo,Africa,5770949,0,18837
2021-11-29,congo,Africa,5770949,68,18905
2021-11-30,congo,Africa,5770949,65,18970
2021-12-01,congo,Africa,5770949,0,18970
2021-12-02,congo,Africa,5770949,0,18970
2021-12-03,congo,Africa,5770949,0,18970
2021-12-04,congo,Africa,5770949,0,18970
2021-12-05,congo,Africa,5770949,0,18970
2021-12-06,congo,Africa,5770949,0,18970
2021-12-07,congo,Africa,5770949,96,19066
2021-12-08,congo,Africa,5770949,0,19066
2021-12-09,congo,Africa,5770949,0,19066
2021-12-10,congo,Africa,5770949,0,19066
2021-12-11,congo,Africa,5770949,0,19066
2021-12-12,congo,Africa,5770949,0,19066
2021-12-13,congo,Africa,5770949,0,19066
2021-12-14,congo,Africa,5770949,0,19066
2021-12-15,congo,Africa,5770949,0,19066
2021-12-16,congo,Africa,5770949,113,19179
2021-12-17,congo,Africa,5770949,0,19179
2021-12-18,congo,Africa,5770949,0,19179
2021-12-19,congo,Africa,5770949,0,19179
2021-12-20,congo,Africa,5770949,0,19179
2021-12-21,congo,Africa,5770949,311,19490
2021-12-22,congo,Africa,5770949,0,19490
2021-12-23,congo,Africa,5770949,0,19490
2021-12-24,congo,Africa,5770949,0,19490
2021-12-25,congo,Africa,5770949,0,19490
2021-12-26,congo,Africa,5770949,0,19490
2021-12-27,congo,Africa,5770949,599,20089
2021-12-28,congo,Africa,5770949,0,20089
2021-12-29,congo,Africa,5770949,0,20089
2021-12-30,congo,Africa,5770949,0,20089
2021-12-31,congo,Africa,5770949,0,20089
2022-01-01,congo,Africa,5770949,1188,21277
2022-01-02,congo,Africa,5770949,0,21277
2022-01-03,congo,Africa,5770949,0,21277
2022-01-04,congo,Africa,5770949,0,21277
2022-01-05,congo,Africa,5770949,0,21277
2022-01-06,congo,Africa,5770949,0,21277
2022-01-07,congo,Africa,5770949,567,21844
2022-01-08,congo,Africa,5770949,0,21844
2022-01-09,congo,Africa,5770949,574,22418
2022-01-10,congo,Africa,5770949,0,22418
2022-01-11,congo,Africa,5770949,0,22418
2022-01-12,congo,Africa,5770949,0,22418
2022-01-13,congo,Africa,5770949,0,22418
2022-01-14,congo,Africa,5770949,551,22969
2022-01-15,congo,Africa,5770949,0,22969
2022-01-16,congo,Africa,5770949,0,22969
2022-01-17,congo,Africa,5770949,275,23244
2022-01-18,congo,Africa,5770949,0,23244
2022-01-19,congo,Africa,5770949,0,23244
2022-01-20,congo,Africa,5770949,0,23244
2022-01-21,congo,Africa,5770949,136,23380
2022-01-22,congo,Africa,5770949,0,23380
2022-01-23,congo,Africa,5770949,105,23485
2022-01-24,congo,Africa,5770949,0,23485
2022-01-25,congo,Africa,5770949,0,23485
2022-01-26,congo,Africa,5770949,0,23485
2022-01-27,congo,Africa,5770949,168,23653
2022-01-28,congo,Africa,5770949,0,23653
2022-01-29,congo,Africa,5770949,0,23653
2022-01-30,congo,Africa,5770949,0,23653
2022-01-31,congo,Africa,5770949,52,23705
2022-02-01,congo,Africa,5770949,0,23705
2022-02-02,congo,Africa,5770949,0,23705
2022-02-03,congo,Africa,5770949,0,23705
2022-02-04,congo,Africa,5770949,0,23705
2022-02-05,congo,Africa,5770949,0,23705
2022-02-06,congo,Africa,5770949,0,23705
2022-02-07,congo,Africa,5770949,87,23792
2022-02-08,congo,Africa,5770949,0,23792
2022-02-09,congo,Africa,5770949,62,23854
2022-02-10,congo,Africa,5770949,6,23860
2022-02-11,congo,Africa,5770949,0,23860
2022-02-12,congo,Africa,5770949,0,23860
2022-02-13,congo,Africa,5770949,0,23860
2022-02-14,congo,Africa,5770949,14,23874
2022-02-15,congo,Africa,5770949,0,23874
2022-02-16,congo,Africa,5770949,0,23874
2022-02-17,congo,Africa,5770949,0,23874
2022-02-18,congo,Africa,5770949,0,23874
2022-02-19,congo,Africa,5770949,0,23874
2022-02-20,congo,Africa,5770949,0,23874
2022-02-21,congo,Africa,5770949,51,23925
2022-02-22,congo,Africa,5770949,0,23925
2022-02-23,congo,Africa,5770949,0,23925
2022-02-24,congo,Africa,5770949,42,23967
2022-02-25,congo,Africa,5770949,0,23967
2022-02-26,congo,Africa,5770949,0,23967
2022-02-27,congo,Africa,5770949,0,23967
2022-02-28,congo,Africa,5770949,53,24020
2022-03-01,congo,Africa,5770949,0,24020
2022-03-02,congo,Africa,5770949,0,24020
2022-03-03,congo,Africa,5770949,0,24020
2022-03-04,congo,Africa,5770949,0,24020
2022-03-05,congo,Africa,5770949,0,24020
2022-03-06,congo,Africa,5770949,0,24020
2022-03-07,congo,Africa,5770949,0,24020
2022-03-08,congo,Africa,5770949,0,24020
2022-03-09,congo,Africa,5770949,21,24041
2022-03-10,congo,Africa,5770949,0,24041
2022-03-11,congo,Africa,5770949,8,24049
2022-03-12,congo,Africa,5770949,0,24049
2022-03-13,congo,Africa,5770949,0,24049
2022-03-14,congo,Africa,5770949,0,24049
2022-03-15,congo,Africa,5770949,0,24049
2022-03-16,congo,Africa,5770949,0,24049
2022-03-17,congo,Africa,5770949,0,24049
2022-03-18,congo,Africa,5770949,10,24059
2022-03-19,congo,Africa,5770949,0,24059
2022-03-20,congo,Africa,5770949,0,24059
2022-03-21,congo,Africa,5770949,3,24062
2022-03-22,congo,Africa,5770949,0,24062
2022-03-23,congo,Africa,5770949,0,24062
2022-03-24,congo,Africa,5770949,0,24062
2022-03-25,congo,Africa,5770949,0,24062
2022-03-26,congo,Africa,5770949,0,24062
2022-03-27,congo,Africa,5770949,0,24062
2022-03-28,congo,Africa,5770949,7,24069
2022-03-29,congo,Africa,5770949,0,24069
2022-03-30,congo,Africa,5770949,0,24069
2022-03-31,congo,Africa,5770949,2,24071
2022-04-01,congo,Africa,5770949,0,24071
2022-04-02,congo,Africa,5770949,0,24071
2022-04-03,congo,Africa,5770949,0,24071
2022-04-04,congo,Africa,5770949,0,24071
2022-04-05,congo,Africa,5770949,8,24079
2022-04-06,congo,Africa,5770949,0,24079
2022-04-07,congo,Africa,5770949,0,24079
2022-04-08,congo,Africa,5770949,0,24079
2022-04-09,congo,Africa,5770949,0,24079
2022-04-10,congo,Africa,5770949,0,24079
2022-04-11,congo,Africa,5770949,0,24079
2022-04-12,congo,Africa,5770949,0,24079
2022-04-13,congo,Africa,5770949,0,24079
2022-04-14,congo,Africa,5770949,0,24079
2022-04-15,congo,Africa,5770949,0,24079
2022-04-16,congo,Africa,5770949,0,24079
2022-04-17,congo,Africa,5770949,0,24079
2022-04-18,congo,Africa,5770949,0,24079
2022-04-19,congo,Africa,5770949,0,24079
2022-04-20,congo,Africa,5770949,0,24079
2022-04-21,congo,Africa,5770949,0,24079
2022-04-22,congo,Africa,5770949,0,24079
2022-04-23,congo,Africa,5770949,0,24079
2022-04-24,congo,Africa,5770949,0,24079
2022-04-25,congo,Africa,5770949,0,24079
2022-04-26,congo,Africa,5770949,0,24079
2022-04-27,congo,Africa,5770949,0,24079
2022-04-28,congo,Africa,5770949,0,24079
2022-04-29,congo,Africa,5770949,0,24079
2022-04-30,congo,Africa,5770949,0,24079
2022-05-01,congo,Africa,5770949,0,24079
2022-05-02,congo,Africa,5770949,0,24079
2022-05-03,congo,Africa,5770949,0,24079
2022-05-04,congo,Africa,5770949,0,24079
2022-05-05,congo,Africa,5770949,0,24079
2020-03-30,cote_d_ivoire,Africa,27594347,3,168
2020-03-31,cote_d_ivoire,Africa,27594347,11,179
2020-04-01,cote_d_ivoire,Africa,27594347,11,190
2020-04-02,cote_d_ivoire,Africa,27594347,4,194
2020-04-03,cote_d_ivoire,Africa,27594347,24,218
2020-04-04,cote_d_ivoire,Africa,27594347,27,245
2020-04-05,cote_d_ivoire,Africa,27594347,16,261
2020-04-06,cote_d_ivoire,Africa,27594347,62,323
2020-04-07,cote_d_ivoire,Africa,27594347,26,349
2020-04-08,cote_d_ivoire,Africa,27594347,35,384
2020-04-09,cote_d_ivoire,Africa,27594347,60,444
2020-04-10,cote_d_ivoire,Africa,27594347,36,480
2020-04-11,cote_d_ivoire,Africa,27594347,53,533
2020-04-12,cote_d_ivoire,Africa,27594347,41,574
2020-04-13,cote_d_ivoire,Africa,27594347,52,626
2020-04-14,cote_d_ivoire,Africa,27594347,12,638
2020-04-15,cote_d_ivoire,Africa,27594347,16,654
2020-04-16,cote_d_ivoire,Africa,27594347,0,654
2020-04-17,cote_d_ivoire,Africa,27594347,34,688
2020-04-18,cote_d_ivoire,Africa,27594347,113,801
2020-04-19,cote_d_ivoire,Africa,27594347,46,847
2020-04-20,cote_d_ivoire,Africa,27594347,32,879
2020-04-21,cote_d_ivoire,Africa,27594347,37,916
2020-04-22,cote_d_ivoire,Africa,27594347,36,952
2020-04-23,cote_d_ivoire,Africa,27594347,52,1004
2020-04-24,cote_d_ivoire,Africa,27594347,73,1077
2020-04-25,cote_d_ivoire,Africa,27594347,0,1077
2020-04-26,cote_d_ivoire,Africa,27594347,73,1150
2020-04-27,cote_d_ivoire,Africa,27594347,14,1164
2020-04-28,cote_d_ivoire,Africa,27594347,19,1183
2020-04-29,cote_d_ivoire,Africa,27594347,55,1238
2020-04-30,cote_d_ivoire,Africa,27594347,37,1275
2020-05-01,cote_d_ivoire,Africa,27594347,58,1333
2020-05-02,cote_d_ivoire,Africa,27594347,29,1362
2020-05-03,cote_d_ivoire,Africa,27594347,36,1398
2020-05-04,cote_d_ivoire,Africa,27594347,34,1432
2020-05-05,cote_d_ivoire,Africa,27594347,32,1464
2020-05-06,cote_d_ivoire,Africa,27594347,52,1516
2020-05-07,cote_d_ivoire,Africa,27594347,55,1571
2020-05-08,cote_d_ivoire,Africa,27594347,31,1602
2020-05-09,cote_d_ivoire,Africa,27594347,65,1667
2020-05-10,cote_d_ivoire,Africa,27594347,33,1700
2020-05-11,cote_d_ivoire,Africa,27594347,30,1730
2020-05-12,cote_d_ivoire,Africa,27594347,127,1857
2020-05-13,cote_d_ivoire,Africa,27594347,55,1912
2020-05-14,cote_d_ivoire,Africa,27594347,59,1971
2020-05-15,cote_d_ivoire,Africa,27594347,46,2017
2020-05-16,cote_d_ivoire,Africa,27594347,44,2061
2020-05-17,cote_d_ivoire,Africa,27594347,48,2109
2020-05-18,cote_d_ivoire,Africa,27594347,10,2119
2020-05-19,cote_d_ivoire,Africa,27594347,34,2153
2020-05-20,cote_d_ivoire,Africa,27594347,78,2231
2020-05-21,cote_d_ivoire,Africa,27594347,70,2301
2020-05-22,cote_d_ivoire,Africa,27594347,40,2341
2020-05-23,cote_d_ivoire,Africa,27594347,25,2366
2020-05-24,cote_d_ivoire,Africa,27594347,10,2376
2020-05-25,cote_d_ivoire,Africa,27594347,47,2423
2020-05-26,cote_d_ivoire,Africa,27594347,54,2477
2020-05-27,cote_d_ivoire,Africa,27594347,79,2556
2020-05-28,cote_d_ivoire,Africa,27594347,85,2641
2020-05-29,cote_d_ivoire,Africa,27594347,109,2750
2020-05-30,cote_d_ivoire,Africa,27594347,49,2799
2020-05-31,cote_d_ivoire,Africa,27594347,34,2833
2020-06-01,cote_d_ivoire,Africa,27594347,118,2951
2020-06-02,cote_d_ivoire,Africa,27594347,73,3024
2020-06-03,cote_d_ivoire,Africa,27594347,86,3110
2020-06-04,cote_d_ivoire,Africa,27594347,152,3262
2020-06-05,cote_d_ivoire,Africa,27594347,169,3431
2020-06-06,cote_d_ivoire,Africa,27594347,126,3557
2020-06-07,cote_d_ivoire,Africa,27594347,182,3739
2020-06-08,cote_d_ivoire,Africa,27594347,142,3881
2020-06-09,cote_d_ivoire,Africa,27594347,114,3995
2020-06-10,cote_d_ivoire,Africa,27594347,186,4181
2020-06-11,cote_d_ivoire,Africa,27594347,223,4404
2020-06-12,cote_d_ivoire,Africa,27594347,280,4684
2020-06-13,cote_d_ivoire,Africa,27594347,164,4848
2020-06-14,cote_d_ivoire,Africa,27594347,236,5084
2020-06-15,cote_d_ivoire,Africa,27594347,355,5439
2020-06-16,cote_d_ivoire,Africa,27594347,240,5679
2020-06-17,cote_d_ivoire,Africa,27594347,384,6063
2020-06-18,cote_d_ivoire,Africa,27594347,381,6444
2020-06-19,cote_d_ivoire,Africa,27594347,430,6874
2020-06-20,cote_d_ivoire,Africa,27594347,402,7276
2020-06-21,cote_d_ivoire,Africa,27594347,216,7492
2020-06-22,cote_d_ivoire,Africa,27594347,185,7677
2020-06-23,cote_d_ivoire,Africa,27594347,227,7904
2020-06-24,cote_d_ivoire,Africa,27594347,260,8164
2020-06-25,cote_d_ivoire,Africa,27594347,170,8334
2020-06-26,cote_d_ivoire,Africa,27594347,405,8739
2020-06-27,cote_d_ivoire,Africa,27594347,205,8944
2020-06-28,cote_d_ivoire,Africa,27594347,157,9101
2020-06-29,cote_d_ivoire,Africa,27594347,113,9214
2020-06-30,cote_d_ivoire,Africa,27594347,285,9499
2020-07-01,cote_d_ivoire,Africa,27594347,203,9702
2020-07-02,cote_d_ivoire,Africa,27594347,290,9992
2020-07-03,cote_d_ivoire,Africa,27594347,252,10244
2020-07-04,cote_d_ivoire,Africa,27594347,218,10462
2020-07-05,cote_d_ivoire,Africa,27594347,310,10772
2020-07-06,cote_d_ivoire,Africa,27594347,194,10966
2020-07-07,cote_d_ivoire,Africa,27594347,228,11194
2020-07-08,cote_d_ivoire,Africa,27594347,310,11504
2020-07-09,cote_d_ivoire,Africa,27594347,246,11750
2020-07-10,cote_d_ivoire,Africa,27594347,302,12052
2020-07-11,cote_d_ivoire,Africa,27594347,391,12443
2020-07-12,cote_d_ivoire,Africa,27594347,323,12766
2020-07-13,cote_d_ivoire,Africa,27594347,106,12872
2020-07-14,cote_d_ivoire,Africa,27594347,165,13037
2020-07-15,cote_d_ivoire,Africa,27594347,366,13403
2020-07-16,cote_d_ivoire,Africa,27594347,151,13554
2020-07-17,cote_d_ivoire,Africa,27594347,142,13696
2020-07-18,cote_d_ivoire,Africa,27594347,216,13912
2020-07-19,cote_d_ivoire,Africa,27594347,207,14119
2020-07-20,cote_d_ivoire,Africa,27594347,193,14312
2020-07-21,cote_d_ivoire,Africa,27594347,219,14531
2020-07-22,cote_d_ivoire,Africa,27594347,202,14733
2020-07-23,cote_d_ivoire,Africa,27594347,268,15001
2020-07-24,cote_d_ivoire,Africa,27594347,252,15253
2020-07-25,cote_d_ivoire,Africa,27594347,241,15494
2020-07-26,cote_d_ivoire,Africa,27594347,102,15596
2020-07-27,cote_d_ivoire,Africa,27594347,59,15655
2020-07-28,cote_d_ivoire,Africa,27594347,58,15713
2020-07-29,cote_d_ivoire,Africa,27594347,100,15813
2020-07-30,cote_d_ivoire,Africa,27594347,165,15978
2020-07-31,cote_d_ivoire,Africa,27594347,69,16047
2020-08-01,cote_d_ivoire,Africa,27594347,62,16109
2020-08-02,cote_d_ivoire,Africa,27594347,73,16182
2020-08-03,cote_d_ivoire,Africa,27594347,38,16220
2020-08-04,cote_d_ivoire,Africa,27594347,73,16293
2020-08-05,cote_d_ivoire,Africa,27594347,56,16349
2020-08-06,cote_d_ivoire,Africa,27594347,98,16447
2020-08-07,cote_d_ivoire,Africa,27594347,77,16524
2020-08-08,cote_d_ivoire,Africa,27594347,96,16620
2020-08-09,cote_d_ivoire,Africa,27594347,95,16715
2020-08-10,cote_d_ivoire,Africa,27594347,83,16798
2020-08-11,cote_d_ivoire,Africa,27594347,49,16847
2020-08-12,cote_d_ivoire,Africa,27594347,0,16847
2020-08-13,cote_d_ivoire,Africa,27594347,42,16889
2020-08-14,cote_d_ivoire,Africa,27594347,46,16935
2020-08-15,cote_d_ivoire,Africa,27594347,58,16993
2020-08-16,cote_d_ivoire,Africa,27594347,33,17026
2020-08-17,cote_d_ivoire,Africa,27594347,81,17107
2020-08-18,cote_d_ivoire,Africa,27594347,43,17150
2020-08-19,cote_d_ivoire,Africa,27594347,82,17232
2020-08-20,cote_d_ivoire,Africa,27594347,17,17249
2020-08-21,cote_d_ivoire,Africa,27594347,61,17310
2020-08-22,cote_d_ivoire,Africa,27594347,64,17374
2020-08-23,cote_d_ivoire,Africa,27594347,97,17471
2020-08-24,cote_d_ivoire,Africa,27594347,35,17506
2020-08-25,cote_d_ivoire,Africa,27594347,56,17562
2020-08-26,cote_d_ivoire,Africa,27594347,41,17603
2020-08-27,cote_d_ivoire,Africa,27594347,99,17702
2020-08-28,cote_d_ivoire,Africa,27594347,95,17797
2020-08-29,cote_d_ivoire,Africa,27594347,96,17893
2020-08-30,cote_d_ivoire,Africa,27594347,55,17948
2020-08-31,cote_d_ivoire,Africa,27594347,119,18067
2020-09-01,cote_d_ivoire,Africa,27594347,36,18103
2020-09-02,cote_d_ivoire,Africa,27594347,58,18161
2020-09-03,cote_d_ivoire,Africa,27594347,47,18208
2020-09-04,cote_d_ivoire,Africa,27594347,61,18269
2020-09-05,cote_d_ivoire,Africa,27594347,203,18472
2020-09-06,cote_d_ivoire,Africa,27594347,116,18588
2020-09-07,cote_d_ivoire,Africa,27594347,113,18701
2020-09-08,cote_d_ivoire,Africa,27594347,77,18778
2020-09-09,cote_d_ivoire,Africa,27594347,37,18815
2020-09-10,cote_d_ivoire,Africa,27594347,54,18869
2020-09-11,cote_d_ivoire,Africa,27594347,47,18916
2020-09-12,cote_d_ivoire,Africa,27594347,71,18987
2020-09-13,cote_d_ivoire,Africa,27594347,26,19013
2020-09-14,cote_d_ivoire,Africa,27594347,53,19066
2020-09-15,cote_d_ivoire,Africa,27594347,34,19100
2020-09-16,cote_d_ivoire,Africa,27594347,32,19132
2020-09-17,cote_d_ivoire,Africa,27594347,26,19158
2020-09-18,cote_d_ivoire,Africa,27594347,42,19200
2020-09-19,cote_d_ivoire,Africa,27594347,69,19269
2020-09-20,cote_d_ivoire,Africa,27594347,51,19320
2020-09-21,cote_d_ivoire,Africa,27594347,7,19327
2020-09-22,cote_d_ivoire,Africa,27594347,16,19343
2020-09-23,cote_d_ivoire,Africa,27594347,87,19430
2020-09-24,cote_d_ivoire,Africa,27594347,71,19501
2020-09-25,cote_d_ivoire,Africa,27594347,55,19556
2020-09-26,cote_d_ivoire,Africa,27594347,44,19600
2020-09-27,cote_d_ivoire,Africa,27594347,29,19629
2020-09-28,cote_d_ivoire,Africa,27594347,12,19641
2020-09-29,cote_d_ivoire,Africa,27594347,28,19669
2020-09-30,cote_d_ivoire,Africa,27594347,55,19724
2020-10-01,cote_d_ivoire,Africa,27594347,31,19755
2020-10-02,cote_d_ivoire,Africa,27594347,38,19793
2020-10-03,cote_d_ivoire,Africa,27594347,56,19849
2020-10-04,cote_d_ivoire,Africa,27594347,33,19882
2020-10-05,cote_d_ivoire,Africa,27594347,3,19885
2020-10-06,cote_d_ivoire,Africa,27594347,18,19903
2020-10-07,cote_d_ivoire,Africa,27594347,32,19935
2020-10-08,cote_d_ivoire,Africa,27594347,47,19982
2020-10-09,cote_d_ivoire,Africa,27594347,54,20036
2020-10-10,cote_d_ivoire,Africa,27594347,92,20128
2020-10-11,cote_d_ivoire,Africa,27594347,26,20154
2020-10-12,cote_d_ivoire,Africa,27594347,1,20155
2020-10-13,cote_d_ivoire,Africa,27594347,28,20183
2020-10-14,cote_d_ivoire,Africa,27594347,34,20217
2020-10-15,cote_d_ivoire,Africa,27594347,40,20257
2020-10-16,cote_d_ivoire,Africa,27594347,18,20275
2020-10-17,cote_d_ivoire,Africa,27594347,26,20301
2020-10-18,cote_d_ivoire,Africa,27594347,22,20323
2020-10-19,cote_d_ivoire,Africa,27594347,1,20324
2020-02-26,croatia,Europe,4058130,2,3
2020-02-27,croatia,Europe,4058130,0,3
2020-02-28,croatia,Europe,4058130,2,5
2020-02-29,croatia,Europe,4058130,1,6
2020-03-01,croatia,Europe,4058130,1,7
2020-03-02,croatia,Europe,4058130,1,8
2020-03-03,croatia,Europe,4058130,1,9
2020-03-04,croatia,Europe,4058130,1,10
2020-03-05,croatia,Europe,4058130,0,10
2020-03-06,croatia,Europe,4058130,1,11
2020-03-07,croatia,Europe,4058130,1,12
2020-03-08,croatia,Europe,4058130,0,12
2020-03-09,croatia,Europe,4058130,1,13
2020-03-10,croatia,Europe,4058130,2,15
2020-03-11,croatia,Europe,4058130,4,19
2020-03-12,croatia,Europe,4058130,8,27
2020-03-13,croatia,Europe,4058130,5,32
2020-03-14,croatia,Europe,4058130,7,39
2020-03-15,croatia,Europe,4058130,10,49
2020-03-16,croatia,Europe,4058130,8,57
2020-03-17,croatia,Europe,4058130,12,69
2020-03-18,croatia,Europe,4058130,20,89
2020-03-19,croatia,Europe,4058130,21,110
2020-03-20,croatia,Europe,4058130,20,130
2020-03-21,croatia,Europe,4058130,76,206
2020-03-22,croatia,Europe,4058130,48,254
2020-03-23,croatia,Europe,4058130,61,315
2020-03-24,croatia,Europe,4058130,67,382
2020-03-25,croatia,Europe,4058130,60,442
2020-03-26,croatia,Europe,4058130,53,495
2020-03-27,croatia,Europe,4058130,91,586
2020-03-28,croatia,Europe,4058130,71,657
2020-03-29,croatia,Europe,4058130,56,713
2020-03-30,croatia,Europe,4058130,77,790
2020-03-31,croatia,Europe,4058130,77,867
2020-04-01,croatia,Europe,4058130,96,963
2020-04-02,croatia,Europe,4058130,48,1011
2020-04-03,croatia,Europe,4058130,68,1079
2020-04-04,croatia,Europe,4058130,47,1126
2020-04-05,croatia,Europe,4058130,56,1182
2020-04-06,croatia,Europe,4058130,40,1222
2020-04-07,croatia,Europe,4058130,60,1282
2020-04-08,croatia,Europe,4058130,61,1343
2020-04-09,croatia,Europe,4058130,64,1407
2020-04-10,croatia,Europe,4058130,88,1495
2020-04-11,croatia,Europe,4058130,39,1534
2020-04-12,croatia,Europe,4058130,66,1600
2020-04-13,croatia,Europe,4058130,50,1650
2020-04-14,croatia,Europe,4058130,54,1704
2020-04-15,croatia,Europe,4058130,37,1741
2020-04-16,croatia,Europe,4058130,50,1791
2020-04-17,croatia,Europe,4058130,23,1814
2020-04-18,croatia,Europe,4058130,18,1832
2020-04-19,croatia,Europe,4058130,39,1871
2020-04-20,croatia,Europe,4058130,10,1881
2020-04-21,croatia,Europe,4058130,27,1908
2020-04-22,croatia,Europe,4058130,42,1950
2020-04-23,croatia,Europe,4058130,31,1981
2020-04-24,croatia,Europe,4058130,28,2009
2020-04-25,croatia,Europe,4058130,7,2016
2020-04-26,croatia,Europe,4058130,14,2030
2020-04-27,croatia,Europe,4058130,9,2039
2020-04-28,croatia,Europe,4058130,8,2047
2020-04-29,croatia,Europe,4058130,15,2062
2020-04-30,croatia,Europe,4058130,14,2076
2020-05-01,croatia,Europe,4058130,9,2085
2020-05-02,croatia,Europe,4058130,3,2088
2020-05-03,croatia,Europe,4058130,8,2096
2020-05-04,croatia,Europe,4058130,5,2101
2020-05-05,croatia,Europe,4058130,11,2112
2020-05-06,croatia,Europe,4058130,7,2119
2020-05-07,croatia,Europe,4058130,6,2125
2020-05-08,croatia,Europe,4058130,36,2161
2020-05-09,croatia,Europe,4058130,15,2176
2020-05-10,croatia,Europe,4058130,11,2187
2020-05-11,croatia,Europe,4058130,9,2196
2020-05-12,croatia,Europe,4058130,11,2207
2020-05-13,croatia,Europe,4058130,6,2213
2020-05-14,croatia,Europe,4058130,8,2221
2020-05-15,croatia,Europe,4058130,1,2222
2020-05-16,croatia,Europe,4058130,2,2224
2020-05-17,croatia,Europe,4058130,2,2226
2020-05-18,croatia,Europe,4058130,2,2228
2020-05-19,croatia,Europe,4058130,4,2232
2020-05-20,croatia,Europe,4058130,2,2234
2020-05-21,croatia,Europe,4058130,3,2237
2020-05-22,croatia,Europe,4058130,6,2243
2020-05-23,croatia,Europe,4058130,0,2243
2020-05-24,croatia,Europe,4058130,1,2244
2020-05-25,croatia,Europe,4058130,0,2244
2020-05-26,croatia,Europe,4058130,0,2244
2020-05-27,croatia,Europe,4058130,0,2244
2020-05-28,croatia,Europe,4058130,1,2245
2020-05-29,croatia,Europe,4058130,0,2245
2020-05-30,croatia,Europe,4058130,1,2246
2020-05-31,croatia,Europe,4058130,0,2246
2020-06-01,croatia,Europe,4058130,0,2246
2020-06-02,croatia,Europe,4058130,0,2246
2020-06-03,croatia,Europe,4058130,0,2246
2020-06-04,croatia,Europe,4058130,1,2247
2020-06-05,croatia,Europe,4058130,0,2247
2020-06-06,croatia,Europe,4058130,0,2247
2020-06-07,croatia,Europe,4058130,0,2247
2020-06-08,croatia,Europe,4058130,0,2247
2020-06-09,croatia,Europe,4058130,0,2247
2020-06-10,croatia,Europe,4058130,2,2249
2020-06-11,croatia,Europe,4058130,0,2249
2020-06-12,croatia,Europe,4058130,0,2249
2020-06-13,croatia,Europe,4058130,2,2251
2020-06-14,croatia,Europe,4058130,1,2252
2020-06-15,croatia,Europe,4058130,2,2254
2020-06-16,croatia,Europe,4058130,1,2255
2020-06-17,croatia,Europe,4058130,3,2258
2020-06-18,croatia,Europe,4058130,11,2269
2020-06-19,croatia,Europe,4058130,11,2280
2020-06-20,croatia,Europe,4058130,19,2299
2020-06-21,croatia,Europe,4058130,18,2317
2020-06-22,croatia,Europe,4058130,19,2336
2020-06-23,croatia,Europe,4058130,30,2366
2020-06-24,croatia,Europe,4058130,22,2388
2020-06-25,croatia,Europe,4058130,95,2483
2020-06-26,croatia,Europe,4058130,56,2539
2020-06-27,croatia,Europe,4058130,85,2624
2020-06-28,croatia,Europe,4058130,67,2691
2020-06-29,croatia,Europe,4058130,34,2725
2020-06-30,croatia,Europe,4058130,52,2777
2020-07-01,croatia,Europe,4058130,54,2831
2020-07-02,croatia,Europe,4058130,81,2912
2020-07-03,croatia,Europe,4058130,96,3008
2020-07-04,croatia,Europe,4058130,86,3094
2020-07-05,croatia,Europe,4058130,57,3151
2020-07-06,croatia,Europe,4058130,69,3220
2020-07-07,croatia,Europe,4058130,52,3272
2020-07-08,croatia,Europe,4058130,53,3325
2020-07-09,croatia,Europe,4058130,91,3416
2020-07-10,croatia,Europe,4058130,116,3532
2020-07-11,croatia,Europe,4058130,140,3672
2020-07-12,croatia,Europe,4058130,50,3722
2020-07-13,croatia,Europe,4058130,53,3775
2020-07-14,croatia,Europe,4058130,52,3827
2020-07-15,croatia,Europe,4058130,126,3953
2020-07-16,croatia,Europe,4058130,86,4039
2020-07-17,croatia,Europe,4058130,98,4137
2020-07-18,croatia,Europe,4058130,116,4253
2020-07-19,croatia,Europe,4058130,92,4345
2020-07-20,croatia,Europe,4058130,25,4370
2020-07-21,croatia,Europe,4058130,52,4422
2020-07-22,croatia,Europe,4058130,108,4530
2020-07-23,croatia,Europe,4058130,104,4634
2020-07-24,croatia,Europe,4058130,81,4715
2020-07-25,croatia,Europe,4058130,77,4792
2020-07-26,croatia,Europe,4058130,65,4857
2020-07-27,croatia,Europe,4058130,24,4881
2020-07-28,croatia,Europe,4058130,41,4922
2020-07-29,croatia,Europe,4058130,71,4993
2020-07-30,croatia,Europe,4058130,78,5071
2020-07-31,croatia,Europe,4058130,67,5138
2020-08-01,croatia,Europe,4058130,86,5224
2020-08-02,croatia,Europe,4058130,36,5260
2020-08-03,croatia,Europe,4058130,34,5294
2020-08-04,croatia,Europe,4058130,24,5318
2020-08-05,croatia,Europe,4058130,58,5376
2020-08-06,croatia,Europe,4058130,28,5404
2020-08-07,croatia,Europe,4058130,62,5466
2020-08-08,croatia,Europe,4058130,77,5543
2020-08-09,croatia,Europe,4058130,61,5604
2020-08-10,croatia,Europe,4058130,45,5649
2020-08-11,croatia,Europe,4058130,91,5740
2020-08-12,croatia,Europe,4058130,130,5870
2020-08-13,croatia,Europe,4058130,180,6050
2020-08-14,croatia,Europe,4058130,208,6258
2020-08-15,croatia,Europe,4058130,162,6420
2020-08-16,croatia,Europe,4058130,151,6571
2020-08-17,croatia,Europe,4058130,85,6656
2020-08-18,croatia,Europe,4058130,199,6855
2020-08-19,croatia,Europe,4058130,219,7074
2020-08-20,croatia,Europe,4058130,255,7329
2020-08-21,croatia,Europe,4058130,265,7594
2020-08-22,croatia,Europe,4058130,306,7900
2020-08-23,croatia,Europe,4058130,275,8175
2020-08-24,croatia,Europe,4058130,136,8311
2020-08-25,croatia,Europe,4058130,219,8530
2020-08-26,croatia,Europe,4058130,358,8888
2020-08-27,croatia,Europe,4058130,304,9192
2020-08-28,croatia,Europe,4058130,357,9549
2020-08-29,croatia,Europe,4058130,312,9861
2020-08-30,croatia,Europe,4058130,262,10123
2020-08-31,croatia,Europe,4058130,146,10269
2020-09-01,croatia,Europe,4058130,145,10414
2020-09-02,croatia,Europe,4058130,311,10725
2020-09-03,croatia,Europe,4058130,369,11094
2020-09-04,croatia,Europe,4058130,334,11428
2020-09-05,croatia,Europe,4058130,311,11739
2020-09-06,croatia,Europe,4058130,225,11964
2020-09-07,croatia,Europe,4058130,117,12081
2020-09-08,croatia,Europe,4058130,204,12285
2020-09-09,croatia,Europe,4058130,341,12626
2020-09-10,croatia,Europe,4058130,291,12917
2020-09-11,croatia,Europe,4058130,190,13107
2020-09-12,croatia,Europe,4058130,261,13368
2020-09-13,croatia,Europe,4058130,165,13533
2020-09-14,croatia,Europe,4058130,65,13598
2020-09-15,croatia,Europe,4058130,151,13749
2020-09-16,croatia,Europe,4058130,280,14029
2020-09-17,croatia,Europe,4058130,250,14279
2020-09-18,croatia,Europe,4058130,234,14513
2020-09-19,croatia,Europe,4058130,212,14725
2020-09-20,croatia,Europe,4058130,197,14922
2020-09-21,croatia,Europe,4058130,70,14992
2020-09-22,croatia,Europe,4058130,144,15136
2020-09-23,croatia,Europe,4058130,204,15340
2020-09-24,croatia,Europe,4058130,232,15572
2020-09-25,croatia,Europe,4058130,223,15795
2020-09-26,croatia,Europe,4058130,212,16007
2020-09-27,croatia,Europe,4058130,190,16197
2020-09-28,croatia,Europe,4058130,48,16245
2020-09-29,croatia,Europe,4058130,135,16380
2020-09-30,croatia,Europe,4058130,213,16593
2020-10-01,croatia,Europe,4058130,234,16827
2020-10-02,croatia,Europe,4058130,333,17160
2020-10-03,croatia,Europe,4058130,241,17401
2020-10-04,croatia,Europe,4058130,258,17659
2020-10-05,croatia,Europe,4058130,138,17797
2020-10-06,croatia,Europe,4058130,287,18084
2020-10-07,croatia,Europe,4058130,363,18447
2020-10-08,croatia,Europe,4058130,542,18989
2020-10-09,croatia,Europe,4058130,457,19446
2020-10-10,croatia,Europe,4058130,486,19932
2020-10-11,croatia,Europe,4058130,508,20440
2020-10-12,croatia,Europe,4058130,181,20621
2020-10-13,croatia,Europe,4058130,372,20993
2020-10-14,croatia,Europe,4058130,748,21741
2020-10-15,croatia,Europe,4058130,793,22534
2020-10-16,croatia,Europe,4058130,1131,23665
2020-10-17,croatia,Europe,4058130,1096,24761
2020-10-18,croatia,Europe,4058130,819,25580
2020-10-19,croatia,Europe,4058130,393,25973
2020-10-20,croatia,Europe,4058130,890,26863
2020-10-21,croatia,Europe,4058130,1424,28287
2020-10-22,croatia,Europe,4058130,1563,29850
2020-10-23,croatia,Europe,4058130,1867,31717
2020-10-24,croatia,Europe,4058130,2242,33959
2020-10-25,croatia,Europe,4058130,2421,36380
2020-10-26,croatia,Europe,4058130,828,37208
2020-10-27,croatia,Europe,4058130,1413,38621
2020-10-28,croatia,Europe,4058130,2378,40999
2020-10-29,croatia,Europe,4058130,2776,43775
2020-10-30,croatia,Europe,4058130,2772,46547
2020-10-31,croatia,Europe,4058130,2769,49316
2020-11-01,croatia,Europe,4058130,2179,51495
2020-11-02,croatia,Europe,4058130,1165,52660
2020-11-03,croatia,Europe,4058130,1427,54087
2020-11-04,croatia,Europe,4058130,2480,56567
2020-11-05,croatia,Europe,4058130,2848,59415
2020-11-06,croatia,Europe,4058130,2890,62305
2020-11-07,croatia,Europe,4058130,2399,64704
2020-11-08,croatia,Europe,4058130,2543,67247
2020-11-09,croatia,Europe,4058130,1529,68776
2020-11-10,croatia,Europe,4058130,1467,70243
2020-11-11,croatia,Europe,4058130,2597,72840
2020-11-12,croatia,Europe,4058130,3082,75922
2020-11-13,croatia,Europe,4058130,3056,78978
2020-11-14,croatia,Europe,4058130,2866,81844
2020-11-15,croatia,Europe,4058130,2362,84206
2020-11-16,croatia,Europe,4058130,1313,85519
2020-11-17,croatia,Europe,4058130,1945,87464
2020-11-18,croatia,Europe,4058130,3251,90715
2020-11-19,croatia,Europe,4058130,3164,93879
2020-11-20,croatia,Europe,4058130,2958,96837
2020-11-21,croatia,Europe,4058130,3573,100410
2020-11-22,croatia,Europe,4058130,3308,103718
2020-11-23,croatia,Europe,4058130,1973,105691
2020-11-24,croatia,Europe,4058130,2323,108014
2020-11-25,croatia,Europe,4058130,3603,111617
2020-11-26,croatia,Europe,4058130,4009,115626
2020-11-27,croatia,Europe,4058130,4080,119706
2020-11-28,croatia,Europe,4058130,3987,123693
2020-11-29,croatia,Europe,4058130,2919,126612
2020-11-30,croatia,Europe,4058130,1830,128442
2020-12-01,croatia,Europe,4058130,2900,131342
2020-12-02,croatia,Europe,4058130,3539,134881
2020-12-03,croatia,Europe,4058130,4534,139415
2020-12-04,croatia,Europe,4058130,3955,143370
2020-12-05,croatia,Europe,4058130,4084,147454
2020-12-06,croatia,Europe,4058130,2899,150353
2020-12-07,croatia,Europe,4058130,1886,152239
2020-12-08,croatia,Europe,4058130,2613,154852
2020-12-09,croatia,Europe,4058130,4520,159372
2020-12-10,croatia,Europe,4058130,4620,163992
2020-12-11,croatia,Europe,4058130,4396,168388
2020-12-12,croatia,Europe,4058130,4135,172523
2020-12-13,croatia,Europe,4058130,3363,175886
2020-12-14,croatia,Europe,4058130,1472,177358
2020-12-15,croatia,Europe,4058130,2360,179718
2020-12-16,croatia,Europe,4058130,3327,183045
2020-12-17,croatia,Europe,4058130,3918,186963
2020-12-18,croatia,Europe,4058130,3272,190235
2020-12-19,croatia,Europe,4058130,2752,192987
2020-12-20,croatia,Europe,4058130,1975,194962
2020-12-21,croatia,Europe,4058130,766,195728
2020-12-22,croatia,Europe,4058130,1595,197323
2020-12-23,croatia,Europe,4058130,2763,200086
2020-12-24,croatia,Europe,4058130,2233,202319
2020-12-25,croatia,Europe,4058130,1643,203962
2020-12-26,croatia,Europe,4058130,350,204312
2020-12-27,croatia,Europe,4058130,618,204930
2020-12-28,croatia,Europe,4058130,316,205246
2020-12-29,croatia,Europe,4058130,1350,206596
2020-12-30,croatia,Europe,4058130,1850,208446
2020-12-31,croatia,Europe,4058130,2391,210837
2021-01-01,croatia,Europe,4058130,1170,212007
2021-01-02,croatia,Europe,4058130,255,212262
2021-01-03,croatia,Europe,4058130,696,212958
2021-01-04,croatia,Europe,4058130,361,213319
2021-01-05,croatia,Europe,4058130,1071,214390
2021-01-06,croatia,Europe,4058130,1896,216286
2021-01-07,croatia,Europe,4058130,562,216848
2021-01-08,croatia,Europe,4058130,1098,217946
2021-01-09,croatia,Europe,4058130,1401,219347
2021-01-10,croatia,Europe,4058130,646,219993
2021-01-11,croatia,Europe,4058130,230,220223
2021-01-12,croatia,Europe,4058130,759,220982
2021-01-13,croatia,Europe,4058130,1135,222117
2021-01-14,croatia,Europe,4058130,980,223097
2021-01-15,croatia,Europe,4058130,715,223812
2021-01-16,croatia,Europe,4058130,763,224575
2021-01-17,croatia,Europe,4058130,379,224954
2021-01-18,croatia,Europe,4058130,174,225128
2021-01-19,croatia,Europe,4058130,520,225648
2021-01-20,croatia,Europe,4058130,902,226550
2021-01-21,croatia,Europe,4058130,776,227326
2021-01-22,croatia,Europe,4058130,643,227969
2021-01-23,croatia,Europe,4058130,599,228568
2021-01-24,croatia,Europe,4058130,352,228920
2021-01-25,croatia,Europe,4058130,134,229054
2021-01-26,croatia,Europe,4058130,448,229502
2021-01-27,croatia,Europe,4058130,857,230359
2021-01-28,croatia,Europe,4058130,619,230978
2021-01-29,croatia,Europe,4058130,561,231539
2021-01-30,croatia,Europe,4058130,551,232090
2021-01-31,croatia,Europe,4058130,336,232426
2021-02-01,croatia,Europe,4058130,94,232520
2021-02-02,croatia,Europe,4058130,387,232907
2021-02-03,croatia,Europe,4058130,730,233637
2021-02-04,croatia,Europe,4058130,516,234153
2021-02-05,croatia,Europe,4058130,549,234702
2021-02-06,croatia,Europe,4058130,424,235126
2021-02-07,croatia,Europe,4058130,276,235402
2021-02-08,croatia,Europe,4058130,71,235473
2021-02-09,croatia,Europe,4058130,283,235756
2021-02-10,croatia,Europe,4058130,577,236333
2021-02-11,croatia,Europe,4058130,376,236709
2021-02-12,croatia,Europe,4058130,371,237080
2021-02-13,croatia,Europe,4058130,379,237459
2021-02-14,croatia,Europe,4058130,198,237657
2021-02-15,croatia,Europe,4058130,68,237725
2021-02-16,croatia,Europe,4058130,274,237999
2021-02-17,croatia,Europe,4058130,502,238501
2021-02-18,croatia,Europe,4058130,365,238866
2021-02-19,croatia,Europe,4058130,388,239254
2021-02-20,croatia,Europe,4058130,431,239685
2021-02-21,croatia,Europe,4058130,260,239945
2021-02-22,croatia,Europe,4058130,72,240017
2021-02-23,croatia,Europe,4058130,343,240360
2021-02-24,croatia,Europe,4058130,688,241048
2021-02-25,croatia,Europe,4058130,544,241592
2021-02-26,croatia,Europe,4058130,505,242097
2021-02-27,croatia,Europe,4058130,520,242617
2021-02-28,croatia,Europe,4058130,356,242973
2021-03-01,croatia,Europe,4058130,91,243064
2021-03-02,croatia,Europe,4058130,394,243458
2021-03-03,croatia,Europe,4058130,747,244205
2021-03-04,croatia,Europe,4058130,667,244872
2021-03-05,croatia,Europe,4058130,590,245462
2021-03-06,croatia,Europe,4058130,658,246120
2021-03-07,croatia,Europe,4058130,394,246514
2021-03-08,croatia,Europe,4058130,94,246608
2021-03-09,croatia,Europe,4058130,491,247099
2021-03-10,croatia,Europe,4058130,962,248061
2021-03-11,croatia,Europe,4058130,777,248838
2021-03-12,croatia,Europe,4058130,823,249661
2021-03-13,croatia,Europe,4058130,823,250484
2021-03-14,croatia,Europe,4058130,561,251045
2021-03-15,croatia,Europe,4058130,129,251174
2021-03-16,croatia,Europe,4058130,691,251865
2021-03-17,croatia,Europe,4058130,1445,253310
2021-03-18,croatia,Europe,4058130,1197,254507
2021-03-19,croatia,Europe,4058130,1112,255619
2021-03-20,croatia,Europe,4058130,1186,256805
2021-03-21,croatia,Europe,4058130,834,257639
2021-03-22,croatia,Europe,4058130,150,257789
2021-03-23,croatia,Europe,4058130,956,258745
2021-03-24,croatia,Europe,4058130,1891,260636
2021-03-25,croatia,Europe,4058130,1673,262309
2021-03-26,croatia,Europe,4058130,1802,264111
2021-03-27,croatia,Europe,4058130,1790,265901
2021-03-28,croatia,Europe,4058130,1321,267222
2021-03-29,croatia,Europe,4058130,300,267522
2021-03-30,croatia,Europe,4058130,1487,269009
2021-03-31,croatia,Europe,4058130,2623,271632
2021-04-01,croatia,Europe,4058130,2422,274054
2021-04-02,croatia,Europe,4058130,2362,276416
2021-04-03,croatia,Europe,4058130,2234,278650
2021-04-04,croatia,Europe,4058130,1376,280026
2021-04-05,croatia,Europe,4058130,138,280164
2021-04-06,croatia,Europe,4058130,735,280899
2021-04-07,croatia,Europe,4058130,1649,282548
2021-04-08,croatia,Europe,4058130,3217,285765
2021-04-09,croatia,Europe,4058130,2599,288364
2021-04-10,croatia,Europe,4058130,2535,290899
2021-04-11,croatia,Europe,4058130,1617,292516
2021-04-12,croatia,Europe,4058130,422,292938
2021-04-13,croatia,Europe,4058130,1936,294874
2021-04-14,croatia,Europe,4058130,3099,297973
2021-04-15,croatia,Europe,4058130,2927,300900
2021-04-16,croatia,Europe,4058130,2698,303598
2021-04-17,croatia,Europe,4058130,2627,306225
2021-04-18,croatia,Europe,4058130,1565,307790
2021-04-19,croatia,Europe,4058130,410,308200
2021-04-20,croatia,Europe,4058130,2106,310306
2021-04-21,croatia,Europe,4058130,3117,313423
2021-04-22,croatia,Europe,4058130,2885,316308
2021-04-23,croatia,Europe,4058130,2529,318837
2021-04-24,croatia,Europe,4058130,2535,321372
2021-04-25,croatia,Europe,4058130,1254,322626
2021-04-26,croatia,Europe,4058130,410,323036
2021-04-27,croatia,Europe,4058130,1797,324833
2021-04-28,croatia,Europe,4058130,2904,327737
2020-03-19,cuba,North America,11313741,1,11
2020-03-20,cuba,North America,11313741,10,21
2020-03-21,cuba,North America,11313741,0,21
2020-03-22,cuba,North America,11313741,14,35
2020-03-23,cuba,North America,11313741,5,40
2020-03-24,cuba,North America,11313741,8,48
2020-03-25,cuba,North America,11313741,9,57
2020-03-26,cuba,North America,11313741,10,67
2020-03-27,cuba,North America,11313741,13,80
2020-03-28,cuba,North America,11313741,39,119
2020-03-29,cuba,North America,11313741,20,139
2020-03-30,cuba,North America,11313741,31,170
2020-03-31,cuba,North America,11313741,16,186
2020-04-01,cuba,North America,11313741,26,212
2020-04-02,cuba,North America,11313741,21,233
2020-04-03,cuba,North America,11313741,36,269
2020-04-04,cuba,North America,11313741,19,288
2020-04-05,cuba,North America,11313741,32,320
2020-04-06,cuba,North America,11313741,30,350
2020-04-07,cuba,North America,11313741,46,396
2020-04-08,cuba,North America,11313741,61,457
2020-04-09,cuba,North America,11313741,58,515
2020-04-10,cuba,North America,11313741,49,564
2020-04-11,cuba,North America,11313741,56,620
2020-04-12,cuba,North America,11313741,49,669
2020-04-13,cuba,North America,11313741,57,726
2020-04-14,cuba,North America,11313741,40,766
2020-04-15,cuba,North America,11313741,48,814
2020-04-16,cuba,North America,11313741,48,862
2020-04-17,cuba,North America,11313741,61,923
2020-04-18,cuba,North America,11313741,63,986
2020-04-19,cuba,North America,11313741,49,1035
2020-04-20,cuba,North America,11313741,52,1087
2020-04-21,cuba,North America,11313741,50,1137
2020-04-22,cuba,North America,11313741,52,1189
2020-04-23,cuba,North America,11313741,46,1235
2020-04-24,cuba,North America,11313741,50,1285
2020-04-25,cuba,North America,11313741,52,1337
2020-04-26,cuba,North America,11313741,32,1369
2020-04-27,cuba,North America,11313741,20,1389
2020-04-28,cuba,North America,11313741,48,1437
2020-04-29,cuba,North America,11313741,30,1467
2020-04-30,cuba,North America,11313741,34,1501
2020-05-01,cuba,North America,11313741,36,1537
2020-05-02,cuba,North America,11313741,74,1611
2020-05-03,cuba,North America,11313741,38,1649
2020-05-04,cuba,North America,11313741,19,1668
2020-05-05,cuba,North America,11313741,17,1685
2020-05-06,cuba,North America,11313741,18,1703
2020-05-07,cuba,North America,11313741,26,1729
2020-05-08,cuba,North America,11313741,12,1741
2020-05-09,cuba,North America,11313741,13,1754
2020-05-10,cuba,North America,11313741,12,1766
2020-05-11,cuba,North America,11313741,17,1783
2020-05-12,cuba,North America,11313741,21,1804
2020-05-13,cuba,North America,11313741,6,1810
2020-05-14,cuba,North America,11313741,20,1830
2020-05-15,cuba,North America,11313741,10,1840
2020-05-16,cuba,North America,11313741,22,1862
2020-05-17,cuba,North America,11313741,10,1872
2020-05-18,cuba,North America,11313741,9,1881
2020-05-19,cuba,North America,11313741,6,1887
2020-05-20,cuba,North America,11313741,13,1900
2020-05-21,cuba,North America,11313741,8,1908
2020-05-22,cuba,North America,11313741,8,1916
2020-05-23,cuba,North America,11313741,15,1931
2020-05-24,cuba,North America,11313741,10,1941
2020-05-25,cuba,North America,11313741,6,1947
2020-05-26,cuba,North America,11313741,16,1963
2020-05-27,cuba,North America,11313741,11,1974
2020-05-28,cuba,North America,11313741,9,1983
2020-05-29,cuba,North America,11313741,22,2005
2020-05-30,cuba,North America,11313741,20,2025
2020-05-31,cuba,North America,11313741,20,2045
2020-06-01,cuba,North America,11313741,38,2083
2020-06-02,cuba,North America,11313741,9,2092
2020-06-03,cuba,North America,11313741,15,2107
2020-06-04,cuba,North America,11313741,12,2119
2020-06-05,cuba,North America,11313741,14,2133
2020-06-06,cuba,North America,11313741,40,2173
2020-06-07,cuba,North America,11313741,18,2191
2020-06-08,cuba,North America,11313741,9,2200
2020-06-09,cuba,North America,11313741,5,2205
2020-06-10,cuba,North America,11313741,6,2211
2020-06-11,cuba,North America,11313741,8,2219
2020-06-12,cuba,North America,11313741,14,2233
2020-06-13,cuba,North America,11313741,5,2238
2020-06-14,cuba,North America,11313741,10,2248
2020-06-15,cuba,North America,11313741,14,2262
2020-06-16,cuba,North America,11313741,11,2273
2020-06-17,cuba,North America,11313741,7,2280
2020-06-18,cuba,North America,11313741,15,2295
2020-06-19,cuba,North America,11313741,10,2305
2020-06-20,cuba,North America,11313741,4,2309
2020-06-21,cuba,North America,11313741,3,2312
2020-06-22,cuba,North America,11313741,3,2315
2020-06-23,cuba,North America,11313741,3,2318
2020-06-24,cuba,North America,11313741,1,2319
2020-06-25,cuba,North America,11313741,2,2321
2020-06-26,cuba,North America,11313741,4,2325
2020-06-27,cuba,North America,11313741,5,2330
2020-06-28,cuba,North America,11313741,2,2332
2020-06-29,cuba,North America,11313741,8,2340
2020-06-30,cuba,North America,11313741,1,2341
2020-07-01,cuba,North America,11313741,7,2348
2020-07-02,cuba,North America,11313741,5,2353
2020-07-03,cuba,North America,11313741,8,2361
2020-07-04,cuba,North America,11313741,8,2369
2020-07-05,cuba,North America,11313741,3,2372
2020-07-06,cuba,North America,11313741,8,2380
2020-07-07,cuba,North America,11313741,15,2395
2020-07-08,cuba,North America,11313741,4,2399
2020-07-09,cuba,North America,11313741,4,2403
2020-07-10,cuba,North America,11313741,10,2413
2020-07-11,cuba,North America,11313741,7,2420
2020-07-12,cuba,North America,11313741,6,2426
2020-07-13,cuba,North America,11313741,2,2428
2020-07-14,cuba,North America,11313741,4,2432
2020-07-15,cuba,North America,11313741,6,2438
2020-07-16,cuba,North America,11313741,2,2440
2020-07-17,cuba,North America,11313741,4,2444
2020-07-18,cuba,North America,11313741,1,2445
2020-07-19,cuba,North America,11313741,1,2446
2020-07-20,cuba,North America,11313741,0,2446
2020-07-21,cuba,North America,11313741,3,2449
2020-07-22,cuba,North America,11313741,13,2462
2020-07-23,cuba,North America,11313741,4,2466
2020-07-24,cuba,North America,11313741,3,2469
2020-07-25,cuba,North America,11313741,9,2478
2020-07-26,cuba,North America,11313741,17,2495
2020-07-27,cuba,North America,11313741,37,2532
2020-07-28,cuba,North America,11313741,23,2555
2020-07-29,cuba,North America,11313741,33,2588
2020-07-30,cuba,North America,11313741,9,2597
2020-07-31,cuba,North America,11313741,11,2608
2020-08-01,cuba,North America,11313741,25,2633
2020-08-02,cuba,North America,11313741,13,2646
2020-08-03,cuba,North America,11313741,24,2670
2020-08-04,cuba,North America,11313741,31,2701
2020-08-05,cuba,North America,11313741,25,2726
2020-08-06,cuba,North America,11313741,49,2775
2020-08-07,cuba,North America,11313741,54,2829
2020-08-08,cuba,North America,11313741,59,2888
2020-08-09,cuba,North America,11313741,65,2953
2020-08-10,cuba,North America,11313741,93,3046
2020-08-11,cuba,North America,11313741,47,3093
2020-08-12,cuba,North America,11313741,35,3128
2020-08-13,cuba,North America,11313741,46,3174
2020-08-14,cuba,North America,11313741,55,3229
2020-08-15,cuba,North America,11313741,63,3292
2020-08-16,cuba,North America,11313741,24,3316
2020-08-17,cuba,North America,11313741,48,3364
2020-08-18,cuba,North America,11313741,44,3408
2020-08-19,cuba,North America,11313741,74,3482
2020-08-20,cuba,North America,11313741,83,3565
2020-08-21,cuba,North America,11313741,17,3582
2020-08-22,cuba,North America,11313741,35,3617
2020-08-23,cuba,North America,11313741,65,3682
2020-08-24,cuba,North America,11313741,35,3717
2020-08-25,cuba,North America,11313741,27,3744
2020-08-26,cuba,North America,11313741,15,3759
2020-08-27,cuba,North America,11313741,47,3806
2020-08-28,cuba,North America,11313741,60,3866
2020-08-29,cuba,North America,11313741,59,3925
2020-08-30,cuba,North America,11313741,48,3973
2020-08-31,cuba,North America,11313741,59,4032
2020-09-01,cuba,North America,11313741,33,4065
2020-09-02,cuba,North America,11313741,61,4126
2020-09-03,cuba,North America,11313741,88,4214
2020-09-04,cuba,North America,11313741,52,4266
2020-09-05,cuba,North America,11313741,32,4298
2020-09-06,cuba,North America,11313741,11,4309
2020-09-07,cuba,North America,11313741,43,4352
2020-09-08,cuba,North America,11313741,25,4377
2020-09-09,cuba,North America,11313741,82,4459
2020-09-10,cuba,North America,11313741,92,4551
2020-09-11,cuba,North America,11313741,42,4593
2020-09-12,cuba,North America,11313741,60,4653
2020-09-13,cuba,North America,11313741,31,4684
2020-09-14,cuba,North America,11313741,42,4726
2020-09-15,cuba,North America,11313741,77,4803
2020-09-16,cuba,North America,11313741,73,4876
2020-09-17,cuba,North America,11313741,57,4933
2020-09-18,cuba,North America,11313741,71,5004
2020-09-19,cuba,North America,11313741,51,5055
2020-09-20,cuba,North America,11313741,36,5091
2020-09-21,cuba,North America,11313741,50,5141
2020-09-22,cuba,North America,11313741,81,5222
2020-09-23,cuba,North America,11313741,48,5270
2020-09-24,cuba,North America,11313741,40,5310
2020-09-25,cuba,North America,11313741,40,5350
2020-09-26,cuba,North America,11313741,62,5412
2020-09-27,cuba,North America,11313741,45,5457
2020-09-28,cuba,North America,11313741,26,5483
2020-09-29,cuba,North America,11313741,48,5531
2020-09-30,cuba,North America,11313741,66,5597
2020-10-01,cuba,North America,11313741,73,5670
2020-10-02,cuba,North America,11313741,48,5718
2020-10-03,cuba,North America,11313741,62,5780
2020-10-04,cuba,North America,11313741,29,5809
2020-10-05,cuba,North America,11313741,36,5845
2020-10-06,cuba,North America,11313741,38,5883
2020-10-07,cuba,North America,11313741,15,5898
2020-10-08,cuba,North America,11313741,19,5917
2020-10-09,cuba,North America,11313741,26,5943
2020-10-10,cuba,North America,11313741,5,5948
2020-10-11,cuba,North America,11313741,30,5978
2020-10-12,cuba,North America,11313741,22,6000
2020-10-13,cuba,North America,11313741,17,6017
2020-10-14,cuba,North America,11313741,18,6035
2020-10-15,cuba,North America,11313741,27,6062
2020-10-16,cuba,North America,11313741,56,6118
2020-10-17,cuba,North America,11313741,52,6170
2020-10-18,cuba,North America,11313741,50,6220
2020-10-19,cuba,North America,11313741,38,6258
2020-10-20,cuba,North America,11313741,47,6305
2020-10-21,cuba,North America,11313741,63,6368
2020-10-22,cuba,North America,11313741,53,6421
2020-10-23,cuba,North America,11313741,58,6479
2020-10-24,cuba,North America,11313741,55,6534
2020-10-25,cuba,North America,11313741,32,6566
2020-10-26,cuba,North America,11313741,29,6595
2020-10-27,cuba,North America,11313741,83,6678
2020-10-28,cuba,North America,11313741,49,6727
2020-10-29,cuba,North America,11313741,39,6766
2020-10-30,cuba,North America,11313741,35,6801
2020-10-31,cuba,North America,11313741,86,6887
2020-11-01,cuba,North America,11313741,48,6935
2020-11-02,cuba,North America,11313741,35,6970
2020-11-03,cuba,North America,11313741,65,7035
2020-11-04,cuba,North America,11313741,109,7144
2020-11-05,cuba,North America,11313741,40,7184
2020-11-06,cuba,North America,11313741,44,7228
2020-11-07,cuba,North America,11313741,39,7267
2020-11-08,cuba,North America,11313741,30,7297
2020-11-09,cuba,North America,11313741,52,7349
2020-11-10,cuba,North America,11313741,43,7392
2020-11-11,cuba,North America,11313741,37,7429
2020-11-12,cuba,North America,11313741,58,7487
2020-11-13,cuba,North America,11313741,54,7541
2020-11-14,cuba,North America,11313741,27,7568
2020-11-15,cuba,North America,11313741,22,7590
2020-11-16,cuba,North America,11313741,49,7639
2020-11-17,cuba,North America,11313741,28,7667
2020-11-18,cuba,North America,11313741,37,7704
2020-11-19,cuba,North America,11313741,21,7725
2020-11-20,cuba,North America,11313741,38,7763
2020-11-21,cuba,North America,11313741,35,7798
2020-11-22,cuba,North America,11313741,48,7846
2020-11-23,cuba,North America,11313741,33,7879
2020-11-24,cuba,North America,11313741,71,7950
2020-11-25,cuba,North America,11313741,76,8026
2020-11-26,cuba,North America,11313741,49,8075
2020-11-27,cuba,North America,11313741,35,8110
2020-11-28,cuba,North America,11313741,63,8173
2020-11-29,cuba,North America,11313741,60,8233
2020-11-30,cuba,North America,11313741,51,8284
2020-12-01,cuba,North America,11313741,97,8381
2020-12-02,cuba,North America,11313741,75,8456
2020-12-03,cuba,North America,11313741,75,8531
2020-12-04,cuba,North America,11313741,79,8610
2020-12-05,cuba,North America,11313741,104,8714
2020-12-06,cuba,North America,11313741,68,8782
2020-12-07,cuba,North America,11313741,124,8906
2020-12-08,cuba,North America,11313741,76,8982
2020-12-09,cuba,North America,11313741,124,9106
2020-12-10,cuba,North America,11313741,75,9181
2020-12-11,cuba,North America,11313741,86,9267
2020-12-12,cuba,North America,11313741,87,9354
2020-12-13,cuba,North America,11313741,69,9423
2020-12-14,cuba,North America,11313741,69,9492
2020-12-15,cuba,North America,11313741,96,9588
2020-12-16,cuba,North America,11313741,83,9671
2020-12-17,cuba,North America,11313741,100,9771
2020-12-18,cuba,North America,11313741,122,9893
2020-12-19,cuba,North America,11313741,131,10024
2020-12-20,cuba,North America,11313741,103,10127
2020-12-21,cuba,North America,11313741,115,10242
2020-12-22,cuba,North America,11313741,142,10384
2020-12-23,cuba,North America,11313741,116,10500
2020-12-24,cuba,North America,11313741,217,10717
2020-12-25,cuba,North America,11313741,183,10900
2020-12-26,cuba,North America,11313741,138,11038
2020-12-27,cuba,North America,11313741,167,11205
2020-12-28,cuba,North America,11313741,229,11434
2020-12-29,cuba,North America,11313741,167,11601
2020-12-30,cuba,North America,11313741,86,11687
2020-12-31,cuba,North America,11313741,176,11863
2021-01-01,cuba,North America,11313741,193,12056
2021-01-02,cuba,North America,11313741,169,12225
2021-01-03,cuba,North America,11313741,199,12424
2021-01-04,cuba,North America,11313741,316,12740
2021-01-05,cuba,North America,11313741,224,12964
2021-01-06,cuba,North America,11313741,201,13165
2021-01-07,cuba,North America,11313741,314,13479
2021-01-08,cuba,North America,11313741,344,13823
2021-01-09,cuba,North America,11313741,365,14188
2021-01-10,cuba,North America,11313741,388,14576
2021-01-11,cuba,North America,11313741,431,15007
2021-01-12,cuba,North America,11313741,487,15494
2021-01-13,cuba,North America,11313741,550,16044
2021-01-14,cuba,North America,11313741,505,16549
2021-01-15,cuba,North America,11313741,547,17096
2021-01-16,cuba,North America,11313741,405,17501
2021-01-17,cuba,North America,11313741,650,18151
2021-01-18,cuba,North America,11313741,292,18443
2021-01-19,cuba,North America,11313741,330,18773
2021-01-20,cuba,North America,11313741,349,19122
2021-01-21,cuba,North America,11313741,408,19530
2021-01-22,cuba,North America,11313741,530,20060
2021-01-23,cuba,North America,11313741,567,20627
2021-01-24,cuba,North America,11313741,634,21261
2021-01-25,cuba,North America,11313741,567,21828
2021-01-26,cuba,North America,11313741,786,22614
2021-01-27,cuba,North America,11313741,825,23439
2021-01-28,cuba,North America,11313741,666,24105
2021-01-29,cuba,North America,11313741,659,24764
2021-01-30,cuba,North America,11313741,910,25674
2021-01-31,cuba,North America,11313741,1012,26686
2021-02-01,cuba,North America,11313741,906,27592
2021-02-02,cuba,North America,11313741,1044,28636
2021-02-03,cuba,North America,11313741,893,29529
2021-02-04,cuba,North America,11313741,816,30345
2021-02-05,cuba,North America,11313741,845,31190
2021-02-06,cuba,North America,11313741,821,32011
2021-02-07,cuba,North America,11313741,820,32831
2021-02-08,cuba,North America,11313741,653,33484
2021-02-09,cuba,North America,11313741,580,34064
2021-02-10,cuba,North America,11313741,858,34922
2021-02-11,cuba,North America,11313741,850,35772
2021-02-12,cuba,North America,11313741,823,36595
2021-02-13,cuba,North America,11313741,888,37483
2021-02-14,cuba,North America,11313741,806,38289
2021-02-15,cuba,North America,11313741,715,39004
2021-02-16,cuba,North America,11313741,937,39941
2021-02-17,cuba,North America,11313741,824,40765
2021-02-18,cuba,North America,11313741,923,41688
2021-02-19,cuba,North America,11313741,859,42547
2021-02-20,cuba,North America,11313741,937,43484
2021-02-21,cuba,North America,11313741,1039,44523
2021-02-22,cuba,North America,11313741,838,45361
2021-02-23,cuba,North America,11313741,836,46197
2021-02-24,cuba,North America,11313741,699,46896
2021-02-25,cuba,North America,11313741,670,47566
2021-02-26,cuba,North America,11313741,875,48441
2021-02-27,cuba,North America,11313741,720,49161
2021-02-28,cuba,North America,11313741,618,49779
2021-03-01,cuba,North America,11313741,811,50590
2021-03-02,cuba,North America,11313741,997,51587
2021-03-03,cuba,North America,11313741,914,52501
2021-03-04,cuba,North America,11313741,807,53308
2021-03-05,cuba,North America,11313741,777,54085
2021-03-06,cuba,North America,11313741,750,54835
2021-03-07,cuba,North America,11313741,858,55693
2021-03-08,cuba,North America,11313741,873,56566
2021-03-09,cuba,North America,11313741,1041,57607
2021-03-10,cuba,North America,11313741,772,58379
2021-03-11,cuba,North America,11313741,778,59157
2021-03-12,cuba,North America,11313741,762,59919
2021-03-13,cuba,North America,11313741,639,60558
2021-03-14,cuba,North America,11313741,914,61472
2021-03-15,cuba,North America,11313741,734,62206
2021-03-16,cuba,North America,11313741,792,62998
2021-03-17,cuba,North America,11313741,727,63725
2021-03-18,cuba,North America,11313741,689,64414
2021-03-19,cuba,North America,11313741,735,65149
2021-03-20,cuba,North America,11313741,813,65962
2021-03-21,cuba,North America,11313741,796,66758
2021-03-22,cuba,North America,11313741,718,67476
2021-03-23,cuba,North America,11313741,774,68250
2021-03-24,cuba,North America,11313741,736,68986
2021-03-25,cuba,North America,11313741,816,69802
2021-03-26,cuba,North America,11313741,832,70634
2021-03-27,cuba,North America,11313741,950,71584
2021-03-28,cuba,North America,11313741,919,72503
2021-03-29,cuba,North America,11313741,701,73204
2021-03-30,cuba,North America,11313741,1008,74212
2021-03-31,cuba,North America,11313741,1051,75263
2021-04-01,cuba,North America,11313741,1013,76276
2021-04-02,cuba,North America,11313741,1077,77353
2021-04-03,cuba,North America,11313741,1029,78382
2021-04-04,cuba,North America,11313741,1162,79544
2021-04-05,cuba,North America,11313741,1066,80610
2021-04-06,cuba,North America,11313741,1030,81640
2021-04-07,cuba,North America,11313741,961,82601
2021-04-08,cuba,North America,11313741,914,83515
2021-04-09,cuba,North America,11313741,1017,84532
2021-04-10,cuba,North America,11313741,1040,85572
2021-04-11,cuba,North America,11313741,959,86531
2021-04-12,cuba,North America,11313741,854,87385
2021-04-13,cuba,North America,11313741,1060,88445
2021-04-14,cuba,North America,11313741,959,89404
2021-04-15,cuba,North America,11313741,1004,90408
2021-04-16,cuba,North America,11313741,1040,91448
2021-04-17,cuba,North America,11313741,1026,92474
2021-04-18,cuba,North America,11313741,1037,93511
2021-04-19,cuba,North America,11313741,1060,94571
2021-04-20,cuba,North America,11313741,1183,95754
2021-04-21,cuba,North America,11313741,1006,96760
2021-04-22,cuba,North America,11313741,1207,97967
2021-04-23,cuba,North America,11313741,1241,99208
2021-04-24,cuba,North America,11313741,1110,100318
2021-04-25,cuba,North America,11313741,1185,101503
2021-04-26,cuba,North America,11313741,938,102441
2021-04-27,cuba,North America,11313741,1083,103524
2021-04-28,cuba,North America,11313741,988,104512
2021-04-29,cuba,North America,11313741,1149,105661
2021-04-30,cuba,North America,11313741,1046,106707
2021-05-01,cuba,North America,11313741,915,107622
2021-05-02,cuba,North America,11313741,1071,108693
2021-05-03,cuba,North America,11313741,932,109625
2021-05-04,cuba,North America,11313741,1019,110644
2021-05-05,cuba,North America,11313741,1010,111654
2021-05-06,cuba,North America,11313741,1060,112714
2021-05-07,cuba,North America,11313741,1162,113876
2021-05-08,cuba,North America,11313741,1036,114912
2021-05-09,cuba,North America,11313741,1069,115981
2021-05-10,cuba,North America,11313741,1116,117097
2021-05-11,cuba,North America,11313741,1071,118168
2021-05-12,cuba,North America,11313741,1207,119375
2021-05-13,cuba,North America,11313741,1186,120561
2021-05-14,cuba,North America,11313741,1277,121838
2021-05-15,cuba,North America,11313741,1383,123221
2021-05-16,cuba,North America,11313741,1233,124454
2021-05-17,cuba,North America,11313741,1057,125511
2021-05-18,cuba,North America,11313741,1244,126755
2021-05-19,cuba,North America,11313741,1339,128094
2021-05-20,cuba,North America,11313741,1252,129346
2021-05-21,cuba,North America,11313741,1197,130543
2021-05-22,cuba,North America,11313741,1289,131832
2021-05-23,cuba,North America,11313741,1221,133053
2021-05-24,cuba,North America,11313741,1155,134208
2021-05-25,cuba,North America,11313741,1291,135499
2021-05-26,cuba,North America,11313741,1129,136628
2021-05-27,cuba,North America,11313741,1102,137730
2021-05-28,cuba,North America,11313741,1169,138899
2021-05-29,cuba,North America,11313741,1188,140087
2021-05-30,cuba,North America,11313741,1079,141166
2021-05-31,cuba,North America,11313741,1100,142266
2021-06-01,cuba,North America,11313741,1057,143323
2021-06-02,cuba,North America,11313741,1191,144514
2021-06-03,cuba,North America,11313741,1053,145567
2021-06-04,cuba,North America,11313741,1129,146696
2021-06-05,cuba,North America,11313741,1135,147831
2021-06-06,cuba,North America,11313741,1087,148918
2021-06-07,cuba,North America,11313741,1185,150103
2021-06-08,cuba,North America,11313741,1156,151259
2021-06-09,cuba,North America,11313741,1161,152420
2021-06-10,cuba,North America,11313741,1158,153578
2021-06-11,cuba,North America,11313741,1288,154866
2021-06-12,cuba,North America,11313741,1372,156238
2021-06-13,cuba,North America,11313741,1470,157708
2021-06-14,cuba,North America,11313741,1349,159057
2021-06-15,cuba,North America,11313741,1537,160594
2021-06-16,cuba,North America,11313741,1403,161997
2021-06-17,cuba,North America,11313741,1418,163415
2021-06-18,cuba,North America,11313741,1481,164896
2021-06-19,cuba,North America,11313741,1472,166368
2021-06-20,cuba,North America,11313741,1436,167804
2021-06-21,cuba,North America,11313741,1561,169365
2021-06-22,cuba,North America,11313741,1489,170854
2021-06-23,cuba,North America,11313741,2055,172909
2021-06-24,cuba,North America,11313741,1880,174789
2021-06-25,cuba,North America,11313741,2464,177253
2021-06-26,cuba,North America,11313741,2403,179656
2021-06-27,cuba,North America,11313741,2698,182354
2021-06-28,cuba,North America,11313741,2589,184943
2021-06-29,cuba,North America,11313741,3080,188023
2021-06-30,cuba,North America,11313741,2970,190993
2021-07-01,cuba,North America,11313741,2952,193945
2021-07-02,cuba,North America,11313741,3308,197253
2021-07-03,cuba,North America,11313741,3475,200728
2021-07-04,cuba,North America,11313741,3519,204247
2021-07-05,cuba,North America,11313741,3075,207322
2021-07-06,cuba,North America,11313741,3591,210913
2021-07-07,cuba,North America,11313741,3664,214577
2021-07-08,cuba,North America,11313741,3819,218396
2021-07-09,cuba,North America,11313741,6422,224818
2021-07-10,cuba,North America,11313741,6750,231568
2021-07-11,cuba,North America,11313741,6923,238491
2021-07-12,cuba,North America,11313741,6423,244914
2021-07-13,cuba,North America,11313741,5613,250527
2021-07-14,cuba,North America,11313741,6080,256607
2021-07-15,cuba,North America,11313741,6479,263086
2021-07-16,cuba,North America,11313741,6460,269546
2021-07-17,cuba,North America,11313741,6062,275608
2021-07-18,cuba,North America,11313741,6279,281887
2021-07-19,cuba,North America,11313741,6505,288392
2021-07-20,cuba,North America,11313741,6057,294449
2021-07-21,cuba,North America,11313741,6405,300854
2021-07-22,cuba,North America,11313741,7745,308599
2021-07-23,cuba,North America,11313741,7784,316383
2021-07-24,cuba,North America,11313741,7732,324115
2021-07-25,cuba,North America,11313741,8853,332968
2021-07-26,cuba,North America,11313741,8184,341152
2021-07-27,cuba,North America,11313741,7903,349055
2021-07-28,cuba,North America,11313741,9323,358378
2021-07-29,cuba,North America,11313741,8607,366985
2021-07-30,cuba,North America,11313741,8736,375721
2021-07-31,cuba,North America,11313741,8875,384596
2021-08-01,cuba,North America,11313741,9747,394343
2021-08-02,cuba,North America,11313741,9279,403622
2021-08-03,cuba,North America,11313741,9629,413251
2021-08-04,cuba,North America,11313741,9363,422614
2021-08-05,cuba,North America,11313741,8399,431013
2021-08-06,cuba,North America,11313741,8886,439899
2021-08-07,cuba,North America,11313741,8893,448792
2021-08-08,cuba,North America,11313741,9427,458219
2021-08-09,cuba,North America,11313741,7950,466169
2021-08-10,cuba,North America,11313741,8936,475105
2021-08-11,cuba,North America,11313741,8605,483710
2021-08-12,cuba,North America,11313741,8194,491904
2021-08-13,cuba,North America,11313741,8312,500216
2021-08-14,cuba,North America,11313741,8816,509032
2021-08-15,cuba,North America,11313741,8636,517668
2021-08-16,cuba,North America,11313741,9169,526837
2021-08-17,cuba,North America,11313741,9772,536609
2021-08-18,cuba,North America,11313741,8666,545275
2021-08-19,cuba,North America,11313741,8972,554247
2021-08-20,cuba,North America,11313741,9764,564011
2021-08-21,cuba,North America,11313741,9740,573751
2021-08-22,cuba,North America,11313741,9548,583299
2021-08-23,cuba,North America,11313741,9320,592619
2021-08-24,cuba,North America,11313741,9907,602526
2021-08-25,cuba,North America,11313741,8637,611163
2021-08-26,cuba,North America,11313741,8509,619672
2021-08-27,cuba,North America,11313741,7639,627311
2021-08-28,cuba,North America,11313741,6850,634161
2021-08-29,cuba,North America,11313741,6277,640438
2021-08-30,cuba,North America,11313741,6075,646513
2021-08-31,cuba,North America,11313741,6342,652855
2021-09-01,cuba,North America,11313741,6609,659464
2021-09-02,cuba,North America,11313741,6208,665672
2021-09-03,cuba,North America,11313741,6927,672599
2021-09-04,cuba,North America,11313741,7854,680453
2021-09-05,cuba,North America,11313741,9221,689674
2021-09-06,cuba,North America,11313741,7230,696904
2021-09-07,cuba,North America,11313741,7771,704675
2021-09-08,cuba,North America,11313741,8317,712992
2021-09-09,cuba,North America,11313741,7747,720739
2021-09-10,cuba,North America,11313741,8394,729133
2021-09-11,cuba,North America,11313741,8035,737168
2021-09-12,cuba,North America,11313741,8034,745202
2021-09-13,cuba,North America,11313741,8342,753544
2021-09-14,cuba,North America,11313741,7516,761060
2021-09-15,cuba,North America,11313741,7437,768497
2021-09-16,cuba,North America,11313741,7628,776125
2021-09-17,cuba,North America,11313741,8291,784416
2021-09-18,cuba,North America,11313741,8517,792933
2021-09-19,cuba,North America,11313741,8434,801367
2021-09-20,cuba,North America,11313741,8544,809911
2021-09-21,cuba,North America,11313741,8289,818200
2021-09-22,cuba,North America,11313741,7151,825351
2021-09-23,cuba,North America,11313741,6935,832286
2021-09-24,cuba,North America,11313741,7695,839981
2021-09-25,cuba,North America,11313741,7513,847494
2021-09-26,cuba,North America,11313741,6673,854167
2021-09-27,cuba,North America,11313741,6632,860799
2021-09-28,cuba,North America,11313741,6009,866808
2021-09-29,cuba,North America,11313741,5617,872425
2021-09-30,cuba,North America,11313741,5003,877428
2021-10-01,cuba,North America,11313741,5049,882477
2021-10-02,cuba,North America,11313741,4873,887350
2021-10-03,cuba,North America,11313741,4097,891447
2021-10-04,cuba,North America,11313741,4272,895719
2021-10-05,cuba,North America,11313741,4793,900512
2021-10-06,cuba,North America,11313741,3596,904108
2021-10-07,cuba,North America,11313741,3833,907941
2021-10-08,cuba,North America,11313741,3396,911337
2021-10-09,cuba,North America,11313741,3442,914779
2021-10-10,cuba,North America,11313741,3604,918383
2021-10-11,cuba,North America,11313741,2945,921328
2021-10-12,cuba,North America,11313741,2638,923966
2021-10-13,cuba,North America,11313741,2354,926320
2021-10-14,cuba,North America,11313741,2364,928684
2021-10-15,cuba,North America,11313741,2138,930822
2021-10-16,cuba,North America,11313741,1946,932768
2021-10-17,cuba,North America,11313741,2197,934965
2021-10-18,cuba,North America,11313741,1844,936809
2021-10-19,cuba,North America,11313741,1768,938577
2021-10-20,cuba,North America,11313741,1550,940127
2021-10-21,cuba,North America,11313741,1435,941562
2021-10-22,cuba,North America,11313741,1476,943038
2021-10-23,cuba,North America,11313741,1393,944431
2021-10-24,cuba,North America,11313741,1319,945750
2021-10-25,cuba,North America,11313741,1210,946960
2021-10-26,cuba,North America,11313741,975,947935
2021-10-27,cuba,North America,11313741,912,948847
2021-10-28,cuba,North America,11313741,900,949747
2021-10-29,cuba,North America,11313741,866,950613
2021-10-30,cuba,North America,11313741,712,951325
2021-10-31,cuba,North America,11313741,676,952001
2021-11-01,cuba,North America,11313741,633,952634
2021-11-02,cuba,North America,11313741,549,953183
2021-11-03,cuba,North America,11313741,567,953750
2021-11-04,cuba,North America,11313741,592,954342
2021-11-05,cuba,North America,11313741,606,954948
2021-11-06,cuba,North America,11313741,550,955498
2021-11-07,cuba,North America,11313741,483,955981
2021-11-08,cuba,North America,11313741,471,956452
2021-11-09,cuba,North America,11313741,467,956919
2021-11-10,cuba,North America,11313741,413,957332
2021-11-11,cuba,North America,11313741,403,957735
2021-11-12,cuba,North America,11313741,362,958097
2021-11-13,cuba,North America,11313741,293,958390
2021-11-14,cuba,North America,11313741,348,958738
2021-11-15,cuba,North America,11313741,326,959064
2021-11-16,cuba,North America,11313741,243,959307
2021-11-17,cuba,North America,11313741,246,959553
2021-11-18,cuba,North America,11313741,316,959869
2021-11-19,cuba,North America,11313741,316,960185
2021-11-20,cuba,North America,11313741,287,960472
2021-11-21,cuba,North America,11313741,330,960802
2021-11-22,cuba,North America,11313741,240,961042
2021-11-23,cuba,North America,11313741,234,961276
2021-11-24,cuba,North America,11313741,182,961458
2021-11-25,cuba,North America,11313741,240,961698
2021-11-26,cuba,North America,11313741,186,961884
2021-11-27,cuba,North America,11313741,183,962067
2020-03-22,cyprus,Asia,1223728,11,95
2020-03-23,cyprus,Asia,1223728,21,116
2020-03-24,cyprus,Asia,1223728,8,124
2020-03-25,cyprus,Asia,1223728,8,132
2020-03-26,cyprus,Asia,1223728,14,146
2020-03-27,cyprus,Asia,1223728,16,162
2020-03-28,cyprus,Asia,1223728,17,179
2020-03-29,cyprus,Asia,1223728,35,214
2020-03-30,cyprus,Asia,1223728,16,230
2020-03-31,cyprus,Asia,1223728,32,262
2020-04-01,cyprus,Asia,1223728,59,321
2020-04-02,cyprus,Asia,1223728,37,358
2020-04-03,cyprus,Asia,1223728,41,399
2020-04-04,cyprus,Asia,1223728,30,429
2020-04-05,cyprus,Asia,1223728,20,449
2020-04-06,cyprus,Asia,1223728,19,468
2020-04-07,cyprus,Asia,1223728,29,497
2020-04-08,cyprus,Asia,1223728,32,529
2020-04-09,cyprus,Asia,1223728,39,568
2020-04-10,cyprus,Asia,1223728,31,599
2020-04-11,cyprus,Asia,1223728,21,620
2020-04-12,cyprus,Asia,1223728,17,637
2020-04-13,cyprus,Asia,1223728,29,666
2020-04-14,cyprus,Asia,1223728,33,699
2020-04-15,cyprus,Asia,1223728,20,719
2020-04-16,cyprus,Asia,1223728,20,739
2020-04-17,cyprus,Asia,1223728,15,754
2020-04-18,cyprus,Asia,1223728,11,765
2020-04-19,cyprus,Asia,1223728,6,771
2020-04-20,cyprus,Asia,1223728,5,776
2020-04-21,cyprus,Asia,1223728,12,788
2020-04-22,cyprus,Asia,1223728,6,794
2020-04-23,cyprus,Asia,1223728,5,799
2020-04-24,cyprus,Asia,1223728,9,808
2020-04-25,cyprus,Asia,1223728,6,814
2020-04-26,cyprus,Asia,1223728,7,821
2020-04-27,cyprus,Asia,1223728,5,826
2020-04-28,cyprus,Asia,1223728,15,841
2020-04-29,cyprus,Asia,1223728,6,847
2020-04-30,cyprus,Asia,1223728,7,854
2020-05-01,cyprus,Asia,1223728,7,861
2020-05-02,cyprus,Asia,1223728,7,868
2020-05-03,cyprus,Asia,1223728,8,876
2020-05-04,cyprus,Asia,1223728,2,878
2020-05-05,cyprus,Asia,1223728,4,882
2020-05-06,cyprus,Asia,1223728,5,887
2020-03-02,czech_republic,Europe,10745981,0,3
2020-03-03,czech_republic,Europe,10745981,0,3
2020-03-04,czech_republic,Europe,10745981,2,5
2020-03-05,czech_republic,Europe,10745981,1,6
2020-03-06,czech_republic,Europe,10745981,3,9
2020-03-07,czech_republic,Europe,10745981,11,20
2020-03-08,czech_republic,Europe,10745981,7,27
2020-03-09,czech_republic,Europe,10745981,6,33
2020-03-10,czech_republic,Europe,10745981,6,39
2020-03-11,czech_republic,Europe,10745981,25,64
2020-03-12,czech_republic,Europe,10745981,31,95
2020-03-13,czech_republic,Europe,10745981,22,117
2020-03-14,czech_republic,Europe,10745981,25,142
2020-03-15,czech_republic,Europe,10745981,48,190
2020-03-16,czech_republic,Europe,10745981,109,299
2020-03-17,czech_republic,Europe,10745981,85,384
2020-03-18,czech_republic,Europe,10745981,67,451
2020-03-19,czech_republic,Europe,10745981,110,561
2020-03-20,czech_republic,Europe,10745981,206,767
2020-03-21,czech_republic,Europe,10745981,124,891
2020-03-22,czech_republic,Europe,10745981,159,1050
2020-03-23,czech_republic,Europe,10745981,115,1165
2020-03-24,czech_republic,Europe,10745981,126,1291
2020-03-25,czech_republic,Europe,10745981,185,1476
2020-03-26,czech_republic,Europe,10745981,292,1768
2020-03-27,czech_republic,Europe,10745981,259,2027
2020-03-28,czech_republic,Europe,10745981,377,2404
2020-03-29,czech_republic,Europe,10745981,263,2667
2020-03-30,czech_republic,Europe,10745981,159,2826
2020-03-31,czech_republic,Europe,10745981,184,3010
2020-04-01,czech_republic,Europe,10745981,306,3316
2020-04-02,czech_republic,Europe,10745981,283,3599
2020-04-03,czech_republic,Europe,10745981,268,3867
2020-04-04,czech_republic,Europe,10745981,333,4200
2020-04-05,czech_republic,Europe,10745981,283,4483
2020-04-06,czech_republic,Europe,10745981,117,4600
2020-04-07,czech_republic,Europe,10745981,236,4836
2020-04-08,czech_republic,Europe,10745981,196,5032
2020-04-09,czech_republic,Europe,10745981,294,5326
2020-04-10,czech_republic,Europe,10745981,257,5583
2020-04-11,czech_republic,Europe,10745981,163,5746
2020-04-12,czech_republic,Europe,10745981,170,5916
2020-04-13,czech_republic,Europe,10745981,89,6005
2020-04-14,czech_republic,Europe,10745981,68,6073
2020-04-15,czech_republic,Europe,10745981,82,6155
2020-04-16,czech_republic,Europe,10745981,160,6315
2020-04-17,czech_republic,Europe,10745981,132,6447
2020-04-18,czech_republic,Europe,10745981,116,6563
2020-04-19,czech_republic,Europe,10745981,105,6668
2020-04-20,czech_republic,Europe,10745981,92,6760
2020-04-21,czech_republic,Europe,10745981,154,6914
2020-04-22,czech_republic,Europe,10745981,133,7047
2020-04-23,czech_republic,Europe,10745981,99,7146
2020-04-24,czech_republic,Europe,10745981,55,7201
2020-04-25,czech_republic,Europe,10745981,86,7287
2020-04-26,czech_republic,Europe,10745981,79,7366
2020-04-27,czech_republic,Europe,10745981,52,7418
2020-04-28,czech_republic,Europe,10745981,41,7459
2020-04-29,czech_republic,Europe,10745981,60,7519
2020-04-30,czech_republic,Europe,10745981,75,7594
2020-05-01,czech_republic,Europe,10745981,108,7702
2020-05-02,czech_republic,Europe,10745981,57,7759
2020-05-03,czech_republic,Europe,10745981,18,7777
2020-05-04,czech_republic,Europe,10745981,26,7803
2020-05-05,czech_republic,Europe,10745981,39,7842
2020-05-06,czech_republic,Europe,10745981,77,7919
2020-05-07,czech_republic,Europe,10745981,79,7998
2020-05-08,czech_republic,Europe,10745981,59,8057
2020-05-09,czech_republic,Europe,10745981,46,8103
2020-05-10,czech_republic,Europe,10745981,18,8121
2020-05-11,czech_republic,Europe,10745981,28,8149
2020-05-12,czech_republic,Europe,10745981,58,8207
2020-05-13,czech_republic,Europe,10745981,45,8252
2020-05-14,czech_republic,Europe,10745981,52,8304
2020-05-15,czech_republic,Europe,10745981,82,8386
2020-05-16,czech_republic,Europe,10745981,55,8441
2020-05-17,czech_republic,Europe,10745981,51,8492
2020-05-18,czech_republic,Europe,10745981,20,8512
2020-05-19,czech_republic,Europe,10745981,114,8626
2020-05-20,czech_republic,Europe,10745981,63,8689
2020-05-21,czech_republic,Europe,10745981,75,8764
2020-05-22,czech_republic,Europe,10745981,36,8800
2020-05-23,czech_republic,Europe,10745981,61,8861
2020-05-24,czech_republic,Europe,10745981,77,8938
2020-05-25,czech_republic,Europe,10745981,65,9003
2020-05-26,czech_republic,Europe,10745981,47,9050
2020-05-27,czech_republic,Europe,10745981,52,9102
2020-05-28,czech_republic,Europe,10745981,37,9139
2020-05-29,czech_republic,Europe,10745981,54,9193
2020-05-30,czech_republic,Europe,10745981,57,9250
2020-05-31,czech_republic,Europe,10745981,34,9284
2020-06-01,czech_republic,Europe,10745981,38,9322
2020-06-02,czech_republic,Europe,10745981,34,9356
2020-06-03,czech_republic,Europe,10745981,64,9420
2020-06-04,czech_republic,Europe,10745981,74,9494
2020-06-05,czech_republic,Europe,10745981,64,9558
2020-06-06,czech_republic,Europe,10745981,35,9593
2020-06-07,czech_republic,Europe,10745981,38,9631
2020-06-08,czech_republic,Europe,10745981,61,9692
2020-06-09,czech_republic,Europe,10745981,69,9761
2020-06-10,czech_republic,Europe,10745981,55,9816
2020-06-11,czech_republic,Europe,10745981,74,9890
2020-06-12,czech_republic,Europe,10745981,65,9955
2020-06-13,czech_republic,Europe,10745981,52,10007
2020-06-14,czech_republic,Europe,10745981,53,10060
2020-06-15,czech_republic,Europe,10745981,33,10093
2020-06-16,czech_republic,Europe,10745981,40,10133
2020-06-17,czech_republic,Europe,10745981,47,10180
2020-06-18,czech_republic,Europe,10745981,51,10231
2020-06-19,czech_republic,Europe,10745981,118,10349
2020-06-20,czech_republic,Europe,10745981,126,10475
2020-06-21,czech_republic,Europe,10745981,43,10518
2020-06-22,czech_republic,Europe,10745981,50,10568
2020-06-23,czech_republic,Europe,10745981,64,10632
2020-06-24,czech_republic,Europe,10745981,89,10721
2020-06-25,czech_republic,Europe,10745981,127,10848
2020-06-26,czech_republic,Europe,10745981,93,10941
2020-06-27,czech_republic,Europe,10745981,169,11110
2020-06-28,czech_republic,Europe,10745981,260,11370
2020-06-29,czech_republic,Europe,10745981,305,11675
2020-06-30,czech_republic,Europe,10745981,201,11876
2020-07-01,czech_republic,Europe,10745981,149,12025
2020-07-02,czech_republic,Europe,10745981,91,12116
2020-07-03,czech_republic,Europe,10745981,133,12249
2020-07-04,czech_republic,Europe,10745981,141,12390
2020-07-05,czech_republic,Europe,10745981,121,12511
2020-07-06,czech_republic,Europe,10745981,75,12586
2020-07-07,czech_republic,Europe,10745981,51,12637
2020-07-08,czech_republic,Europe,10745981,118,12755
2020-07-09,czech_republic,Europe,10745981,129,12884
2020-07-10,czech_republic,Europe,10745981,105,12989
2020-07-11,czech_republic,Europe,10745981,141,13130
2020-07-12,czech_republic,Europe,10745981,53,13183
2020-07-13,czech_republic,Europe,10745981,59,13242
2020-07-14,czech_republic,Europe,10745981,65,13307
2020-07-15,czech_republic,Europe,10745981,105,13412
2020-07-16,czech_republic,Europe,10745981,135,13547
2020-07-17,czech_republic,Europe,10745981,137,13684
2020-07-18,czech_republic,Europe,10745981,129,13813
2020-07-19,czech_republic,Europe,10745981,112,13925
2020-07-20,czech_republic,Europe,10745981,91,14016
2020-07-21,czech_republic,Europe,10745981,168,14184
2020-07-22,czech_republic,Europe,10745981,208,14392
2020-07-23,czech_republic,Europe,10745981,245,14637
2020-07-24,czech_republic,Europe,10745981,231,14868
2020-07-25,czech_republic,Europe,10745981,278,15146
2020-07-26,czech_republic,Europe,10745981,132,15278
2020-07-27,czech_republic,Europe,10745981,114,15392
2020-07-28,czech_republic,Europe,10745981,194,15586
2020-07-29,czech_republic,Europe,10745981,276,15862
2020-07-30,czech_republic,Europe,10745981,274,16136
2020-07-31,czech_republic,Europe,10745981,254,16390
2020-08-01,czech_republic,Europe,10745981,231,16621
2020-08-02,czech_republic,Europe,10745981,125,16746
2020-08-03,czech_republic,Europe,10745981,101,16847
2020-08-04,czech_republic,Europe,10745981,208,17055
2020-08-05,czech_republic,Europe,10745981,287,17342
2020-08-06,czech_republic,Europe,10745981,241,17583
2020-08-07,czech_republic,Europe,10745981,215,17798
2020-08-08,czech_republic,Europe,10745981,322,18120
2020-08-09,czech_republic,Europe,10745981,173,18293
2020-08-10,czech_republic,Europe,10745981,122,18415
2020-08-11,czech_republic,Europe,10745981,141,18556
2020-08-12,czech_republic,Europe,10745981,289,18845
2020-08-13,czech_republic,Europe,10745981,289,19134
2020-08-14,czech_republic,Europe,10745981,331,19465
2020-08-15,czech_republic,Europe,10745981,291,19756
2020-08-16,czech_republic,Europe,10745981,197,19953
2020-08-17,czech_republic,Europe,10745981,121,20074
2020-08-18,czech_republic,Europe,10745981,191,20265
2020-08-19,czech_republic,Europe,10745981,281,20546
2020-08-20,czech_republic,Europe,10745981,313,20859
2020-08-21,czech_republic,Europe,10745981,246,21105
2020-08-22,czech_republic,Europe,10745981,506,21611
2020-08-23,czech_republic,Europe,10745981,234,21845
2020-08-24,czech_republic,Europe,10745981,136,21981
2020-08-25,czech_republic,Europe,10745981,259,22240
2020-08-26,czech_republic,Europe,10745981,364,22604
2020-08-27,czech_republic,Europe,10745981,396,23000
2020-08-28,czech_republic,Europe,10745981,350,23350
2020-08-29,czech_republic,Europe,10745981,485,23835
2020-08-30,czech_republic,Europe,10745981,320,24155
2020-08-31,czech_republic,Europe,10745981,275,24430
2020-09-01,czech_republic,Europe,10745981,256,24686
2020-09-02,czech_republic,Europe,10745981,497,25183
2020-09-03,czech_republic,Europe,10745981,645,25828
2020-09-04,czech_republic,Europe,10745981,675,26503
2020-09-05,czech_republic,Europe,10745981,797,27300
2020-09-06,czech_republic,Europe,10745981,504,27804
2020-09-07,czech_republic,Europe,10745981,410,28214
2020-09-08,czech_republic,Europe,10745981,561,28775
2020-09-09,czech_republic,Europe,10745981,1161,29936
2020-09-10,czech_republic,Europe,10745981,1158,31094
2020-09-11,czech_republic,Europe,10745981,1383,32477
2020-09-12,czech_republic,Europe,10745981,1442,33919
2020-09-13,czech_republic,Europe,10745981,1537,35456
2020-09-14,czech_republic,Europe,10745981,791,36247
2020-09-15,czech_republic,Europe,10745981,1028,37275
2020-09-16,czech_republic,Europe,10745981,1676,38951
2020-09-17,czech_republic,Europe,10745981,2133,41084
2020-09-18,czech_republic,Europe,10745981,3125,44209
2020-09-19,czech_republic,Europe,10745981,2108,46317
2020-09-20,czech_republic,Europe,10745981,2045,48362
2020-09-21,czech_republic,Europe,10745981,984,49346
2020-09-22,czech_republic,Europe,10745981,1477,50823
2020-09-23,czech_republic,Europe,10745981,2387,53210
2020-09-24,czech_republic,Europe,10745981,2305,55515
2020-09-25,czech_republic,Europe,10745981,2906,58421
2020-09-26,czech_republic,Europe,10745981,2945,61366
2020-09-27,czech_republic,Europe,10745981,1981,63347
2020-09-28,czech_republic,Europe,10745981,1305,64652
2020-09-29,czech_republic,Europe,10745981,1284,65936
2020-09-30,czech_republic,Europe,10745981,1962,67898
2020-10-01,czech_republic,Europe,10745981,2925,70823
2020-10-02,czech_republic,Europe,10745981,3503,74326
2020-10-03,czech_republic,Europe,10745981,3795,78121
2020-10-04,czech_republic,Europe,10745981,2554,80675
2020-10-05,czech_republic,Europe,10745981,1841,82516
2020-10-06,czech_republic,Europe,10745981,3117,85633
2020-10-07,czech_republic,Europe,10745981,4458,90091
2020-10-08,czech_republic,Europe,10745981,5336,95427
2020-10-09,czech_republic,Europe,10745981,5394,100821
2020-10-10,czech_republic,Europe,10745981,8618,109439
2020-10-11,czech_republic,Europe,10745981,4637,114076
2020-10-12,czech_republic,Europe,10745981,3104,117180
2020-10-13,czech_republic,Europe,10745981,4307,121487
2020-10-14,czech_republic,Europe,10745981,8324,129811
2020-10-15,czech_republic,Europe,10745981,9544,139355
2020-10-16,czech_republic,Europe,10745981,9724,149079
2020-10-17,czech_republic,Europe,10745981,11104,160183
2020-10-18,czech_republic,Europe,10745981,8713,168896
2020-10-19,czech_republic,Europe,10745981,5059,173955
2020-10-20,czech_republic,Europe,10745981,8078,182033
2020-10-21,czech_republic,Europe,10745981,11985,194018
2020-10-22,czech_republic,Europe,10745981,14971,208989
2020-10-23,czech_republic,Europe,10745981,14158,223147
2020-10-24,czech_republic,Europe,10745981,15248,238395
2020-10-25,czech_republic,Europe,10745981,12473,250868
2020-10-26,czech_republic,Europe,10745981,7300,258168
2020-10-27,czech_republic,Europe,10745981,10275,268443
2020-10-28,czech_republic,Europe,10745981,15667,284110
2020-10-29,czech_republic,Europe,10745981,12977,297087
2020-10-30,czech_republic,Europe,10745981,13050,310137
2020-10-31,czech_republic,Europe,10745981,13605,323742
2020-11-01,czech_republic,Europe,10745981,11428,335170
2020-11-02,czech_republic,Europe,10745981,6551,341721
2020-11-03,czech_republic,Europe,10745981,9241,350962
2020-11-04,czech_republic,Europe,10745981,12090,363052
2020-11-05,czech_republic,Europe,10745981,15726,378778
2020-11-06,czech_republic,Europe,10745981,13237,392015
2020-11-07,czech_republic,Europe,10745981,11546,403561
2020-11-08,czech_republic,Europe,10745981,7721,411282
2020-11-09,czech_republic,Europe,10745981,3611,414893
2020-11-10,czech_republic,Europe,10745981,6048,420941
2020-11-11,czech_republic,Europe,10745981,9057,429998
2020-11-12,czech_republic,Europe,10745981,8919,438917
2020-11-13,czech_republic,Europe,10745981,7874,446791
2020-11-14,czech_republic,Europe,10745981,7358,454149
2020-11-15,czech_republic,Europe,10745981,4196,458345
2020-11-16,czech_republic,Europe,10745981,1891,460236
2020-11-17,czech_republic,Europe,10745981,5426,465662
2020-11-18,czech_republic,Europe,10745981,4246,469908
2020-03-22,democratic_republic_of_the_congo,Africa,94629737,7,30
2020-03-23,democratic_republic_of_the_congo,Africa,94629737,6,36
2020-03-24,democratic_republic_of_the_congo,Africa,94629737,9,45
2020-03-25,democratic_republic_of_the_congo,Africa,94629737,3,48
2020-03-26,democratic_republic_of_the_congo,Africa,94629737,3,51
2020-03-27,democratic_republic_of_the_congo,Africa,94629737,0,51
2020-03-28,democratic_republic_of_the_congo,Africa,94629737,14,65
2020-03-29,democratic_republic_of_the_congo,Africa,94629737,16,81
2020-03-30,democratic_republic_of_the_congo,Africa,94629737,0,81
2020-03-31,democratic_republic_of_the_congo,Africa,94629737,17,98
2020-04-01,democratic_republic_of_the_congo,Africa,94629737,11,109
2020-04-02,democratic_republic_of_the_congo,Africa,94629737,25,134
2020-04-03,democratic_republic_of_the_congo,Africa,94629737,14,148
2020-04-04,democratic_republic_of_the_congo,Africa,94629737,6,154
2020-04-05,democratic_republic_of_the_congo,Africa,94629737,0,154
2020-04-06,democratic_republic_of_the_congo,Africa,94629737,7,161
2020-04-07,democratic_republic_of_the_congo,Africa,94629737,19,180
2020-04-08,democratic_republic_of_the_congo,Africa,94629737,0,180
2020-04-09,democratic_republic_of_the_congo,Africa,94629737,0,180
2020-04-10,democratic_republic_of_the_congo,Africa,94629737,43,223
2020-04-11,democratic_republic_of_the_congo,Africa,94629737,0,223
2020-04-12,democratic_republic_of_the_congo,Africa,94629737,11,234
2020-04-13,democratic_republic_of_the_congo,Africa,94629737,1,235
2020-04-14,democratic_republic_of_the_congo,Africa,94629737,6,241
2020-04-15,democratic_republic_of_the_congo,Africa,94629737,13,254
2020-04-16,democratic_republic_of_the_congo,Africa,94629737,13,267
2020-04-17,democratic_republic_of_the_congo,Africa,94629737,20,287
2020-04-18,democratic_republic_of_the_congo,Africa,94629737,20,307
2020-04-19,democratic_republic_of_the_congo,Africa,94629737,20,327
2020-04-20,democratic_republic_of_the_congo,Africa,94629737,5,332
2020-04-21,democratic_republic_of_the_congo,Africa,94629737,18,350
2020-04-22,democratic_republic_of_the_congo,Africa,94629737,9,359
2020-04-23,democratic_republic_of_the_congo,Africa,94629737,18,377
2020-04-24,democratic_republic_of_the_congo,Africa,94629737,17,394
2020-04-25,democratic_republic_of_the_congo,Africa,94629737,22,416
2020-04-26,democratic_republic_of_the_congo,Africa,94629737,26,442
2020-04-27,democratic_republic_of_the_congo,Africa,94629737,17,459
2020-04-28,democratic_republic_of_the_congo,Africa,94629737,12,471
2020-04-29,democratic_republic_of_the_congo,Africa,94629737,20,491
2020-04-30,democratic_republic_of_the_congo,Africa,94629737,81,572
2020-05-01,democratic_republic_of_the_congo,Africa,94629737,32,604
2020-05-02,democratic_republic_of_the_congo,Africa,94629737,70,674
2020-05-03,democratic_republic_of_the_congo,Africa,94629737,0,674
2020-05-04,democratic_republic_of_the_congo,Africa,94629737,8,682
2020-05-05,democratic_republic_of_the_congo,Africa,94629737,23,705
2020-05-06,democratic_republic_of_the_congo,Africa,94629737,92,797
2020-05-07,democratic_republic_of_the_congo,Africa,94629737,66,863
2020-05-08,democratic_republic_of_the_congo,Africa,94629737,0,863
2020-05-09,democratic_republic_of_the_congo,Africa,94629737,74,937
2020-05-10,democratic_republic_of_the_congo,Africa,94629737,54,991
2020-05-11,democratic_republic_of_the_congo,Africa,94629737,33,1024
2020-05-12,democratic_republic_of_the_congo,Africa,94629737,78,1102
2020-05-13,democratic_republic_of_the_congo,Africa,94629737,67,1169
2020-05-14,democratic_republic_of_the_congo,Africa,94629737,73,1242
2020-05-15,democratic_republic_of_the_congo,Africa,94629737,56,1298
2020-05-16,democratic_republic_of_the_congo,Africa,94629737,157,1455
2020-05-17,democratic_republic_of_the_congo,Africa,94629737,0,1455
2020-05-18,democratic_republic_of_the_congo,Africa,94629737,83,1538
2020-05-19,democratic_republic_of_the_congo,Africa,94629737,91,1629
2020-05-20,democratic_republic_of_the_congo,Africa,94629737,102,1731
2020-05-21,democratic_republic_of_the_congo,Africa,94629737,104,1835
2020-05-22,democratic_republic_of_the_congo,Africa,94629737,110,1945
2020-05-23,democratic_republic_of_the_congo,Africa,94629737,80,2025
2020-05-24,democratic_republic_of_the_congo,Africa,94629737,116,2141
2020-05-25,democratic_republic_of_the_congo,Africa,94629737,156,2297
2020-05-26,democratic_republic_of_the_congo,Africa,94629737,106,2403
2020-05-27,democratic_republic_of_the_congo,Africa,94629737,143,2546
2020-05-28,democratic_republic_of_the_congo,Africa,94629737,114,2660
2020-05-29,democratic_republic_of_the_congo,Africa,94629737,173,2833
2020-05-30,democratic_republic_of_the_congo,Africa,94629737,133,2966
2020-05-31,democratic_republic_of_the_congo,Africa,94629737,104,3070
2020-06-01,democratic_republic_of_the_congo,Africa,94629737,125,3195
2020-06-02,democratic_republic_of_the_congo,Africa,94629737,131,3326
2020-06-03,democratic_republic_of_the_congo,Africa,94629737,169,3495
2020-06-04,democratic_republic_of_the_congo,Africa,94629737,149,3644
2020-06-05,democratic_republic_of_the_congo,Africa,94629737,120,3764
2020-06-06,democratic_republic_of_the_congo,Africa,94629737,114,3878
2020-06-07,democratic_republic_of_the_congo,Africa,94629737,138,4016
2020-06-08,democratic_republic_of_the_congo,Africa,94629737,90,4106
2020-06-09,democratic_republic_of_the_congo,Africa,94629737,153,4259
2020-06-10,democratic_republic_of_the_congo,Africa,94629737,131,4390
2020-06-11,democratic_republic_of_the_congo,Africa,94629737,125,4515
2020-06-12,democratic_republic_of_the_congo,Africa,94629737,122,4637
2020-06-13,democratic_republic_of_the_congo,Africa,94629737,87,4724
2020-06-14,democratic_republic_of_the_congo,Africa,94629737,54,4778
2020-06-15,democratic_republic_of_the_congo,Africa,94629737,59,4837
2020-06-16,democratic_republic_of_the_congo,Africa,94629737,137,4974
2020-06-17,democratic_republic_of_the_congo,Africa,94629737,126,5100
2020-06-18,democratic_republic_of_the_congo,Africa,94629737,183,5283
2020-06-19,democratic_republic_of_the_congo,Africa,94629737,194,5477
2020-06-20,democratic_republic_of_the_congo,Africa,94629737,195,5672
2020-06-21,democratic_republic_of_the_congo,Africa,94629737,154,5826
2020-06-22,democratic_republic_of_the_congo,Africa,94629737,98,5924
2020-06-23,democratic_republic_of_the_congo,Africa,94629737,103,6027
2020-06-24,democratic_republic_of_the_congo,Africa,94629737,186,6213
2020-06-25,democratic_republic_of_the_congo,Africa,94629737,198,6411
2020-06-26,democratic_republic_of_the_congo,Africa,94629737,141,6552
2020-06-27,democratic_republic_of_the_congo,Africa,94629737,138,6690
2020-06-28,democratic_republic_of_the_congo,Africa,94629737,137,6827
2020-06-29,democratic_republic_of_the_congo,Africa,94629737,112,6939
2020-06-30,democratic_republic_of_the_congo,Africa,94629737,100,7039
2020-07-01,democratic_republic_of_the_congo,Africa,94629737,83,7122
2020-07-02,democratic_republic_of_the_congo,Africa,94629737,67,7189
2020-07-03,democratic_republic_of_the_congo,Africa,94629737,122,7311
2020-07-04,democratic_republic_of_the_congo,Africa,94629737,68,7379
2020-07-05,democratic_republic_of_the_congo,Africa,94629737,32,7411
2020-07-06,democratic_republic_of_the_congo,Africa,94629737,21,7432
2020-07-07,democratic_republic_of_the_congo,Africa,94629737,0,7432
2020-07-08,democratic_republic_of_the_congo,Africa,94629737,0,7432
2020-07-09,democratic_republic_of_the_congo,Africa,94629737,414,7846
2020-07-10,democratic_republic_of_the_congo,Africa,94629737,59,7905
2020-07-11,democratic_republic_of_the_congo,Africa,94629737,66,7971
2020-07-12,democratic_republic_of_the_congo,Africa,94629737,62,8033
2020-07-13,democratic_republic_of_the_congo,Africa,94629737,42,8075
2020-07-14,democratic_republic_of_the_congo,Africa,94629737,60,8135
2020-07-15,democratic_republic_of_the_congo,Africa,94629737,28,8163
2020-07-16,democratic_republic_of_the_congo,Africa,94629737,36,8199
2020-07-17,democratic_republic_of_the_congo,Africa,94629737,50,8249
2020-07-18,democratic_republic_of_the_congo,Africa,94629737,75,8324
2020-07-19,democratic_republic_of_the_congo,Africa,94629737,79,8403
2020-07-20,democratic_republic_of_the_congo,Africa,94629737,40,8443
2020-07-21,democratic_republic_of_the_congo,Africa,94629737,91,8534
2020-07-22,democratic_republic_of_the_congo,Africa,94629737,92,8626
2020-07-23,democratic_republic_of_the_congo,Africa,94629737,94,8720
2020-07-24,democratic_republic_of_the_congo,Africa,94629737,47,8767
2020-07-25,democratic_republic_of_the_congo,Africa,94629737,34,8801
2020-07-26,democratic_republic_of_the_congo,Africa,94629737,30,8831
2020-07-27,democratic_republic_of_the_congo,Africa,94629737,13,8844
2020-07-28,democratic_republic_of_the_congo,Africa,94629737,29,8873
2020-07-29,democratic_republic_of_the_congo,Africa,94629737,58,8931
2020-07-30,democratic_republic_of_the_congo,Africa,94629737,79,9010
2020-07-31,democratic_republic_of_the_congo,Africa,94629737,60,9070
2020-08-01,democratic_republic_of_the_congo,Africa,94629737,14,9084
2020-08-02,democratic_republic_of_the_congo,Africa,94629737,31,9115
2020-08-03,democratic_republic_of_the_congo,Africa,94629737,18,9133
2020-08-04,democratic_republic_of_the_congo,Africa,94629737,45,9178
2020-08-05,democratic_republic_of_the_congo,Africa,94629737,75,9253
2020-08-06,democratic_republic_of_the_congo,Africa,94629737,56,9309
2020-08-07,democratic_republic_of_the_congo,Africa,94629737,46,9355
2020-08-08,democratic_republic_of_the_congo,Africa,94629737,81,9436
2020-08-09,democratic_republic_of_the_congo,Africa,94629737,18,9454
2020-08-10,democratic_republic_of_the_congo,Africa,94629737,35,9489
2020-08-11,democratic_republic_of_the_congo,Africa,94629737,10,9499
2020-08-12,democratic_republic_of_the_congo,Africa,94629737,39,9538
2020-08-13,democratic_republic_of_the_congo,Africa,94629737,51,9589
2020-08-14,democratic_republic_of_the_congo,Africa,94629737,16,9605
2020-08-15,democratic_republic_of_the_congo,Africa,94629737,33,9638
2020-08-16,democratic_republic_of_the_congo,Africa,94629737,38,9676
2020-08-17,democratic_republic_of_the_congo,Africa,94629737,30,9706
2020-08-18,democratic_republic_of_the_congo,Africa,94629737,15,9721
2020-08-19,democratic_republic_of_the_congo,Africa,94629737,20,9741
2020-08-20,democratic_republic_of_the_congo,Africa,94629737,16,9757
2020-08-21,democratic_republic_of_the_congo,Africa,94629737,45,9802
2020-08-22,democratic_republic_of_the_congo,Africa,94629737,9,9811
2020-08-23,democratic_republic_of_the_congo,Africa,94629737,19,9830
2020-08-24,democratic_republic_of_the_congo,Africa,94629737,12,9842
2020-08-25,democratic_republic_of_the_congo,Africa,94629737,49,9891
2020-08-26,democratic_republic_of_the_congo,Africa,94629737,21,9912
2020-08-27,democratic_republic_of_the_congo,Africa,94629737,3,9915
2020-08-28,democratic_republic_of_the_congo,Africa,94629737,79,9994
2020-08-29,democratic_republic_of_the_congo,Africa,94629737,13,10007
2020-08-30,democratic_republic_of_the_congo,Africa,94629737,38,10045
2020-08-31,democratic_republic_of_the_congo,Africa,94629737,52,10097
2020-09-01,democratic_republic_of_the_congo,Africa,94629737,7,10104
2020-09-02,democratic_republic_of_the_congo,Africa,94629737,10,10114
2020-09-03,democratic_republic_of_the_congo,Africa,94629737,11,10125
2020-09-04,democratic_republic_of_the_congo,Africa,94629737,24,10149
2020-09-05,democratic_republic_of_the_congo,Africa,94629737,29,10178
2020-09-06,democratic_republic_of_the_congo,Africa,94629737,32,10210
2020-09-07,democratic_republic_of_the_congo,Africa,94629737,23,10233
2020-09-08,democratic_republic_of_the_congo,Africa,94629737,59,10292
2020-09-09,democratic_republic_of_the_congo,Africa,94629737,32,10324
2020-09-10,democratic_republic_of_the_congo,Africa,94629737,19,10343
2020-09-11,democratic_republic_of_the_congo,Africa,94629737,18,10361
2020-09-12,democratic_republic_of_the_congo,Africa,94629737,24,10385
2020-09-13,democratic_republic_of_the_congo,Africa,94629737,5,10390
2020-09-14,democratic_republic_of_the_congo,Africa,94629737,0,10390
2020-09-15,democratic_republic_of_the_congo,Africa,94629737,11,10401
2020-09-16,democratic_republic_of_the_congo,Africa,94629737,13,10414
2020-09-17,democratic_republic_of_the_congo,Africa,94629737,28,10442
2020-09-18,democratic_republic_of_the_congo,Africa,94629737,14,10456
2020-09-19,democratic_republic_of_the_congo,Africa,94629737,32,10488
2020-09-20,democratic_republic_of_the_congo,Africa,94629737,27,10515
2020-09-21,democratic_republic_of_the_congo,Africa,94629737,4,10519
2020-09-22,democratic_republic_of_the_congo,Africa,94629737,4,10523
2020-09-23,democratic_republic_of_the_congo,Africa,94629737,14,10537
2020-09-24,democratic_republic_of_the_congo,Africa,94629737,18,10555
2020-09-25,democratic_republic_of_the_congo,Africa,94629737,23,10578
2020-09-26,democratic_republic_of_the_congo,Africa,94629737,15,10593
2020-09-27,democratic_republic_of_the_congo,Africa,94629737,19,10612
2020-09-28,democratic_republic_of_the_congo,Africa,94629737,12,10624
2020-09-29,democratic_republic_of_the_congo,Africa,94629737,7,10631
2020-09-30,democratic_republic_of_the_congo,Africa,94629737,28,10659
2020-10-01,democratic_republic_of_the_congo,Africa,94629737,26,10685
2020-10-02,democratic_republic_of_the_congo,Africa,94629737,44,10729
2020-10-03,democratic_republic_of_the_congo,Africa,94629737,23,10752
2020-10-04,democratic_republic_of_the_congo,Africa,94629737,8,10760
2020-10-05,democratic_republic_of_the_congo,Africa,94629737,18,10778
2020-10-06,democratic_republic_of_the_congo,Africa,94629737,11,10789
2020-10-07,democratic_republic_of_the_congo,Africa,94629737,15,10804
2020-10-08,democratic_republic_of_the_congo,Africa,94629737,18,10822
2020-10-09,democratic_republic_of_the_congo,Africa,94629737,13,10835
2020-10-10,democratic_republic_of_the_congo,Africa,94629737,6,10841
2020-10-11,democratic_republic_of_the_congo,Africa,94629737,10,10851
2020-10-12,democratic_republic_of_the_congo,Africa,94629737,17,10868
2020-10-13,democratic_republic_of_the_congo,Africa,94629737,4,10872
2020-10-14,democratic_republic_of_the_congo,Africa,94629737,63,10935
2020-10-15,democratic_republic_of_the_congo,Africa,94629737,0,10935
2020-10-16,democratic_republic_of_the_congo,Africa,94629737,64,10999
2020-10-17,democratic_republic_of_the_congo,Africa,94629737,1,11000
2020-10-18,democratic_republic_of_the_congo,Africa,94629737,6,11006
2020-10-19,democratic_republic_of_the_congo,Africa,94629737,46,11052
2020-10-20,democratic_republic_of_the_congo,Africa,94629737,14,11066
2020-10-21,democratic_republic_of_the_congo,Africa,94629737,0,11066
2020-10-22,democratic_republic_of_the_congo,Africa,94629737,31,11097
2020-10-23,democratic_republic_of_the_congo,Africa,94629737,25,11122
2020-10-24,democratic_republic_of_the_congo,Africa,94629737,21,11143
2020-10-25,democratic_republic_of_the_congo,Africa,94629737,0,11143
2020-10-26,democratic_republic_of_the_congo,Africa,94629737,31,11174
2020-10-27,democratic_republic_of_the_congo,Africa,94629737,17,11191
2020-10-28,democratic_republic_of_the_congo,Africa,94629737,20,11211
2020-10-29,democratic_republic_of_the_congo,Africa,94629737,42,11253
2020-10-30,democratic_republic_of_the_congo,Africa,94629737,53,11306
2020-10-31,democratic_republic_of_the_congo,Africa,94629737,67,11373
2020-11-01,democratic_republic_of_the_congo,Africa,94629737,0,11373
2020-11-02,democratic_republic_of_the_congo,Africa,94629737,22,11395
2020-11-03,democratic_republic_of_the_congo,Africa,94629737,32,11427
2020-11-04,democratic_republic_of_the_congo,Africa,94629737,23,11450
2020-11-05,democratic_republic_of_the_congo,Africa,94629737,0,11450
2020-11-06,democratic_republic_of_the_congo,Africa,94629737,67,11517
2020-11-07,democratic_republic_of_the_congo,Africa,94629737,33,11550
2020-11-08,democratic_republic_of_the_congo,Africa,94629737,41,11591
2020-11-09,democratic_republic_of_the_congo,Africa,94629737,17,11608
2020-11-10,democratic_republic_of_the_congo,Africa,94629737,34,11642
2020-11-11,democratic_republic_of_the_congo,Africa,94629737,14,11656
2020-11-12,democratic_republic_of_the_congo,Africa,94629737,36,11692
2020-11-13,democratic_republic_of_the_congo,Africa,94629737,0,11692
2020-11-14,democratic_republic_of_the_congo,Africa,94629737,68,11760
2020-11-15,democratic_republic_of_the_congo,Africa,94629737,0,11760
2020-11-16,democratic_republic_of_the_congo,Africa,94629737,79,11839
2020-11-17,democratic_republic_of_the_congo,Africa,94629737,27,11866
2020-11-18,democratic_republic_of_the_congo,Africa,94629737,52,11918
2020-11-19,democratic_republic_of_the_congo,Africa,94629737,90,12008
2020-11-20,democratic_republic_of_the_congo,Africa,94629737,121,12129
2020-11-21,democratic_republic_of_the_congo,Africa,94629737,51,12180
2020-11-22,democratic_republic_of_the_congo,Africa,94629737,0,12180
2020-11-23,democratic_republic_of_the_congo,Africa,94629737,98,12278
2020-11-24,democratic_republic_of_the_congo,Africa,94629737,32,12310
2020-11-25,democratic_republic_of_the_congo,Africa,94629737,55,12365
2020-11-26,democratic_republic_of_the_congo,Africa,94629737,105,12470
2020-11-27,democratic_republic_of_the_congo,Africa,94629737,71,12541
2020-11-28,democratic_republic_of_the_congo,Africa,94629737,67,12608
2020-11-29,democratic_republic_of_the_congo,Africa,94629737,94,12702
2020-11-30,democratic_republic_of_the_congo,Africa,94629737,70,12772
2020-12-01,democratic_republic_of_the_congo,Africa,94629737,87,12859
2020-12-02,democratic_republic_of_the_congo,Africa,94629737,128,12987
2020-12-03,democratic_republic_of_the_congo,Africa,94629737,145,13132
2020-12-04,democratic_republic_of_the_congo,Africa,94629737,149,13281
2020-12-05,democratic_republic_of_the_congo,Africa,94629737,132,13413
2020-12-06,democratic_republic_of_the_congo,Africa,94629737,114,13527
2020-12-07,democratic_republic_of_the_congo,Africa,94629737,68,13595
2020-12-08,democratic_republic_of_the_congo,Africa,94629737,155,13750
2020-12-09,democratic_republic_of_the_congo,Africa,94629737,93,13843
2020-12-10,democratic_republic_of_the_congo,Africa,94629737,154,13997
2020-12-11,democratic_republic_of_the_congo,Africa,94629737,173,14170
2020-12-12,democratic_republic_of_the_congo,Africa,94629737,172,14342
2020-12-13,democratic_republic_of_the_congo,Africa,94629737,119,14461
2020-12-14,democratic_republic_of_the_congo,Africa,94629737,52,14513
2020-12-15,democratic_republic_of_the_congo,Africa,94629737,84,14597
2020-12-16,democratic_republic_of_the_congo,Africa,94629737,333,14930
2020-12-17,democratic_republic_of_the_congo,Africa,94629737,159,15089
2020-12-18,democratic_republic_of_the_congo,Africa,94629737,123,15212
2020-12-19,democratic_republic_of_the_congo,Africa,94629737,185,15397
2020-12-20,democratic_republic_of_the_congo,Africa,94629737,98,15495
2020-12-21,democratic_republic_of_the_congo,Africa,94629737,174,15669
2020-12-22,democratic_republic_of_the_congo,Africa,94629737,141,15810
2020-12-23,democratic_republic_of_the_congo,Africa,94629737,229,16039
2020-12-24,democratic_republic_of_the_congo,Africa,94629737,243,16282
2020-12-25,democratic_republic_of_the_congo,Africa,94629737,190,16472
2020-12-26,democratic_republic_of_the_congo,Africa,94629737,291,16763
2020-12-27,democratic_republic_of_the_congo,Africa,94629737,76,16839
2020-12-28,democratic_republic_of_the_congo,Africa,94629737,78,16917
2020-12-29,democratic_republic_of_the_congo,Africa,94629737,265,17182
2020-12-30,democratic_republic_of_the_congo,Africa,94629737,193,17375
2020-12-31,democratic_republic_of_the_congo,Africa,94629737,283,17658
2021-01-01,democratic_republic_of_the_congo,Africa,94629737,191,17849
2021-01-02,democratic_republic_of_the_congo,Africa,94629737,149,17998
2021-01-03,democratic_republic_of_the_congo,Africa,94629737,104,18102
2021-01-04,democratic_republic_of_the_congo,Africa,94629737,51,18153
2021-01-05,democratic_republic_of_the_congo,Africa,94629737,95,18248
2021-01-06,democratic_republic_of_the_congo,Africa,94629737,239,18487
2021-01-07,democratic_republic_of_the_congo,Africa,94629737,251,18738
2021-01-08,democratic_republic_of_the_congo,Africa,94629737,231,18969
2021-01-09,democratic_republic_of_the_congo,Africa,94629737,190,19159
2021-01-10,democratic_republic_of_the_congo,Africa,94629737,277,19436
2021-01-11,democratic_republic_of_the_congo,Africa,94629737,60,19496
2021-01-12,democratic_republic_of_the_congo,Africa,94629737,211,19707
2021-01-13,democratic_republic_of_the_congo,Africa,94629737,296,20003
2021-01-14,democratic_republic_of_the_congo,Africa,94629737,476,20479
2021-01-15,democratic_republic_of_the_congo,Africa,94629737,77,20556
2021-01-16,democratic_republic_of_the_congo,Africa,94629737,137,20693
2021-01-17,democratic_republic_of_the_congo,Africa,94629737,215,20908
2021-01-18,democratic_republic_of_the_congo,Africa,94629737,152,21060
2021-01-19,democratic_republic_of_the_congo,Africa,94629737,80,21140
2021-01-20,democratic_republic_of_the_congo,Africa,94629737,162,21302
2021-01-21,democratic_republic_of_the_congo,Africa,94629737,98,21400
2021-01-22,democratic_republic_of_the_congo,Africa,94629737,197,21597
2021-01-23,democratic_republic_of_the_congo,Africa,94629737,116,21713
2021-01-24,democratic_republic_of_the_congo,Africa,94629737,156,21869
2021-01-25,democratic_republic_of_the_congo,Africa,94629737,85,21954
2021-01-26,democratic_republic_of_the_congo,Africa,94629737,94,22048
2021-01-27,democratic_republic_of_the_congo,Africa,94629737,130,22178
2021-01-28,democratic_republic_of_the_congo,Africa,94629737,144,22322
2021-01-29,democratic_republic_of_the_congo,Africa,94629737,133,22455
2021-01-30,democratic_republic_of_the_congo,Africa,94629737,149,22604
2021-01-31,democratic_republic_of_the_congo,Africa,94629737,167,22771
2021-02-01,democratic_republic_of_the_congo,Africa,94629737,71,22842
2021-02-02,democratic_republic_of_the_congo,Africa,94629737,201,23043
2021-02-03,democratic_republic_of_the_congo,Africa,94629737,139,23182
2021-02-04,democratic_republic_of_the_congo,Africa,94629737,40,23222
2021-02-05,democratic_republic_of_the_congo,Africa,94629737,149,23371
2021-02-06,democratic_republic_of_the_congo,Africa,94629737,114,23485
2021-02-07,democratic_republic_of_the_congo,Africa,94629737,114,23599
2021-02-08,democratic_republic_of_the_congo,Africa,94629737,72,23671
2021-02-09,democratic_republic_of_the_congo,Africa,94629737,100,23771
2021-02-10,democratic_republic_of_the_congo,Africa,94629737,119,23890
2021-02-11,democratic_republic_of_the_congo,Africa,94629737,136,24026
2021-02-12,democratic_republic_of_the_congo,Africa,94629737,126,24152
2021-02-13,democratic_republic_of_the_congo,Africa,94629737,88,24240
2021-02-14,democratic_republic_of_the_congo,Africa,94629737,55,24295
2021-02-15,democratic_republic_of_the_congo,Africa,94629737,91,24386
2021-02-16,democratic_republic_of_the_congo,Africa,94629737,37,24423
2021-02-17,democratic_republic_of_the_congo,Africa,94629737,179,24602
2021-02-18,democratic_republic_of_the_congo,Africa,94629737,192,24794
2021-02-19,democratic_republic_of_the_congo,Africa,94629737,170,24964
2021-02-20,democratic_republic_of_the_congo,Africa,94629737,116,25080
2021-02-21,democratic_republic_of_the_congo,Africa,94629737,0,25080
2021-02-22,democratic_republic_of_the_congo,Africa,94629737,64,25144
2021-02-23,democratic_republic_of_the_congo,Africa,94629737,226,25370
2021-02-24,democratic_republic_of_the_congo,Africa,94629737,102,25472
2021-02-25,democratic_republic_of_the_congo,Africa,94629737,124,25596
2021-02-26,democratic_republic_of_the_congo,Africa,94629737,95,25691
2021-02-27,democratic_republic_of_the_congo,Africa,94629737,101,25792
2021-02-28,democratic_republic_of_the_congo,Africa,94629737,121,25913
2021-03-01,democratic_republic_of_the_congo,Africa,94629737,49,25962
2021-03-02,democratic_republic_of_the_congo,Africa,94629737,88,26050
2021-03-03,democratic_republic_of_the_congo,Africa,94629737,197,26247
2021-03-04,democratic_republic_of_the_congo,Africa,94629737,93,26340
2021-03-05,democratic_republic_of_the_congo,Africa,94629737,65,26405
2021-03-06,democratic_republic_of_the_congo,Africa,94629737,64,26469
2021-03-07,democratic_republic_of_the_congo,Africa,94629737,72,26541
2021-03-08,democratic_republic_of_the_congo,Africa,94629737,86,26627
2021-03-09,democratic_republic_of_the_congo,Africa,94629737,57,26684
2021-03-10,democratic_republic_of_the_congo,Africa,94629737,54,26738
2021-03-11,democratic_republic_of_the_congo,Africa,94629737,21,26759
2021-03-12,democratic_republic_of_the_congo,Africa,94629737,87,26846
2021-03-13,democratic_republic_of_the_congo,Africa,94629737,92,26938
2021-03-14,democratic_republic_of_the_congo,Africa,94629737,76,27014
2021-03-15,democratic_republic_of_the_congo,Africa,94629737,63,27077
2021-03-16,democratic_republic_of_the_congo,Africa,94629737,23,27100
2021-03-17,democratic_republic_of_the_congo,Africa,94629737,152,27252
2021-03-18,democratic_republic_of_the_congo,Africa,94629737,38,27290
2021-03-19,democratic_republic_of_the_congo,Africa,94629737,66,27356
2021-03-20,democratic_republic_of_the_congo,Africa,94629737,112,27468
2021-03-21,democratic_republic_of_the_congo,Africa,94629737,85,27553
2021-03-22,democratic_republic_of_the_congo,Africa,94629737,19,27572
2021-03-23,democratic_republic_of_the_congo,Africa,94629737,8,27580
2021-03-24,democratic_republic_of_the_congo,Africa,94629737,80,27660
2021-03-25,democratic_republic_of_the_congo,Africa,94629737,69,27729
2021-03-26,democratic_republic_of_the_congo,Africa,94629737,65,27794
2021-03-27,democratic_republic_of_the_congo,Africa,94629737,93,27887
2021-03-28,democratic_republic_of_the_congo,Africa,94629737,43,27930
2021-03-29,democratic_republic_of_the_congo,Africa,94629737,82,28012
2021-03-30,democratic_republic_of_the_congo,Africa,94629737,64,28076
2021-03-31,democratic_republic_of_the_congo,Africa,94629737,66,28142
2021-04-01,democratic_republic_of_the_congo,Africa,94629737,57,28199
2021-04-02,democratic_republic_of_the_congo,Africa,94629737,18,28217
2021-04-03,democratic_republic_of_the_congo,Africa,94629737,75,28292
2021-04-04,democratic_republic_of_the_congo,Africa,94629737,33,28325
2021-04-05,democratic_republic_of_the_congo,Africa,94629737,29,28354
2021-04-06,democratic_republic_of_the_congo,Africa,94629737,23,28377
2021-04-07,democratic_republic_of_the_congo,Africa,94629737,33,28410
2021-04-08,democratic_republic_of_the_congo,Africa,94629737,64,28474
2021-04-09,democratic_republic_of_the_congo,Africa,94629737,37,28511
2021-04-10,democratic_republic_of_the_congo,Africa,94629737,31,28542
2021-04-11,democratic_republic_of_the_congo,Africa,94629737,37,28579
2021-04-12,democratic_republic_of_the_congo,Africa,94629737,32,28611
2021-04-13,democratic_republic_of_the_congo,Africa,94629737,54,28665
2021-04-14,democratic_republic_of_the_congo,Africa,94629737,49,28714
2021-04-15,democratic_republic_of_the_congo,Africa,94629737,55,28769
2021-04-16,democratic_republic_of_the_congo,Africa,94629737,90,28859
2021-04-17,democratic_republic_of_the_congo,Africa,94629737,35,28894
2021-04-18,democratic_republic_of_the_congo,Africa,94629737,62,28956
2021-04-19,democratic_republic_of_the_congo,Africa,94629737,49,29005
2021-04-20,democratic_republic_of_the_congo,Africa,94629737,79,29084
2021-04-21,democratic_republic_of_the_congo,Africa,94629737,149,29233
2021-04-22,democratic_republic_of_the_congo,Africa,94629737,117,29350
2021-04-23,democratic_republic_of_the_congo,Africa,94629737,55,29405
2021-04-24,democratic_republic_of_the_congo,Africa,94629737,93,29498
2021-04-25,democratic_republic_of_the_congo,Africa,94629737,78,29576
2021-04-26,democratic_republic_of_the_congo,Africa,94629737,35,29611
2021-04-27,democratic_republic_of_the_congo,Africa,94629737,90,29701
2021-04-28,democratic_republic_of_the_congo,Africa,94629737,67,29768
2021-04-29,democratic_republic_of_the_congo,Africa,94629737,44,29812
2021-04-30,democratic_republic_of_the_congo,Africa,94629737,41,29853
2021-05-01,democratic_republic_of_the_congo,Africa,94629737,51,29904
2021-05-02,democratic_republic_of_the_congo,Africa,94629737,60,29964
2021-05-03,democratic_republic_of_the_congo,Africa,94629737,41,30005
2021-05-04,democratic_republic_of_the_congo,Africa,94629737,66,30071
2021-05-05,democratic_republic_of_the_congo,Africa,94629737,59,30130
2021-05-06,democratic_republic_of_the_congo,Africa,94629737,71,30201
2021-05-07,democratic_republic_of_the_congo,Africa,94629737,39,30240
2021-05-08,democratic_republic_of_the_congo,Africa,94629737,45,30285
2021-05-09,democratic_republic_of_the_congo,Africa,94629737,38,30323
2021-05-10,democratic_republic_of_the_congo,Africa,94629737,27,30350
2021-05-11,democratic_republic_of_the_congo,Africa,94629737,42,30392
2021-05-12,democratic_republic_of_the_congo,Africa,94629737,37,30429
2021-05-13,democratic_republic_of_the_congo,Africa,94629737,49,30478
2021-05-14,democratic_republic_of_the_congo,Africa,94629737,33,30511
2021-05-15,democratic_republic_of_the_congo,Africa,94629737,35,30546
2021-05-16,democratic_republic_of_the_congo,Africa,94629737,16,30562
2021-05-17,democratic_republic_of_the_congo,Africa,94629737,47,30609
2021-05-18,democratic_republic_of_the_congo,Africa,94629737,11,30620
2021-05-19,democratic_republic_of_the_congo,Africa,94629737,88,30708
2021-05-20,democratic_republic_of_the_congo,Africa,94629737,49,30757
2021-05-21,democratic_republic_of_the_congo,Africa,94629737,68,30825
2021-05-22,democratic_republic_of_the_congo,Africa,94629737,149,30974
2021-05-23,democratic_republic_of_the_congo,Africa,94629737,0,30974
2021-05-24,democratic_republic_of_the_congo,Africa,94629737,78,31052
2021-05-25,democratic_republic_of_the_congo,Africa,94629737,120,31172
2021-05-26,democratic_republic_of_the_congo,Africa,94629737,76,31248
2021-05-27,democratic_republic_of_the_congo,Africa,94629737,31,31279
2021-05-28,democratic_republic_of_the_congo,Africa,94629737,107,31386
2021-05-29,democratic_republic_of_the_congo,Africa,94629737,30,31416
2021-05-30,democratic_republic_of_the_congo,Africa,94629737,141,31557
2021-05-31,democratic_republic_of_the_congo,Africa,94629737,94,31651
2021-06-01,democratic_republic_of_the_congo,Africa,94629737,165,31816
2021-06-02,democratic_republic_of_the_congo,Africa,94629737,118,31934
2021-06-03,democratic_republic_of_the_congo,Africa,94629737,243,32177
2021-06-04,democratic_republic_of_the_congo,Africa,94629737,368,32545
2021-06-05,democratic_republic_of_the_congo,Africa,94629737,251,32796
2021-06-06,democratic_republic_of_the_congo,Africa,94629737,406,33202
2021-06-07,democratic_republic_of_the_congo,Africa,94629737,136,33338
2021-06-08,democratic_republic_of_the_congo,Africa,94629737,239,33577
2021-06-09,democratic_republic_of_the_congo,Africa,94629737,379,33956
2021-06-10,democratic_republic_of_the_congo,Africa,94629737,310,34266
2021-06-11,democratic_republic_of_the_congo,Africa,94629737,429,34695
2021-06-12,democratic_republic_of_the_congo,Africa,94629737,254,34949
2021-06-13,democratic_republic_of_the_congo,Africa,94629737,279,35228
2021-06-14,democratic_republic_of_the_congo,Africa,94629737,440,35668
2021-06-15,democratic_republic_of_the_congo,Africa,94629737,250,35918
2021-06-16,democratic_republic_of_the_congo,Africa,94629737,304,36222
2021-06-17,democratic_republic_of_the_congo,Africa,94629737,358,36580
2021-06-18,democratic_republic_of_the_congo,Africa,94629737,377,36957
2021-06-19,democratic_republic_of_the_congo,Africa,94629737,562,37519
2021-06-20,democratic_republic_of_the_congo,Africa,94629737,290,37809
2021-06-21,democratic_republic_of_the_congo,Africa,94629737,117,37926
2021-06-22,democratic_republic_of_the_congo,Africa,94629737,404,38330
2020-02-28,denmark,Europe,5830190,1,2
2020-02-29,denmark,Europe,5830190,1,3
2020-03-01,denmark,Europe,5830190,1,4
2020-03-02,denmark,Europe,5830190,0,4
2020-03-03,denmark,Europe,5830190,6,10
2020-03-04,denmark,Europe,5830190,4,14
2020-03-05,denmark,Europe,5830190,5,19
2020-03-06,denmark,Europe,5830190,2,21
2020-03-07,denmark,Europe,5830190,6,27
2020-03-08,denmark,Europe,5830190,8,35
2020-03-09,denmark,Europe,5830190,55,90
2020-03-10,denmark,Europe,5830190,172,262
2020-03-11,denmark,Europe,5830190,252,514
2020-03-12,denmark,Europe,5830190,160,674
2020-03-13,denmark,Europe,5830190,130,804
2020-03-14,denmark,Europe,5830190,32,836
2020-03-15,denmark,Europe,5830190,28,864
2020-03-16,denmark,Europe,5830190,50,914
2020-03-17,denmark,Europe,5830190,63,977
2020-03-18,denmark,Europe,5830190,80,1057
2020-03-19,denmark,Europe,5830190,94,1151
2020-03-20,denmark,Europe,5830190,104,1255
2020-03-21,denmark,Europe,5830190,71,1326
2020-03-22,denmark,Europe,5830190,69,1395
2020-03-23,denmark,Europe,5830190,65,1460
2020-03-24,denmark,Europe,5830190,131,1591
2020-03-25,denmark,Europe,5830190,133,1724
2020-03-26,denmark,Europe,5830190,153,1877
2020-03-27,denmark,Europe,5830190,169,2046
2020-03-28,denmark,Europe,5830190,155,2201
2020-03-29,denmark,Europe,5830190,194,2395
2020-03-30,denmark,Europe,5830190,182,2577
2020-03-31,denmark,Europe,5830190,283,2860
2020-04-01,denmark,Europe,5830190,247,3107
2020-04-02,denmark,Europe,5830190,279,3386
2020-04-03,denmark,Europe,5830190,371,3757
2020-04-04,denmark,Europe,5830190,320,4077
2020-04-05,denmark,Europe,5830190,292,4369
2020-04-06,denmark,Europe,5830190,312,4681
2020-04-07,denmark,Europe,5830190,390,5071
2020-04-08,denmark,Europe,5830190,331,5402
2020-04-09,denmark,Europe,5830190,233,5635
2020-04-10,denmark,Europe,5830190,184,5819
2020-04-11,denmark,Europe,5830190,177,5996
2020-04-12,denmark,Europe,5830190,178,6174
2020-04-13,denmark,Europe,5830190,144,6318
2020-04-14,denmark,Europe,5830190,193,6511
2020-04-15,denmark,Europe,5830190,170,6681
2020-04-16,denmark,Europe,5830190,198,6879
2020-04-17,denmark,Europe,5830190,194,7073
2020-04-18,denmark,Europe,5830190,169,7242
2020-04-19,denmark,Europe,5830190,142,7384
2020-04-20,denmark,Europe,5830190,131,7515
2020-04-21,denmark,Europe,5830190,180,7695
2020-04-22,denmark,Europe,5830190,217,7912
2020-04-23,denmark,Europe,5830190,161,8073
2020-04-24,denmark,Europe,5830190,137,8210
2020-04-25,denmark,Europe,5830190,235,8445
2020-04-26,denmark,Europe,5830190,130,8575
2020-04-27,denmark,Europe,5830190,123,8698
2020-04-28,denmark,Europe,5830190,153,8851
2020-04-29,denmark,Europe,5830190,157,9008
2020-04-30,denmark,Europe,5830190,150,9158
2020-05-01,denmark,Europe,5830190,153,9311
2020-05-02,denmark,Europe,5830190,96,9407
2020-05-03,denmark,Europe,5830190,116,9523
2020-05-04,denmark,Europe,5830190,147,9670
2020-05-05,denmark,Europe,5830190,151,9821
2020-05-06,denmark,Europe,5830190,117,9938
2020-05-07,denmark,Europe,5830190,145,10083
2020-05-08,denmark,Europe,5830190,135,10218
2020-05-09,denmark,Europe,5830190,101,10319
2020-05-10,denmark,Europe,5830190,110,10429
2020-05-11,denmark,Europe,5830190,84,10513
2020-05-12,denmark,Europe,5830190,78,10591
2020-05-13,denmark,Europe,5830190,76,10667
2020-05-14,denmark,Europe,5830190,46,10713
2020-05-15,denmark,Europe,5830190,78,10791
2020-05-16,denmark,Europe,5830190,67,10858
2020-05-17,denmark,Europe,5830190,69,10927
2020-05-18,denmark,Europe,5830190,41,10968
2020-05-19,denmark,Europe,5830190,76,11044
2020-05-20,denmark,Europe,5830190,73,11117
2020-05-21,denmark,Europe,5830190,65,11182
2020-05-22,denmark,Europe,5830190,48,11230
2020-05-23,denmark,Europe,5830190,59,11289
2020-05-24,denmark,Europe,5830190,71,11360
2020-05-25,denmark,Europe,5830190,27,11387
2020-05-26,denmark,Europe,5830190,41,11428
2020-05-27,denmark,Europe,5830190,52,11480
2020-05-28,denmark,Europe,5830190,32,11512
2020-05-29,denmark,Europe,5830190,81,11593
2020-05-30,denmark,Europe,5830190,40,11633
2020-05-31,denmark,Europe,5830190,36,11669
2020-06-01,denmark,Europe,5830190,30,11699
2020-06-02,denmark,Europe,5830190,35,11734
2020-06-03,denmark,Europe,5830190,37,11771
2020-06-04,denmark,Europe,5830190,40,11811
2020-06-05,denmark,Europe,5830190,64,11875
2020-06-06,denmark,Europe,5830190,49,11924
2020-06-07,denmark,Europe,5830190,24,11948
2020-06-08,denmark,Europe,5830190,14,11962
2020-06-09,denmark,Europe,5830190,39,12001
2020-06-10,denmark,Europe,5830190,15,12016
2020-06-11,denmark,Europe,5830190,19,12035
2020-06-12,denmark,Europe,5830190,64,12099
2020-06-13,denmark,Europe,5830190,40,12139
2020-06-14,denmark,Europe,5830190,54,12193
2020-06-15,denmark,Europe,5830190,24,12217
2020-06-16,denmark,Europe,5830190,33,12250
2020-06-17,denmark,Europe,5830190,44,12294
2020-06-18,denmark,Europe,5830190,50,12344
2020-06-19,denmark,Europe,5830190,47,12391
2020-06-20,denmark,Europe,5830190,0,12391
2020-06-21,denmark,Europe,5830190,0,12391
2020-06-22,denmark,Europe,5830190,136,12527
2020-06-23,denmark,Europe,5830190,34,12561
2020-06-24,denmark,Europe,5830190,54,12615
2020-06-25,denmark,Europe,5830190,21,12636
2020-06-26,denmark,Europe,5830190,39,12675
2020-06-27,denmark,Europe,5830190,0,12675
2020-06-28,denmark,Europe,5830190,0,12675
2020-06-29,denmark,Europe,5830190,76,12751
2020-06-30,denmark,Europe,5830190,17,12768
2020-07-01,denmark,Europe,5830190,26,12794
2020-07-02,denmark,Europe,5830190,21,12815
2020-07-03,denmark,Europe,5830190,17,12832
2020-07-04,denmark,Europe,5830190,0,12832
2020-07-05,denmark,Europe,5830190,0,12832
2020-07-06,denmark,Europe,5830190,46,12878
2020-07-07,denmark,Europe,5830190,10,12888
2020-07-08,denmark,Europe,5830190,12,12900
2020-07-09,denmark,Europe,5830190,16,12916
2020-07-10,denmark,Europe,5830190,30,12946
2020-07-11,denmark,Europe,5830190,0,12946
2020-07-12,denmark,Europe,5830190,0,12946
2020-07-13,denmark,Europe,5830190,91,13037
2020-07-14,denmark,Europe,5830190,24,13061
2020-07-15,denmark,Europe,5830190,31,13092
2020-07-16,denmark,Europe,5830190,32,13124
2020-07-17,denmark,Europe,5830190,49,13173
2020-07-18,denmark,Europe,5830190,0,13173
2020-07-19,denmark,Europe,5830190,0,13173
2020-07-20,denmark,Europe,5830190,89,13262
2020-07-21,denmark,Europe,5830190,40,13302
2020-07-22,denmark,Europe,5830190,46,13348
2020-07-23,denmark,Europe,5830190,42,13390
2020-07-24,denmark,Europe,5830190,48,13438
2020-07-25,denmark,Europe,5830190,0,13438
2020-07-26,denmark,Europe,5830190,0,13438
2020-07-27,denmark,Europe,5830190,109,13547
2020-07-28,denmark,Europe,5830190,30,13577
2020-07-29,denmark,Europe,5830190,57,13634
2020-07-30,denmark,Europe,5830190,91,13725
2020-07-31,denmark,Europe,5830190,64,13789
2020-08-01,denmark,Europe,5830190,0,13789
2020-08-02,denmark,Europe,5830190,0,13789
2020-08-03,denmark,Europe,5830190,207,13996
2020-08-04,denmark,Europe,5830190,77,14073
2020-08-05,denmark,Europe,5830190,112,14185
2020-08-06,denmark,Europe,5830190,121,14306
2020-08-07,denmark,Europe,5830190,136,14442
2020-08-08,denmark,Europe,5830190,0,14442
2020-08-09,denmark,Europe,5830190,0,14442
2020-08-10,denmark,Europe,5830190,373,14815
2020-08-11,denmark,Europe,5830190,144,14959
2020-08-12,denmark,Europe,5830190,111,15070
2020-08-13,denmark,Europe,5830190,144,15214
2020-08-14,denmark,Europe,5830190,165,15379
2020-08-15,denmark,Europe,5830190,104,15483
2020-08-16,denmark,Europe,5830190,134,15617
2020-08-17,denmark,Europe,5830190,123,15740
2020-08-18,denmark,Europe,5830190,115,15855
2020-08-19,denmark,Europe,5830190,85,15940
2020-08-20,denmark,Europe,5830190,116,16056
2020-08-21,denmark,Europe,5830190,71,16127
2020-08-22,denmark,Europe,5830190,112,16239
2020-08-23,denmark,Europe,5830190,78,16317
2020-08-24,denmark,Europe,5830190,80,16397
2020-08-25,denmark,Europe,5830190,83,16480
2020-08-26,denmark,Europe,5830190,57,16537
2020-08-27,denmark,Europe,5830190,90,16627
2020-08-28,denmark,Europe,5830190,73,16700
2020-08-29,denmark,Europe,5830190,79,16779
2020-08-30,denmark,Europe,5830190,112,16891
2020-08-31,denmark,Europe,5830190,94,16985
2020-09-01,denmark,Europe,5830190,99,17084
2020-09-02,denmark,Europe,5830190,111,17195
2020-09-03,denmark,Europe,5830190,179,17374
2020-09-04,denmark,Europe,5830190,173,17547
2020-09-05,denmark,Europe,5830190,189,17736
2020-09-06,denmark,Europe,5830190,147,17883
2020-09-07,denmark,Europe,5830190,230,18113
2020-09-08,denmark,Europe,5830190,243,18356
2020-09-09,denmark,Europe,5830190,251,18607
2020-09-10,denmark,Europe,5830190,317,18924
2020-09-11,denmark,Europe,5830190,292,19216
2020-09-12,denmark,Europe,5830190,341,19557
2020-09-13,denmark,Europe,5830190,333,19890
2020-09-14,denmark,Europe,5830190,347,20237
2020-09-15,denmark,Europe,5830190,334,20571
2020-09-16,denmark,Europe,5830190,369,20940
2020-09-17,denmark,Europe,5830190,453,21393
2020-09-18,denmark,Europe,5830190,454,21847
2020-09-19,denmark,Europe,5830190,589,22436
2020-09-20,denmark,Europe,5830190,469,22905
2020-09-21,denmark,Europe,5830190,418,23323
2020-09-22,denmark,Europe,5830190,476,23799
2020-09-23,denmark,Europe,5830190,558,24357
2020-09-24,denmark,Europe,5830190,559,24916
2020-09-25,denmark,Europe,5830190,678,25594
2020-09-26,denmark,Europe,5830190,619,26213
2020-09-27,denmark,Europe,5830190,424,26637
2020-09-28,denmark,Europe,5830190,435,27072
2020-09-29,denmark,Europe,5830190,392,27464
2020-09-30,denmark,Europe,5830190,534,27998
2020-10-01,denmark,Europe,5830190,398,28396
2020-10-02,denmark,Europe,5830190,536,28932
2020-10-03,denmark,Europe,5830190,370,29302
2020-10-04,denmark,Europe,5830190,378,29680
2020-10-05,denmark,Europe,5830190,377,30057
2020-10-06,denmark,Europe,5830190,322,30379
2020-10-07,denmark,Europe,5830190,331,30710
2020-10-08,denmark,Europe,5830190,446,31156
2020-10-09,denmark,Europe,5830190,482,31638
2020-10-10,denmark,Europe,5830190,444,32082
2020-10-11,denmark,Europe,5830190,340,32422
2020-10-12,denmark,Europe,5830190,389,32811
2020-10-13,denmark,Europe,5830190,290,33101
2020-10-14,denmark,Europe,5830190,492,33593
2020-10-15,denmark,Europe,5830190,430,34023
2020-10-16,denmark,Europe,5830190,418,34441
2020-10-17,denmark,Europe,5830190,500,34941
2020-10-18,denmark,Europe,5830190,451,35392
2020-10-19,denmark,Europe,5830190,452,35844
2020-10-20,denmark,Europe,5830190,529,36373
2020-10-21,denmark,Europe,5830190,630,37003
2020-10-22,denmark,Europe,5830190,760,37763
2020-10-23,denmark,Europe,5830190,859,38622
2020-10-24,denmark,Europe,5830190,789,39411
2020-10-25,denmark,Europe,5830190,945,40356
2020-10-26,denmark,Europe,5830190,1056,41412
2020-10-27,denmark,Europe,5830190,745,42157
2020-10-28,denmark,Europe,5830190,1017,43174
2020-10-29,denmark,Europe,5830190,860,44034
2020-10-30,denmark,Europe,5830190,1191,45225
2020-10-31,denmark,Europe,5830190,1126,46351
2020-11-01,denmark,Europe,5830190,948,47299
2020-11-02,denmark,Europe,5830190,942,48241
2020-11-03,denmark,Europe,5830190,1353,49594
2020-11-04,denmark,Europe,5830190,936,50530
2020-11-05,denmark,Europe,5830190,1223,51753
2020-11-06,denmark,Europe,5830190,1427,53180
2020-11-07,denmark,Europe,5830190,1050,54230
2020-11-08,denmark,Europe,5830190,891,55121
2020-11-09,denmark,Europe,5830190,771,55892
2020-11-10,denmark,Europe,5830190,1066,56958
2020-11-11,denmark,Europe,5830190,994,57952
2020-11-12,denmark,Europe,5830190,1011,58963
2020-11-13,denmark,Europe,5830190,1037,60000
2020-11-14,denmark,Europe,5830190,1078,61078
2020-11-15,denmark,Europe,5830190,1058,62136
2020-11-16,denmark,Europe,5830190,1195,63331
2020-11-17,denmark,Europe,5830190,1220,64551
2020-11-18,denmark,Europe,5830190,1257,65808
2020-11-19,denmark,Europe,5830190,1297,67105
2020-11-20,denmark,Europe,5830190,1257,68362
2020-11-21,denmark,Europe,5830190,1273,69635
2020-11-22,denmark,Europe,5830190,850,70485
2020-11-23,denmark,Europe,5830190,1169,71654
2020-11-24,denmark,Europe,5830190,1367,73021
2020-11-25,denmark,Europe,5830190,1183,74204
2020-11-26,denmark,Europe,5830190,1191,75395
2020-11-27,denmark,Europe,5830190,1323,76718
2020-11-28,denmark,Europe,5830190,1636,78354
2020-11-29,denmark,Europe,5830190,998,79352
2020-11-30,denmark,Europe,5830190,1129,80481
2020-12-01,denmark,Europe,5830190,1468,81949
2020-12-02,denmark,Europe,5830190,1586,83535
2020-12-03,denmark,Europe,5830190,1605,85140
2020-12-04,denmark,Europe,5830190,1603,86743
2020-12-05,denmark,Europe,5830190,2115,88858
2020-12-06,denmark,Europe,5830190,1745,90603
2020-12-07,denmark,Europe,5830190,2046,92649
2020-12-08,denmark,Europe,5830190,2150,94799
2020-12-09,denmark,Europe,5830190,2558,97357
2020-12-10,denmark,Europe,5830190,3132,100489
2020-12-11,denmark,Europe,5830190,3075,103564
2020-12-12,denmark,Europe,5830190,3552,107116
2020-12-13,denmark,Europe,5830190,2642,109758
2020-12-14,denmark,Europe,5830190,3337,113095
2020-12-15,denmark,Europe,5830190,2992,116087
2020-12-16,denmark,Europe,5830190,3692,119779
2020-12-17,denmark,Europe,5830190,4034,123813
2020-12-18,denmark,Europe,5830190,4508,128321
2020-12-19,denmark,Europe,5830190,3285,131606
2020-12-20,denmark,Europe,5830190,2828,134434
2020-12-21,denmark,Europe,5830190,3198,137632
2020-12-22,denmark,Europe,5830190,2543,140175
2020-12-23,denmark,Europe,5830190,3297,143472
2020-12-24,denmark,Europe,5830190,2869,146341
2020-12-25,denmark,Europe,5830190,2992,149333
2020-12-26,denmark,Europe,5830190,1834,151167
2020-12-27,denmark,Europe,5830190,2180,153347
2020-12-28,denmark,Europe,5830190,2479,155826
2020-12-29,denmark,Europe,5830190,2621,158447
2020-12-30,denmark,Europe,5830190,2783,161230
2020-12-31,denmark,Europe,5830190,2249,163479
2021-01-01,denmark,Europe,5830190,2451,165930
2021-01-02,denmark,Europe,5830190,1611,167541
2021-01-03,denmark,Europe,5830190,1170,168711
2021-01-04,denmark,Europe,5830190,2076,170787
2021-01-05,denmark,Europe,5830190,1992,172779
2021-01-06,denmark,Europe,5830190,2216,174995
2021-01-07,denmark,Europe,5830190,1842,176837
2021-01-08,denmark,Europe,5830190,1660,178497
2021-01-09,denmark,Europe,5830190,1743,180240
2021-01-10,denmark,Europe,5830190,1246,181486
2021-01-11,denmark,Europe,5830190,1239,182725
2021-01-12,denmark,Europe,5830190,1076,183801
2021-01-13,denmark,Europe,5830190,1358,185159
2021-01-14,denmark,Europe,5830190,1502,186661
2021-01-15,denmark,Europe,5830190,659,187320
2021-01-16,denmark,Europe,5830190,879,188199
2021-01-17,denmark,Europe,5830190,889,189088
2021-01-18,denmark,Europe,5830190,807,189895
2021-01-19,denmark,Europe,5830190,724,190619
2021-01-20,denmark,Europe,5830190,886,191505
2021-01-21,denmark,Europe,5830190,760,192265
2021-01-22,denmark,Europe,5830190,773,193038
2021-01-23,denmark,Europe,5830190,879,193917
2021-01-24,denmark,Europe,5830190,754,194671
2021-01-25,denmark,Europe,5830190,625,195296
2021-01-26,denmark,Europe,5830190,652,195948
2021-01-27,denmark,Europe,5830190,592,196540
2021-01-28,denmark,Europe,5830190,668,197208
2021-01-29,denmark,Europe,5830190,456,197664
2021-01-30,denmark,Europe,5830190,431,198095
2021-01-31,denmark,Europe,5830190,377,198472
2021-02-01,denmark,Europe,5830190,488,198960
2021-02-02,denmark,Europe,5830190,397,199357
2021-02-03,denmark,Europe,5830190,425,199782
2021-02-04,denmark,Europe,5830190,553,200335
2021-02-05,denmark,Europe,5830190,438,200773
2021-02-06,denmark,Europe,5830190,413,201186
2021-02-07,denmark,Europe,5830190,435,201621
2021-02-08,denmark,Europe,5830190,430,202051
2021-02-09,denmark,Europe,5830190,366,202417
2021-02-10,denmark,Europe,5830190,470,202887
2021-02-11,denmark,Europe,5830190,478,203365
2021-02-12,denmark,Europe,5830190,428,203793
2021-02-13,denmark,Europe,5830190,274,204067
2021-02-14,denmark,Europe,5830190,295,204362
2021-02-15,denmark,Europe,5830190,437,204799
2021-02-16,denmark,Europe,5830190,384,205183
2021-02-17,denmark,Europe,5830190,414,205597
2021-02-18,denmark,Europe,5830190,468,206065
2021-02-19,denmark,Europe,5830190,552,206617
2021-02-20,denmark,Europe,5830190,464,207081
2021-02-21,denmark,Europe,5830190,496,207577
2021-02-22,denmark,Europe,5830190,450,208027
2021-02-23,denmark,Europe,5830190,529,208556
2021-02-24,denmark,Europe,5830190,523,209079
2021-02-25,denmark,Europe,5830190,603,209682
2021-02-26,denmark,Europe,5830190,530,210212
2021-02-27,denmark,Europe,5830190,520,210732
2021-02-28,denmark,Europe,5830190,463,211195
2021-03-01,denmark,Europe,5830190,497,211692
2021-03-02,denmark,Europe,5830190,532,212224
2021-03-03,denmark,Europe,5830190,574,212798
2021-03-04,denmark,Europe,5830190,520,213318
2021-03-05,denmark,Europe,5830190,614,213932
2021-03-06,denmark,Europe,5830190,394,214326
2021-03-07,denmark,Europe,5830190,513,214839
2021-03-08,denmark,Europe,5830190,425,215264
2021-03-09,denmark,Europe,5830190,527,215791
2021-03-10,denmark,Europe,5830190,2007,217798
2021-03-11,denmark,Europe,5830190,862,218660
2021-03-12,denmark,Europe,5830190,645,219305
2021-03-13,denmark,Europe,5830190,613,219918
2021-03-14,denmark,Europe,5830190,541,220459
2021-03-15,denmark,Europe,5830190,612,221071
2021-03-16,denmark,Europe,5830190,771,221842
2021-03-17,denmark,Europe,5830190,787,222629
2021-03-18,denmark,Europe,5830190,786,223415
2021-03-19,denmark,Europe,5830190,843,224258
2021-03-20,denmark,Europe,5830190,590,224848
2021-03-21,denmark,Europe,5830190,657,225505
2021-03-22,denmark,Europe,5830190,339,225844
2021-03-23,denmark,Europe,5830190,0,225844
2021-03-24,denmark,Europe,5830190,0,225844
2021-03-25,denmark,Europe,5830190,0,225844
2021-03-26,denmark,Europe,5830190,789,226633
2021-03-27,denmark,Europe,5830190,416,227049
2021-03-28,denmark,Europe,5830190,964,228013
2021-03-29,denmark,Europe,5830190,679,228692
2021-03-30,denmark,Europe,5830190,1210,229902
2021-03-31,denmark,Europe,5830190,701,230603
2021-04-01,denmark,Europe,5830190,662,231265
2021-04-02,denmark,Europe,5830190,708,231973
2021-04-03,denmark,Europe,5830190,745,232718
2021-04-04,denmark,Europe,5830190,600,233318
2021-04-05,denmark,Europe,5830190,480,233798
2021-04-06,denmark,Europe,5830190,519,234317
2021-04-07,denmark,Europe,5830190,614,234931
2021-04-08,denmark,Europe,5830190,717,235648
2021-04-09,denmark,Europe,5830190,698,236346
2021-04-10,denmark,Europe,5830190,755,237101
2021-04-11,denmark,Europe,5830190,691,237792
2021-04-12,denmark,Europe,5830190,514,238306
2021-04-13,denmark,Europe,5830190,563,238869
2021-04-14,denmark,Europe,5830190,663,239532
2021-04-15,denmark,Europe,5830190,798,240330
2021-04-16,denmark,Europe,5830190,677,241007
2021-04-17,denmark,Europe,5830190,724,241731
2021-04-18,denmark,Europe,5830190,902,242633
2021-04-19,denmark,Europe,5830190,741,243374
2021-04-20,denmark,Europe,5830190,691,244065
2021-04-21,denmark,Europe,5830190,803,244868
2021-04-22,denmark,Europe,5830190,893,245761
2021-04-23,denmark,Europe,5830190,702,246463
2021-04-24,denmark,Europe,5830190,547,247010
2021-04-25,denmark,Europe,5830190,612,247622
2021-04-26,denmark,Europe,5830190,704,248326
2021-04-27,denmark,Europe,5830190,624,248950
2021-04-28,denmark,Europe,5830190,835,249785
2021-04-29,denmark,Europe,5830190,769,250554
2021-04-30,denmark,Europe,5830190,874,251428
2021-05-01,denmark,Europe,5830190,617,252045
2021-05-02,denmark,Europe,5830190,867,252912
2021-05-03,denmark,Europe,5830190,761,253673
2021-05-04,denmark,Europe,5830190,809,254482
2021-05-05,denmark,Europe,5830190,988,255470
2021-05-06,denmark,Europe,5830190,1012,256482
2021-05-07,denmark,Europe,5830190,1023,257505
2021-05-08,denmark,Europe,5830190,677,258182
2021-05-09,denmark,Europe,5830190,874,259056
2021-05-10,denmark,Europe,5830190,932,259988
2021-05-11,denmark,Europe,5830190,925,260913
2021-05-12,denmark,Europe,5830190,1246,262159
2021-05-13,denmark,Europe,5830190,1355,263514
2021-05-14,denmark,Europe,5830190,951,264465
2021-05-15,denmark,Europe,5830190,1074,265539
2021-05-16,denmark,Europe,5830190,964,266503
2021-05-17,denmark,Europe,5830190,836,267339
2021-05-18,denmark,Europe,5830190,916,268255
2021-05-19,denmark,Europe,5830190,1088,269343
2021-05-20,denmark,Europe,5830190,1214,270557
2021-05-21,denmark,Europe,5830190,1351,271908
2021-05-22,denmark,Europe,5830190,751,272659
2021-05-23,denmark,Europe,5830190,835,273494
2021-05-24,denmark,Europe,5830190,919,274413
2021-05-25,denmark,Europe,5830190,794,275207
2021-05-26,denmark,Europe,5830190,1073,276280
2021-05-27,denmark,Europe,5830190,1119,277399
2021-05-28,denmark,Europe,5830190,997,278396
2021-05-29,denmark,Europe,5830190,1038,279434
2021-05-30,denmark,Europe,5830190,949,280383
2021-05-31,denmark,Europe,5830190,844,281227
2021-06-01,denmark,Europe,5830190,908,282135
2021-06-02,denmark,Europe,5830190,954,283089
2021-06-03,denmark,Europe,5830190,1028,284117
2021-06-04,denmark,Europe,5830190,927,285044
2021-06-05,denmark,Europe,5830190,592,285636
2021-06-06,denmark,Europe,5830190,853,286489
2021-06-07,denmark,Europe,5830190,459,286948
2021-06-08,denmark,Europe,5830190,377,287325
2021-06-09,denmark,Europe,5830190,904,288229
2021-06-10,denmark,Europe,5830190,475,288704
2021-06-11,denmark,Europe,5830190,418,289122
2021-06-12,denmark,Europe,5830190,437,289559
2021-06-13,denmark,Europe,5830190,315,289874
2021-06-14,denmark,Europe,5830190,237,290111
2021-06-15,denmark,Europe,5830190,222,290333
2021-06-16,denmark,Europe,5830190,353,290686
2021-06-17,denmark,Europe,5830190,331,291017
2021-06-18,denmark,Europe,5830190,203,291220
2021-06-19,denmark,Europe,5830190,243,291463
2021-06-20,denmark,Europe,5830190,189,291652
2021-06-21,denmark,Europe,5830190,149,291801
2021-06-22,denmark,Europe,5830190,155,291956
2021-06-23,denmark,Europe,5830190,223,292179
2021-06-24,denmark,Europe,5830190,173,292352
2021-06-25,denmark,Europe,5830190,222,292574
2021-06-26,denmark,Europe,5830190,195,292769
2021-06-27,denmark,Europe,5830190,174,292943
2021-06-28,denmark,Europe,5830190,151,293094
2021-06-29,denmark,Europe,5830190,243,293337
2021-06-30,denmark,Europe,5830190,340,293677
2021-07-01,denmark,Europe,5830190,475,294152
2021-07-02,denmark,Europe,5830190,326,294478
2021-07-03,denmark,Europe,5830190,447,294925
2021-07-04,denmark,Europe,5830190,392,295317
2021-07-05,denmark,Europe,5830190,337,295654
2021-07-06,denmark,Europe,5830190,542,296196
2021-07-07,denmark,Europe,5830190,689,296885
2021-07-08,denmark,Europe,5830190,658,297543
2021-07-09,denmark,Europe,5830190,551,298094
2021-07-10,denmark,Europe,5830190,520,298614
2021-07-11,denmark,Europe,5830190,609,299223
2021-07-12,denmark,Europe,5830190,848,300071
2021-07-13,denmark,Europe,5830190,1055,301126
2021-07-14,denmark,Europe,5830190,1202,302328
2021-07-15,denmark,Europe,5830190,1141,303469
2021-07-16,denmark,Europe,5830190,960,304429
2021-07-17,denmark,Europe,5830190,1030,305459
2021-07-18,denmark,Europe,5830190,641,306100
2021-07-19,denmark,Europe,5830190,844,306944
2021-07-20,denmark,Europe,5830190,820,307764
2021-07-21,denmark,Europe,5830190,851,308615
2021-07-22,denmark,Europe,5830190,805,309420
2021-07-23,denmark,Europe,5830190,707,310127
2021-07-24,denmark,Europe,5830190,749,310876
2021-07-25,denmark,Europe,5830190,644,311520
2021-07-26,denmark,Europe,5830190,772,312292
2021-07-27,denmark,Europe,5830190,559,312851
2021-07-28,denmark,Europe,5830190,1284,314135
2021-07-29,denmark,Europe,5830190,848,314983
2021-07-30,denmark,Europe,5830190,1085,316068
2021-07-31,denmark,Europe,5830190,739,316807
2021-08-01,denmark,Europe,5830190,893,317700
2021-08-02,denmark,Europe,5830190,785,318485
2021-08-03,denmark,Europe,5830190,810,319295
2021-08-04,denmark,Europe,5830190,927,320222
2021-08-05,denmark,Europe,5830190,932,321154
2021-08-06,denmark,Europe,5830190,865,322019
2021-08-07,denmark,Europe,5830190,946,322965
2021-08-08,denmark,Europe,5830190,821,323786
2021-08-09,denmark,Europe,5830190,935,324721
2021-08-10,denmark,Europe,5830190,1004,325725
2021-08-11,denmark,Europe,5830190,1162,326887
2021-08-12,denmark,Europe,5830190,1085,327972
2021-08-13,denmark,Europe,5830190,1038,329010
2021-08-14,denmark,Europe,5830190,917,329927
2021-08-15,denmark,Europe,5830190,850,330777
2021-08-16,denmark,Europe,5830190,959,331736
2021-08-17,denmark,Europe,5830190,886,332622
2021-08-18,denmark,Europe,5830190,1193,333815
2021-08-19,denmark,Europe,5830190,984,334799
2021-08-20,denmark,Europe,5830190,923,335722
2021-08-21,denmark,Europe,5830190,1024,336746
2021-08-22,denmark,Europe,5830190,720,337466
2021-08-23,denmark,Europe,5830190,774,338240
2021-08-24,denmark,Europe,5830190,1340,339580
2021-08-25,denmark,Europe,5830190,987,340567
2021-08-26,denmark,Europe,5830190,982,341549
2021-08-27,denmark,Europe,5830190,925,342474
2021-08-28,denmark,Europe,5830190,877,343351
2021-08-29,denmark,Europe,5830190,737,344088
2021-08-30,denmark,Europe,5830190,762,344850
2021-08-31,denmark,Europe,5830190,843,345693
2021-09-01,denmark,Europe,5830190,825,346518
2021-09-02,denmark,Europe,5830190,694,347212
2021-09-03,denmark,Europe,5830190,697,347909
2021-09-04,denmark,Europe,5830190,438,348347
2021-09-05,denmark,Europe,5830190,632,348979
2021-09-06,denmark,Europe,5830190,461,349440
2021-09-07,denmark,Europe,5830190,451,349891
2021-09-08,denmark,Europe,5830190,514,350405
2021-09-09,denmark,Europe,5830190,591,350996
2021-09-10,denmark,Europe,5830190,557,351553
2021-09-11,denmark,Europe,5830190,386,351939
2021-09-12,denmark,Europe,5830190,434,352373
2021-09-13,denmark,Europe,5830190,263,352636
2021-09-14,denmark,Europe,5830190,425,353061
2021-09-15,denmark,Europe,5830190,370,353431
2021-09-16,denmark,Europe,5830190,313,353744
2021-09-17,denmark,Europe,5830190,324,354068
2021-09-18,denmark,Europe,5830190,325,354393
2021-09-19,denmark,Europe,5830190,252,354645
2021-09-20,denmark,Europe,5830190,268,354913
2021-09-21,denmark,Europe,5830190,344,355257
2021-09-22,denmark,Europe,5830190,346,355603
2021-09-23,denmark,Europe,5830190,341,355944
2021-09-24,denmark,Europe,5830190,382,356326
2021-09-25,denmark,Europe,5830190,358,356684
2021-09-26,denmark,Europe,5830190,353,357037
2021-09-27,denmark,Europe,5830190,333,357370
2021-09-28,denmark,Europe,5830190,457,357827
2021-09-29,denmark,Europe,5830190,542,358369
2021-09-30,denmark,Europe,5830190,427,358796
2021-10-01,denmark,Europe,5830190,441,359237
2021-10-02,denmark,Europe,5830190,426,359663
2021-10-03,denmark,Europe,5830190,368,360031
2021-10-04,denmark,Europe,5830190,380,360411
2021-10-05,denmark,Europe,5830190,477,360888
2021-10-06,denmark,Europe,5830190,573,361461
2021-10-07,denmark,Europe,5830190,607,362068
2021-10-08,denmark,Europe,5830190,670,362738
2021-10-09,denmark,Europe,5830190,618,363356
2021-10-10,denmark,Europe,5830190,544,363900
2021-10-11,denmark,Europe,5830190,564,364464
2021-10-12,denmark,Europe,5830190,587,365051
2021-10-13,denmark,Europe,5830190,789,365840
2021-10-14,denmark,Europe,5830190,767,366607
2021-10-15,denmark,Europe,5830190,700,367307
2021-10-16,denmark,Europe,5830190,753,368060
2021-10-17,denmark,Europe,5830190,591,368651
2021-10-18,denmark,Europe,5830190,752,369403
2021-10-19,denmark,Europe,5830190,756,370159
2021-10-20,denmark,Europe,5830190,1127,371286
2021-10-21,denmark,Europe,5830190,1247,372533
2021-10-22,denmark,Europe,5830190,1270,373803
2021-10-23,denmark,Europe,5830190,1262,375065
2021-10-24,denmark,Europe,5830190,1349,376414
2021-10-25,denmark,Europe,5830190,1411,377825
2021-10-26,denmark,Europe,5830190,1253,379078
2021-10-27,denmark,Europe,5830190,1871,380949
2021-10-28,denmark,Europe,5830190,1847,382796
2021-10-29,denmark,Europe,5830190,1784,384580
2021-10-30,denmark,Europe,5830190,1671,386251
2021-10-31,denmark,Europe,5830190,1532,387783
2021-11-01,denmark,Europe,5830190,1457,389240
2021-11-02,denmark,Europe,5830190,1981,391221
2021-11-03,denmark,Europe,5830190,1978,393199
2021-11-04,denmark,Europe,5830190,2598,395797
2021-11-05,denmark,Europe,5830190,2251,398048
2021-11-06,denmark,Europe,5830190,2097,400145
2021-11-07,denmark,Europe,5830190,2416,402561
2021-11-08,denmark,Europe,5830190,2294,404855
2021-11-09,denmark,Europe,5830190,2562,407417
2021-11-10,denmark,Europe,5830190,3017,410434
2021-11-11,denmark,Europe,5830190,2132,412566
2021-11-12,denmark,Europe,5830190,4585,417151
2021-11-13,denmark,Europe,5830190,2948,420099
2021-11-14,denmark,Europe,5830190,3223,423322
2021-11-15,denmark,Europe,5830190,3670,426992
2021-11-16,denmark,Europe,5830190,3899,430891
2021-11-17,denmark,Europe,5830190,3907,434798
2021-11-18,denmark,Europe,5830190,4013,438811
2021-11-19,denmark,Europe,5830190,4070,442881
2021-11-20,denmark,Europe,5830190,3795,446676
2021-11-21,denmark,Europe,5830190,3415,450091
2021-11-22,denmark,Europe,5830190,3711,453802
2021-11-23,denmark,Europe,5830190,4199,458001
2021-11-24,denmark,Europe,5830190,4426,462427
2021-11-25,denmark,Europe,5830190,4390,466817
2021-11-26,denmark,Europe,5830190,4076,470893
2021-11-27,denmark,Europe,5830190,3744,474637
2021-11-28,denmark,Europe,5830190,4290,478927
2021-11-29,denmark,Europe,5830190,4326,483253
2021-11-30,denmark,Europe,5830190,4148,487401
2021-12-01,denmark,Europe,5830190,5120,492521
2021-12-02,denmark,Europe,5830190,4680,497201
2021-12-03,denmark,Europe,5830190,4559,501760
2021-12-04,denmark,Europe,5830190,4325,506085
2021-12-05,denmark,Europe,5830190,3026,509111
2021-12-06,denmark,Europe,5830190,7146,516257
2021-12-07,denmark,Europe,5830190,6324,522581
2021-12-08,denmark,Europe,5830190,6629,529210
2021-12-09,denmark,Europe,5830190,6985,536195
2021-12-10,denmark,Europe,5830190,6599,542794
2021-12-11,denmark,Europe,5830190,5606,548400
2021-12-12,denmark,Europe,5830190,5989,554389
2021-12-13,denmark,Europe,5830190,7799,562188
2021-12-14,denmark,Europe,5830190,8314,570502
2021-12-15,denmark,Europe,5830190,8773,579275
2021-12-16,denmark,Europe,5830190,9999,589274
2021-12-17,denmark,Europe,5830190,11194,600468
2021-12-18,denmark,Europe,5830190,8594,609062
2021-12-19,denmark,Europe,5830190,8212,617274
2021-12-20,denmark,Europe,5830190,10082,627356
2021-12-21,denmark,Europe,5830190,13057,640413
2021-12-22,denmark,Europe,5830190,12855,653268
2021-12-23,denmark,Europe,5830190,11874,665142
2021-12-24,denmark,Europe,5830190,10702,675844
2021-12-25,denmark,Europe,5830190,9564,685408
2021-12-26,denmark,Europe,5830190,14200,699608
2021-12-27,denmark,Europe,5830190,15525,715133
2021-12-28,denmark,Europe,5830190,12330,727463
2021-12-29,denmark,Europe,5830190,22023,749486
2021-12-30,denmark,Europe,5830190,20280,769766
2021-12-31,denmark,Europe,5830190,17605,787371
2022-01-01,denmark,Europe,5830190,19836,807207
2021-08-22,dominica,North America,72319,16,1339
2021-08-23,dominica,North America,72319,0,1339
2021-08-24,dominica,North America,72319,0,1339
2021-08-25,dominica,North America,72319,0,1339
2021-08-26,dominica,North America,72319,0,1339
2021-08-27,dominica,North America,72319,0,1339
2021-08-28,dominica,North America,72319,299,1638
2021-08-29,dominica,North America,72319,0,1638
2021-08-30,dominica,North America,72319,0,1638
2021-08-31,dominica,North America,72319,0,1638
2021-09-01,dominica,North America,72319,0,1638
2021-09-02,dominica,North America,72319,194,1832
2021-09-03,dominica,North America,72319,0,1832
2021-09-04,dominica,North America,72319,164,1996
2021-09-05,dominica,North America,72319,0,1996
2021-09-06,dominica,North America,72319,2,1998
2021-09-07,dominica,North America,72319,0,1998
2021-09-08,dominica,North America,72319,177,2175
2021-09-09,dominica,North America,72319,105,2280
2021-09-10,dominica,North America,72319,110,2390
2021-09-11,dominica,North America,72319,108,2498
2021-09-12,dominica,North America,72319,0,2498
2021-09-13,dominica,North America,72319,0,2498
2021-09-14,dominica,North America,72319,136,2634
2021-09-15,dominica,North America,72319,64,2698
2021-09-16,dominica,North America,72319,60,2758
2021-09-17,dominica,North America,72319,0,2758
2021-09-18,dominica,North America,72319,0,2758
2021-09-19,dominica,North America,72319,134,2892
2021-09-20,dominica,North America,72319,16,2908
2021-09-21,dominica,North America,72319,0,2908
2021-09-22,dominica,North America,72319,226,3134
2021-09-23,dominica,North America,72319,63,3197
2021-09-24,dominica,North America,72319,0,3197
2021-09-25,dominica,North America,72319,0,3197
2021-09-26,dominica,North America,72319,96,3293
2021-09-27,dominica,North America,72319,0,3293
2021-09-28,dominica,North America,72319,0,3293
2021-09-29,dominica,North America,72319,0,3293
2021-09-30,dominica,North America,72319,188,3481
2021-10-01,dominica,North America,72319,74,3555
2021-10-02,dominica,North America,72319,47,3602
2021-10-03,dominica,North America,72319,71,3673
2021-10-04,dominica,North America,72319,26,3699
2021-10-05,dominica,North America,72319,87,3786
2021-10-06,dominica,North America,72319,58,3844
2021-10-07,dominica,North America,72319,49,3893
2021-10-08,dominica,North America,72319,55,3948
2021-10-09,dominica,North America,72319,0,3948
2021-10-10,dominica,North America,72319,58,4006
2021-10-11,dominica,North America,72319,14,4020
2021-10-12,dominica,North America,72319,66,4086
2021-10-13,dominica,North America,72319,27,4113
2021-10-14,dominica,North America,72319,40,4153
2021-10-15,dominica,North America,72319,0,4153
2021-10-16,dominica,North America,72319,0,4153
2021-10-17,dominica,North America,72319,0,4153
2021-10-18,dominica,North America,72319,0,4153
2021-10-19,dominica,North America,72319,213,4366
2021-10-20,dominica,North America,72319,46,4412
2021-10-21,dominica,North America,72319,53,4465
2021-10-22,dominica,North America,72319,43,4508
2021-10-23,dominica,North America,72319,0,4508
2021-10-24,dominica,North America,72319,0,4508
2021-10-25,dominica,North America,72319,66,4574
2021-10-26,dominica,North America,72319,85,4659
2021-10-27,dominica,North America,72319,32,4691
2021-10-28,dominica,North America,72319,51,4742
2021-10-29,dominica,North America,72319,41,4783
2021-10-30,dominica,North America,72319,0,4783
2021-10-31,dominica,North America,72319,40,4823
2021-11-01,dominica,North America,72319,0,4823
2021-11-02,dominica,North America,72319,0,4823
2021-11-03,dominica,North America,72319,0,4823
2021-11-04,dominica,North America,72319,138,4961
2021-11-05,dominica,North America,72319,0,4961
2021-11-06,dominica,North America,72319,0,4961
2021-11-07,dominica,North America,72319,0,4961
2021-11-08,dominica,North America,72319,109,5070
2021-11-09,dominica,North America,72319,78,5148
2021-11-10,dominica,North America,72319,28,5176
2021-11-11,dominica,North America,72319,59,5235
2021-11-12,dominica,North America,72319,0,5235
2021-11-13,dominica,North America,72319,0,5235
2021-11-14,dominica,North America,72319,101,5336
2021-11-15,dominica,North America,72319,0,5336
2021-11-16,dominica,North America,72319,105,5441
2021-11-17,dominica,North America,72319,0,5441
2021-11-18,dominica,North America,72319,109,5550
2021-11-19,dominica,North America,72319,39,5589
2021-11-20,dominica,North America,72319,53,5642
2021-11-21,dominica,North America,72319,0,5642
2021-11-22,dominica,North America,72319,0,5642
2021-11-23,dominica,North America,72319,0,5642
2021-11-24,dominica,North America,72319,0,5642
2021-11-25,dominica,North America,72319,177,5819
2021-11-26,dominica,North America,72319,0,5819
2021-11-27,dominica,North America,72319,0,5819
2021-11-28,dominica,North America,72319,136,5955
2021-11-29,dominica,North America,72319,0,5955
2021-11-30,dominica,North America,72319,73,6028
2021-12-01,dominica,North America,72319,0,6028
2020-02-20,egypt,Africa,105928386,0,1
2020-02-21,egypt,Africa,105928386,0,1
2020-02-22,egypt,Africa,105928386,0,1
2020-02-23,egypt,Africa,105928386,0,1
2020-02-24,egypt,Africa,105928386,0,1
2020-02-25,egypt,Africa,105928386,0,1
2020-02-26,egypt,Africa,105928386,0,1
2020-02-27,egypt,Africa,105928386,0,1
2020-02-28,egypt,Africa,105928386,0,1
2020-02-29,egypt,Africa,105928386,0,1
2020-03-01,egypt,Africa,105928386,1,2
2020-03-02,egypt,Africa,105928386,0,2
2020-03-03,egypt,Africa,105928386,0,2
2020-03-04,egypt,Africa,105928386,0,2
2020-03-05,egypt,Africa,105928386,1,3
2020-03-06,egypt,Africa,105928386,12,15
2020-03-07,egypt,Africa,105928386,33,48
2020-03-08,egypt,Africa,105928386,7,55
2020-03-09,egypt,Africa,105928386,4,59
2020-03-10,egypt,Africa,105928386,0,59
2020-03-11,egypt,Africa,105928386,8,67
2020-03-12,egypt,Africa,105928386,13,80
2020-03-13,egypt,Africa,105928386,13,93
2020-03-14,egypt,Africa,105928386,17,110
2020-03-15,egypt,Africa,105928386,16,126
2020-03-16,egypt,Africa,105928386,40,166
2020-03-17,egypt,Africa,105928386,30,196
2020-03-18,egypt,Africa,105928386,14,210
2020-03-19,egypt,Africa,105928386,46,256
2020-03-20,egypt,Africa,105928386,29,285
2020-03-21,egypt,Africa,105928386,9,294
2020-03-22,egypt,Africa,105928386,33,327
2020-04-01,el_salvador,North America,6547158,1,33
2020-04-02,el_salvador,North America,6547158,8,41
2020-04-03,el_salvador,North America,6547158,5,46
2020-04-04,el_salvador,North America,6547158,10,56
2020-04-05,el_salvador,North America,6547158,6,62
2020-04-06,el_salvador,North America,6547158,7,69
2020-04-07,el_salvador,North America,6547158,9,78
2020-04-08,el_salvador,North America,6547158,15,93
2020-04-09,el_salvador,North America,6547158,10,103
2020-04-10,el_salvador,North America,6547158,14,117
2020-04-11,el_salvador,North America,6547158,1,118
2020-04-12,el_salvador,North America,6547158,7,125
2020-04-13,el_salvador,North America,6547158,12,137
2020-04-14,el_salvador,North America,6547158,12,149
2020-04-15,el_salvador,North America,6547158,10,159
2020-04-16,el_salvador,North America,6547158,5,164
2020-04-17,el_salvador,North America,6547158,13,177
2020-04-18,el_salvador,North America,6547158,13,190
2020-04-19,el_salvador,North America,6547158,11,201
2020-04-20,el_salvador,North America,6547158,17,218
2020-04-21,el_salvador,North America,6547158,7,225
2020-04-22,el_salvador,North America,6547158,12,237
2020-04-23,el_salvador,North America,6547158,13,250
2020-04-24,el_salvador,North America,6547158,11,261
2020-04-25,el_salvador,North America,6547158,13,274
2020-04-26,el_salvador,North America,6547158,24,298
2020-04-27,el_salvador,North America,6547158,25,323
2020-04-28,el_salvador,North America,6547158,22,345
2020-04-29,el_salvador,North America,6547158,32,377
2020-04-30,el_salvador,North America,6547158,18,395
2020-05-01,el_salvador,North America,6547158,29,424
2020-05-02,el_salvador,North America,6547158,22,446
2020-05-03,el_salvador,North America,6547158,44,490
2020-05-04,el_salvador,North America,6547158,65,555
2020-05-05,el_salvador,North America,6547158,32,587
2020-05-06,el_salvador,North America,6547158,46,633
2020-05-07,el_salvador,North America,6547158,62,695
2020-05-08,el_salvador,North America,6547158,47,742
2020-05-09,el_salvador,North America,6547158,42,784
2020-05-10,el_salvador,North America,6547158,105,889
2020-05-11,el_salvador,North America,6547158,69,958
2020-05-12,el_salvador,North America,6547158,40,998
2020-05-13,el_salvador,North America,6547158,39,1037
2020-05-14,el_salvador,North America,6547158,75,1112
2020-05-15,el_salvador,North America,6547158,98,1210
2020-05-16,el_salvador,North America,6547158,55,1265
2020-05-17,el_salvador,North America,6547158,73,1338
2020-05-18,el_salvador,North America,6547158,75,1413
2020-05-19,el_salvador,North America,6547158,85,1498
2020-05-20,el_salvador,North America,6547158,73,1571
2020-05-21,el_salvador,North America,6547158,69,1640
2020-05-22,el_salvador,North America,6547158,85,1725
2020-05-23,el_salvador,North America,6547158,94,1819
2020-05-24,el_salvador,North America,6547158,96,1915
2020-05-25,el_salvador,North America,6547158,68,1983
2020-05-26,el_salvador,North America,6547158,59,2042
2020-05-27,el_salvador,North America,6547158,67,2109
2020-05-28,el_salvador,North America,6547158,85,2194
2020-05-29,el_salvador,North America,6547158,84,2278
2020-05-30,el_salvador,North America,6547158,117,2395
2020-05-31,el_salvador,North America,6547158,122,2517
2020-06-01,el_salvador,North America,6547158,65,2582
2020-06-02,el_salvador,North America,6547158,71,2653
2020-06-03,el_salvador,North America,6547158,52,2705
2020-06-04,el_salvador,North America,6547158,76,2781
2020-06-05,el_salvador,North America,6547158,68,2849
2020-06-06,el_salvador,North America,6547158,85,2934
2020-06-07,el_salvador,North America,6547158,81,3015
2020-06-08,el_salvador,North America,6547158,89,3104
2020-06-09,el_salvador,North America,6547158,87,3191
2020-06-10,el_salvador,North America,6547158,83,3274
2020-06-11,el_salvador,North America,6547158,99,3373
2020-06-12,el_salvador,North America,6547158,108,3481
2020-06-13,el_salvador,North America,6547158,122,3603
2020-06-14,el_salvador,North America,6547158,117,3720
2020-06-15,el_salvador,North America,6547158,106,3826
2020-06-16,el_salvador,North America,6547158,115,3941
2020-06-17,el_salvador,North America,6547158,125,4066
2020-06-18,el_salvador,North America,6547158,134,4200
2020-06-19,el_salvador,North America,6547158,129,4329
2020-06-20,el_salvador,North America,6547158,146,4475
2020-06-21,el_salvador,North America,6547158,151,4626
2020-06-22,el_salvador,North America,6547158,182,4808
2020-06-23,el_salvador,North America,6547158,165,4973
2020-06-24,el_salvador,North America,6547158,177,5150
2020-06-25,el_salvador,North America,6547158,186,5336
2020-06-26,el_salvador,North America,6547158,181,5517
2020-06-27,el_salvador,North America,6547158,210,5727
2020-06-28,el_salvador,North America,6547158,207,5934
2020-06-29,el_salvador,North America,6547158,239,6173
2020-06-30,el_salvador,North America,6547158,265,6438
2020-07-01,el_salvador,North America,6547158,298,6736
2020-07-02,el_salvador,North America,6547158,264,7000
2020-07-03,el_salvador,North America,6547158,267,7267
2020-07-04,el_salvador,North America,6547158,240,7507
2020-07-05,el_salvador,North America,6547158,270,7777
2020-07-06,el_salvador,North America,6547158,250,8027
2020-07-07,el_salvador,North America,6547158,280,8307
2020-07-08,el_salvador,North America,6547158,259,8566
2020-07-09,el_salvador,North America,6547158,278,8844
2020-07-10,el_salvador,North America,6547158,298,9142
2020-07-11,el_salvador,North America,6547158,249,9391
2020-07-12,el_salvador,North America,6547158,283,9674
2020-07-13,el_salvador,North America,6547158,304,9978
2020-07-14,el_salvador,North America,6547158,325,10303
2020-07-15,el_salvador,North America,6547158,342,10645
2020-07-16,el_salvador,North America,6547158,312,10957
2020-07-17,el_salvador,North America,6547158,250,11207
2020-07-18,el_salvador,North America,6547158,301,11508
2020-07-19,el_salvador,North America,6547158,338,11846
2020-07-20,el_salvador,North America,6547158,361,12207
2020-07-21,el_salvador,North America,6547158,375,12582
2020-07-22,el_salvador,North America,6547158,393,12975
2020-07-23,el_salvador,North America,6547158,402,13377
2020-07-24,el_salvador,North America,6547158,415,13792
2020-07-25,el_salvador,North America,6547158,429,14221
2020-07-26,el_salvador,North America,6547158,409,14630
2020-07-27,el_salvador,North America,6547158,405,15035
2020-07-28,el_salvador,North America,6547158,411,15446
2020-07-29,el_salvador,North America,6547158,395,15841
2020-07-30,el_salvador,North America,6547158,389,16230
2020-07-31,el_salvador,North America,6547158,402,16632
2020-08-01,el_salvador,North America,6547158,418,17050
2020-08-02,el_salvador,North America,6547158,398,17448
2020-08-03,el_salvador,North America,6547158,395,17843
2020-08-04,el_salvador,North America,6547158,419,18262
2020-08-05,el_salvador,North America,6547158,439,18701
2020-08-06,el_salvador,North America,6547158,425,19126
2020-08-07,el_salvador,North America,6547158,418,19544
2020-08-08,el_salvador,North America,6547158,434,19978
2020-08-09,el_salvador,North America,6547158,445,20423
2020-08-10,el_salvador,North America,6547158,449,20872
2020-08-11,el_salvador,North America,6547158,397,21269
2020-08-12,el_salvador,North America,6547158,375,21644
2020-08-13,el_salvador,North America,6547158,349,21993
2020-08-14,el_salvador,North America,6547158,321,22314
2020-08-15,el_salvador,North America,6547158,305,22619
2020-08-16,el_salvador,North America,6547158,293,22912
2020-08-17,el_salvador,North America,6547158,281,23193
2020-08-18,el_salvador,North America,6547158,269,23462
2020-08-19,el_salvador,North America,6547158,255,23717
2020-08-20,el_salvador,North America,6547158,247,23964
2020-08-21,el_salvador,North America,6547158,236,24200
2020-08-22,el_salvador,North America,6547158,220,24420
2020-08-23,el_salvador,North America,6547158,202,24622
2020-08-24,el_salvador,North America,6547158,189,24811
2020-08-25,el_salvador,North America,6547158,175,24986
2020-08-26,el_salvador,North America,6547158,154,25140
2020-08-27,el_salvador,North America,6547158,144,25284
2020-08-28,el_salvador,North America,6547158,131,25415
2020-08-29,el_salvador,North America,6547158,122,25537
2020-08-30,el_salvador,North America,6547158,98,25635
2020-08-31,el_salvador,North America,6547158,94,25729
2020-09-01,el_salvador,North America,6547158,91,25820
2020-09-02,el_salvador,North America,6547158,84,25904
2020-09-03,el_salvador,North America,6547158,96,26000
2020-09-04,el_salvador,North America,6547158,99,26099
2020-09-05,el_salvador,North America,6547158,107,26206
2020-09-06,el_salvador,North America,6547158,102,26308
2020-09-07,el_salvador,North America,6547158,105,26413
2020-09-08,el_salvador,North America,6547158,98,26511
2020-09-09,el_salvador,North America,6547158,91,26602
2020-09-10,el_salvador,North America,6547158,86,26688
2020-09-11,el_salvador,North America,6547158,85,26773
2020-09-12,el_salvador,North America,6547158,78,26851
2020-09-13,el_salvador,North America,6547158,77,26928
2020-09-14,el_salvador,North America,6547158,81,27009
2020-09-15,el_salvador,North America,6547158,79,27088
2020-09-16,el_salvador,North America,6547158,75,27163
2020-09-17,el_salvador,North America,6547158,86,27249
2020-09-18,el_salvador,North America,6547158,97,27346
2020-09-19,el_salvador,North America,6547158,82,27428
2020-09-20,el_salvador,North America,6547158,125,27553
2020-09-21,el_salvador,North America,6547158,245,27798
2020-09-22,el_salvador,North America,6547158,156,27954
2020-09-23,el_salvador,North America,6547158,0,27954
2020-09-24,el_salvador,North America,6547158,247,28201
2020-09-25,el_salvador,North America,6547158,214,28415
2020-09-26,el_salvador,North America,6547158,0,28415
2020-09-27,el_salvador,North America,6547158,215,28630
2020-09-28,el_salvador,North America,6547158,267,28897
2020-09-29,el_salvador,North America,6547158,84,28981
2020-09-30,el_salvador,North America,6547158,96,29077
2020-10-01,el_salvador,North America,6547158,98,29175
2020-10-02,el_salvador,North America,6547158,0,29175
2020-10-03,el_salvador,North America,6547158,183,29358
2020-10-04,el_salvador,North America,6547158,92,29450
2020-10-05,el_salvador,North America,6547158,89,29539
2020-10-06,el_salvador,North America,6547158,95,29634
2020-10-07,el_salvador,North America,6547158,103,29737
2020-10-08,el_salvador,North America,6547158,105,29842
2020-10-09,el_salvador,North America,6547158,109,29951
2020-10-10,el_salvador,North America,6547158,119,30070
2020-10-11,el_salvador,North America,6547158,126,30196
2020-10-12,el_salvador,North America,6547158,139,30335
2020-10-13,el_salvador,North America,6547158,145,30480
2020-10-14,el_salvador,North America,6547158,286,30766
2020-10-15,el_salvador,North America,6547158,295,31061
2020-10-16,el_salvador,North America,6547158,204,31265
2020-10-17,el_salvador,North America,6547158,191,31456
2020-10-18,el_salvador,North America,6547158,210,31666
2020-10-19,el_salvador,North America,6547158,160,31826
2020-10-20,el_salvador,North America,6547158,149,31975
2020-10-21,el_salvador,North America,6547158,145,32120
2020-10-22,el_salvador,North America,6547158,142,32262
2020-10-23,el_salvador,North America,6547158,159,32421
2020-10-24,el_salvador,North America,6547158,164,32585
2020-10-25,el_salvador,North America,6547158,167,32752
2020-10-26,el_salvador,North America,6547158,173,32925
2020-10-27,el_salvador,North America,6547158,165,33090
2020-10-28,el_salvador,North America,6547158,174,33264
2020-10-29,el_salvador,North America,6547158,181,33445
2020-10-30,el_salvador,North America,6547158,186,33631
2020-10-31,el_salvador,North America,6547158,195,33826
2020-11-01,el_salvador,North America,6547158,189,34015
2020-11-02,el_salvador,North America,6547158,199,34214
2020-11-03,el_salvador,North America,6547158,190,34404
2020-04-23,equatorial_guinea,Africa,1488778,0,209
2020-04-24,equatorial_guinea,Africa,1488778,5,214
2020-04-25,equatorial_guinea,Africa,1488778,44,258
2020-04-26,equatorial_guinea,Africa,1488778,0,258
2020-04-27,equatorial_guinea,Africa,1488778,0,258
2020-04-28,equatorial_guinea,Africa,1488778,57,315
2020-04-29,equatorial_guinea,Africa,1488778,0,315
2020-04-30,equatorial_guinea,Africa,1488778,0,315
2020-05-01,equatorial_guinea,Africa,1488778,0,315
2020-05-02,equatorial_guinea,Africa,1488778,0,315
2020-05-03,equatorial_guinea,Africa,1488778,0,315
2020-05-04,equatorial_guinea,Africa,1488778,0,315
2020-05-05,equatorial_guinea,Africa,1488778,0,315
2020-05-06,equatorial_guinea,Africa,1488778,124,439
2020-05-07,equatorial_guinea,Africa,1488778,0,439
2020-05-08,equatorial_guinea,Africa,1488778,0,439
2020-05-09,equatorial_guinea,Africa,1488778,0,439
2020-05-10,equatorial_guinea,Africa,1488778,0,439
2020-05-11,equatorial_guinea,Africa,1488778,0,439
2020-05-12,equatorial_guinea,Africa,1488778,0,439
2020-05-13,equatorial_guinea,Africa,1488778,83,522
2020-05-14,equatorial_guinea,Africa,1488778,61,583
2020-05-15,equatorial_guinea,Africa,1488778,11,594
2020-05-16,equatorial_guinea,Africa,1488778,0,594
2020-05-17,equatorial_guinea,Africa,1488778,0,594
2020-05-18,equatorial_guinea,Africa,1488778,125,719
2020-05-19,equatorial_guinea,Africa,1488778,106,825
2020-05-20,equatorial_guinea,Africa,1488778,65,890
2020-05-21,equatorial_guinea,Africa,1488778,13,903
2020-05-22,equatorial_guinea,Africa,1488778,57,960
2020-05-23,equatorial_guinea,Africa,1488778,0,960
2020-05-24,equatorial_guinea,Africa,1488778,0,960
2020-05-25,equatorial_guinea,Africa,1488778,83,1043
2020-05-26,equatorial_guinea,Africa,1488778,0,1043
2020-05-27,equatorial_guinea,Africa,1488778,0,1043
2020-05-28,equatorial_guinea,Africa,1488778,0,1043
2020-05-29,equatorial_guinea,Africa,1488778,263,1306
2020-05-30,equatorial_guinea,Africa,1488778,0,1306
2020-05-31,equatorial_guinea,Africa,1488778,0,1306
2020-06-01,equatorial_guinea,Africa,1488778,0,1306
2020-06-02,equatorial_guinea,Africa,1488778,0,1306
2020-06-03,equatorial_guinea,Africa,1488778,0,1306
2020-06-04,equatorial_guinea,Africa,1488778,0,1306
2020-06-05,equatorial_guinea,Africa,1488778,0,1306
2020-06-06,equatorial_guinea,Africa,1488778,0,1306
2020-06-07,equatorial_guinea,Africa,1488778,0,1306
2020-06-08,equatorial_guinea,Africa,1488778,0,1306
2020-06-09,equatorial_guinea,Africa,1488778,0,1306
2020-06-10,equatorial_guinea,Africa,1488778,0,1306
2020-06-11,equatorial_guinea,Africa,1488778,0,1306
2020-06-12,equatorial_guinea,Africa,1488778,0,1306
2020-06-13,equatorial_guinea,Africa,1488778,0,1306
2020-06-14,equatorial_guinea,Africa,1488778,0,1306
2020-06-15,equatorial_guinea,Africa,1488778,0,1306
2020-06-16,equatorial_guinea,Africa,1488778,0,1306
2020-06-17,equatorial_guinea,Africa,1488778,358,1664
2020-06-18,equatorial_guinea,Africa,1488778,0,1664
2020-06-19,equatorial_guinea,Africa,1488778,0,1664
2020-06-20,equatorial_guinea,Africa,1488778,0,1664
2020-06-21,equatorial_guinea,Africa,1488778,0,1664
2020-06-22,equatorial_guinea,Africa,1488778,0,1664
2020-06-23,equatorial_guinea,Africa,1488778,0,1664
2020-06-24,equatorial_guinea,Africa,1488778,0,1664
2020-06-25,equatorial_guinea,Africa,1488778,337,2001
2020-06-26,equatorial_guinea,Africa,1488778,0,2001
2020-06-27,equatorial_guinea,Africa,1488778,0,2001
2020-06-28,equatorial_guinea,Africa,1488778,0,2001
2020-06-29,equatorial_guinea,Africa,1488778,0,2001
2020-06-30,equatorial_guinea,Africa,1488778,0,2001
2020-07-01,equatorial_guinea,Africa,1488778,0,2001
2020-07-02,equatorial_guinea,Africa,1488778,0,2001
2020-07-03,equatorial_guinea,Africa,1488778,1070,3071
2020-07-04,equatorial_guinea,Africa,1488778,0,3071
2020-07-05,equatorial_guinea,Africa,1488778,0,3071
2020-07-06,equatorial_guinea,Africa,1488778,0,3071
2020-07-07,equatorial_guinea,Africa,1488778,0,3071
2020-07-08,equatorial_guinea,Africa,1488778,0,3071
2020-07-09,equatorial_guinea,Africa,1488778,0,3071
2020-07-10,equatorial_guinea,Africa,1488778,0,3071
2020-07-11,equatorial_guinea,Africa,1488778,0,3071
2020-07-12,equatorial_guinea,Africa,1488778,0,3071
2020-07-13,equatorial_guinea,Africa,1488778,0,3071
2020-07-14,equatorial_guinea,Africa,1488778,0,3071
2020-07-15,equatorial_guinea,Africa,1488778,0,3071
2020-07-16,equatorial_guinea,Africa,1488778,0,3071
2020-07-17,equatorial_guinea,Africa,1488778,0,3071
2020-07-18,equatorial_guinea,Africa,1488778,0,3071
2020-07-19,equatorial_guinea,Africa,1488778,0,3071
2020-07-20,equatorial_guinea,Africa,1488778,0,3071
2020-07-21,equatorial_guinea,Africa,1488778,0,3071
2020-07-22,equatorial_guinea,Africa,1488778,0,3071
2020-07-23,equatorial_guinea,Africa,1488778,0,3071
2020-07-24,equatorial_guinea,Africa,1488778,0,3071
2020-07-25,equatorial_guinea,Africa,1488778,0,3071
2020-07-26,equatorial_guinea,Africa,1488778,0,3071
2020-07-27,equatorial_guinea,Africa,1488778,0,3071
2020-07-28,equatorial_guinea,Africa,1488778,0,3071
2020-07-29,equatorial_guinea,Africa,1488778,0,3071
2020-07-30,equatorial_guinea,Africa,1488778,0,3071
2020-07-31,equatorial_guinea,Africa,1488778,1750,4821
2020-08-01,equatorial_guinea,Africa,1488778,0,4821
2020-08-02,equatorial_guinea,Africa,1488778,0,4821
2020-08-03,equatorial_guinea,Africa,1488778,0,4821
2020-08-04,equatorial_guinea,Africa,1488778,0,4821
2020-08-05,equatorial_guinea,Africa,1488778,0,4821
2020-08-06,equatorial_guinea,Africa,1488778,0,4821
2020-08-07,equatorial_guinea,Africa,1488778,0,4821
2020-08-08,equatorial_guinea,Africa,1488778,0,4821
2020-08-09,equatorial_guinea,Africa,1488778,0,4821
2020-08-10,equatorial_guinea,Africa,1488778,0,4821
2020-08-11,equatorial_guinea,Africa,1488778,0,4821
2020-08-12,equatorial_guinea,Africa,1488778,0,4821
2020-08-13,equatorial_guinea,Africa,1488778,0,4821
2020-08-14,equatorial_guinea,Africa,1488778,0,4821
2020-08-15,equatorial_guinea,Africa,1488778,0,4821
2020-08-16,equatorial_guinea,Africa,1488778,0,4821
2020-08-17,equatorial_guinea,Africa,1488778,0,4821
2020-08-18,equatorial_guinea,Africa,1488778,0,4821
2020-08-19,equatorial_guinea,Africa,1488778,71,4892
2020-08-20,equatorial_guinea,Africa,1488778,0,4892
2020-08-21,equatorial_guinea,Africa,1488778,34,4926
2020-08-22,equatorial_guinea,Africa,1488778,0,4926
2020-08-23,equatorial_guinea,Africa,1488778,0,4926
2020-08-24,equatorial_guinea,Africa,1488778,0,4926
2020-08-25,equatorial_guinea,Africa,1488778,0,4926
2020-08-26,equatorial_guinea,Africa,1488778,2,4928
2020-08-27,equatorial_guinea,Africa,1488778,0,4928
2020-08-28,equatorial_guinea,Africa,1488778,13,4941
2020-08-29,equatorial_guinea,Africa,1488778,0,4941
2020-08-30,equatorial_guinea,Africa,1488778,0,4941
2020-08-31,equatorial_guinea,Africa,1488778,0,4941
2020-09-01,equatorial_guinea,Africa,1488778,24,4965
2020-09-02,equatorial_guinea,Africa,1488778,0,4965
2020-09-03,equatorial_guinea,Africa,1488778,0,4965
2020-09-04,equatorial_guinea,Africa,1488778,7,4972
2020-09-05,equatorial_guinea,Africa,1488778,0,4972
2020-09-06,equatorial_guinea,Africa,1488778,0,4972
2020-09-07,equatorial_guinea,Africa,1488778,13,4985
2020-09-08,equatorial_guinea,Africa,1488778,0,4985
2020-09-09,equatorial_guinea,Africa,1488778,5,4990
2020-09-10,equatorial_guinea,Africa,1488778,0,4990
2020-09-11,equatorial_guinea,Africa,1488778,6,4996
2020-09-12,equatorial_guinea,Africa,1488778,0,4996
2020-09-13,equatorial_guinea,Africa,1488778,0,4996
2020-09-14,equatorial_guinea,Africa,1488778,4,5000
2020-09-15,equatorial_guinea,Africa,1488778,0,5000
2020-09-16,equatorial_guinea,Africa,1488778,0,5000
2020-09-17,equatorial_guinea,Africa,1488778,2,5002
2020-09-18,equatorial_guinea,Africa,1488778,0,5002
2020-09-19,equatorial_guinea,Africa,1488778,0,5002
2020-09-20,equatorial_guinea,Africa,1488778,0,5002
2020-09-21,equatorial_guinea,Africa,1488778,0,5002
2020-09-22,equatorial_guinea,Africa,1488778,16,5018
2020-09-23,equatorial_guinea,Africa,1488778,0,5018
2020-09-24,equatorial_guinea,Africa,1488778,0,5018
2020-09-25,equatorial_guinea,Africa,1488778,0,5018
2020-09-26,equatorial_guinea,Africa,1488778,10,5028
2020-09-27,equatorial_guinea,Africa,1488778,0,5028
2020-09-28,equatorial_guinea,Africa,1488778,0,5028
2020-09-29,equatorial_guinea,Africa,1488778,2,5030
2020-09-30,equatorial_guinea,Africa,1488778,0,5030
2020-10-01,equatorial_guinea,Africa,1488778,15,5045
2020-10-02,equatorial_guinea,Africa,1488778,0,5045
2020-10-03,equatorial_guinea,Africa,1488778,0,5045
2020-10-04,equatorial_guinea,Africa,1488778,0,5045
2020-10-05,equatorial_guinea,Africa,1488778,0,5045
2020-10-06,equatorial_guinea,Africa,1488778,7,5052
2020-10-07,equatorial_guinea,Africa,1488778,0,5052
2020-10-08,equatorial_guinea,Africa,1488778,10,5062
2020-10-09,equatorial_guinea,Africa,1488778,1,5063
2020-10-10,equatorial_guinea,Africa,1488778,0,5063
2020-10-11,equatorial_guinea,Africa,1488778,0,5063
2020-10-12,equatorial_guinea,Africa,1488778,3,5066
2020-10-13,equatorial_guinea,Africa,1488778,0,5066
2020-10-14,equatorial_guinea,Africa,1488778,2,5068
2020-10-15,equatorial_guinea,Africa,1488778,0,5068
2020-10-16,equatorial_guinea,Africa,1488778,0,5068
2020-10-17,equatorial_guinea,Africa,1488778,2,5070
2020-10-18,equatorial_guinea,Africa,1488778,0,5070
2020-10-19,equatorial_guinea,Africa,1488778,0,5070
2020-10-20,equatorial_guinea,Africa,1488778,4,5074
2020-10-21,equatorial_guinea,Africa,1488778,0,5074
2020-10-22,equatorial_guinea,Africa,1488778,0,5074
2020-10-23,equatorial_guinea,Africa,1488778,0,5074
2020-10-24,equatorial_guinea,Africa,1488778,5,5079
2020-10-25,equatorial_guinea,Africa,1488778,0,5079
2020-10-26,equatorial_guinea,Africa,1488778,0,5079
2020-10-27,equatorial_guinea,Africa,1488778,4,5083
2020-10-28,equatorial_guinea,Africa,1488778,0,5083
2020-10-29,equatorial_guinea,Africa,1488778,0,5083
2020-10-30,equatorial_guinea,Africa,1488778,0,5083
2020-10-31,equatorial_guinea,Africa,1488778,5,5088
2020-11-01,equatorial_guinea,Africa,1488778,0,5088
2020-11-02,equatorial_guinea,Africa,1488778,1,5089
2020-11-03,equatorial_guinea,Africa,1488778,0,5089
2020-11-04,equatorial_guinea,Africa,1488778,0,5089
2020-11-05,equatorial_guinea,Africa,1488778,3,5092
2020-11-06,equatorial_guinea,Africa,1488778,0,5092
2020-11-07,equatorial_guinea,Africa,1488778,0,5092
2020-11-08,equatorial_guinea,Africa,1488778,0,5092
2020-11-09,equatorial_guinea,Africa,1488778,0,5092
2020-11-10,equatorial_guinea,Africa,1488778,10,5102
2020-11-11,equatorial_guinea,Africa,1488778,0,5102
2020-11-12,equatorial_guinea,Africa,1488778,2,5104
2020-11-13,equatorial_guinea,Africa,1488778,0,5104
2020-11-14,equatorial_guinea,Africa,1488778,0,5104
2020-11-15,equatorial_guinea,Africa,1488778,0,5104
2020-11-16,equatorial_guinea,Africa,1488778,0,5104
2020-11-17,equatorial_guinea,Africa,1488778,17,5121
2020-11-18,equatorial_guinea,Africa,1488778,0,5121
2020-11-19,equatorial_guinea,Africa,1488778,0,5121
2020-11-20,equatorial_guinea,Africa,1488778,0,5121
2020-11-21,equatorial_guinea,Africa,1488778,9,5130
2020-11-22,equatorial_guinea,Africa,1488778,0,5130
2020-11-23,equatorial_guinea,Africa,1488778,7,5137
2020-11-24,equatorial_guinea,Africa,1488778,0,5137
2020-11-25,equatorial_guinea,Africa,1488778,0,5137
2020-11-26,equatorial_guinea,Africa,1488778,9,5146
2020-11-27,equatorial_guinea,Africa,1488778,0,5146
2020-11-28,equatorial_guinea,Africa,1488778,7,5153
2020-11-29,equatorial_guinea,Africa,1488778,0,5153
2020-11-30,equatorial_guinea,Africa,1488778,0,5153
2020-12-01,equatorial_guinea,Africa,1488778,3,5156
2020-12-02,equatorial_guinea,Africa,1488778,0,5156
2020-12-03,equatorial_guinea,Africa,1488778,3,5159
2020-12-04,equatorial_guinea,Africa,1488778,0,5159
2020-12-05,equatorial_guinea,Africa,1488778,0,5159
2020-12-06,equatorial_guinea,Africa,1488778,0,5159
2020-12-07,equatorial_guinea,Africa,1488778,7,5166
2020-12-08,equatorial_guinea,Africa,1488778,0,5166
2020-12-09,equatorial_guinea,Africa,1488778,17,5183
2020-12-10,equatorial_guinea,Africa,1488778,0,5183
2020-12-11,equatorial_guinea,Africa,1488778,0,5183
2020-12-12,equatorial_guinea,Africa,1488778,2,5185
2020-12-13,equatorial_guinea,Africa,1488778,0,5185
2020-12-14,equatorial_guinea,Africa,1488778,0,5185
2020-12-15,equatorial_guinea,Africa,1488778,10,5195
2020-12-16,equatorial_guinea,Africa,1488778,0,5195
2020-12-17,equatorial_guinea,Africa,1488778,19,5214
2020-12-18,equatorial_guinea,Africa,1488778,0,5214
2020-12-19,equatorial_guinea,Africa,1488778,0,5214
2020-12-20,equatorial_guinea,Africa,1488778,0,5214
2020-12-21,equatorial_guinea,Africa,1488778,17,5231
2020-12-22,equatorial_guinea,Africa,1488778,0,5231
2020-12-23,equatorial_guinea,Africa,1488778,5,5236
2020-12-24,equatorial_guinea,Africa,1488778,0,5236
2020-12-25,equatorial_guinea,Africa,1488778,0,5236
2020-12-26,equatorial_guinea,Africa,1488778,0,5236
2020-12-27,equatorial_guinea,Africa,1488778,12,5248
2020-12-28,equatorial_guinea,Africa,1488778,0,5248
2020-12-29,equatorial_guinea,Africa,1488778,0,5248
2020-12-30,equatorial_guinea,Africa,1488778,16,5264
2020-12-31,equatorial_guinea,Africa,1488778,13,5277
2021-01-01,equatorial_guinea,Africa,1488778,0,5277
2021-01-02,equatorial_guinea,Africa,1488778,0,5277
2021-01-03,equatorial_guinea,Africa,1488778,0,5277
2021-01-04,equatorial_guinea,Africa,1488778,2,5279
2021-01-05,equatorial_guinea,Africa,1488778,0,5279
2021-01-06,equatorial_guinea,Africa,1488778,7,5286
2021-01-07,equatorial_guinea,Africa,1488778,0,5286
2021-01-08,equatorial_guinea,Africa,1488778,3,5289
2021-01-09,equatorial_guinea,Africa,1488778,0,5289
2021-01-10,equatorial_guinea,Africa,1488778,0,5289
2021-01-11,equatorial_guinea,Africa,1488778,7,5296
2021-01-12,equatorial_guinea,Africa,1488778,0,5296
2021-01-13,equatorial_guinea,Africa,1488778,20,5316
2021-01-14,equatorial_guinea,Africa,1488778,0,5316
2021-01-15,equatorial_guinea,Africa,1488778,0,5316
2021-01-16,equatorial_guinea,Africa,1488778,40,5356
2021-01-17,equatorial_guinea,Africa,1488778,0,5356
2021-01-18,equatorial_guinea,Africa,1488778,9,5365
2021-01-19,equatorial_guinea,Africa,1488778,0,5365
2021-01-20,equatorial_guinea,Africa,1488778,0,5365
2021-01-21,equatorial_guinea,Africa,1488778,0,5365
2021-01-22,equatorial_guinea,Africa,1488778,36,5401
2021-01-23,equatorial_guinea,Africa,1488778,0,5401
2021-01-24,equatorial_guinea,Africa,1488778,0,5401
2021-01-25,equatorial_guinea,Africa,1488778,53,5454
2021-01-26,equatorial_guinea,Africa,1488778,0,5454
2021-01-27,equatorial_guinea,Africa,1488778,38,5492
2021-01-28,equatorial_guinea,Africa,1488778,0,5492
2021-01-29,equatorial_guinea,Africa,1488778,24,5516
2021-01-30,equatorial_guinea,Africa,1488778,0,5516
2021-01-31,equatorial_guinea,Africa,1488778,0,5516
2021-02-01,equatorial_guinea,Africa,1488778,18,5534
2021-02-02,equatorial_guinea,Africa,1488778,0,5534
2021-02-03,equatorial_guinea,Africa,1488778,0,5534
2021-02-04,equatorial_guinea,Africa,1488778,0,5534
2021-02-05,equatorial_guinea,Africa,1488778,44,5578
2021-02-06,equatorial_guinea,Africa,1488778,0,5578
2021-02-07,equatorial_guinea,Africa,1488778,0,5578
2021-02-08,equatorial_guinea,Africa,1488778,36,5614
2021-02-09,equatorial_guinea,Africa,1488778,0,5614
2021-02-10,equatorial_guinea,Africa,1488778,44,5658
2021-02-11,equatorial_guinea,Africa,1488778,5,5663
2021-02-12,equatorial_guinea,Africa,1488778,0,5663
2021-02-13,equatorial_guinea,Africa,1488778,31,5694
2021-02-14,equatorial_guinea,Africa,1488778,0,5694
2021-02-15,equatorial_guinea,Africa,1488778,0,5694
2021-02-16,equatorial_guinea,Africa,1488778,0,5694
2021-02-17,equatorial_guinea,Africa,1488778,0,5694
2021-02-18,equatorial_guinea,Africa,1488778,53,5747
2021-02-19,equatorial_guinea,Africa,1488778,0,5747
2021-02-20,equatorial_guinea,Africa,1488778,51,5798
2021-02-21,equatorial_guinea,Africa,1488778,0,5798
2021-02-22,equatorial_guinea,Africa,1488778,0,5798
2021-02-23,equatorial_guinea,Africa,1488778,54,5852
2021-02-24,equatorial_guinea,Africa,1488778,0,5852
2021-02-25,equatorial_guinea,Africa,1488778,0,5852
2021-02-26,equatorial_guinea,Africa,1488778,105,5957
2021-02-27,equatorial_guinea,Africa,1488778,48,6005
2021-02-28,equatorial_guinea,Africa,1488778,0,6005
2021-03-01,equatorial_guinea,Africa,1488778,90,6095
2021-03-02,equatorial_guinea,Africa,1488778,0,6095
2021-03-03,equatorial_guinea,Africa,1488778,115,6210
2021-03-04,equatorial_guinea,Africa,1488778,0,6210
2021-03-05,equatorial_guinea,Africa,1488778,0,6210
2021-03-06,equatorial_guinea,Africa,1488778,119,6329
2021-03-07,equatorial_guinea,Africa,1488778,0,6329
2021-03-08,equatorial_guinea,Africa,1488778,42,6371
2021-03-09,equatorial_guinea,Africa,1488778,0,6371
2021-03-10,equatorial_guinea,Africa,1488778,0,6371
2021-03-11,equatorial_guinea,Africa,1488778,85,6456
2021-03-12,equatorial_guinea,Africa,1488778,0,6456
2021-03-13,equatorial_guinea,Africa,1488778,106,6562
2021-03-14,equatorial_guinea,Africa,1488778,0,6562
2021-03-15,equatorial_guinea,Africa,1488778,0,6562
2021-03-16,equatorial_guinea,Africa,1488778,41,6603
2021-03-17,equatorial_guinea,Africa,1488778,0,6603
2021-03-18,equatorial_guinea,Africa,1488778,63,6666
2021-03-19,equatorial_guinea,Africa,1488778,0,6666
2021-03-20,equatorial_guinea,Africa,1488778,70,6736
2021-03-21,equatorial_guinea,Africa,1488778,0,6736
2021-03-22,equatorial_guinea,Africa,1488778,44,6780
2021-03-23,equatorial_guinea,Africa,1488778,0,6780
2021-03-24,equatorial_guinea,Africa,1488778,71,6851
2021-03-25,equatorial_guinea,Africa,1488778,0,6851
2021-03-26,equatorial_guinea,Africa,1488778,0,6851
2021-03-27,equatorial_guinea,Africa,1488778,51,6902
2021-03-28,equatorial_guinea,Africa,1488778,0,6902
2021-03-29,equatorial_guinea,Africa,1488778,12,6914
2021-03-30,equatorial_guinea,Africa,1488778,0,6914
2021-03-31,equatorial_guinea,Africa,1488778,0,6914
2021-04-01,equatorial_guinea,Africa,1488778,94,7008
2021-04-02,equatorial_guinea,Africa,1488778,0,7008
2021-04-03,equatorial_guinea,Africa,1488778,0,7008
2021-04-04,equatorial_guinea,Africa,1488778,0,7008
2021-04-05,equatorial_guinea,Africa,1488778,51,7059
2021-04-06,equatorial_guinea,Africa,1488778,0,7059
2021-04-07,equatorial_guinea,Africa,1488778,0,7059
2021-04-08,equatorial_guinea,Africa,1488778,0,7059
2021-04-09,equatorial_guinea,Africa,1488778,0,7059
2021-04-10,equatorial_guinea,Africa,1488778,160,7219
2021-04-11,equatorial_guinea,Africa,1488778,0,7219
2021-04-12,equatorial_guinea,Africa,1488778,0,7219
2021-04-13,equatorial_guinea,Africa,1488778,35,7254
2021-04-14,equatorial_guinea,Africa,1488778,26,7280
2021-04-15,equatorial_guinea,Africa,1488778,39,7319
2021-04-16,equatorial_guinea,Africa,1488778,38,7357
2021-04-17,equatorial_guinea,Africa,1488778,37,7394
2021-04-18,equatorial_guinea,Africa,1488778,29,7423
2021-04-19,equatorial_guinea,Africa,1488778,0,7423
2021-04-20,equatorial_guinea,Africa,1488778,82,7505
2021-04-21,equatorial_guinea,Africa,1488778,0,7505
2021-04-22,equatorial_guinea,Africa,1488778,0,7505
2021-04-23,equatorial_guinea,Africa,1488778,54,7559
2021-04-24,equatorial_guinea,Africa,1488778,0,7559
2021-04-25,equatorial_guinea,Africa,1488778,0,7559
2021-04-26,equatorial_guinea,Africa,1488778,0,7559
2021-04-27,equatorial_guinea,Africa,1488778,0,7559
2021-04-28,equatorial_guinea,Africa,1488778,0,7559
2021-04-29,equatorial_guinea,Africa,1488778,135,7694
2021-04-30,equatorial_guinea,Africa,1488778,0,7694
2021-05-01,equatorial_guinea,Africa,1488778,0,7694
2021-05-02,equatorial_guinea,Africa,1488778,0,7694
2021-05-03,equatorial_guinea,Africa,1488778,0,7694
2021-05-04,equatorial_guinea,Africa,1488778,0,7694
2021-05-05,equatorial_guinea,Africa,1488778,0,7694
2021-05-06,equatorial_guinea,Africa,1488778,0,7694
2021-05-07,equatorial_guinea,Africa,1488778,0,7694
2021-05-08,equatorial_guinea,Africa,1488778,0,7694
2021-05-09,equatorial_guinea,Africa,1488778,0,7694
2021-05-10,equatorial_guinea,Africa,1488778,0,7694
2021-05-11,equatorial_guinea,Africa,1488778,0,7694
2021-05-12,equatorial_guinea,Africa,1488778,0,7694
2021-05-13,equatorial_guinea,Africa,1488778,0,7694
2021-05-14,equatorial_guinea,Africa,1488778,0,7694
2021-05-15,equatorial_guinea,Africa,1488778,0,7694
2021-05-16,equatorial_guinea,Africa,1488778,0,7694
2021-05-17,equatorial_guinea,Africa,1488778,0,7694
2021-05-18,equatorial_guinea,Africa,1488778,0,7694
2021-05-19,equatorial_guinea,Africa,1488778,0,7694
2021-05-20,equatorial_guinea,Africa,1488778,742,8436
2021-05-21,equatorial_guinea,Africa,1488778,0,8436
2021-05-22,equatorial_guinea,Africa,1488778,0,8436
2021-05-23,equatorial_guinea,Africa,1488778,0,8436
2021-05-24,equatorial_guinea,Africa,1488778,40,8476
2021-05-25,equatorial_guinea,Africa,1488778,0,8476
2021-05-26,equatorial_guinea,Africa,1488778,0,8476
2021-05-27,equatorial_guinea,Africa,1488778,0,8476
2021-05-28,equatorial_guinea,Africa,1488778,0,8476
2021-05-29,equatorial_guinea,Africa,1488778,53,8529
2021-05-30,equatorial_guinea,Africa,1488778,0,8529
2021-05-31,equatorial_guinea,Africa,1488778,0,8529
2021-06-01,equatorial_guinea,Africa,1488778,43,8572
2021-06-02,equatorial_guinea,Africa,1488778,0,8572
2021-06-03,equatorial_guinea,Africa,1488778,0,8572
2021-06-04,equatorial_guinea,Africa,1488778,0,8572
2021-06-05,equatorial_guinea,Africa,1488778,54,8626
2021-06-06,equatorial_guinea,Africa,1488778,0,8626
2021-06-07,equatorial_guinea,Africa,1488778,0,8626
2021-06-08,equatorial_guinea,Africa,1488778,14,8640
2021-06-09,equatorial_guinea,Africa,1488778,0,8640
2021-06-10,equatorial_guinea,Africa,1488778,0,8640
2021-06-11,equatorial_guinea,Africa,1488778,0,8640
2021-06-12,equatorial_guinea,Africa,1488778,10,8650
2021-06-13,equatorial_guinea,Africa,1488778,0,8650
2021-06-14,equatorial_guinea,Africa,1488778,12,8662
2021-06-15,equatorial_guinea,Africa,1488778,0,8662
2021-06-16,equatorial_guinea,Africa,1488778,0,8662
2021-06-17,equatorial_guinea,Africa,1488778,18,8680
2021-06-18,equatorial_guinea,Africa,1488778,18,8698
2021-06-19,equatorial_guinea,Africa,1488778,0,8698
2021-06-20,equatorial_guinea,Africa,1488778,0,8698
2021-06-21,equatorial_guinea,Africa,1488778,10,8708
2021-06-22,equatorial_guinea,Africa,1488778,0,8708
2021-06-23,equatorial_guinea,Africa,1488778,0,8708
2021-06-24,equatorial_guinea,Africa,1488778,4,8712
2021-06-25,equatorial_guinea,Africa,1488778,0,8712
2021-06-26,equatorial_guinea,Africa,1488778,11,8723
2021-06-27,equatorial_guinea,Africa,1488778,0,8723
2021-06-28,equatorial_guinea,Africa,1488778,0,8723
2021-06-29,equatorial_guinea,Africa,1488778,11,8734
2021-06-30,equatorial_guinea,Africa,1488778,0,8734
2021-07-01,equatorial_guinea,Africa,1488778,8,8742
2021-07-02,equatorial_guinea,Africa,1488778,0,8742
2021-07-03,equatorial_guinea,Africa,1488778,17,8759
2021-07-04,equatorial_guinea,Africa,1488778,0,8759
2021-07-05,equatorial_guinea,Africa,1488778,0,8759
2021-07-06,equatorial_guinea,Africa,1488778,16,8775
2021-07-07,equatorial_guinea,Africa,1488778,0,8775
2021-07-08,equatorial_guinea,Africa,1488778,15,8790
2021-07-09,equatorial_guinea,Africa,1488778,0,8790
2020-02-28,estonia,Europe,1328196,0,1
2020-02-29,estonia,Europe,1328196,0,1
2020-03-01,estonia,Europe,1328196,0,1
2020-03-02,estonia,Europe,1328196,0,1
2020-03-03,estonia,Europe,1328196,1,2
2020-03-04,estonia,Europe,1328196,0,2
2020-03-05,estonia,Europe,1328196,3,5
2020-03-06,estonia,Europe,1328196,5,10
2020-03-07,estonia,Europe,1328196,0,10
2020-03-08,estonia,Europe,1328196,0,10
2020-03-09,estonia,Europe,1328196,0,10
2020-03-10,estonia,Europe,1328196,3,13
2020-03-11,estonia,Europe,1328196,3,16
2020-03-12,estonia,Europe,1328196,11,27
2020-03-13,estonia,Europe,1328196,52,79
2020-03-14,estonia,Europe,1328196,36,115
2020-03-15,estonia,Europe,1328196,56,171
2020-03-16,estonia,Europe,1328196,34,205
2020-03-17,estonia,Europe,1328196,20,225
2020-03-18,estonia,Europe,1328196,33,258
2020-03-19,estonia,Europe,1328196,9,267
2020-03-20,estonia,Europe,1328196,16,283
2020-03-21,estonia,Europe,1328196,23,306
2020-03-22,estonia,Europe,1328196,20,326
2020-03-23,estonia,Europe,1328196,26,352
2020-03-24,estonia,Europe,1328196,17,369
2020-03-25,estonia,Europe,1328196,35,404
2020-03-26,estonia,Europe,1328196,134,538
2020-03-27,estonia,Europe,1328196,37,575
2020-03-28,estonia,Europe,1328196,70,645
2020-03-29,estonia,Europe,1328196,34,679
2020-03-30,estonia,Europe,1328196,36,715
2020-03-31,estonia,Europe,1328196,30,745
2020-04-01,estonia,Europe,1328196,34,779
2020-04-02,estonia,Europe,1328196,79,858
2020-04-03,estonia,Europe,1328196,103,961
2020-04-04,estonia,Europe,1328196,78,1039
2020-04-05,estonia,Europe,1328196,58,1097
2020-04-06,estonia,Europe,1328196,11,1108
2020-04-07,estonia,Europe,1328196,41,1149
2020-04-08,estonia,Europe,1328196,36,1185
2020-04-09,estonia,Europe,1328196,22,1207
2020-04-10,estonia,Europe,1328196,51,1258
2020-04-11,estonia,Europe,1328196,46,1304
2020-04-12,estonia,Europe,1328196,5,1309
2020-04-13,estonia,Europe,1328196,23,1332
2020-04-14,estonia,Europe,1328196,41,1373
2020-04-15,estonia,Europe,1328196,27,1400
2020-04-16,estonia,Europe,1328196,34,1434
2020-04-17,estonia,Europe,1328196,25,1459
2020-04-18,estonia,Europe,1328196,53,1512
2020-04-19,estonia,Europe,1328196,16,1528
2020-04-20,estonia,Europe,1328196,7,1535
2020-04-21,estonia,Europe,1328196,17,1552
2020-04-22,estonia,Europe,1328196,7,1559
2020-04-23,estonia,Europe,1328196,33,1592
2020-04-24,estonia,Europe,1328196,13,1605
2020-04-25,estonia,Europe,1328196,30,1635
2020-04-26,estonia,Europe,1328196,8,1643
2020-04-27,estonia,Europe,1328196,4,1647
2020-04-28,estonia,Europe,1328196,13,1660
2020-04-29,estonia,Europe,1328196,6,1666
2020-04-30,estonia,Europe,1328196,23,1689
2020-05-01,estonia,Europe,1328196,5,1694
2020-05-02,estonia,Europe,1328196,5,1699
2020-05-03,estonia,Europe,1328196,1,1700
2020-05-04,estonia,Europe,1328196,3,1703
2020-05-05,estonia,Europe,1328196,8,1711
2020-05-06,estonia,Europe,1328196,2,1713
2020-05-07,estonia,Europe,1328196,7,1720
2020-05-08,estonia,Europe,1328196,5,1725
2020-05-09,estonia,Europe,1328196,8,1733
2020-05-10,estonia,Europe,1328196,6,1739
2020-05-11,estonia,Europe,1328196,2,1741
2020-05-12,estonia,Europe,1328196,5,1746
2020-05-13,estonia,Europe,1328196,5,1751
2020-05-14,estonia,Europe,1328196,7,1758
2020-05-15,estonia,Europe,1328196,8,1766
2020-05-16,estonia,Europe,1328196,4,1770
2020-05-17,estonia,Europe,1328196,4,1774
2020-05-18,estonia,Europe,1328196,10,1784
2020-05-19,estonia,Europe,1328196,7,1791
2020-05-20,estonia,Europe,1328196,3,1794
2020-05-21,estonia,Europe,1328196,6,1800
2020-05-22,estonia,Europe,1328196,7,1807
2020-05-23,estonia,Europe,1328196,14,1821
2020-05-24,estonia,Europe,1328196,2,1823
2020-05-25,estonia,Europe,1328196,1,1824
2020-05-26,estonia,Europe,1328196,10,1834
2020-05-27,estonia,Europe,1328196,6,1840
2020-05-28,estonia,Europe,1328196,11,1851
2020-05-29,estonia,Europe,1328196,8,1859
2020-05-30,estonia,Europe,1328196,6,1865
2020-05-31,estonia,Europe,1328196,4,1869
2020-06-01,estonia,Europe,1328196,1,1870
2020-06-02,estonia,Europe,1328196,0,1870
2020-06-03,estonia,Europe,1328196,10,1880
2020-06-04,estonia,Europe,1328196,10,1890
2020-06-05,estonia,Europe,1328196,20,1910
2020-06-06,estonia,Europe,1328196,21,1931
2020-06-07,estonia,Europe,1328196,8,1939
2020-06-08,estonia,Europe,1328196,1,1940
2020-06-09,estonia,Europe,1328196,7,1947
2020-06-10,estonia,Europe,1328196,11,1958
2020-06-11,estonia,Europe,1328196,7,1965
2020-06-12,estonia,Europe,1328196,5,1970
2020-06-13,estonia,Europe,1328196,3,1973
2020-06-14,estonia,Europe,1328196,0,1973
2020-06-15,estonia,Europe,1328196,1,1974
2020-06-16,estonia,Europe,1328196,1,1975
2020-06-17,estonia,Europe,1328196,2,1977
2020-06-18,estonia,Europe,1328196,0,1977
2020-06-19,estonia,Europe,1328196,2,1979
2020-06-20,estonia,Europe,1328196,2,1981
2020-06-21,estonia,Europe,1328196,0,1981
2020-06-22,estonia,Europe,1328196,0,1981
2020-06-23,estonia,Europe,1328196,1,1982
2020-06-24,estonia,Europe,1328196,1,1983
2020-06-25,estonia,Europe,1328196,1,1984
2020-06-26,estonia,Europe,1328196,2,1986
2020-06-27,estonia,Europe,1328196,0,1986
2020-06-28,estonia,Europe,1328196,1,1987
2020-06-29,estonia,Europe,1328196,0,1987
2020-06-30,estonia,Europe,1328196,2,1989
2020-07-01,estonia,Europe,1328196,0,1989
2020-07-02,estonia,Europe,1328196,1,1990
2020-07-03,estonia,Europe,1328196,1,1991
2020-07-04,estonia,Europe,1328196,2,1993
2020-07-05,estonia,Europe,1328196,0,1993
2020-07-06,estonia,Europe,1328196,1,1994
2020-07-07,estonia,Europe,1328196,1,1995
2020-07-08,estonia,Europe,1328196,8,2003
2020-07-09,estonia,Europe,1328196,8,2011
2020-07-10,estonia,Europe,1328196,2,2013
2020-07-11,estonia,Europe,1328196,1,2014
2020-07-12,estonia,Europe,1328196,0,2014
2020-07-13,estonia,Europe,1328196,0,2014
2020-07-14,estonia,Europe,1328196,1,2015
2020-07-15,estonia,Europe,1328196,1,2016
2020-07-16,estonia,Europe,1328196,0,2016
2020-07-17,estonia,Europe,1328196,4,2020
2020-07-18,estonia,Europe,1328196,1,2021
2020-07-19,estonia,Europe,1328196,0,2021
2020-07-20,estonia,Europe,1328196,0,2021
2020-07-21,estonia,Europe,1328196,1,2022
2020-07-22,estonia,Europe,1328196,3,2025
2020-07-23,estonia,Europe,1328196,2,2027
2020-07-24,estonia,Europe,1328196,1,2028
2020-07-25,estonia,Europe,1328196,5,2033
2020-07-26,estonia,Europe,1328196,1,2034
2020-07-27,estonia,Europe,1328196,0,2034
2020-07-28,estonia,Europe,1328196,4,2038
2020-07-29,estonia,Europe,1328196,4,2042
2020-07-30,estonia,Europe,1328196,9,2051
2020-07-31,estonia,Europe,1328196,13,2064
2020-08-01,estonia,Europe,1328196,8,2072
2020-08-02,estonia,Europe,1328196,7,2079
2020-08-03,estonia,Europe,1328196,1,2080
2020-08-04,estonia,Europe,1328196,11,2091
2020-08-05,estonia,Europe,1328196,22,2113
2020-08-06,estonia,Europe,1328196,11,2124
2020-08-07,estonia,Europe,1328196,9,2133
2020-08-08,estonia,Europe,1328196,14,2147
2020-08-09,estonia,Europe,1328196,5,2152
2020-08-10,estonia,Europe,1328196,6,2158
2020-08-11,estonia,Europe,1328196,9,2167
2020-08-12,estonia,Europe,1328196,7,2174
2020-08-13,estonia,Europe,1328196,0,2174
2020-08-14,estonia,Europe,1328196,3,2177
2020-08-15,estonia,Europe,1328196,7,2184
2020-08-16,estonia,Europe,1328196,6,2190
2020-08-17,estonia,Europe,1328196,2,2192
2020-08-18,estonia,Europe,1328196,8,2200
2020-08-19,estonia,Europe,1328196,7,2207
2020-08-20,estonia,Europe,1328196,20,2227
2020-08-21,estonia,Europe,1328196,17,2244
2020-08-22,estonia,Europe,1328196,21,2265
2020-08-23,estonia,Europe,1328196,7,2272
2020-08-24,estonia,Europe,1328196,3,2275
2020-08-25,estonia,Europe,1328196,19,2294
2020-08-26,estonia,Europe,1328196,17,2311
2020-08-27,estonia,Europe,1328196,14,2325
2020-08-28,estonia,Europe,1328196,18,2343
2020-04-06,ethiopia,Africa,120265111,1,44
2020-04-07,ethiopia,Africa,120265111,8,52
2020-04-08,ethiopia,Africa,120265111,3,55
2020-04-09,ethiopia,Africa,120265111,1,56
2020-04-10,ethiopia,Africa,120265111,9,65
2020-04-11,ethiopia,Africa,120265111,4,69
2020-04-12,ethiopia,Africa,120265111,2,71
2020-04-13,ethiopia,Africa,120265111,3,74
2020-04-14,ethiopia,Africa,120265111,8,82
2020-04-15,ethiopia,Africa,120265111,3,85
2020-04-16,ethiopia,Africa,120265111,7,92
2020-04-17,ethiopia,Africa,120265111,4,96
2020-04-18,ethiopia,Africa,120265111,9,105
2020-04-19,ethiopia,Africa,120265111,3,108
2020-04-20,ethiopia,Africa,120265111,3,111
2020-04-21,ethiopia,Africa,120265111,3,114
2020-04-22,ethiopia,Africa,120265111,2,116
2020-04-23,ethiopia,Africa,120265111,0,116
2020-04-24,ethiopia,Africa,120265111,1,117
2020-04-25,ethiopia,Africa,120265111,5,122
2020-04-26,ethiopia,Africa,120265111,1,123
2020-04-27,ethiopia,Africa,120265111,1,124
2020-04-28,ethiopia,Africa,120265111,2,126
2020-04-29,ethiopia,Africa,120265111,4,130
2020-04-30,ethiopia,Africa,120265111,1,131
2020-05-01,ethiopia,Africa,120265111,2,133
2020-05-02,ethiopia,Africa,120265111,0,133
2020-05-03,ethiopia,Africa,120265111,2,135
2020-05-04,ethiopia,Africa,120265111,5,140
2020-05-05,ethiopia,Africa,120265111,5,145
2020-05-06,ethiopia,Africa,120265111,17,162
2020-05-07,ethiopia,Africa,120265111,29,191
2020-05-08,ethiopia,Africa,120265111,3,194
2020-05-09,ethiopia,Africa,120265111,16,210
2020-05-10,ethiopia,Africa,120265111,29,239
2020-05-11,ethiopia,Africa,120265111,11,250
2020-05-12,ethiopia,Africa,120265111,11,261
2020-05-13,ethiopia,Africa,120265111,2,263
2020-05-14,ethiopia,Africa,120265111,9,272
2020-05-15,ethiopia,Africa,120265111,15,287
2020-05-16,ethiopia,Africa,120265111,19,306
2020-05-17,ethiopia,Africa,120265111,11,317
2020-05-18,ethiopia,Africa,120265111,35,352
2020-05-19,ethiopia,Africa,120265111,13,365
2020-05-20,ethiopia,Africa,120265111,24,389
2020-05-21,ethiopia,Africa,120265111,10,399
2020-05-22,ethiopia,Africa,120265111,34,433
2020-05-23,ethiopia,Africa,120265111,61,494
2020-05-24,ethiopia,Africa,120265111,88,582
2020-05-25,ethiopia,Africa,120265111,73,655
2020-05-26,ethiopia,Africa,120265111,46,701
2020-05-27,ethiopia,Africa,120265111,30,731
2020-05-28,ethiopia,Africa,120265111,100,831
2020-05-29,ethiopia,Africa,120265111,137,968
2020-05-30,ethiopia,Africa,120265111,95,1063
2020-05-31,ethiopia,Africa,120265111,109,1172
2020-06-01,ethiopia,Africa,120265111,85,1257
2020-06-02,ethiopia,Africa,120265111,87,1344
2020-06-03,ethiopia,Africa,120265111,142,1486
2020-06-04,ethiopia,Africa,120265111,150,1636
2020-06-05,ethiopia,Africa,120265111,169,1805
2020-06-06,ethiopia,Africa,120265111,129,1934
2020-06-07,ethiopia,Africa,120265111,86,2020
2020-06-08,ethiopia,Africa,120265111,136,2156
2020-06-09,ethiopia,Africa,120265111,180,2336
2020-06-10,ethiopia,Africa,120265111,170,2506
2020-06-11,ethiopia,Africa,120265111,164,2670
2020-06-12,ethiopia,Africa,120265111,245,2915
2020-06-13,ethiopia,Africa,120265111,251,3166
2020-06-14,ethiopia,Africa,120265111,179,3345
2020-06-15,ethiopia,Africa,120265111,176,3521
2020-06-16,ethiopia,Africa,120265111,109,3630
2020-06-17,ethiopia,Africa,120265111,129,3759
2020-06-18,ethiopia,Africa,120265111,195,3954
2020-06-19,ethiopia,Africa,120265111,116,4070
2020-06-20,ethiopia,Africa,120265111,399,4469
2020-06-21,ethiopia,Africa,120265111,63,4532
2020-06-22,ethiopia,Africa,120265111,131,4663
2020-06-23,ethiopia,Africa,120265111,185,4848
2020-06-24,ethiopia,Africa,120265111,186,5034
2020-06-25,ethiopia,Africa,120265111,141,5175
2020-06-26,ethiopia,Africa,120265111,250,5425
2020-06-27,ethiopia,Africa,120265111,145,5570
2020-06-28,ethiopia,Africa,120265111,119,5689
2020-06-29,ethiopia,Africa,120265111,157,5846
2020-06-30,ethiopia,Africa,120265111,0,5846
2020-07-01,ethiopia,Africa,120265111,0,5846
2020-07-02,ethiopia,Africa,120265111,0,5846
2020-07-03,ethiopia,Africa,120265111,0,5846
2020-07-04,ethiopia,Africa,120265111,0,5846
2020-07-05,ethiopia,Africa,120265111,0,5846
2020-07-06,ethiopia,Africa,120265111,0,5846
2020-07-07,ethiopia,Africa,120265111,0,5846
2020-07-08,ethiopia,Africa,120265111,928,6774
2020-07-09,ethiopia,Africa,120265111,199,6973
2020-07-10,ethiopia,Africa,120265111,147,7120
2020-07-11,ethiopia,Africa,120265111,282,7402
2020-07-12,ethiopia,Africa,120265111,158,7560
2020-07-13,ethiopia,Africa,120265111,206,7766
2020-07-14,ethiopia,Africa,120265111,203,7969
2020-07-15,ethiopia,Africa,120265111,212,8181
2020-07-16,ethiopia,Africa,120265111,294,8475
2020-07-17,ethiopia,Africa,120265111,328,8803
2020-07-18,ethiopia,Africa,120265111,344,9147
2020-07-19,ethiopia,Africa,120265111,356,9503
2020-07-20,ethiopia,Africa,120265111,704,10207
2020-07-21,ethiopia,Africa,120265111,865,11072
2020-07-22,ethiopia,Africa,120265111,452,11524
2020-07-23,ethiopia,Africa,120265111,409,11933
2020-07-24,ethiopia,Africa,120265111,760,12693
2020-07-25,ethiopia,Africa,120265111,555,13248
2020-07-26,ethiopia,Africa,120265111,720,13968
2020-07-27,ethiopia,Africa,120265111,579,14547
2020-07-28,ethiopia,Africa,120265111,653,15200
2020-07-29,ethiopia,Africa,120265111,610,15810
2020-07-30,ethiopia,Africa,120265111,805,16615
2020-07-31,ethiopia,Africa,120265111,915,17530
2020-08-01,ethiopia,Africa,120265111,469,17999
2020-08-02,ethiopia,Africa,120265111,707,18706
2020-08-03,ethiopia,Africa,120265111,583,19289
2020-08-04,ethiopia,Africa,120265111,588,19877
2020-08-05,ethiopia,Africa,120265111,459,20336
2020-08-06,ethiopia,Africa,120265111,564,20900
2020-08-07,ethiopia,Africa,120265111,552,21452
2020-08-08,ethiopia,Africa,120265111,801,22253
2020-08-09,ethiopia,Africa,120265111,565,22818
2020-08-10,ethiopia,Africa,120265111,773,23591
2020-08-11,ethiopia,Africa,120265111,584,24175
2020-08-12,ethiopia,Africa,120265111,943,25118
2020-08-13,ethiopia,Africa,120265111,1086,26204
2020-08-14,ethiopia,Africa,120265111,1038,27242
2020-08-15,ethiopia,Africa,120265111,1652,28894
2020-08-16,ethiopia,Africa,120265111,982,29876
2020-08-17,ethiopia,Africa,120265111,1460,31336
2020-08-18,ethiopia,Africa,120265111,1386,32722
2020-08-19,ethiopia,Africa,120265111,1336,34058
2020-08-20,ethiopia,Africa,120265111,1778,35836
2020-08-21,ethiopia,Africa,120265111,1829,37665
2020-08-22,ethiopia,Africa,120265111,1368,39033
2020-08-23,ethiopia,Africa,120265111,1638,40671
2020-08-24,ethiopia,Africa,120265111,1472,42143
2020-08-25,ethiopia,Africa,120265111,1545,43688
2020-08-26,ethiopia,Africa,120265111,1533,45221
2020-08-27,ethiopia,Africa,120265111,1186,46407
2020-08-28,ethiopia,Africa,120265111,1733,48140
2020-08-29,ethiopia,Africa,120265111,1514,49654
2020-08-30,ethiopia,Africa,120265111,1468,51122
2020-08-31,ethiopia,Africa,120265111,1009,52131
2020-09-01,ethiopia,Africa,120265111,1173,53304
2020-09-02,ethiopia,Africa,120265111,1105,54409
2020-09-03,ethiopia,Africa,120265111,804,55213
2020-09-04,ethiopia,Africa,120265111,1303,56516
2020-09-05,ethiopia,Africa,120265111,950,57466
2020-09-06,ethiopia,Africa,120265111,1206,58672
2020-09-07,ethiopia,Africa,120265111,976,59648
2020-09-08,ethiopia,Africa,120265111,1136,60784
2020-09-09,ethiopia,Africa,120265111,916,61700
2020-09-10,ethiopia,Africa,120265111,878,62578
2020-09-11,ethiopia,Africa,120265111,789,63367
2020-09-12,ethiopia,Africa,120265111,521,63888
2020-09-13,ethiopia,Africa,120265111,413,64301
2020-09-14,ethiopia,Africa,120265111,485,64786
2020-09-15,ethiopia,Africa,120265111,700,65486
2020-09-16,ethiopia,Africa,120265111,738,66224
2020-09-17,ethiopia,Africa,120265111,689,66913
2020-09-18,ethiopia,Africa,120265111,602,67515
2020-09-19,ethiopia,Africa,120265111,616,68131
2020-09-20,ethiopia,Africa,120265111,689,68820
2020-09-21,ethiopia,Africa,120265111,889,69709
2020-09-22,ethiopia,Africa,120265111,713,70422
2020-09-23,ethiopia,Africa,120265111,661,71083
2020-09-24,ethiopia,Africa,120265111,604,71687
2020-09-25,ethiopia,Africa,120265111,486,72173
2020-09-26,ethiopia,Africa,120265111,527,72700
2020-09-27,ethiopia,Africa,120265111,632,73332
2020-09-28,ethiopia,Africa,120265111,612,73944
2020-09-29,ethiopia,Africa,120265111,640,74584
2020-09-30,ethiopia,Africa,120265111,784,75368
2020-10-01,ethiopia,Africa,120265111,730,76098
2020-10-02,ethiopia,Africa,120265111,890,76988
2020-10-03,ethiopia,Africa,120265111,872,77860
2020-10-04,ethiopia,Africa,120265111,959,78819
2020-10-05,ethiopia,Africa,120265111,618,79437
2020-10-06,ethiopia,Africa,120265111,566,80003
2020-10-07,ethiopia,Africa,120265111,892,80895
2020-10-08,ethiopia,Africa,120265111,902,81797
2020-10-09,ethiopia,Africa,120265111,865,82662
2020-10-10,ethiopia,Africa,120265111,767,83429
2020-10-11,ethiopia,Africa,120265111,866,84295
2020-10-12,ethiopia,Africa,120265111,841,85136
2020-10-13,ethiopia,Africa,120265111,582,85718
2020-10-14,ethiopia,Africa,120265111,712,86430
2020-10-15,ethiopia,Africa,120265111,739,87169
2020-10-16,ethiopia,Africa,120265111,665,87834
2020-10-17,ethiopia,Africa,120265111,600,88434
2020-10-18,ethiopia,Africa,120265111,703,89137
2020-10-19,ethiopia,Africa,120265111,723,89860
2020-10-20,ethiopia,Africa,120265111,630,90490
2020-10-21,ethiopia,Africa,120265111,628,91118
2020-10-22,ethiopia,Africa,120265111,575,91693
2020-10-23,ethiopia,Africa,120265111,536,92229
2020-10-24,ethiopia,Africa,120265111,629,92858
2020-10-25,ethiopia,Africa,120265111,485,93343
2020-10-26,ethiopia,Africa,120265111,364,93707
2020-10-27,ethiopia,Africa,120265111,511,94218
2020-10-28,ethiopia,Africa,120265111,602,94820
2020-10-29,ethiopia,Africa,120265111,481,95301
2020-10-30,ethiopia,Africa,120265111,488,95789
2020-10-31,ethiopia,Africa,120265111,380,96169
2020-11-01,ethiopia,Africa,120265111,414,96583
2020-11-02,ethiopia,Africa,120265111,359,96942
2020-11-03,ethiopia,Africa,120265111,560,97502
2020-11-04,ethiopia,Africa,120265111,379,97881
2020-11-05,ethiopia,Africa,120265111,510,98391
2020-11-06,ethiopia,Africa,120265111,355,98746
2020-11-07,ethiopia,Africa,120265111,455,99201
2020-11-08,ethiopia,Africa,120265111,474,99675
2020-11-09,ethiopia,Africa,120265111,307,99982
2020-11-10,ethiopia,Africa,120265111,345,100327
2020-11-11,ethiopia,Africa,120265111,400,100727
2020-11-12,ethiopia,Africa,120265111,521,101248
2020-11-13,ethiopia,Africa,120265111,509,101757
2020-11-14,ethiopia,Africa,120265111,564,102321
2020-11-15,ethiopia,Africa,120265111,399,102720
2020-11-16,ethiopia,Africa,120265111,336,103056
2020-11-17,ethiopia,Africa,120265111,339,103395
2020-11-18,ethiopia,Africa,120265111,533,103928
2020-11-19,ethiopia,Africa,120265111,499,104427
2020-11-20,ethiopia,Africa,120265111,452,104879
2020-11-21,ethiopia,Africa,120265111,473,105352
2020-11-22,ethiopia,Africa,120265111,433,105785
2020-11-23,ethiopia,Africa,120265111,418,106203
2020-11-24,ethiopia,Africa,120265111,388,106591
2020-11-25,ethiopia,Africa,120265111,518,107109
2020-11-26,ethiopia,Africa,120265111,560,107669
2020-11-27,ethiopia,Africa,120265111,769,108438
2020-11-28,ethiopia,Africa,120265111,492,108930
2020-11-29,ethiopia,Africa,120265111,604,109534
2020-11-30,ethiopia,Africa,120265111,540,110074
2020-12-01,ethiopia,Africa,120265111,480,110554
2020-12-02,ethiopia,Africa,120265111,430,110984
2020-12-03,ethiopia,Africa,120265111,595,111579
2020-12-04,ethiopia,Africa,120265111,512,112091
2020-12-05,ethiopia,Africa,120265111,649,112740
2020-12-06,ethiopia,Africa,120265111,555,113295
2020-12-07,ethiopia,Africa,120265111,440,113735
2020-12-08,ethiopia,Africa,120265111,531,114266
2020-12-09,ethiopia,Africa,120265111,568,114834
2020-12-10,ethiopia,Africa,120265111,526,115360
2020-12-11,ethiopia,Africa,120265111,422,115782
2020-12-12,ethiopia,Africa,120265111,515,116297
2020-12-13,ethiopia,Africa,120265111,472,116769
2020-12-14,ethiopia,Africa,120265111,473,117242
2020-12-15,ethiopia,Africa,120265111,300,117542
2020-12-16,ethiopia,Africa,120265111,464,118006
2020-12-17,ethiopia,Africa,120265111,475,118481
2020-12-18,ethiopia,Africa,120265111,544,119025
2020-12-19,ethiopia,Africa,120265111,469,119494
2020-12-20,ethiopia,Africa,120265111,457,119951
2020-12-21,ethiopia,Africa,120265111,397,120348
2020-12-22,ethiopia,Africa,120265111,290,120638
2020-12-23,ethiopia,Africa,120265111,351,120989
2020-12-24,ethiopia,Africa,120265111,410,121399
2020-12-25,ethiopia,Africa,120265111,481,121880
2020-12-26,ethiopia,Africa,120265111,533,122413
2020-12-27,ethiopia,Africa,120265111,451,122864
2020-12-28,ethiopia,Africa,120265111,281,123145
2020-12-29,ethiopia,Africa,120265111,243,123388
2020-12-30,ethiopia,Africa,120265111,468,123856
2020-12-31,ethiopia,Africa,120265111,408,124264
2021-01-01,ethiopia,Africa,120265111,388,124652
2021-01-02,ethiopia,Africa,120265111,397,125049
2021-01-03,ethiopia,Africa,120265111,573,125622
2021-01-04,ethiopia,Africa,120265111,297,125919
2021-01-05,ethiopia,Africa,120265111,322,126241
2021-01-06,ethiopia,Africa,120265111,545,126786
2021-01-07,ethiopia,Africa,120265111,441,127227
2021-01-08,ethiopia,Africa,120265111,345,127572
2021-01-09,ethiopia,Africa,120265111,220,127792
2021-01-10,ethiopia,Africa,120265111,524,128316
2021-01-11,ethiopia,Africa,120265111,300,128616
2021-01-12,ethiopia,Africa,120265111,376,128992
2021-01-13,ethiopia,Africa,120265111,463,129455
2021-01-14,ethiopia,Africa,120265111,467,129922
2021-01-15,ethiopia,Africa,120265111,404,130326
2021-01-16,ethiopia,Africa,120265111,446,130772
2021-01-17,ethiopia,Africa,120265111,423,131195
2021-01-18,ethiopia,Africa,120265111,351,131546
2021-01-19,ethiopia,Africa,120265111,181,131727
2021-01-20,ethiopia,Africa,120265111,307,132034
2021-01-21,ethiopia,Africa,120265111,292,132326
2021-01-22,ethiopia,Africa,120265111,555,132881
2021-01-23,ethiopia,Africa,120265111,417,133298
2021-01-24,ethiopia,Africa,120265111,469,133767
2021-01-25,ethiopia,Africa,120265111,365,134132
2021-01-26,ethiopia,Africa,120265111,437,134569
2021-01-27,ethiopia,Africa,120265111,476,135045
2021-01-28,ethiopia,Africa,120265111,549,135594
2021-01-29,ethiopia,Africa,120265111,771,136365
2021-01-30,ethiopia,Africa,120265111,656,137021
2021-01-31,ethiopia,Africa,120265111,629,137650
2021-02-01,ethiopia,Africa,120265111,734,138384
2021-02-02,ethiopia,Africa,120265111,477,138861
2021-02-03,ethiopia,Africa,120265111,547,139408
2021-02-04,ethiopia,Africa,120265111,749,140157
2021-02-05,ethiopia,Africa,120265111,726,140883
2021-02-06,ethiopia,Africa,120265111,570,141453
2021-02-07,ethiopia,Africa,120265111,885,142338
2021-02-08,ethiopia,Africa,120265111,656,142994
2021-02-09,ethiopia,Africa,120265111,572,143566
2021-02-10,ethiopia,Africa,120265111,683,144249
2021-02-11,ethiopia,Africa,120265111,613,144862
2021-02-12,ethiopia,Africa,120265111,686,145548
2021-02-13,ethiopia,Africa,120265111,756,146304
2021-02-14,ethiopia,Africa,120265111,788,147092
2021-02-15,ethiopia,Africa,120265111,733,147825
2021-02-16,ethiopia,Africa,120265111,665,148490
2021-02-17,ethiopia,Africa,120265111,818,149308
2021-02-18,ethiopia,Africa,120265111,871,150179
2021-02-19,ethiopia,Africa,120265111,837,151016
2021-02-20,ethiopia,Africa,120265111,841,151857
2021-02-21,ethiopia,Africa,120265111,949,152806
2021-02-22,ethiopia,Africa,120265111,735,153541
2021-02-23,ethiopia,Africa,120265111,716,154257
2021-02-24,ethiopia,Africa,120265111,977,155234
2021-02-25,ethiopia,Africa,120265111,878,156112
2021-02-26,ethiopia,Africa,120265111,935,157047
2021-02-27,ethiopia,Africa,120265111,1006,158053
2021-02-28,ethiopia,Africa,120265111,1019,159072
2021-03-01,ethiopia,Africa,120265111,900,159972
2021-03-02,ethiopia,Africa,120265111,841,160813
2021-03-03,ethiopia,Africa,120265111,1161,161974
2021-03-04,ethiopia,Africa,120265111,980,162954
2021-03-05,ethiopia,Africa,120265111,1119,164073
2021-03-06,ethiopia,Africa,120265111,956,165029
2021-03-07,ethiopia,Africa,120265111,1109,166138
2021-03-08,ethiopia,Africa,120265111,995,167133
2021-03-09,ethiopia,Africa,120265111,1202,168335
2021-03-10,ethiopia,Africa,120265111,1543,169878
2021-03-11,ethiopia,Africa,120265111,1332,171210
2021-03-12,ethiopia,Africa,120265111,1361,172571
2021-03-13,ethiopia,Africa,120265111,1483,174054
2021-03-14,ethiopia,Africa,120265111,1413,175467
2021-03-15,ethiopia,Africa,120265111,1151,176618
2021-03-16,ethiopia,Africa,120265111,1490,178108
2021-03-17,ethiopia,Africa,120265111,1704,179812
2021-03-18,ethiopia,Africa,120265111,2057,181869
2021-03-19,ethiopia,Africa,120265111,1994,183863
2021-03-20,ethiopia,Africa,120265111,1778,185641
2021-03-21,ethiopia,Africa,120265111,1724,187365
2021-03-22,ethiopia,Africa,120265111,1537,188902
2021-03-23,ethiopia,Africa,120265111,1692,190594
2021-03-24,ethiopia,Africa,120265111,1981,192575
2021-03-25,ethiopia,Africa,120265111,1949,194524
2021-03-26,ethiopia,Africa,120265111,2097,196621
2021-03-27,ethiopia,Africa,120265111,2173,198794
2021-03-28,ethiopia,Africa,120265111,1769,200563
2021-03-29,ethiopia,Africa,120265111,1982,202545
2021-03-30,ethiopia,Africa,120265111,1976,204521
2021-03-31,ethiopia,Africa,120265111,2068,206589
2021-04-01,ethiopia,Africa,120265111,2372,208961
2021-04-02,ethiopia,Africa,120265111,2353,211314
2021-04-03,ethiopia,Africa,120265111,1997,213311
2021-04-04,ethiopia,Africa,120265111,1878,215189
2021-04-05,ethiopia,Africa,120265111,2138,217327
2021-04-06,ethiopia,Africa,120265111,2054,219381
2021-04-07,ethiopia,Africa,120265111,2163,221544
2021-04-08,ethiopia,Africa,120265111,2121,223665
2021-04-09,ethiopia,Africa,120265111,1851,225516
2021-04-10,ethiopia,Africa,120265111,1739,227255
2021-04-11,ethiopia,Africa,120265111,1741,228996
2021-04-12,ethiopia,Africa,120265111,1948,230944
2021-04-13,ethiopia,Africa,120265111,1568,232512
2021-04-14,ethiopia,Africa,120265111,1893,234405
2021-04-15,ethiopia,Africa,120265111,2149,236554
2021-04-16,ethiopia,Africa,120265111,1973,238527
2020-08-01,fiji,Australia/Oceania,908543,0,27
2020-08-02,fiji,Australia/Oceania,908543,0,27
2020-08-03,fiji,Australia/Oceania,908543,0,27
2020-08-04,fiji,Australia/Oceania,908543,0,27
2020-08-05,fiji,Australia/Oceania,908543,0,27
2020-08-06,fiji,Australia/Oceania,908543,0,27
2020-08-07,fiji,Australia/Oceania,908543,0,27
2020-08-08,fiji,Australia/Oceania,908543,0,27
2020-08-09,fiji,Australia/Oceania,908543,0,27
2020-08-10,fiji,Australia/Oceania,908543,0,27
2020-08-11,fiji,Australia/Oceania,908543,0,27
2020-08-12,fiji,Australia/Oceania,908543,0,27
2020-08-13,fiji,Australia/Oceania,908543,1,28
2020-08-14,fiji,Australia/Oceania,908543,0,28
2020-08-15,fiji,Australia/Oceania,908543,0,28
2020-08-16,fiji,Australia/Oceania,908543,0,28
2020-08-17,fiji,Australia/Oceania,908543,0,28
2020-08-18,fiji,Australia/Oceania,908543,0,28
2020-08-19,fiji,Australia/Oceania,908543,0,28
2020-08-20,fiji,Australia/Oceania,908543,0,28
2020-08-21,fiji,Australia/Oceania,908543,0,28
2020-08-22,fiji,Australia/Oceania,908543,0,28
2020-08-23,fiji,Australia/Oceania,908543,0,28
2020-08-24,fiji,Australia/Oceania,908543,0,28
2020-08-25,fiji,Australia/Oceania,908543,0,28
2020-08-26,fiji,Australia/Oceania,908543,0,28
2020-08-27,fiji,Australia/Oceania,908543,0,28
2020-08-28,fiji,Australia/Oceania,908543,0,28
2020-08-29,fiji,Australia/Oceania,908543,0,28
2020-08-30,fiji,Australia/Oceania,908543,0,28
2020-08-31,fiji,Australia/Oceania,908543,0,28
2020-09-01,fiji,Australia/Oceania,908543,1,29
2020-09-02,fiji,Australia/Oceania,908543,0,29
2020-09-03,fiji,Australia/Oceania,908543,0,29
2020-09-04,fiji,Australia/Oceania,908543,0,29
2020-09-05,fiji,Australia/Oceania,908543,2,31
2020-09-06,fiji,Australia/Oceania,908543,0,31
2020-09-07,fiji,Australia/Oceania,908543,0,31
2020-09-08,fiji,Australia/Oceania,908543,0,31
2020-09-09,fiji,Australia/Oceania,908543,1,32
2020-09-10,fiji,Australia/Oceania,908543,0,32
2020-09-11,fiji,Australia/Oceania,908543,0,32
2020-09-12,fiji,Australia/Oceania,908543,0,32
2020-09-13,fiji,Australia/Oceania,908543,0,32
2020-09-14,fiji,Australia/Oceania,908543,0,32
2020-09-15,fiji,Australia/Oceania,908543,0,32
2020-09-16,fiji,Australia/Oceania,908543,0,32
2020-09-17,fiji,Australia/Oceania,908543,0,32
2020-09-18,fiji,Australia/Oceania,908543,0,32
2020-09-19,fiji,Australia/Oceania,908543,0,32
2020-09-20,fiji,Australia/Oceania,908543,0,32
2020-09-21,fiji,Australia/Oceania,908543,0,32
2020-09-22,fiji,Australia/Oceania,908543,0,32
2020-09-23,fiji,Australia/Oceania,908543,0,32
2020-09-24,fiji,Australia/Oceania,908543,0,32
2020-09-25,fiji,Australia/Oceania,908543,0,32
2020-09-26,fiji,Australia/Oceania,908543,0,32
2020-09-27,fiji,Australia/Oceania,908543,0,32
2020-09-28,fiji,Australia/Oceania,908543,0,32
2020-09-29,fiji,Australia/Oceania,908543,0,32
2020-09-30,fiji,Australia/Oceania,908543,0,32
2020-10-01,fiji,Australia/Oceania,908543,0,32
2020-10-02,fiji,Australia/Oceania,908543,0,32
2020-10-03,fiji,Australia/Oceania,908543,0,32
2020-10-04,fiji,Australia/Oceania,908543,0,32
2020-10-05,fiji,Australia/Oceania,908543,0,32
2020-10-06,fiji,Australia/Oceania,908543,0,32
2020-10-07,fiji,Australia/Oceania,908543,0,32
2020-10-08,fiji,Australia/Oceania,908543,0,32
2020-10-09,fiji,Australia/Oceania,908543,0,32
2020-10-10,fiji,Australia/Oceania,908543,0,32
2020-10-11,fiji,Australia/Oceania,908543,0,32
2020-10-12,fiji,Australia/Oceania,908543,0,32
2020-10-13,fiji,Australia/Oceania,908543,0,32
2020-10-14,fiji,Australia/Oceania,908543,0,32
2020-10-15,fiji,Australia/Oceania,908543,0,32
2020-10-16,fiji,Australia/Oceania,908543,0,32
2020-10-17,fiji,Australia/Oceania,908543,0,32
2020-10-18,fiji,Australia/Oceania,908543,0,32
2020-10-19,fiji,Australia/Oceania,908543,0,32
2020-10-20,fiji,Australia/Oceania,908543,0,32
2020-10-21,fiji,Australia/Oceania,908543,1,33
2020-10-22,fiji,Australia/Oceania,908543,0,33
2020-10-23,fiji,Australia/Oceania,908543,0,33
2020-10-24,fiji,Australia/Oceania,908543,0,33
2020-10-25,fiji,Australia/Oceania,908543,0,33
2020-10-26,fiji,Australia/Oceania,908543,0,33
2020-10-27,fiji,Australia/Oceania,908543,0,33
2020-10-28,fiji,Australia/Oceania,908543,0,33
2020-10-29,fiji,Australia/Oceania,908543,0,33
2020-10-30,fiji,Australia/Oceania,908543,1,34
2020-10-31,fiji,Australia/Oceania,908543,0,34
2020-11-01,fiji,Australia/Oceania,908543,0,34
2020-11-02,fiji,Australia/Oceania,908543,0,34
2020-11-03,fiji,Australia/Oceania,908543,0,34
2020-11-04,fiji,Australia/Oceania,908543,0,34
2020-11-05,fiji,Australia/Oceania,908543,0,34
2020-11-06,fiji,Australia/Oceania,908543,0,34
2020-11-07,fiji,Australia/Oceania,908543,0,34
2020-11-08,fiji,Australia/Oceania,908543,0,34
2020-11-09,fiji,Australia/Oceania,908543,0,34
2020-11-10,fiji,Australia/Oceania,908543,0,34
2020-11-11,fiji,Australia/Oceania,908543,1,35
2020-11-12,fiji,Australia/Oceania,908543,0,35
2020-11-13,fiji,Australia/Oceania,908543,0,35
2020-11-14,fiji,Australia/Oceania,908543,0,35
2020-11-15,fiji,Australia/Oceania,908543,0,35
2020-11-16,fiji,Australia/Oceania,908543,0,35
2020-11-17,fiji,Australia/Oceania,908543,0,35
2020-11-18,fiji,Australia/Oceania,908543,0,35
2020-11-19,fiji,Australia/Oceania,908543,0,35
2020-11-20,fiji,Australia/Oceania,908543,0,35
2020-11-21,fiji,Australia/Oceania,908543,0,35
2020-11-22,fiji,Australia/Oceania,908543,0,35
2020-02-16,france,Europe,65542502,0,12
2020-02-17,france,Europe,65542502,0,12
2020-02-18,france,Europe,65542502,0,12
2020-02-19,france,Europe,65542502,0,12
2020-02-20,france,Europe,65542502,0,12
2020-02-21,france,Europe,65542502,0,12
2020-02-22,france,Europe,65542502,0,12
2020-02-23,france,Europe,65542502,0,12
2020-02-24,france,Europe,65542502,0,12
2020-02-25,france,Europe,65542502,2,14
2020-02-26,france,Europe,65542502,4,18
2020-02-27,france,Europe,65542502,19,37
2020-02-28,france,Europe,65542502,18,55
2020-02-29,france,Europe,65542502,39,94
2020-03-01,france,Europe,65542502,27,121
2020-03-02,france,Europe,65542502,56,177
2020-03-03,france,Europe,65542502,20,197
2020-03-04,france,Europe,65542502,67,264
2020-03-05,france,Europe,65542502,126,390
2020-03-06,france,Europe,65542502,209,599
2020-03-07,france,Europe,65542502,269,868
2020-03-08,france,Europe,65542502,236,1104
2020-03-09,france,Europe,65542502,185,1289
2020-03-10,france,Europe,65542502,338,1627
2020-03-11,france,Europe,65542502,452,2079
2020-03-12,france,Europe,65542502,540,2619
2020-03-13,france,Europe,65542502,714,3333
2020-03-14,france,Europe,65542502,761,4094
2020-03-15,france,Europe,65542502,840,4934
2020-03-16,france,Europe,65542502,1100,6034
2020-03-17,france,Europe,65542502,997,7031
2020-03-18,france,Europe,65542502,1277,8308
2020-03-19,france,Europe,65542502,1691,9999
2020-03-20,france,Europe,65542502,1469,11468
2020-03-21,france,Europe,65542502,1678,13146
2020-03-22,france,Europe,65542502,1417,14563
2020-03-23,france,Europe,65542502,3488,18051
2020-03-24,france,Europe,65542502,2224,20275
2020-03-25,france,Europe,65542502,2662,22937
2020-03-26,france,Europe,65542502,3564,26501
2020-03-27,france,Europe,65542502,3462,29963
2020-03-28,france,Europe,65542502,4191,34154
2020-03-29,france,Europe,65542502,2362,36516
2020-03-30,france,Europe,65542502,3977,40493
2020-03-31,france,Europe,65542502,6887,47380
2020-04-01,france,Europe,65542502,4418,51798
2020-04-02,france,Europe,65542502,1923,53721
2020-04-03,france,Europe,65542502,4755,58476
2020-04-04,france,Europe,65542502,3877,62353
2020-04-05,france,Europe,65542502,1703,64056
2020-04-06,france,Europe,65542502,3555,67611
2020-04-07,france,Europe,65542502,3432,71043
2020-04-08,france,Europe,65542502,3526,74569
2020-04-09,france,Europe,65542502,3895,78464
2020-04-10,france,Europe,65542502,3946,82410
2020-04-11,france,Europe,65542502,2829,85239
2020-04-12,france,Europe,65542502,1466,86705
2020-04-13,france,Europe,65542502,2428,89133
2020-04-14,france,Europe,65542502,4996,94129
2020-04-15,france,Europe,65542502,2393,96522
2020-04-16,france,Europe,65542502,2400,98922
2020-04-17,france,Europe,65542502,368,99290
2020-04-18,france,Europe,65542502,2335,101625
2020-04-19,france,Europe,65542502,714,102339
2020-04-20,france,Europe,65542502,1864,104203
2020-04-21,france,Europe,65542502,2423,106626
2020-04-22,france,Europe,65542502,1661,108287
2020-04-23,france,Europe,65542502,1502,109789
2020-04-24,france,Europe,65542502,1611,111400
2020-04-25,france,Europe,65542502,1397,112797
2020-04-26,france,Europe,65542502,419,113216
2020-04-27,france,Europe,65542502,3420,116636
2020-04-28,france,Europe,65542502,1381,118017
2020-04-29,france,Europe,65542502,1675,119692
2020-04-30,france,Europe,65542502,1061,120753
2020-05-01,france,Europe,65542502,563,121316
2020-05-02,france,Europe,65542502,740,122056
2020-05-03,france,Europe,65542502,287,122343
2020-05-04,france,Europe,65542502,537,122880
2020-05-05,france,Europe,65542502,1029,123909
2020-05-06,france,Europe,65542502,3898,127807
2020-05-07,france,Europe,65542502,586,128393
2020-05-08,france,Europe,65542502,598,128991
2020-05-09,france,Europe,65542502,403,129394
2020-05-10,france,Europe,65542502,195,129589
2020-05-11,france,Europe,65542502,425,130014
2020-05-12,france,Europe,65542502,659,130673
2020-05-13,france,Europe,65542502,473,131146
2020-05-14,france,Europe,65542502,580,131726
2020-05-15,france,Europe,65542502,524,132250
2020-05-16,france,Europe,65542502,347,132597
2020-05-17,france,Europe,65542502,112,132709
2020-05-18,france,Europe,65542502,459,133168
2020-05-19,france,Europe,65542502,489,133657
2020-05-20,france,Europe,65542502,389,134046
2020-05-21,france,Europe,65542502,296,134342
2020-05-22,france,Europe,65542502,366,134708
2020-05-23,france,Europe,65542502,233,134941
2020-05-24,france,Europe,65542502,107,135048
2020-05-25,france,Europe,65542502,334,135382
2020-05-26,france,Europe,65542502,257,135639
2020-05-27,france,Europe,65542502,178,135817
2020-05-28,france,Europe,65542502,3098,138915
2020-05-29,france,Europe,65542502,556,139471
2020-05-30,france,Europe,65542502,1703,141174
2020-05-31,france,Europe,65542502,239,141413
2020-06-01,france,Europe,65542502,315,141728
2020-06-02,france,Europe,65542502,283,142011
2020-06-03,france,Europe,65542502,330,142341
2020-06-04,france,Europe,65542502,720,143061
2020-06-05,france,Europe,65542502,573,143634
2020-06-06,france,Europe,65542502,543,144177
2020-06-07,france,Europe,65542502,322,144499
2020-06-08,france,Europe,65542502,198,144697
2020-06-09,france,Europe,65542502,378,145075
2020-06-10,france,Europe,65542502,511,145586
2020-06-11,france,Europe,65542502,399,145985
2020-06-12,france,Europe,65542502,681,146666
2020-06-13,france,Europe,65542502,494,147160
2020-06-14,france,Europe,65542502,382,147542
2020-06-15,france,Europe,65542502,143,147685
2020-06-16,france,Europe,65542502,323,148008
2020-06-17,france,Europe,65542502,430,148438
2020-06-18,france,Europe,65542502,438,148876
2020-06-19,france,Europe,65542502,761,149637
2020-06-20,france,Europe,65542502,602,150239
2020-06-21,france,Europe,65542502,267,150506
2020-06-22,france,Europe,65542502,350,150856
2020-06-23,france,Europe,65542502,485,151341
2020-06-24,france,Europe,65542502,76,151417
2020-06-25,france,Europe,65542502,0,151417
2020-06-26,france,Europe,65542502,1490,152907
2020-06-27,france,Europe,65542502,490,153397
2020-06-28,france,Europe,65542502,490,153887
2020-06-29,france,Europe,65542502,263,154150
2020-06-30,france,Europe,65542502,508,154658
2020-07-01,france,Europe,65542502,861,155519
2020-07-02,france,Europe,65542502,618,156137
2020-07-03,france,Europe,65542502,546,156683
2020-07-04,france,Europe,65542502,526,157209
2020-07-05,france,Europe,65542502,600,157809
2020-07-06,france,Europe,65542502,165,157974
2020-07-07,france,Europe,65542502,446,158420
2020-07-08,france,Europe,65542502,622,159042
2020-07-09,france,Europe,65542502,583,159625
2020-07-10,france,Europe,65542502,617,160242
2020-07-11,france,Europe,65542502,628,160870
2020-07-12,france,Europe,65542502,627,161497
2020-07-13,france,Europe,65542502,270,161767
2020-07-14,france,Europe,65542502,480,162247
2020-07-15,france,Europe,65542502,390,162637
2020-07-16,france,Europe,65542502,501,163138
2020-07-17,france,Europe,65542502,785,163923
2020-07-18,france,Europe,65542502,812,164735
2020-07-19,france,Europe,65542502,812,165547
2020-07-20,france,Europe,65542502,328,165875
2020-07-21,france,Europe,65542502,548,166423
2020-07-22,france,Europe,65542502,937,167360
2020-07-23,france,Europe,65542502,997,168357
2020-07-24,france,Europe,65542502,1060,169417
2020-07-25,france,Europe,65542502,956,170373
2020-07-26,france,Europe,65542502,955,171328
2020-07-27,france,Europe,65542502,482,171810
2020-07-28,france,Europe,65542502,680,172490
2020-07-29,france,Europe,65542502,1306,173796
2020-07-30,france,Europe,65542502,1292,175088
2020-07-31,france,Europe,65542502,1263,176351
2020-08-01,france,Europe,65542502,0,176351
2020-08-02,france,Europe,65542502,2646,178997
2020-08-03,france,Europe,65542502,522,179519
2020-08-04,france,Europe,65542502,975,180494
2020-08-05,france,Europe,65542502,1591,182085
2020-08-06,france,Europe,65542502,1505,183590
2020-08-07,france,Europe,65542502,2147,185737
2020-08-08,france,Europe,65542502,1910,187647
2020-08-09,france,Europe,65542502,1909,189556
2020-08-10,france,Europe,65542502,737,190293
2020-08-11,france,Europe,65542502,1311,191604
2020-08-12,france,Europe,65542502,2369,193973
2020-08-13,france,Europe,65542502,2505,196478
2020-08-14,france,Europe,65542502,2671,199149
2020-08-15,france,Europe,65542502,3106,202255
2020-08-16,france,Europe,65542502,2829,205084
2020-08-17,france,Europe,65542502,463,205547
2020-08-18,france,Europe,65542502,2100,207647
2020-08-19,france,Europe,65542502,3544,211191
2020-08-20,france,Europe,65542502,4477,215668
2020-08-21,france,Europe,65542502,4304,219972
2020-08-22,france,Europe,65542502,3380,223352
2020-08-23,france,Europe,65542502,4596,227948
2020-08-24,france,Europe,65542502,1835,229783
2020-08-25,france,Europe,65542502,3101,232884
2020-08-26,france,Europe,65542502,5095,237979
2020-08-27,france,Europe,65542502,5735,243714
2020-08-28,france,Europe,65542502,6925,250639
2020-08-29,france,Europe,65542502,5117,255756
2020-08-30,france,Europe,65542502,5080,260836
2020-08-31,france,Europe,65542502,2892,263728
2020-09-01,france,Europe,65542502,4675,268403
2020-09-02,france,Europe,65542502,6585,274988
2020-09-03,france,Europe,65542502,6716,281704
2020-09-04,france,Europe,65542502,8423,290127
2020-09-05,france,Europe,65542502,8024,298151
2020-09-06,france,Europe,65542502,6636,304787
2020-09-07,france,Europe,65542502,3944,308731
2020-09-08,france,Europe,65542502,6141,314872
2020-09-09,france,Europe,65542502,8049,322921
2020-09-10,france,Europe,65542502,9237,332158
2020-09-11,france,Europe,65542502,8827,340985
2020-09-12,france,Europe,65542502,9911,350896
2020-09-13,france,Europe,65542502,6741,357637
2020-09-14,france,Europe,65542502,5779,363416
2020-09-15,france,Europe,65542502,7369,370785
2020-09-16,france,Europe,65542502,9182,379967
2020-09-17,france,Europe,65542502,9941,389908
2020-09-18,france,Europe,65542502,12402,402310
2020-09-19,france,Europe,65542502,12667,414977
2020-09-20,france,Europe,65542502,9918,424895
2020-09-21,france,Europe,65542502,4972,429867
2020-09-22,france,Europe,65542502,9392,439259
2020-09-23,france,Europe,65542502,12267,451526
2020-09-24,france,Europe,65542502,15105,466631
2020-09-25,france,Europe,65542502,14825,481456
2020-09-26,france,Europe,65542502,13525,494981
2020-09-27,france,Europe,65542502,10438,505419
2020-09-28,france,Europe,65542502,3819,509238
2020-09-29,france,Europe,65542502,7555,516793
2020-09-30,france,Europe,65542502,12054,528847
2020-10-01,france,Europe,65542502,13110,541957
2020-10-02,france,Europe,65542502,11400,553357
2020-10-03,france,Europe,65542502,15927,569284
2020-10-04,france,Europe,65542502,11792,581076
2020-10-05,france,Europe,65542502,4771,585847
2020-10-06,france,Europe,65542502,9843,595690
2020-10-07,france,Europe,65542502,17592,613282
2020-10-08,france,Europe,65542502,17013,630295
2020-10-09,france,Europe,65542502,19087,649382
2020-10-10,france,Europe,65542502,25240,674622
2020-10-11,france,Europe,65542502,15110,689732
2020-10-12,france,Europe,65542502,7981,697713
2020-10-13,france,Europe,65542502,12193,709906
2020-10-14,france,Europe,65542502,21200,731106
2020-10-15,france,Europe,65542502,28736,759842
2020-10-16,france,Europe,65542502,23542,783384
2020-10-17,france,Europe,65542502,30431,813815
2020-10-18,france,Europe,65542502,28000,841815
2020-10-19,france,Europe,65542502,12428,854243
2020-10-20,france,Europe,65542502,19208,873451
2020-10-21,france,Europe,65542502,25034,898485
2020-10-22,france,Europe,65542502,39060,937545
2020-10-23,france,Europe,65542502,39445,976990
2020-10-24,france,Europe,65542502,42626,1019616
2020-10-25,france,Europe,65542502,48808,1068424
2020-10-26,france,Europe,65542502,25123,1093547
2020-10-27,france,Europe,65542502,31360,1124907
2020-10-28,france,Europe,65542502,34194,1159101
2020-10-29,france,Europe,65542502,44705,1203806
2020-10-30,france,Europe,65542502,46185,1249991
2020-10-31,france,Europe,65542502,33447,1283438
2020-11-01,france,Europe,65542502,45258,1328696
2020-11-02,france,Europe,65542502,51104,1379800
2020-11-03,france,Europe,65542502,35912,1415712
2020-11-04,france,Europe,65542502,39880,1455592
2020-11-05,france,Europe,65542502,56292,1511884
2020-11-06,france,Europe,65542502,58581,1570465
2020-11-07,france,Europe,65542502,83324,1653789
2020-11-08,france,Europe,65542502,38059,1691848
2020-11-09,france,Europe,65542502,20732,1712580
2020-11-10,france,Europe,65542502,22632,1735212
2020-11-11,france,Europe,65542502,35488,1770700
2020-11-12,france,Europe,65542502,32948,1803648
2020-11-13,france,Europe,65542502,24147,1827795
2020-11-14,france,Europe,65542502,31937,1859732
2020-11-15,france,Europe,65542502,27370,1887102
2020-11-16,france,Europe,65542502,10645,1897747
2020-11-17,france,Europe,65542502,13630,1911377
2020-11-18,france,Europe,65542502,26636,1938013
2020-11-19,france,Europe,65542502,19848,1957861
2020-11-20,france,Europe,65542502,21473,1979334
2020-11-21,france,Europe,65542502,16780,1996114
2020-11-22,france,Europe,65542502,12347,2008461
2020-11-23,france,Europe,65542502,4178,2012639
2020-11-24,france,Europe,65542502,8591,2021230
2020-11-25,france,Europe,65542502,15280,2036510
2020-11-26,france,Europe,65542502,12728,2049238
2020-11-27,france,Europe,65542502,11692,2060930
2020-11-28,france,Europe,65542502,11806,2072736
2020-11-29,france,Europe,65542502,9182,2081918
2020-11-30,france,Europe,65542502,3758,2085676
2020-12-01,france,Europe,65542502,7585,2093261
2020-12-02,france,Europe,65542502,13198,2106459
2020-12-03,france,Europe,65542502,11914,2118373
2020-12-04,france,Europe,65542502,10530,2128903
2020-12-05,france,Europe,65542502,12127,2141030
2020-12-06,france,Europe,65542502,10344,2151374
2020-12-07,france,Europe,65542502,3201,2154575
2020-12-08,france,Europe,65542502,12869,2167444
2020-12-09,france,Europe,65542502,13697,2181141
2020-12-10,france,Europe,65542502,12904,2194045
2020-12-11,france,Europe,65542502,12581,2206626
2020-12-12,france,Europe,65542502,13088,2219714
2020-12-13,france,Europe,65542502,10823,2230537
2020-12-14,france,Europe,65542502,2874,2233411
2020-12-15,france,Europe,65542502,10822,2244233
2020-12-16,france,Europe,65542502,16531,2260764
2020-12-17,france,Europe,65542502,17130,2277894
2020-12-18,france,Europe,65542502,14709,2292603
2020-12-19,france,Europe,65542502,16484,2309087
2020-12-20,france,Europe,65542502,12011,2321098
2020-12-21,france,Europe,65542502,5440,2326538
2020-12-22,france,Europe,65542502,11069,2337607
2020-12-23,france,Europe,65542502,14010,2351617
2020-12-24,france,Europe,65542502,20302,2371919
2020-12-25,france,Europe,65542502,19015,2390934
2020-12-26,france,Europe,65542502,2903,2393837
2020-12-27,france,Europe,65542502,8279,2402116
2020-12-28,france,Europe,65542502,2778,2404894
2020-12-29,france,Europe,65542502,10694,2415588
2020-12-30,france,Europe,65542502,24828,2440416
2020-12-31,france,Europe,65542502,18700,2459116
2021-01-01,france,Europe,65542502,18157,2477273
2021-01-02,france,Europe,65542502,3253,2480526
2021-01-03,france,Europe,65542502,11720,2492246
2021-01-04,france,Europe,65542502,3774,2496020
2021-01-05,france,Europe,65542502,19228,2515248
2021-01-06,france,Europe,65542502,23817,2539065
2021-01-07,france,Europe,65542502,20367,2559432
2021-01-08,france,Europe,65542502,18594,2578026
2021-01-09,france,Europe,65542502,18935,2596961
2021-01-10,france,Europe,65542502,14963,2611924
2021-01-11,france,Europe,65542502,3362,2615286
2021-01-12,france,Europe,65542502,18536,2633822
2021-01-13,france,Europe,65542502,22384,2656206
2021-01-14,france,Europe,65542502,19921,2676127
2021-01-15,france,Europe,65542502,19962,2696089
2021-01-16,france,Europe,65542502,20088,2716177
2021-01-17,france,Europe,65542502,15618,2731795
2021-01-18,france,Europe,65542502,3506,2735301
2021-01-19,france,Europe,65542502,22155,2757456
2021-01-20,france,Europe,65542502,25135,2782591
2021-01-21,france,Europe,65542502,21442,2804033
2021-01-22,france,Europe,65542502,21858,2825891
2021-01-23,france,Europe,65542502,22451,2848342
2021-01-24,france,Europe,65542502,17301,2865643
2021-01-25,france,Europe,65542502,3979,2869622
2021-01-26,france,Europe,65542502,20726,2890348
2021-01-27,france,Europe,65542502,25259,2915607
2021-01-28,france,Europe,65542502,22307,2937914
2021-01-29,france,Europe,65542502,21451,2959365
2021-01-30,france,Europe,65542502,22890,2982255
2021-01-31,france,Europe,65542502,18051,3000306
2021-02-01,france,Europe,65542502,4079,3004385
2021-02-02,france,Europe,65542502,21900,3026285
2021-02-03,france,Europe,65542502,24739,3051024
2021-02-04,france,Europe,65542502,22005,3073029
2021-02-05,france,Europe,65542502,20776,3093805
2021-02-06,france,Europe,65542502,19319,3113124
2021-02-07,france,Europe,65542502,18501,3131625
2021-02-08,france,Europe,65542502,4051,3135676
2021-02-09,france,Europe,65542502,17708,3153384
2021-02-10,france,Europe,65542502,23824,3177208
2021-02-11,france,Europe,65542502,19766,3196974
2021-02-12,france,Europe,65542502,19427,3216401
2021-02-13,france,Europe,65542502,19924,3236325
2021-02-14,france,Europe,65542502,15527,3251852
2021-02-15,france,Europe,65542502,4107,3255959
2021-02-16,france,Europe,65542502,18384,3274343
2021-02-17,france,Europe,65542502,23478,3297821
2021-02-18,france,Europe,65542502,21116,3318937
2021-02-19,france,Europe,65542502,22631,3341568
2021-02-20,france,Europe,65542502,20994,3362562
2021-02-21,france,Europe,65542502,20689,3383251
2021-02-22,france,Europe,65542502,4360,3387611
2021-02-23,france,Europe,65542502,18829,3406440
2021-02-24,france,Europe,65542502,29579,3436019
2021-02-25,france,Europe,65542502,23839,3459858
2021-02-26,france,Europe,65542502,23655,3483513
2021-02-27,france,Europe,65542502,22519,3506032
2021-02-28,france,Europe,65542502,18724,3524756
2021-03-01,france,Europe,65542502,4413,3529169
2021-03-02,france,Europe,65542502,21450,3550619
2021-03-03,france,Europe,65542502,25139,3575758
2021-03-04,france,Europe,65542502,23723,3599481
2021-03-05,france,Europe,65542502,22060,3621541
2021-03-06,france,Europe,65542502,21871,3643412
2021-03-07,france,Europe,65542502,20482,3663894
2021-03-08,france,Europe,65542502,4999,3668893
2021-03-09,france,Europe,65542502,21868,3690761
2021-03-10,france,Europe,65542502,28438,3719199
2021-03-11,france,Europe,65542502,25494,3744693
2021-03-12,france,Europe,65542502,23676,3768369
2021-03-13,france,Europe,65542502,27927,3796296
2021-03-14,france,Europe,65542502,24721,3821017
2021-03-15,france,Europe,65542502,6073,3827090
2021-03-16,france,Europe,65542502,28130,3855220
2021-03-17,france,Europe,65542502,36131,3891351
2021-03-18,france,Europe,65542502,32844,3924195
2021-03-19,france,Europe,65542502,32911,3957106
2021-03-20,france,Europe,65542502,33169,3990275
2021-03-21,france,Europe,65542502,28699,4018974
2021-03-22,france,Europe,65542502,35259,4054233
2021-03-23,france,Europe,65542502,23350,4077583
2021-03-24,france,Europe,65542502,31334,4108917
2021-03-25,france,Europe,65542502,42831,4151748
2021-03-26,france,Europe,65542502,39292,4191040
2021-03-27,france,Europe,65542502,39995,4231035
2021-03-28,france,Europe,65542502,34736,4265771
2021-03-29,france,Europe,65542502,26843,4292614
2021-03-30,france,Europe,65542502,26580,4319194
2021-03-31,france,Europe,65542502,39327,4358521
2021-04-01,france,Europe,65542502,47541,4406062
2021-04-02,france,Europe,65542502,43804,4449866
2021-04-03,france,Europe,65542502,18571,4468437
2021-04-04,france,Europe,65542502,57172,4525609
2021-04-05,france,Europe,65542502,11576,4537185
2021-04-06,france,Europe,65542502,54241,4591426
2021-04-07,france,Europe,65542502,28890,4620316
2021-04-08,france,Europe,65542502,14892,4635208
2021-04-09,france,Europe,65542502,38704,4673912
2021-04-10,france,Europe,65542502,40620,4714532
2021-04-11,france,Europe,65542502,32747,4747279
2021-04-12,france,Europe,65542502,8011,4755290
2021-04-13,france,Europe,65542502,36705,4791995
2021-04-14,france,Europe,65542502,40827,4832822
2021-04-15,france,Europe,65542502,35703,4868525
2021-04-16,france,Europe,65542502,34199,4902724
2021-04-17,france,Europe,65542502,33653,4936377
2021-04-18,france,Europe,65542502,27538,4963915
2021-04-19,france,Europe,65542502,6847,4970762
2021-04-20,france,Europe,65542502,39882,5010644
2021-04-21,france,Europe,65542502,32815,5043459
2021-04-22,france,Europe,65542502,32205,5075664
2021-04-23,france,Europe,65542502,30349,5106013
2021-04-24,france,Europe,65542502,30624,5136637
2021-04-25,france,Europe,65542502,22959,5159596
2021-04-26,france,Europe,65542502,5586,5165182
2021-04-27,france,Europe,65542502,28451,5193633
2021-04-28,france,Europe,65542502,29598,5223231
2021-04-29,france,Europe,65542502,24904,5248135
2021-04-30,france,Europe,65542502,22803,5270938
2021-05-01,france,Europe,65542502,24090,5295028
2021-05-02,france,Europe,65542502,9279,5304307
2021-05-03,france,Europe,65542502,3529,5307836
2021-05-04,france,Europe,65542502,22871,5330707
2021-05-05,france,Europe,65542502,24400,5355107
2021-05-06,france,Europe,65542502,20375,5375482
2021-05-07,france,Europe,65542502,17947,5393429
2021-05-08,france,Europe,65542502,19468,5412897
2021-05-09,france,Europe,65542502,8566,5421463
2021-05-10,france,Europe,65542502,3089,5424552
2021-05-11,france,Europe,65542502,18573,5443125
2021-05-12,france,Europe,65542502,20175,5463300
2021-05-13,france,Europe,65542502,18263,5481563
2021-05-14,france,Europe,65542502,6593,5488156
2021-05-15,france,Europe,65542502,14719,5502875
2021-05-16,france,Europe,65542502,13089,5515964
2021-05-17,france,Europe,65542502,3144,5519108
2021-05-18,france,Europe,65542502,16151,5535259
2021-05-19,france,Europe,65542502,17877,5553136
2021-05-20,france,Europe,65542502,15415,5568551
2021-05-21,france,Europe,65542502,12800,5581351
2021-05-22,france,Europe,65542502,12611,5593962
2020-04-21,french_guiana,South America,313094,0,97
2020-04-22,french_guiana,South America,313094,10,107
2020-04-23,french_guiana,South America,313094,0,107
2020-04-24,french_guiana,South America,313094,4,111
2020-04-25,french_guiana,South America,313094,0,111
2020-04-26,french_guiana,South America,313094,0,111
2020-04-27,french_guiana,South America,313094,0,111
2020-04-28,french_guiana,South America,313094,14,125
2020-04-29,french_guiana,South America,313094,0,125
2020-04-30,french_guiana,South America,313094,1,126
2020-05-01,french_guiana,South America,313094,2,128
2020-05-02,french_guiana,South America,313094,0,128
2020-05-03,french_guiana,South America,313094,0,128
2020-05-04,french_guiana,South America,313094,5,133
2020-05-05,french_guiana,South America,313094,0,133
2020-05-06,french_guiana,South America,313094,5,138
2020-05-07,french_guiana,South America,313094,0,138
2020-05-08,french_guiana,South America,313094,3,141
2020-05-09,french_guiana,South America,313094,0,141
2020-05-10,french_guiana,South America,313094,3,144
2020-05-11,french_guiana,South America,313094,0,144
2020-05-12,french_guiana,South America,313094,9,153
2020-05-13,french_guiana,South America,313094,11,164
2020-05-14,french_guiana,South America,313094,20,184
2020-05-15,french_guiana,South America,313094,5,189
2020-05-16,french_guiana,South America,313094,8,197
2020-05-17,french_guiana,South America,313094,0,197
2020-05-18,french_guiana,South America,313094,13,210
2020-05-19,french_guiana,South America,313094,8,218
2020-05-20,french_guiana,South America,313094,19,237
2020-05-21,french_guiana,South America,313094,12,249
2020-05-22,french_guiana,South America,313094,12,261
2020-05-23,french_guiana,South America,313094,18,279
2020-05-24,french_guiana,South America,313094,49,328
2020-05-25,french_guiana,South America,313094,25,353
2020-05-26,french_guiana,South America,313094,31,384
2020-05-27,french_guiana,South America,313094,22,406
2020-05-28,french_guiana,South America,313094,30,436
2020-05-29,french_guiana,South America,313094,14,450
2020-05-30,french_guiana,South America,313094,27,477
2020-05-31,french_guiana,South America,313094,22,499
2020-06-01,french_guiana,South America,313094,0,499
2020-06-02,french_guiana,South America,313094,18,517
2020-06-03,french_guiana,South America,313094,16,533
2020-06-04,french_guiana,South America,313094,23,556
2020-06-05,french_guiana,South America,313094,33,589
2020-06-06,french_guiana,South America,313094,50,639
2020-06-07,french_guiana,South America,313094,50,689
2020-06-08,french_guiana,South America,313094,40,729
2020-06-09,french_guiana,South America,313094,44,773
2020-06-10,french_guiana,South America,313094,92,865
2020-06-11,french_guiana,South America,313094,52,917
2020-06-12,french_guiana,South America,313094,126,1043
2020-06-13,french_guiana,South America,313094,118,1161
2020-06-14,french_guiana,South America,313094,94,1255
2020-06-15,french_guiana,South America,313094,71,1326
2020-06-16,french_guiana,South America,313094,95,1421
2020-06-17,french_guiana,South America,313094,133,1554
2020-06-18,french_guiana,South America,313094,204,1758
2020-06-19,french_guiana,South America,313094,211,1969
2020-06-20,french_guiana,South America,313094,194,2163
2020-06-21,french_guiana,South America,313094,278,2441
2020-06-22,french_guiana,South America,313094,17,2458
2020-06-23,french_guiana,South America,313094,135,2593
2020-06-24,french_guiana,South America,313094,234,2827
2020-06-25,french_guiana,South America,313094,206,3033
2020-06-26,french_guiana,South America,313094,237,3270
2020-06-27,french_guiana,South America,313094,191,3461
2020-06-28,french_guiana,South America,313094,0,3461
2020-06-29,french_guiana,South America,313094,313,3774
2020-06-30,french_guiana,South America,313094,230,4004
2020-07-01,french_guiana,South America,313094,264,4268
2020-07-02,french_guiana,South America,313094,176,4444
2020-07-03,french_guiana,South America,313094,114,4558
2020-07-04,french_guiana,South America,313094,355,4913
2020-07-05,french_guiana,South America,313094,0,4913
2020-07-06,french_guiana,South America,313094,141,5054
2020-07-07,french_guiana,South America,313094,124,5178
2020-07-08,french_guiana,South America,313094,281,5459
2020-07-09,french_guiana,South America,313094,99,5558
2020-07-10,french_guiana,South America,313094,146,5704
2020-07-11,french_guiana,South America,313094,245,5949
2020-07-12,french_guiana,South America,313094,0,5949
2020-07-13,french_guiana,South America,313094,221,6170
2020-07-14,french_guiana,South America,313094,59,6229
2020-07-15,french_guiana,South America,313094,70,6299
2020-07-16,french_guiana,South America,313094,94,6393
2020-07-17,french_guiana,South America,313094,116,6509
2020-07-18,french_guiana,South America,313094,146,6655
2020-07-19,french_guiana,South America,313094,0,6655
2020-07-20,french_guiana,South America,313094,90,6745
2020-07-21,french_guiana,South America,313094,106,6851
2020-07-22,french_guiana,South America,313094,32,6883
2020-07-23,french_guiana,South America,313094,203,7086
2020-07-24,french_guiana,South America,313094,165,7251
2020-07-25,french_guiana,South America,313094,81,7332
2020-07-26,french_guiana,South America,313094,0,7332
2020-07-27,french_guiana,South America,313094,182,7514
2020-07-28,french_guiana,South America,313094,48,7562
2020-07-29,french_guiana,South America,313094,85,7647
2020-07-30,french_guiana,South America,313094,81,7728
2020-07-31,french_guiana,South America,313094,71,7799
2020-08-01,french_guiana,South America,313094,58,7857
2020-08-02,french_guiana,South America,313094,0,7857
2020-08-03,french_guiana,South America,313094,91,7948
2020-08-04,french_guiana,South America,313094,50,7998
2020-08-05,french_guiana,South America,313094,71,8069
2020-08-06,french_guiana,South America,313094,58,8127
2020-08-07,french_guiana,South America,313094,77,8204
2020-08-08,french_guiana,South America,313094,63,8267
2020-08-09,french_guiana,South America,313094,0,8267
2020-08-10,french_guiana,South America,313094,57,8324
2020-08-11,french_guiana,South America,313094,36,8360
2020-08-12,french_guiana,South America,313094,63,8423
2020-08-13,french_guiana,South America,313094,48,8471
2020-08-14,french_guiana,South America,313094,78,8549
2020-08-15,french_guiana,South America,313094,39,8588
2020-08-16,french_guiana,South America,313094,0,8588
2020-08-17,french_guiana,South America,313094,34,8622
2020-08-18,french_guiana,South America,313094,35,8657
2020-08-19,french_guiana,South America,313094,54,8711
2020-08-20,french_guiana,South America,313094,32,8743
2020-08-21,french_guiana,South America,313094,34,8777
2020-08-22,french_guiana,South America,313094,20,8797
2020-08-23,french_guiana,South America,313094,0,8797
2020-08-24,french_guiana,South America,313094,78,8875
2020-08-25,french_guiana,South America,313094,29,8904
2020-08-26,french_guiana,South America,313094,32,8936
2020-08-27,french_guiana,South America,313094,46,8982
2020-08-28,french_guiana,South America,313094,40,9022
2020-08-29,french_guiana,South America,313094,54,9076
2020-08-30,french_guiana,South America,313094,0,9076
2020-08-31,french_guiana,South America,313094,39,9115
2020-09-01,french_guiana,South America,313094,39,9154
2020-09-02,french_guiana,South America,313094,55,9209
2020-09-03,french_guiana,South America,313094,42,9251
2020-09-04,french_guiana,South America,313094,25,9276
2020-09-05,french_guiana,South America,313094,46,9322
2020-09-06,french_guiana,South America,313094,0,9322
2020-09-07,french_guiana,South America,313094,33,9355
2020-09-08,french_guiana,South America,313094,32,9387
2020-09-09,french_guiana,South America,313094,31,9418
2020-09-10,french_guiana,South America,313094,44,9462
2020-09-11,french_guiana,South America,313094,32,9494
2020-09-12,french_guiana,South America,313094,27,9521
2020-09-13,french_guiana,South America,313094,0,9521
2020-09-14,french_guiana,South America,313094,31,9552
2020-09-15,french_guiana,South America,313094,26,9578
2020-09-16,french_guiana,South America,313094,17,9595
2020-09-17,french_guiana,South America,313094,28,9623
2020-09-18,french_guiana,South America,313094,36,9659
2020-09-19,french_guiana,South America,313094,33,9692
2020-09-20,french_guiana,South America,313094,0,9692
2020-09-21,french_guiana,South America,313094,20,9712
2020-09-22,french_guiana,South America,313094,26,9738
2020-09-23,french_guiana,South America,313094,24,9762
2020-09-24,french_guiana,South America,313094,28,9790
2020-09-25,french_guiana,South America,313094,41,9831
2020-09-26,french_guiana,South America,313094,32,9863
2020-09-27,french_guiana,South America,313094,0,9863
2020-09-28,french_guiana,South America,313094,32,9895
2020-09-29,french_guiana,South America,313094,34,9929
2020-09-30,french_guiana,South America,313094,26,9955
2020-10-01,french_guiana,South America,313094,11,9966
2020-10-02,french_guiana,South America,313094,2,9968
2020-10-03,french_guiana,South America,313094,61,10029
2020-10-04,french_guiana,South America,313094,0,10029
2020-10-05,french_guiana,South America,313094,28,10057
2020-10-06,french_guiana,South America,313094,13,10070
2020-10-07,french_guiana,South America,313094,33,10103
2020-10-08,french_guiana,South America,313094,25,10128
2020-10-09,french_guiana,South America,313094,16,10144
2020-10-10,french_guiana,South America,313094,0,10144
2020-10-11,french_guiana,South America,313094,26,10170
2020-10-12,french_guiana,South America,313094,10,10180
2020-10-13,french_guiana,South America,313094,12,10192
2020-10-14,french_guiana,South America,313094,10,10202
2020-10-15,french_guiana,South America,313094,31,10233
2020-10-16,french_guiana,South America,313094,6,10239
2020-10-17,french_guiana,South America,313094,4,10243
2020-10-18,french_guiana,South America,313094,0,10243
2020-10-19,french_guiana,South America,313094,25,10268
2020-10-20,french_guiana,South America,313094,0,10268
2020-10-21,french_guiana,South America,313094,27,10295
2020-10-22,french_guiana,South America,313094,47,10342
2020-10-23,french_guiana,South America,313094,9,10351
2020-10-24,french_guiana,South America,313094,25,10376
2020-10-25,french_guiana,South America,313094,0,10376
2020-10-26,french_guiana,South America,313094,9,10385
2020-10-27,french_guiana,South America,313094,12,10397
2020-10-28,french_guiana,South America,313094,7,10404
2020-10-29,french_guiana,South America,313094,21,10425
2020-10-30,french_guiana,South America,313094,92,10517
2020-10-31,french_guiana,South America,313094,19,10536
2020-11-01,french_guiana,South America,313094,0,10536
2020-11-02,french_guiana,South America,313094,31,10567
2020-11-03,french_guiana,South America,313094,10,10577
2020-11-04,french_guiana,South America,313094,14,10591
2020-11-05,french_guiana,South America,313094,29,10620
2020-11-06,french_guiana,South America,313094,27,10647
2020-11-07,french_guiana,South America,313094,57,10704
2020-11-08,french_guiana,South America,313094,0,10704
2020-11-09,french_guiana,South America,313094,11,10715
2020-11-10,french_guiana,South America,313094,14,10729
2020-11-11,french_guiana,South America,313094,33,10762
2020-11-12,french_guiana,South America,313094,18,10780
2020-11-13,french_guiana,South America,313094,28,10808
2020-11-14,french_guiana,South America,313094,36,10844
2020-11-15,french_guiana,South America,313094,0,10844
2020-11-16,french_guiana,South America,313094,32,10876
2020-11-17,french_guiana,South America,313094,24,10900
2020-11-18,french_guiana,South America,313094,30,10930
2020-11-19,french_guiana,South America,313094,20,10950
2020-11-20,french_guiana,South America,313094,37,10987
2020-11-21,french_guiana,South America,313094,27,11014
2020-11-22,french_guiana,South America,313094,0,11014
2020-11-23,french_guiana,South America,313094,28,11042
2020-11-24,french_guiana,South America,313094,37,11079
2020-11-25,french_guiana,South America,313094,37,11116
2020-11-26,french_guiana,South America,313094,22,11138
2020-11-27,french_guiana,South America,313094,20,11158
2020-11-28,french_guiana,South America,313094,21,11179
2020-11-29,french_guiana,South America,313094,0,11179
2020-11-30,french_guiana,South America,313094,25,11204
2020-12-01,french_guiana,South America,313094,36,11240
2020-12-02,french_guiana,South America,313094,43,11283
2020-12-03,french_guiana,South America,313094,35,11318
2020-12-04,french_guiana,South America,313094,16,11334
2020-12-05,french_guiana,South America,313094,73,11407
2020-12-06,french_guiana,South America,313094,0,11407
2020-12-07,french_guiana,South America,313094,51,11458
2020-12-08,french_guiana,South America,313094,55,11513
2020-12-09,french_guiana,South America,313094,87,11600
2020-12-10,french_guiana,South America,313094,77,11677
2020-12-11,french_guiana,South America,313094,78,11755
2020-12-12,french_guiana,South America,313094,45,11800
2020-12-13,french_guiana,South America,313094,0,11800
2020-12-14,french_guiana,South America,313094,55,11855
2020-12-15,french_guiana,South America,313094,51,11906
2020-12-16,french_guiana,South America,313094,120,12026
2020-12-17,french_guiana,South America,313094,137,12163
2020-12-18,french_guiana,South America,313094,118,12281
2020-12-19,french_guiana,South America,313094,88,12369
2020-12-20,french_guiana,South America,313094,0,12369
2020-12-21,french_guiana,South America,313094,64,12433
2020-12-22,french_guiana,South America,313094,66,12499
2020-12-23,french_guiana,South America,313094,48,12547
2020-12-24,french_guiana,South America,313094,138,12685
2020-12-25,french_guiana,South America,313094,88,12773
2020-12-26,french_guiana,South America,313094,6,12779
2020-12-27,french_guiana,South America,313094,0,12779
2020-12-28,french_guiana,South America,313094,53,12832
2020-12-29,french_guiana,South America,313094,64,12896
2020-12-30,french_guiana,South America,313094,149,13045
2020-12-31,french_guiana,South America,313094,121,13166
2021-01-01,french_guiana,South America,313094,107,13273
2021-01-02,french_guiana,South America,313094,15,13288
2021-01-03,french_guiana,South America,313094,0,13288
2021-01-04,french_guiana,South America,313094,86,13374
2021-01-05,french_guiana,South America,313094,123,13497
2021-01-06,french_guiana,South America,313094,135,13632
2021-01-07,french_guiana,South America,313094,193,13825
2021-01-08,french_guiana,South America,313094,145,13970
2021-01-09,french_guiana,South America,313094,143,14113
2021-01-10,french_guiana,South America,313094,0,14113
2021-01-11,french_guiana,South America,313094,108,14221
2021-01-12,french_guiana,South America,313094,149,14370
2021-01-13,french_guiana,South America,313094,156,14526
2021-01-14,french_guiana,South America,313094,128,14654
2021-01-15,french_guiana,South America,313094,122,14776
2021-01-16,french_guiana,South America,313094,199,14975
2021-01-17,french_guiana,South America,313094,0,14975
2021-01-18,french_guiana,South America,313094,80,15055
2021-01-19,french_guiana,South America,313094,132,15187
2021-01-20,french_guiana,South America,313094,124,15311
2021-01-21,french_guiana,South America,313094,120,15431
2021-01-22,french_guiana,South America,313094,129,15560
2021-01-23,french_guiana,South America,313094,104,15664
2021-01-24,french_guiana,South America,313094,0,15664
2021-01-25,french_guiana,South America,313094,38,15702
2021-01-26,french_guiana,South America,313094,77,15779
2021-01-27,french_guiana,South America,313094,78,15857
2021-01-28,french_guiana,South America,313094,75,15932
2021-01-29,french_guiana,South America,313094,96,16028
2021-01-30,french_guiana,South America,313094,55,16083
2021-01-31,french_guiana,South America,313094,0,16083
2021-02-01,french_guiana,South America,313094,51,16134
2021-02-02,french_guiana,South America,313094,51,16185
2021-02-03,french_guiana,South America,313094,33,16218
2021-02-04,french_guiana,South America,313094,46,16264
2021-02-05,french_guiana,South America,313094,32,16296
2021-02-06,french_guiana,South America,313094,0,16296
2021-02-07,french_guiana,South America,313094,0,16296
2021-02-08,french_guiana,South America,313094,0,16296
2021-02-09,french_guiana,South America,313094,0,16296
2021-02-10,french_guiana,South America,313094,0,16296
2021-02-11,french_guiana,South America,313094,0,16296
2021-02-12,french_guiana,South America,313094,160,16456
2021-02-13,french_guiana,South America,313094,0,16456
2021-02-14,french_guiana,South America,313094,0,16456
2021-02-15,french_guiana,South America,313094,0,16456
2021-02-16,french_guiana,South America,313094,0,16456
2021-02-17,french_guiana,South America,313094,0,16456
2021-02-18,french_guiana,South America,313094,0,16456
2021-02-19,french_guiana,South America,313094,73,16529
2021-02-20,french_guiana,South America,313094,0,16529
2021-02-21,french_guiana,South America,313094,0,16529
2021-02-22,french_guiana,South America,313094,0,16529
2021-02-23,french_guiana,South America,313094,0,16529
2021-02-24,french_guiana,South America,313094,0,16529
2021-02-25,french_guiana,South America,313094,0,16529
2021-02-26,french_guiana,South America,313094,98,16627
2021-02-27,french_guiana,South America,313094,0,16627
2021-02-28,french_guiana,South America,313094,0,16627
2021-03-01,french_guiana,South America,313094,0,16627
2021-03-02,french_guiana,South America,313094,0,16627
2021-03-03,french_guiana,South America,313094,0,16627
2021-03-04,french_guiana,South America,313094,0,16627
2021-03-05,french_guiana,South America,313094,66,16693
2021-03-06,french_guiana,South America,313094,0,16693
2021-03-07,french_guiana,South America,313094,0,16693
2021-03-08,french_guiana,South America,313094,0,16693
2021-03-09,french_guiana,South America,313094,0,16693
2021-03-10,french_guiana,South America,313094,0,16693
2021-03-11,french_guiana,South America,313094,0,16693
2021-03-12,french_guiana,South America,313094,71,16764
2021-03-13,french_guiana,South America,313094,0,16764
2021-03-14,french_guiana,South America,313094,0,16764
2021-03-15,french_guiana,South America,313094,0,16764
2021-03-16,french_guiana,South America,313094,0,16764
2021-03-17,french_guiana,South America,313094,0,16764
2021-03-18,french_guiana,South America,313094,0,16764
2021-03-19,french_guiana,South America,313094,0,16764
2021-03-20,french_guiana,South America,313094,0,16764
2021-03-21,french_guiana,South America,313094,0,16764
2021-03-22,french_guiana,South America,313094,0,16764
2021-03-23,french_guiana,South America,313094,0,16764
2021-03-24,french_guiana,South America,313094,158,16922
2021-03-25,french_guiana,South America,313094,0,16922
2021-03-26,french_guiana,South America,313094,0,16922
2021-03-27,french_guiana,South America,313094,0,16922
2021-03-28,french_guiana,South America,313094,0,16922
2021-03-29,french_guiana,South America,313094,0,16922
2021-03-30,french_guiana,South America,313094,0,16922
2021-03-31,french_guiana,South America,313094,210,17132
2021-04-01,french_guiana,South America,313094,0,17132
2021-04-02,french_guiana,South America,313094,0,17132
2021-04-03,french_guiana,South America,313094,0,17132
2021-04-04,french_guiana,South America,313094,0,17132
2021-04-05,french_guiana,South America,313094,0,17132
2021-04-06,french_guiana,South America,313094,186,17318
2021-04-07,french_guiana,South America,313094,0,17318
2021-04-08,french_guiana,South America,313094,123,17441
2021-04-09,french_guiana,South America,313094,108,17549
2021-04-10,french_guiana,South America,313094,0,17549
2021-04-11,french_guiana,South America,313094,0,17549
2021-04-12,french_guiana,South America,313094,157,17706
2021-04-13,french_guiana,South America,313094,100,17806
2021-04-14,french_guiana,South America,313094,77,17883
2021-04-15,french_guiana,South America,313094,82,17965
2021-04-16,french_guiana,South America,313094,116,18081
2021-04-17,french_guiana,South America,313094,0,18081
2021-04-18,french_guiana,South America,313094,0,18081
2021-04-19,french_guiana,South America,313094,180,18261
2021-04-20,french_guiana,South America,313094,0,18261
2021-04-21,french_guiana,South America,313094,284,18545
2021-04-22,french_guiana,South America,313094,148,18693
2021-04-23,french_guiana,South America,313094,133,18826
2021-04-24,french_guiana,South America,313094,0,18826
2021-04-25,french_guiana,South America,313094,0,18826
2021-04-26,french_guiana,South America,313094,178,19004
2021-04-27,french_guiana,South America,313094,95,19099
2021-04-28,french_guiana,South America,313094,165,19264
2021-04-29,french_guiana,South America,313094,140,19404
2021-04-30,french_guiana,South America,313094,139,19543
2021-05-01,french_guiana,South America,313094,0,19543
2021-05-02,french_guiana,South America,313094,0,19543
2021-05-03,french_guiana,South America,313094,154,19697
2021-05-04,french_guiana,South America,313094,185,19882
2021-05-05,french_guiana,South America,313094,196,20078
2021-05-06,french_guiana,South America,313094,148,20226
2021-05-07,french_guiana,South America,313094,140,20366
2021-05-08,french_guiana,South America,313094,0,20366
2021-05-09,french_guiana,South America,313094,0,20366
2021-05-10,french_guiana,South America,313094,278,20644
2021-05-11,french_guiana,South America,313094,233,20877
2021-05-12,french_guiana,South America,313094,229,21106
2021-05-13,french_guiana,South America,313094,327,21433
2021-05-14,french_guiana,South America,313094,32,21465
2021-05-15,french_guiana,South America,313094,0,21465
2021-05-16,french_guiana,South America,313094,0,21465
2021-05-17,french_guiana,South America,313094,380,21845
2021-05-18,french_guiana,South America,313094,270,22115
2021-05-19,french_guiana,South America,313094,267,22382
2021-05-20,french_guiana,South America,313094,228,22610
2021-05-21,french_guiana,South America,313094,170,22780
2021-05-22,french_guiana,South America,313094,0,22780
2021-05-23,french_guiana,South America,313094,0,22780
2021-05-24,french_guiana,South America,313094,321,23101
2021-05-25,french_guiana,South America,313094,71,23172
2021-05-26,french_guiana,South America,313094,208,23380
2021-05-27,french_guiana,South America,313094,229,23609
2021-05-28,french_guiana,South America,313094,154,23763
2021-05-29,french_guiana,South America,313094,0,23763
2021-05-30,french_guiana,South America,313094,0,23763
2021-05-31,french_guiana,South America,313094,273,24036
2021-06-01,french_guiana,South America,313094,176,24212
2021-06-02,french_guiana,South America,313094,153,24365
2021-06-03,french_guiana,South America,313094,169,24534
2021-06-04,french_guiana,South America,313094,191,24725
2021-06-05,french_guiana,South America,313094,0,24725
2021-06-06,french_guiana,South America,313094,0,24725
2021-06-07,french_guiana,South America,313094,210,24935
2021-06-08,french_guiana,South America,313094,158,25093
2021-06-09,french_guiana,South America,313094,199,25292
2021-06-10,french_guiana,South America,313094,0,25292
2021-06-11,french_guiana,South America,313094,214,25506
2021-06-12,french_guiana,South America,313094,0,25506
2021-06-13,french_guiana,South America,313094,0,25506
2021-06-14,french_guiana,South America,313094,282,25788
2021-06-15,french_guiana,South America,313094,162,25950
2021-06-16,french_guiana,South America,313094,193,26143
2021-06-17,french_guiana,South America,313094,0,26143
2021-06-18,french_guiana,South America,313094,307,26450
2021-06-19,french_guiana,South America,313094,0,26450
2021-06-20,french_guiana,South America,313094,0,26450
2021-06-21,french_guiana,South America,313094,197,26647
2021-06-22,french_guiana,South America,313094,152,26799
2021-06-23,french_guiana,South America,313094,133,26932
2021-06-24,french_guiana,South America,313094,108,27040
2021-06-25,french_guiana,South America,313094,135,27175
2021-06-26,french_guiana,South America,313094,111,27286
2021-06-27,french_guiana,South America,313094,0,27286
2021-06-28,french_guiana,South America,313094,32,27318
2021-06-29,french_guiana,South America,313094,97,27415
2021-06-30,french_guiana,South America,313094,121,27536
2021-07-01,french_guiana,South America,313094,92,27628
2021-07-02,french_guiana,South America,313094,102,27730
2021-07-03,french_guiana,South America,313094,0,27730
2021-07-04,french_guiana,South America,313094,0,27730
2021-07-05,french_guiana,South America,313094,157,27887
2021-07-06,french_guiana,South America,313094,109,27996
2021-07-07,french_guiana,South America,313094,85,28081
2021-07-08,french_guiana,South America,313094,118,28199
2021-07-09,french_guiana,South America,313094,82,28281
2021-07-10,french_guiana,South America,313094,0,28281
2021-07-11,french_guiana,South America,313094,0,28281
2021-07-12,french_guiana,South America,313094,140,28421
2021-07-13,french_guiana,South America,313094,133,28554
2021-07-14,french_guiana,South America,313094,127,28681
2021-07-15,french_guiana,South America,313094,33,28714
2021-07-16,french_guiana,South America,313094,89,28803
2021-07-17,french_guiana,South America,313094,0,28803
2021-07-18,french_guiana,South America,313094,0,28803
2021-07-19,french_guiana,South America,313094,192,28995
2021-07-20,french_guiana,South America,313094,138,29133
2021-07-21,french_guiana,South America,313094,152,29285
2021-07-22,french_guiana,South America,313094,134,29419
2021-07-23,french_guiana,South America,313094,114,29533
2021-07-24,french_guiana,South America,313094,0,29533
2021-07-25,french_guiana,South America,313094,0,29533
2021-07-26,french_guiana,South America,313094,153,29686
2021-07-27,french_guiana,South America,313094,128,29814
2021-07-28,french_guiana,South America,313094,136,29950
2021-07-29,french_guiana,South America,313094,90,30040
2021-07-30,french_guiana,South America,313094,124,30164
2021-07-31,french_guiana,South America,313094,0,30164
2021-08-01,french_guiana,South America,313094,0,30164
2021-08-02,french_guiana,South America,313094,165,30329
2021-08-03,french_guiana,South America,313094,120,30449
2021-08-04,french_guiana,South America,313094,162,30611
2021-08-05,french_guiana,South America,313094,145,30756
2021-08-06,french_guiana,South America,313094,119,30875
2021-08-07,french_guiana,South America,313094,0,30875
2021-08-08,french_guiana,South America,313094,0,30875
2021-08-09,french_guiana,South America,313094,224,31099
2021-08-10,french_guiana,South America,313094,177,31276
2021-08-11,french_guiana,South America,313094,163,31439
2021-08-12,french_guiana,South America,313094,194,31633
2021-08-13,french_guiana,South America,313094,193,31826
2021-08-14,french_guiana,South America,313094,0,31826
2021-08-15,french_guiana,South America,313094,0,31826
2021-08-16,french_guiana,South America,313094,354,32180
2021-08-17,french_guiana,South America,313094,246,32426
2021-08-18,french_guiana,South America,313094,218,32644
2021-08-19,french_guiana,South America,313094,225,32869
2021-08-20,french_guiana,South America,313094,191,33060
2021-08-21,french_guiana,South America,313094,0,33060
2021-08-22,french_guiana,South America,313094,0,33060
2021-08-23,french_guiana,South America,313094,392,33452
2021-08-24,french_guiana,South America,313094,270,33722
2021-08-25,french_guiana,South America,313094,244,33966
2021-08-26,french_guiana,South America,313094,200,34166
2021-08-27,french_guiana,South America,313094,209,34375
2021-08-28,french_guiana,South America,313094,0,34375
2021-08-29,french_guiana,South America,313094,0,34375
2021-08-30,french_guiana,South America,313094,400,34775
2021-08-31,french_guiana,South America,313094,298,35073
2021-09-01,french_guiana,South America,313094,236,35309
2021-09-02,french_guiana,South America,313094,219,35528
2021-09-03,french_guiana,South America,313094,193,35721
2021-09-04,french_guiana,South America,313094,0,35721
2021-09-05,french_guiana,South America,313094,0,35721
2021-09-06,french_guiana,South America,313094,314,36035
2021-09-07,french_guiana,South America,313094,186,36221
2021-09-08,french_guiana,South America,313094,260,36481
2021-09-09,french_guiana,South America,313094,185,36666
2021-09-10,french_guiana,South America,313094,193,36859
2021-09-11,french_guiana,South America,313094,0,36859
2021-09-12,french_guiana,South America,313094,0,36859
2021-09-13,french_guiana,South America,313094,351,37210
2021-09-14,french_guiana,South America,313094,247,37457
2021-09-15,french_guiana,South America,313094,299,37756
2021-09-16,french_guiana,South America,313094,265,38021
2021-09-17,french_guiana,South America,313094,245,38266
2021-09-18,french_guiana,South America,313094,0,38266
2021-09-19,french_guiana,South America,313094,0,38266
2021-09-20,french_guiana,South America,313094,445,38711
2021-09-21,french_guiana,South America,313094,254,38965
2021-09-22,french_guiana,South America,313094,274,39239
2021-09-23,french_guiana,South America,313094,252,39491
2021-09-24,french_guiana,South America,313094,299,39790
2021-09-25,french_guiana,South America,313094,0,39790
2021-09-26,french_guiana,South America,313094,0,39790
2021-09-27,french_guiana,South America,313094,0,39790
2021-09-28,french_guiana,South America,313094,779,40569
2021-09-29,french_guiana,South America,313094,276,40845
2021-09-30,french_guiana,South America,313094,268,41113
2021-10-01,french_guiana,South America,313094,212,41325
2021-10-02,french_guiana,South America,313094,0,41325
2021-10-03,french_guiana,South America,313094,0,41325
2021-10-04,french_guiana,South America,313094,243,41568
2021-10-05,french_guiana,South America,313094,145,41713
2021-10-06,french_guiana,South America,313094,444,42157
2021-10-07,french_guiana,South America,313094,225,42382
2021-10-08,french_guiana,South America,313094,161,42543
2021-10-09,french_guiana,South America,313094,0,42543
2021-10-10,french_guiana,South America,313094,0,42543
2021-10-11,french_guiana,South America,313094,251,42794
2021-10-12,french_guiana,South America,313094,168,42962
2021-10-13,french_guiana,South America,313094,152,43114
2021-10-14,french_guiana,South America,313094,141,43255
2021-10-15,french_guiana,South America,313094,121,43376
2021-10-16,french_guiana,South America,313094,0,43376
2021-10-17,french_guiana,South America,313094,0,43376
2021-10-18,french_guiana,South America,313094,185,43561
2021-10-19,french_guiana,South America,313094,129,43690
2021-10-20,french_guiana,South America,313094,126,43816
2021-10-21,french_guiana,South America,313094,122,43938
2021-10-22,french_guiana,South America,313094,122,44060
2021-10-23,french_guiana,South America,313094,0,44060
2021-10-24,french_guiana,South America,313094,0,44060
2021-10-25,french_guiana,South America,313094,165,44225
2021-10-26,french_guiana,South America,313094,122,44347
2021-10-27,french_guiana,South America,313094,91,44438
2021-10-28,french_guiana,South America,313094,116,44554
2021-10-29,french_guiana,South America,313094,0,44554
2021-10-30,french_guiana,South America,313094,75,44629
2021-10-31,french_guiana,South America,313094,0,44629
2021-11-01,french_guiana,South America,313094,0,44629
2021-11-02,french_guiana,South America,313094,155,44784
2021-11-03,french_guiana,South America,313094,90,44874
2021-11-04,french_guiana,South America,313094,90,44964
2021-11-05,french_guiana,South America,313094,64,45028
2021-11-06,french_guiana,South America,313094,0,45028
2021-11-07,french_guiana,South America,313094,0,45028
2021-11-08,french_guiana,South America,313094,115,45143
2021-11-09,french_guiana,South America,313094,102,45245
2021-11-10,french_guiana,South America,313094,61,45306
2021-11-11,french_guiana,South America,313094,0,45306
2021-11-12,french_guiana,South America,313094,60,45366
2021-11-13,french_guiana,South America,313094,0,45366
2021-11-14,french_guiana,South America,313094,0,45366
2021-11-15,french_guiana,South America,313094,79,45445
2021-11-16,french_guiana,South America,313094,57,45502
2021-11-17,french_guiana,South America,313094,46,45548
2021-11-18,french_guiana,South America,313094,35,45583
2021-11-19,french_guiana,South America,313094,33,45616
2021-11-20,french_guiana,South America,313094,0,45616
2021-11-21,french_guiana,South America,313094,0,45616
2021-11-22,french_guiana,South America,313094,59,45675
2021-11-23,french_guiana,South America,313094,56,45731
2021-11-24,french_guiana,South America,313094,32,45763
2021-11-25,french_guiana,South America,313094,39,45802
2021-11-26,french_guiana,South America,313094,62,45864
2021-11-27,french_guiana,South America,313094,0,45864
2021-11-28,french_guiana,South America,313094,0,45864
2021-11-29,french_guiana,South America,313094,75,45939
2021-11-30,french_guiana,South America,313094,75,46014
2021-12-01,french_guiana,South America,313094,46,46060
2021-12-02,french_guiana,South America,313094,34,46094
2021-12-03,french_guiana,South America,313094,48,46142
2021-12-04,french_guiana,South America,313094,0,46142
2021-12-05,french_guiana,South America,313094,0,46142
2021-12-06,french_guiana,South America,313094,63,46205
2021-12-07,french_guiana,South America,313094,56,46261
2021-12-08,french_guiana,South America,313094,43,46304
2021-12-09,french_guiana,South America,313094,61,46365
2021-12-10,french_guiana,South America,313094,56,46421
2021-12-11,french_guiana,South America,313094,0,46421
2021-12-12,french_guiana,South America,313094,0,46421
2021-12-13,french_guiana,South America,313094,89,46510
2021-12-14,french_guiana,South America,313094,80,46590
2021-12-15,french_guiana,South America,313094,55,46645
2021-12-16,french_guiana,South America,313094,45,46690
2021-12-17,french_guiana,South America,313094,42,46732
2021-12-18,french_guiana,South America,313094,0,46732
2021-12-19,french_guiana,South America,313094,0,46732
2021-12-20,french_guiana,South America,313094,109,46841
2021-12-21,french_guiana,South America,313094,69,46910
2021-12-22,french_guiana,South America,313094,102,47012
2021-12-23,french_guiana,South America,313094,117,47129
2021-12-24,french_guiana,South America,313094,100,47229
2021-12-25,french_guiana,South America,313094,0,47229
2021-12-26,french_guiana,South America,313094,0,47229
2021-12-27,french_guiana,South America,313094,103,47332
2021-12-28,french_guiana,South America,313094,299,47631
2021-12-29,french_guiana,South America,313094,407,48038
2021-12-30,french_guiana,South America,313094,361,48399
2021-12-31,french_guiana,South America,313094,538,48937
2022-01-01,french_guiana,South America,313094,0,48937
2022-01-02,french_guiana,South America,313094,0,48937
2022-01-03,french_guiana,South America,313094,834,49771
2022-01-04,french_guiana,South America,313094,960,50731
2022-01-05,french_guiana,South America,313094,1734,52465
2022-01-06,french_guiana,South America,313094,1345,53810
2022-01-07,french_guiana,South America,313094,2170,55980
2022-01-08,french_guiana,South America,313094,0,55980
2022-01-09,french_guiana,South America,313094,0,55980
2022-01-10,french_guiana,South America,313094,4510,60490
2022-01-11,french_guiana,South America,313094,1190,61680
2022-01-12,french_guiana,South America,313094,2429,64109
2022-01-13,french_guiana,South America,313094,974,65083
2022-01-14,french_guiana,South America,313094,2192,67275
2022-01-15,french_guiana,South America,313094,0,67275
2022-01-16,french_guiana,South America,313094,0,67275
2022-01-17,french_guiana,South America,313094,2106,69381
2022-01-18,french_guiana,South America,313094,1102,70483
2022-01-19,french_guiana,South America,313094,993,71476
2022-01-20,french_guiana,South America,313094,642,72118
2022-01-21,french_guiana,South America,313094,701,72819
2022-01-22,french_guiana,South America,313094,0,72819
2022-01-23,french_guiana,South America,313094,0,72819
2020-03-24,gambia,Africa,2543054,1,3
2020-03-25,gambia,Africa,2543054,0,3
2020-03-26,gambia,Africa,2543054,0,3
2020-03-27,gambia,Africa,2543054,0,3
2020-03-28,gambia,Africa,2543054,0,3
2020-03-29,gambia,Africa,2543054,1,4
2020-03-30,gambia,Africa,2543054,0,4
2020-03-31,gambia,Africa,2543054,0,4
2020-04-01,gambia,Africa,2543054,0,4
2020-04-02,gambia,Africa,2543054,0,4
2020-04-03,gambia,Africa,2543054,0,4
2020-04-04,gambia,Africa,2543054,0,4
2020-04-05,gambia,Africa,2543054,0,4
2020-04-06,gambia,Africa,2543054,0,4
2020-04-07,gambia,Africa,2543054,0,4
2020-04-08,gambia,Africa,2543054,0,4
2020-04-09,gambia,Africa,2543054,0,4
2020-04-10,gambia,Africa,2543054,0,4
2020-04-11,gambia,Africa,2543054,5,9
2020-04-12,gambia,Africa,2543054,0,9
2020-04-13,gambia,Africa,2543054,0,9
2020-04-14,gambia,Africa,2543054,0,9
2020-04-15,gambia,Africa,2543054,0,9
2020-04-16,gambia,Africa,2543054,0,9
2020-04-17,gambia,Africa,2543054,0,9
2020-04-18,gambia,Africa,2543054,0,9
2020-04-19,gambia,Africa,2543054,1,10
2020-04-20,gambia,Africa,2543054,0,10
2020-04-21,gambia,Africa,2543054,0,10
2020-04-22,gambia,Africa,2543054,0,10
2020-04-23,gambia,Africa,2543054,0,10
2020-04-24,gambia,Africa,2543054,0,10
2020-04-25,gambia,Africa,2543054,0,10
2020-04-26,gambia,Africa,2543054,0,10
2020-04-27,gambia,Africa,2543054,0,10
2020-04-28,gambia,Africa,2543054,0,10
2020-04-29,gambia,Africa,2543054,0,10
2020-04-30,gambia,Africa,2543054,1,11
2020-05-01,gambia,Africa,2543054,1,12
2020-05-02,gambia,Africa,2543054,5,17
2020-05-03,gambia,Africa,2543054,0,17
2020-05-04,gambia,Africa,2543054,0,17
2020-05-05,gambia,Africa,2543054,0,17
2020-05-06,gambia,Africa,2543054,0,17
2020-05-07,gambia,Africa,2543054,1,18
2020-05-08,gambia,Africa,2543054,2,20
2020-05-09,gambia,Africa,2543054,0,20
2020-05-10,gambia,Africa,2543054,0,20
2020-05-11,gambia,Africa,2543054,2,22
2020-05-12,gambia,Africa,2543054,0,22
2020-05-13,gambia,Africa,2543054,1,23
2020-05-14,gambia,Africa,2543054,0,23
2020-05-15,gambia,Africa,2543054,0,23
2020-05-16,gambia,Africa,2543054,0,23
2020-05-17,gambia,Africa,2543054,0,23
2020-05-18,gambia,Africa,2543054,1,24
2020-05-19,gambia,Africa,2543054,0,24
2020-05-20,gambia,Africa,2543054,0,24
2020-05-21,gambia,Africa,2543054,0,24
2020-05-22,gambia,Africa,2543054,1,25
2020-05-23,gambia,Africa,2543054,0,25
2020-05-24,gambia,Africa,2543054,0,25
2020-05-25,gambia,Africa,2543054,0,25
2020-05-26,gambia,Africa,2543054,0,25
2020-05-27,gambia,Africa,2543054,0,25
2020-05-28,gambia,Africa,2543054,0,25
2020-05-29,gambia,Africa,2543054,0,25
2020-05-30,gambia,Africa,2543054,0,25
2020-05-31,gambia,Africa,2543054,0,25
2020-06-01,gambia,Africa,2543054,0,25
2020-06-02,gambia,Africa,2543054,0,25
2020-06-03,gambia,Africa,2543054,1,26
2020-06-04,gambia,Africa,2543054,0,26
2020-06-05,gambia,Africa,2543054,0,26
2020-06-06,gambia,Africa,2543054,0,26
2020-06-07,gambia,Africa,2543054,0,26
2020-06-08,gambia,Africa,2543054,2,28
2020-06-09,gambia,Africa,2543054,0,28
2020-06-10,gambia,Africa,2543054,0,28
2020-06-11,gambia,Africa,2543054,0,28
2020-06-12,gambia,Africa,2543054,0,28
2020-06-13,gambia,Africa,2543054,0,28
2020-06-14,gambia,Africa,2543054,0,28
2020-06-15,gambia,Africa,2543054,2,30
2020-06-16,gambia,Africa,2543054,4,34
2020-06-17,gambia,Africa,2543054,0,34
2020-06-18,gambia,Africa,2543054,2,36
2020-06-19,gambia,Africa,2543054,0,36
2020-06-20,gambia,Africa,2543054,0,36
2020-06-21,gambia,Africa,2543054,1,37
2020-06-22,gambia,Africa,2543054,4,41
2020-06-23,gambia,Africa,2543054,0,41
2020-06-24,gambia,Africa,2543054,1,42
2020-06-25,gambia,Africa,2543054,0,42
2020-06-26,gambia,Africa,2543054,1,43
2020-06-27,gambia,Africa,2543054,1,44
2020-06-28,gambia,Africa,2543054,1,45
2020-06-29,gambia,Africa,2543054,2,47
2020-06-30,gambia,Africa,2543054,2,49
2020-07-01,gambia,Africa,2543054,0,49
2020-07-02,gambia,Africa,2543054,6,55
2020-07-03,gambia,Africa,2543054,0,55
2020-07-04,gambia,Africa,2543054,2,57
2020-07-05,gambia,Africa,2543054,0,57
2020-02-27,georgia,Asia,3974908,0,1
2020-02-28,georgia,Asia,3974908,1,2
2020-02-29,georgia,Asia,3974908,1,3
2020-03-01,georgia,Asia,3974908,0,3
2020-03-02,georgia,Asia,3974908,0,3
2020-03-03,georgia,Asia,3974908,0,3
2020-03-04,georgia,Asia,3974908,0,3
2020-03-05,georgia,Asia,3974908,6,9
2020-03-06,georgia,Asia,3974908,0,9
2020-03-07,georgia,Asia,3974908,4,13
2020-03-08,georgia,Asia,3974908,0,13
2020-03-09,georgia,Asia,3974908,2,15
2020-03-10,georgia,Asia,3974908,8,23
2020-03-11,georgia,Asia,3974908,1,24
2020-03-12,georgia,Asia,3974908,1,25
2020-03-13,georgia,Asia,3974908,0,25
2020-03-14,georgia,Asia,3974908,5,30
2020-03-15,georgia,Asia,3974908,3,33
2020-03-16,georgia,Asia,3974908,0,33
2020-03-17,georgia,Asia,3974908,1,34
2020-03-18,georgia,Asia,3974908,4,38
2020-03-19,georgia,Asia,3974908,2,40
2020-03-20,georgia,Asia,3974908,4,44
2020-03-21,georgia,Asia,3974908,5,49
2020-03-22,georgia,Asia,3974908,5,54
2020-03-23,georgia,Asia,3974908,7,61
2020-03-24,georgia,Asia,3974908,9,70
2020-03-25,georgia,Asia,3974908,5,75
2020-03-26,georgia,Asia,3974908,4,79
2020-03-27,georgia,Asia,3974908,4,83
2020-03-28,georgia,Asia,3974908,7,90
2020-03-29,georgia,Asia,3974908,1,91
2020-03-30,georgia,Asia,3974908,12,103
2020-03-31,georgia,Asia,3974908,7,110
2020-04-01,georgia,Asia,3974908,7,117
2020-04-02,georgia,Asia,3974908,17,134
2020-04-03,georgia,Asia,3974908,21,155
2020-04-04,georgia,Asia,3974908,7,162
2020-04-05,georgia,Asia,3974908,12,174
2020-04-06,georgia,Asia,3974908,14,188
2020-04-07,georgia,Asia,3974908,8,196
2020-04-08,georgia,Asia,3974908,15,211
2020-04-09,georgia,Asia,3974908,7,218
2020-04-10,georgia,Asia,3974908,16,234
2020-04-11,georgia,Asia,3974908,8,242
2020-04-12,georgia,Asia,3974908,15,257
2020-04-13,georgia,Asia,3974908,15,272
2020-04-14,georgia,Asia,3974908,28,300
2020-04-15,georgia,Asia,3974908,6,306
2020-04-16,georgia,Asia,3974908,42,348
2020-04-17,georgia,Asia,3974908,22,370
2020-04-18,georgia,Asia,3974908,18,388
2020-04-19,georgia,Asia,3974908,6,394
2020-04-20,georgia,Asia,3974908,8,402
2020-04-21,georgia,Asia,3974908,6,408
2020-04-22,georgia,Asia,3974908,8,416
2020-04-23,georgia,Asia,3974908,9,425
2020-04-24,georgia,Asia,3974908,19,444
2020-04-25,georgia,Asia,3974908,12,456
2020-04-26,georgia,Asia,3974908,30,486
2020-04-27,georgia,Asia,3974908,11,497
2020-04-28,georgia,Asia,3974908,14,511
2020-04-29,georgia,Asia,3974908,6,517
2020-04-30,georgia,Asia,3974908,22,539
2020-05-01,georgia,Asia,3974908,27,566
2020-05-02,georgia,Asia,3974908,16,582
2020-05-03,georgia,Asia,3974908,7,589
2020-05-04,georgia,Asia,3974908,4,593
2020-05-05,georgia,Asia,3974908,11,604
2020-05-06,georgia,Asia,3974908,6,610
2020-05-07,georgia,Asia,3974908,5,615
2020-05-08,georgia,Asia,3974908,8,623
2020-05-09,georgia,Asia,3974908,3,626
2020-05-10,georgia,Asia,3974908,9,635
2020-05-11,georgia,Asia,3974908,3,638
2020-05-12,georgia,Asia,3974908,4,642
2020-05-13,georgia,Asia,3974908,5,647
2020-05-14,georgia,Asia,3974908,20,667
2020-05-15,georgia,Asia,3974908,4,671
2020-05-16,georgia,Asia,3974908,12,683
2020-05-17,georgia,Asia,3974908,12,695
2020-05-18,georgia,Asia,3974908,6,701
2020-05-19,georgia,Asia,3974908,6,707
2020-05-20,georgia,Asia,3974908,6,713
2020-05-21,georgia,Asia,3974908,8,721
2020-05-22,georgia,Asia,3974908,2,723
2020-05-23,georgia,Asia,3974908,5,728
2020-05-24,georgia,Asia,3974908,2,730
2020-05-25,georgia,Asia,3974908,1,731
2020-05-26,georgia,Asia,3974908,1,732
2020-05-27,georgia,Asia,3974908,3,735
2020-05-28,georgia,Asia,3974908,3,738
2020-05-29,georgia,Asia,3974908,8,746
2020-05-30,georgia,Asia,3974908,11,757
2020-05-31,georgia,Asia,3974908,26,783
2020-06-01,georgia,Asia,3974908,11,794
2020-06-02,georgia,Asia,3974908,2,796
2020-06-03,georgia,Asia,3974908,4,800
2020-06-04,georgia,Asia,3974908,1,801
2020-06-05,georgia,Asia,3974908,4,805
2020-06-06,georgia,Asia,3974908,3,808
2020-06-07,georgia,Asia,3974908,1,809
2020-06-08,georgia,Asia,3974908,3,812
2020-06-09,georgia,Asia,3974908,6,818
2020-06-10,georgia,Asia,3974908,9,827
2020-06-11,georgia,Asia,3974908,4,831
2020-06-12,georgia,Asia,3974908,12,843
2020-06-13,georgia,Asia,3974908,8,851
2020-06-14,georgia,Asia,3974908,13,864
2020-06-15,georgia,Asia,3974908,15,879
2020-06-16,georgia,Asia,3974908,0,879
2020-06-17,georgia,Asia,3974908,9,888
2020-06-18,georgia,Asia,3974908,5,893
2020-06-19,georgia,Asia,3974908,3,896
2020-06-20,georgia,Asia,3974908,2,898
2020-06-21,georgia,Asia,3974908,8,906
2020-06-22,georgia,Asia,3974908,2,908
2020-06-23,georgia,Asia,3974908,3,911
2020-06-24,georgia,Asia,3974908,3,914
2020-06-25,georgia,Asia,3974908,3,917
2020-06-26,georgia,Asia,3974908,2,919
2020-06-27,georgia,Asia,3974908,2,921
2020-06-28,georgia,Asia,3974908,3,924
2020-06-29,georgia,Asia,3974908,2,926
2020-06-30,georgia,Asia,3974908,2,928
2020-07-01,georgia,Asia,3974908,3,931
2020-07-02,georgia,Asia,3974908,8,939
2020-07-03,georgia,Asia,3974908,4,943
2020-07-04,georgia,Asia,3974908,5,948
2020-07-05,georgia,Asia,3974908,3,951
2020-07-06,georgia,Asia,3974908,2,953
2020-07-07,georgia,Asia,3974908,5,958
2020-07-08,georgia,Asia,3974908,5,963
2020-07-09,georgia,Asia,3974908,5,968
2020-07-10,georgia,Asia,3974908,5,973
2020-07-11,georgia,Asia,3974908,8,981
2020-07-12,georgia,Asia,3974908,5,986
2020-07-13,georgia,Asia,3974908,9,995
2020-07-14,georgia,Asia,3974908,4,999
2020-07-15,georgia,Asia,3974908,5,1004
2020-07-16,georgia,Asia,3974908,2,1006
2020-07-17,georgia,Asia,3974908,4,1010
2020-07-18,georgia,Asia,3974908,8,1018
2020-07-19,georgia,Asia,3974908,10,1028
2020-07-20,georgia,Asia,3974908,11,1039
2020-07-21,georgia,Asia,3974908,10,1049
2020-07-22,georgia,Asia,3974908,24,1073
2020-07-23,georgia,Asia,3974908,12,1085
2020-07-24,georgia,Asia,3974908,19,1104
2020-07-25,georgia,Asia,3974908,13,1117
2020-07-26,georgia,Asia,3974908,14,1131
2020-07-27,georgia,Asia,3974908,6,1137
2020-07-28,georgia,Asia,3974908,8,1145
2020-07-29,georgia,Asia,3974908,10,1155
2020-07-30,georgia,Asia,3974908,5,1160
2020-07-31,georgia,Asia,3974908,8,1168
2020-08-01,georgia,Asia,3974908,3,1171
2020-08-02,georgia,Asia,3974908,6,1177
2020-08-03,georgia,Asia,3974908,2,1179
2020-08-04,georgia,Asia,3974908,3,1182
2020-08-05,georgia,Asia,3974908,15,1197
2020-08-06,georgia,Asia,3974908,9,1206
2020-08-07,georgia,Asia,3974908,7,1213
2020-08-08,georgia,Asia,3974908,3,1216
2020-08-09,georgia,Asia,3974908,9,1225
2020-08-10,georgia,Asia,3974908,25,1250
2020-08-11,georgia,Asia,3974908,14,1264
2020-08-12,georgia,Asia,3974908,14,1278
2020-08-13,georgia,Asia,3974908,5,1283
2020-08-14,georgia,Asia,3974908,23,1306
2020-08-15,georgia,Asia,3974908,15,1321
2020-08-16,georgia,Asia,3974908,15,1336
2020-08-17,georgia,Asia,3974908,5,1341
2020-08-18,georgia,Asia,3974908,10,1351
2020-08-19,georgia,Asia,3974908,10,1361
2020-08-20,georgia,Asia,3974908,9,1370
2020-08-21,georgia,Asia,3974908,15,1385
2020-08-22,georgia,Asia,3974908,9,1394
2020-08-23,georgia,Asia,3974908,17,1411
2020-08-24,georgia,Asia,3974908,10,1421
2020-08-25,georgia,Asia,3974908,8,1429
2020-08-26,georgia,Asia,3974908,7,1436
2020-08-27,georgia,Asia,3974908,11,1447
2020-08-28,georgia,Asia,3974908,8,1455
2020-08-29,georgia,Asia,3974908,7,1462
2020-08-30,georgia,Asia,3974908,7,1469
2020-08-31,georgia,Asia,3974908,18,1487
2020-09-01,georgia,Asia,3974908,23,1510
2020-09-02,georgia,Asia,3974908,38,1548
2020-09-03,georgia,Asia,3974908,20,1568
2020-09-04,georgia,Asia,3974908,28,1596
2020-09-05,georgia,Asia,3974908,25,1621
2020-09-06,georgia,Asia,3974908,29,1650
2020-09-07,georgia,Asia,3974908,34,1684
2020-09-08,georgia,Asia,3974908,45,1729
2020-09-09,georgia,Asia,3974908,44,1773
2020-09-10,georgia,Asia,3974908,57,1830
2020-09-11,georgia,Asia,3974908,87,1917
2020-09-12,georgia,Asia,3974908,158,2075
2020-09-13,georgia,Asia,3974908,152,2227
2020-09-14,georgia,Asia,3974908,165,2392
2020-09-15,georgia,Asia,3974908,170,2562
2020-09-16,georgia,Asia,3974908,196,2758
2020-09-17,georgia,Asia,3974908,179,2937
2020-09-18,georgia,Asia,3974908,182,3119
2020-09-19,georgia,Asia,3974908,187,3306
2020-09-20,georgia,Asia,3974908,196,3502
2020-09-21,georgia,Asia,3974908,193,3695
2020-09-22,georgia,Asia,3974908,218,3913
2020-09-23,georgia,Asia,3974908,227,4140
2020-09-24,georgia,Asia,3974908,259,4399
2020-09-25,georgia,Asia,3974908,265,4664
2020-09-26,georgia,Asia,3974908,296,4960
2020-09-27,georgia,Asia,3974908,294,5254
2020-09-28,georgia,Asia,3974908,298,5552
2020-09-29,georgia,Asia,3974908,314,5866
2020-09-30,georgia,Asia,3974908,326,6192
2020-10-01,georgia,Asia,3974908,448,6640
2020-10-02,georgia,Asia,3974908,453,7093
2020-10-03,georgia,Asia,3974908,471,7564
2020-10-04,georgia,Asia,3974908,554,8118
2020-10-05,georgia,Asia,3974908,578,8696
2020-10-06,georgia,Asia,3974908,549,9245
2020-10-07,georgia,Asia,3974908,508,9753
2020-10-08,georgia,Asia,3974908,472,10225
2020-10-09,georgia,Asia,3974908,527,10752
2020-10-10,georgia,Asia,3974908,519,11271
2020-10-11,georgia,Asia,3974908,523,11794
2020-10-12,georgia,Asia,3974908,478,12272
2020-10-13,georgia,Asia,3974908,569,12841
2020-10-14,georgia,Asia,3974908,680,13521
2020-10-15,georgia,Asia,3974908,919,14440
2020-10-16,georgia,Asia,3974908,887,15327
2020-10-17,georgia,Asia,3974908,958,16285
2020-10-18,georgia,Asia,3974908,1192,17477
2020-10-19,georgia,Asia,3974908,1186,18663
2020-10-20,georgia,Asia,3974908,1194,19857
2020-10-21,georgia,Asia,3974908,1351,21208
2020-10-22,georgia,Asia,3974908,1595,22803
2020-10-23,georgia,Asia,3974908,1759,24562
2020-10-24,georgia,Asia,3974908,1941,26503
2020-10-25,georgia,Asia,3974908,1928,28431
2020-10-26,georgia,Asia,3974908,1872,30303
2020-10-27,georgia,Asia,3974908,1824,32127
2020-10-28,georgia,Asia,3974908,1731,33858
2020-10-29,georgia,Asia,3974908,1709,35567
2020-10-30,georgia,Asia,3974908,1696,37263
2020-10-31,georgia,Asia,3974908,1673,38936
2020-11-01,georgia,Asia,3974908,1791,40727
2020-11-02,georgia,Asia,3974908,1852,42579
2020-11-03,georgia,Asia,3974908,1943,44522
2020-11-04,georgia,Asia,3974908,2295,46817
2020-11-05,georgia,Asia,3974908,2401,49218
2020-11-06,georgia,Asia,3974908,2775,51993
2020-11-07,georgia,Asia,3974908,2859,54852
2020-11-08,georgia,Asia,3974908,2901,57753
2020-11-09,georgia,Asia,3974908,2927,60680
2020-11-10,georgia,Asia,3974908,2970,63650
2020-11-11,georgia,Asia,3974908,2911,66561
2020-11-12,georgia,Asia,3974908,3120,69681
2020-11-13,georgia,Asia,3974908,3473,73154
2020-11-14,georgia,Asia,3974908,3504,76658
2020-11-15,georgia,Asia,3974908,3020,79678
2020-11-16,georgia,Asia,3974908,3157,82835
2020-11-17,georgia,Asia,3974908,3117,85952
2020-11-18,georgia,Asia,3974908,3443,89395
2020-11-19,georgia,Asia,3974908,3697,93092
2020-11-20,georgia,Asia,3974908,3768,96860
2020-11-21,georgia,Asia,3974908,3824,100684
2020-11-22,georgia,Asia,3974908,4048,104732
2020-11-23,georgia,Asia,3974908,3958,108690
2020-11-24,georgia,Asia,3974908,3128,111818
2020-11-25,georgia,Asia,3974908,3071,114889
2020-11-26,georgia,Asia,3974908,3801,118690
2020-11-27,georgia,Asia,3974908,4780,123470
2020-11-28,georgia,Asia,3974908,4472,127942
2020-11-29,georgia,Asia,3974908,4426,132368
2020-11-30,georgia,Asia,3974908,3216,135584
2020-12-01,georgia,Asia,3974908,3759,139343
2020-12-02,georgia,Asia,3974908,4033,143376
2020-12-03,georgia,Asia,3974908,4260,147636
2020-12-04,georgia,Asia,3974908,5068,152704
2020-12-05,georgia,Asia,3974908,5450,158154
2020-12-06,georgia,Asia,3974908,4321,162475
2020-12-07,georgia,Asia,3974908,2501,164976
2020-12-08,georgia,Asia,3974908,4673,169649
2020-12-09,georgia,Asia,3974908,4734,174383
2020-12-10,georgia,Asia,3974908,4570,178953
2020-12-11,georgia,Asia,3974908,4146,183099
2020-12-12,georgia,Asia,3974908,3907,187006
2020-12-13,georgia,Asia,3974908,2720,189726
2020-12-14,georgia,Asia,3974908,1337,191063
2020-12-15,georgia,Asia,3974908,3837,194900
2020-12-16,georgia,Asia,3974908,3487,198387
2020-12-17,georgia,Asia,3974908,2981,201368
2020-12-18,georgia,Asia,3974908,2635,204003
2020-12-19,georgia,Asia,3974908,2904,206907
2020-12-20,georgia,Asia,3974908,1731,208638
2020-12-21,georgia,Asia,3974908,824,209462
2020-12-22,georgia,Asia,3974908,3064,212526
2020-12-23,georgia,Asia,3974908,2345,214871
2020-12-24,georgia,Asia,3974908,1972,216843
2020-12-25,georgia,Asia,3974908,1881,218724
2020-12-26,georgia,Asia,3974908,1784,220508
2020-12-27,georgia,Asia,3974908,1097,221605
2020-12-28,georgia,Asia,3974908,538,222143
2020-12-29,georgia,Asia,3974908,2012,224155
2020-12-30,georgia,Asia,3974908,1738,225893
2020-12-31,georgia,Asia,3974908,1527,227420
2021-01-01,georgia,Asia,3974908,990,228410
2021-01-02,georgia,Asia,3974908,342,228752
2021-01-03,georgia,Asia,3974908,417,229169
2021-01-04,georgia,Asia,3974908,594,229763
2021-01-05,georgia,Asia,3974908,2316,232079
2021-01-06,georgia,Asia,3974908,1800,233879
2021-01-07,georgia,Asia,3974908,1612,235491
2021-01-08,georgia,Asia,3974908,537,236028
2021-01-09,georgia,Asia,3974908,2058,238086
2021-01-10,georgia,Asia,3974908,1143,239229
2021-01-11,georgia,Asia,3974908,551,239780
2021-01-12,georgia,Asia,3974908,1857,241637
2021-01-13,georgia,Asia,3974908,1618,243255
2020-02-20,germany,Europe,84282880,0,16
2020-02-21,germany,Europe,84282880,0,16
2020-02-22,germany,Europe,84282880,0,16
2020-02-23,germany,Europe,84282880,0,16
2020-02-24,germany,Europe,84282880,0,16
2020-02-25,germany,Europe,84282880,2,18
2020-02-26,germany,Europe,84282880,8,26
2020-02-27,germany,Europe,84282880,22,48
2020-02-28,germany,Europe,84282880,26,74
2020-02-29,germany,Europe,84282880,5,79
2020-03-01,germany,Europe,84282880,51,130
2020-03-02,germany,Europe,84282880,35,165
2020-03-03,germany,Europe,84282880,38,203
2020-03-04,germany,Europe,84282880,59,262
2020-03-05,germany,Europe,84282880,283,545
2020-03-06,germany,Europe,84282880,125,670
2020-03-07,germany,Europe,84282880,130,800
2020-03-08,germany,Europe,84282880,240,1040
2020-03-09,germany,Europe,84282880,184,1224
2020-03-10,germany,Europe,84282880,341,1565
2020-03-11,germany,Europe,84282880,401,1966
2020-03-12,germany,Europe,84282880,779,2745
2020-03-13,germany,Europe,84282880,930,3675
2020-03-14,germany,Europe,84282880,924,4599
2020-03-15,germany,Europe,84282880,1214,5813
2020-03-16,germany,Europe,84282880,1459,7272
2020-03-17,germany,Europe,84282880,2095,9367
2020-03-18,germany,Europe,84282880,2960,12327
2020-03-19,germany,Europe,84282880,2993,15320
2020-03-20,germany,Europe,84282880,4528,19848
2020-03-21,germany,Europe,84282880,2516,22364
2020-03-22,germany,Europe,84282880,2509,24873
2020-03-23,germany,Europe,84282880,4183,29056
2020-03-24,germany,Europe,84282880,3935,32991
2020-03-25,germany,Europe,84282880,4332,37323
2020-03-26,germany,Europe,84282880,6615,43938
2020-03-27,germany,Europe,84282880,6933,50871
2020-03-28,germany,Europe,84282880,6824,57695
2020-03-29,germany,Europe,84282880,4740,62435
2020-03-30,germany,Europe,84282880,4450,66885
2020-03-31,germany,Europe,84282880,4923,71808
2020-04-01,germany,Europe,84282880,6173,77981
2020-04-02,germany,Europe,84282880,6813,84794
2020-04-03,germany,Europe,84282880,6365,91159
2020-04-04,germany,Europe,84282880,4933,96092
2020-04-05,germany,Europe,84282880,4031,100123
2020-04-06,germany,Europe,84282880,3252,103375
2020-04-07,germany,Europe,84282880,4288,107663
2020-04-08,germany,Europe,84282880,5633,113296
2020-04-09,germany,Europe,84282880,4939,118235
2020-04-10,germany,Europe,84282880,3936,122171
2020-04-11,germany,Europe,84282880,3281,125452
2020-04-12,germany,Europe,84282880,2402,127854
2020-04-13,germany,Europe,84282880,2218,130072
2020-04-14,germany,Europe,84282880,2138,132210
2020-04-15,germany,Europe,84282880,2543,134753
2020-04-16,germany,Europe,84282880,2945,137698
2020-04-17,germany,Europe,84282880,3699,141397
2020-04-18,germany,Europe,84282880,2327,143724
2020-04-19,germany,Europe,84282880,2018,145742
2020-04-20,germany,Europe,84282880,1323,147065
2020-04-21,germany,Europe,84282880,1388,148453
2020-04-22,germany,Europe,84282880,2195,150648
2020-04-23,germany,Europe,84282880,2481,153129
2020-04-24,germany,Europe,84282880,1870,154999
2020-04-25,germany,Europe,84282880,1514,156513
2020-04-26,germany,Europe,84282880,1257,157770
2020-04-27,germany,Europe,84282880,988,158758
2020-04-28,germany,Europe,84282880,1154,159912
2020-04-29,germany,Europe,84282880,1627,161539
2020-04-30,germany,Europe,84282880,1470,163009
2020-05-01,germany,Europe,84282880,1068,164077
2020-05-02,germany,Europe,84282880,890,164967
2020-05-03,germany,Europe,84282880,697,165664
2020-05-04,germany,Europe,84282880,488,166152
2020-05-05,germany,Europe,84282880,855,167007
2020-05-06,germany,Europe,84282880,1155,168162
2020-05-07,germany,Europe,84282880,1268,169430
2020-05-08,germany,Europe,84282880,1158,170588
2020-05-09,germany,Europe,84282880,736,171324
2020-05-10,germany,Europe,84282880,555,171879
2020-05-11,germany,Europe,84282880,697,172576
2020-05-12,germany,Europe,84282880,595,173171
2020-05-13,germany,Europe,84282880,927,174098
2020-05-14,germany,Europe,84282880,877,174975
2020-05-15,germany,Europe,84282880,724,175699
2020-05-16,germany,Europe,84282880,545,176244
2020-05-17,germany,Europe,84282880,407,176651
2020-05-18,germany,Europe,84282880,638,177289
2020-05-19,germany,Europe,84282880,538,177827
2020-05-20,germany,Europe,84282880,704,178531
2020-05-21,germany,Europe,84282880,490,179021
2020-05-22,germany,Europe,84282880,692,179713
2020-05-23,germany,Europe,84282880,273,179986
2020-05-24,germany,Europe,84282880,342,180328
2020-05-25,germany,Europe,84282880,461,180789
2020-05-26,germany,Europe,84282880,499,181288
2020-05-27,germany,Europe,84282880,607,181895
2020-05-28,germany,Europe,84282880,557,182452
2020-05-29,germany,Europe,84282880,567,183019
2020-05-30,germany,Europe,84282880,275,183294
2020-05-31,germany,Europe,84282880,200,183494
2020-06-01,germany,Europe,84282880,271,183765
2020-06-02,germany,Europe,84282880,326,184091
2020-06-03,germany,Europe,84282880,334,184425
2020-06-04,germany,Europe,84282880,498,184923
2020-06-05,germany,Europe,84282880,491,185414
2020-06-06,germany,Europe,84282880,282,185696
2020-06-07,germany,Europe,84282880,173,185869
2020-06-08,germany,Europe,84282880,336,186205
2020-06-09,germany,Europe,84282880,311,186516
2020-06-10,germany,Europe,84282880,0,186516
2020-06-11,germany,Europe,84282880,279,186795
2020-06-12,germany,Europe,84282880,456,187251
2020-06-13,germany,Europe,84282880,172,187423
2020-06-14,germany,Europe,84282880,248,187671
2020-06-15,germany,Europe,84282880,373,188044
2020-06-16,germany,Europe,84282880,338,188382
2020-06-17,germany,Europe,84282880,1122,189504
2020-06-18,germany,Europe,84282880,622,190126
2020-06-19,germany,Europe,84282880,534,190660
2020-06-20,germany,Europe,84282880,556,191216
2020-06-21,germany,Europe,84282880,359,191575
2020-06-22,germany,Europe,84282880,544,192119
2020-06-23,germany,Europe,84282880,659,192778
2020-06-24,germany,Europe,84282880,476,193254
2020-06-25,germany,Europe,84282880,531,193785
2020-06-26,germany,Europe,84282880,614,194399
2020-06-27,germany,Europe,84282880,290,194689
2020-06-28,germany,Europe,84282880,175,194864
2020-06-29,germany,Europe,84282880,528,195392
2020-06-30,germany,Europe,84282880,440,195832
2020-07-01,germany,Europe,84282880,492,196324
2020-07-02,germany,Europe,84282880,393,196717
2020-07-03,germany,Europe,84282880,283,197000
2020-07-04,germany,Europe,84282880,418,197418
2020-07-05,germany,Europe,84282880,140,197558
2020-07-06,germany,Europe,84282880,499,198057
2020-07-07,germany,Europe,84282880,298,198355
2020-07-08,germany,Europe,84282880,410,198765
2020-07-09,germany,Europe,84282880,433,199198
2020-07-10,germany,Europe,84282880,390,199588
2020-07-11,germany,Europe,84282880,224,199812
2020-07-12,germany,Europe,84282880,138,199950
2020-07-13,germany,Europe,84282880,486,200436
2020-07-14,germany,Europe,84282880,330,200766
2020-07-15,germany,Europe,84282880,486,201252
2020-07-16,germany,Europe,84282880,584,201836
2020-07-17,germany,Europe,84282880,509,202345
2020-07-18,germany,Europe,84282880,227,202572
2020-07-19,germany,Europe,84282880,273,202845
2020-07-20,germany,Europe,84282880,642,203487
2020-07-21,germany,Europe,84282880,403,203890
2020-07-22,germany,Europe,84282880,580,204470
2020-07-23,germany,Europe,84282880,672,205142
2020-07-24,germany,Europe,84282880,818,205960
2020-07-25,germany,Europe,84282880,372,206332
2020-07-26,germany,Europe,84282880,409,206741
2020-07-27,germany,Europe,84282880,638,207379
2020-07-28,germany,Europe,84282880,572,207951
2020-07-29,germany,Europe,84282880,860,208811
2020-07-30,germany,Europe,84282880,842,209653
2020-07-31,germany,Europe,84282880,1012,210665
2020-08-01,germany,Europe,84282880,412,211077
2020-08-02,germany,Europe,84282880,385,211462
2020-08-03,germany,Europe,84282880,858,212320
2020-08-04,germany,Europe,84282880,760,213080
2020-08-05,germany,Europe,84282880,1024,214104
2020-08-06,germany,Europe,84282880,1106,215210
2020-08-07,germany,Europe,84282880,1105,216315
2020-08-08,germany,Europe,84282880,581,216896
2020-08-09,germany,Europe,84282880,385,217281
2020-08-10,germany,Europe,84282880,1219,218500
2020-08-11,germany,Europe,84282880,1030,219530
2020-08-12,germany,Europe,84282880,1320,220850
2020-08-13,germany,Europe,84282880,1419,222269
2020-08-14,germany,Europe,84282880,1505,223774
2020-08-15,germany,Europe,84282880,704,224478
2020-08-16,germany,Europe,84282880,519,224997
2020-08-17,germany,Europe,84282880,1689,226686
2020-08-18,germany,Europe,84282880,1419,228105
2020-08-19,germany,Europe,84282880,1595,229700
2020-08-20,germany,Europe,84282880,1584,231284
2020-08-21,germany,Europe,84282880,1737,233021
2020-08-22,germany,Europe,84282880,836,233857
2020-08-23,germany,Europe,84282880,632,234489
2020-08-24,germany,Europe,84282880,1628,236117
2020-08-25,germany,Europe,84282880,1455,237572
2020-08-26,germany,Europe,84282880,1428,239000
2020-08-27,germany,Europe,84282880,1565,240565
2020-08-28,germany,Europe,84282880,1549,242114
2020-08-29,germany,Europe,84282880,711,242825
2020-08-30,germany,Europe,84282880,470,243295
2020-08-31,germany,Europe,84282880,1497,244792
2020-09-01,germany,Europe,84282880,1209,246001
2020-09-02,germany,Europe,84282880,1390,247391
2020-09-03,germany,Europe,84282880,1423,248814
2020-09-04,germany,Europe,84282880,1467,250281
2020-09-05,germany,Europe,84282880,775,251056
2020-09-06,germany,Europe,84282880,668,251724
2020-09-07,germany,Europe,84282880,1901,253625
2020-09-08,germany,Europe,84282880,1331,254956
2020-09-09,germany,Europe,84282880,1393,256349
2020-09-10,germany,Europe,84282880,1758,258107
2020-09-11,germany,Europe,84282880,1618,259725
2020-09-12,germany,Europe,84282880,821,260546
2020-09-13,germany,Europe,84282880,752,261298
2020-09-14,germany,Europe,84282880,1923,263221
2020-09-15,germany,Europe,84282880,1623,264844
2020-09-16,germany,Europe,84282880,2021,266865
2020-09-17,germany,Europe,84282880,2177,269042
2020-09-18,germany,Europe,84282880,2202,271244
2020-09-19,germany,Europe,84282880,1064,272308
2020-09-20,germany,Europe,84282880,1169,273477
2020-09-21,germany,Europe,84282880,2074,275551
2020-09-22,germany,Europe,84282880,1625,277176
2020-09-23,germany,Europe,84282880,2029,279205
2020-09-24,germany,Europe,84282880,2140,281345
2020-09-25,germany,Europe,84282880,2361,283706
2020-09-26,germany,Europe,84282880,1319,285025
2020-09-27,germany,Europe,84282880,1313,286338
2020-09-28,germany,Europe,84282880,2280,288618
2020-09-29,germany,Europe,84282880,1848,290466
2020-09-30,germany,Europe,84282880,2445,292911
2020-10-01,germany,Europe,84282880,2619,295530
2020-10-02,germany,Europe,84282880,2833,298363
2020-10-03,germany,Europe,84282880,1665,300028
2020-10-04,germany,Europe,84282880,1543,301571
2020-10-05,germany,Europe,84282880,3086,304657
2020-10-06,germany,Europe,84282880,2462,307119
2020-10-07,germany,Europe,84282880,3994,311113
2020-10-08,germany,Europe,84282880,4401,315514
2020-10-09,germany,Europe,84282880,4964,320478
2020-10-10,germany,Europe,84282880,2975,323453
2020-10-11,germany,Europe,84282880,2838,326291
2020-10-12,germany,Europe,84282880,4803,331094
2020-10-13,germany,Europe,84282880,4585,335679
2020-10-14,germany,Europe,84282880,6063,341742
2020-10-15,germany,Europe,84282880,7074,348816
2020-10-16,germany,Europe,84282880,7976,356792
2020-10-17,germany,Europe,84282880,4941,361733
2020-10-18,germany,Europe,84282880,5248,366981
2020-10-19,germany,Europe,84282880,6750,373731
2020-10-20,germany,Europe,84282880,7167,380898
2020-10-21,germany,Europe,84282880,10457,391355
2020-10-22,germany,Europe,84282880,12519,403874
2020-10-23,germany,Europe,84282880,13476,417350
2020-10-24,germany,Europe,84282880,10458,427808
2020-10-25,germany,Europe,84282880,9829,437637
2020-10-26,germany,Europe,84282880,12621,450258
2020-10-27,germany,Europe,84282880,13161,463419
2020-10-28,germany,Europe,84282880,16202,479621
2020-10-29,germany,Europe,84282880,18732,498353
2020-10-30,germany,Europe,84282880,19367,517720
2020-10-31,germany,Europe,84282880,14070,531790
2020-11-01,germany,Europe,84282880,12556,544346
2020-11-02,germany,Europe,84282880,16240,560586
2020-11-03,germany,Europe,84282880,16545,577131
2020-11-04,germany,Europe,84282880,20228,597359
2020-11-05,germany,Europe,84282880,21757,619116
2020-11-06,germany,Europe,84282880,22246,641362
2020-11-07,germany,Europe,84282880,17119,658481
2020-11-08,germany,Europe,84282880,14026,672507
2020-11-09,germany,Europe,84282880,16465,688972
2020-11-10,germany,Europe,84282880,16668,705640
2020-11-11,germany,Europe,84282880,20536,726176
2020-11-12,germany,Europe,84282880,23462,749638
2020-11-13,germany,Europe,84282880,23184,772822
2020-11-14,germany,Europe,84282880,16077,788899
2020-11-15,germany,Europe,84282880,14045,802944
2020-11-16,germany,Europe,84282880,14582,817526
2020-11-17,germany,Europe,84282880,16206,833732
2020-11-18,germany,Europe,84282880,20801,854533
2020-11-19,germany,Europe,84282880,23676,878209
2020-11-20,germany,Europe,84282880,23450,901659
2020-11-21,germany,Europe,84282880,16612,918271
2020-11-22,germany,Europe,84282880,13840,932111
2020-11-23,germany,Europe,84282880,14537,946648
2020-11-24,germany,Europe,84282880,16258,962906
2020-11-25,germany,Europe,84282880,20825,983731
2020-11-26,germany,Europe,84282880,21576,1005307
2020-11-27,germany,Europe,84282880,22018,1027325
2020-11-28,germany,Europe,84282880,14645,1041970
2020-11-29,germany,Europe,84282880,13637,1055607
2020-11-30,germany,Europe,84282880,14156,1069763
2020-12-01,germany,Europe,84282880,15898,1085661
2020-12-02,germany,Europe,84282880,20171,1105832
2020-12-03,germany,Europe,84282880,22910,1128742
2020-12-04,germany,Europe,84282880,23541,1152283
2020-12-05,germany,Europe,84282880,17812,1170095
2020-12-06,germany,Europe,84282880,14750,1184845
2020-12-07,germany,Europe,84282880,15161,1200006
2020-12-08,germany,Europe,84282880,18319,1218325
2020-12-09,germany,Europe,84282880,23928,1242253
2020-12-10,germany,Europe,84282880,28179,1270432
2020-12-11,germany,Europe,84282880,28344,1298776
2020-12-12,germany,Europe,84282880,21816,1320592
2020-12-13,germany,Europe,84282880,17891,1338483
2020-12-14,germany,Europe,84282880,18658,1357141
2020-12-15,germany,Europe,84282880,21377,1378518
2020-12-16,germany,Europe,84282880,28969,1407487
2020-12-17,germany,Europe,84282880,30951,1438438
2020-12-18,germany,Europe,84282880,31553,1469991
2020-12-19,germany,Europe,84282880,23970,1493961
2020-12-20,germany,Europe,84282880,20822,1514783
2020-12-21,germany,Europe,84282880,19333,1534116
2020-12-22,germany,Europe,84282880,22495,1556611
2020-12-23,germany,Europe,84282880,31297,1587908
2020-12-24,germany,Europe,84282880,26418,1614326
2020-12-25,germany,Europe,84282880,18411,1632737
2020-12-26,germany,Europe,84282880,10432,1643169
2020-12-27,germany,Europe,84282880,12153,1655322
2020-12-28,germany,Europe,84282880,17323,1672645
2020-12-29,germany,Europe,84282880,19118,1691763
2020-12-30,germany,Europe,84282880,28410,1720173
2020-12-31,germany,Europe,84282880,25345,1745518
2021-01-01,germany,Europe,84282880,17007,1762525
2021-01-02,germany,Europe,84282880,11015,1773540
2021-01-03,germany,Europe,84282880,10620,1784160
2021-01-04,germany,Europe,84282880,12056,1796216
2021-01-05,germany,Europe,84282880,18361,1814577
2021-01-06,germany,Europe,84282880,26651,1841228
2021-01-07,germany,Europe,84282880,28100,1869328
2021-01-08,germany,Europe,84282880,25629,1894957
2021-01-09,germany,Europe,84282880,20202,1915159
2021-01-10,germany,Europe,84282880,14195,1929354
2021-01-11,germany,Europe,84282880,11723,1941077
2021-01-12,germany,Europe,84282880,16516,1957593
2021-01-13,germany,Europe,84282880,23461,1981054
2021-01-14,germany,Europe,84282880,22957,2004011
2021-01-15,germany,Europe,84282880,19790,2023801
2021-01-16,germany,Europe,84282880,14871,2038672
2021-01-17,germany,Europe,84282880,11712,2050384
2021-01-18,germany,Europe,84282880,8930,2059314
2021-01-19,germany,Europe,84282880,12322,2071636
2021-01-20,germany,Europe,84282880,18559,2090195
2021-01-21,germany,Europe,84282880,18700,2108895
2021-01-22,germany,Europe,84282880,16366,2125261
2021-01-23,germany,Europe,84282880,12428,2137689
2021-01-24,germany,Europe,84282880,10083,2147772
2021-01-25,germany,Europe,84282880,6580,2154352
2021-01-26,germany,Europe,84282880,9716,2164068
2021-01-27,germany,Europe,84282880,15611,2179679
2021-01-28,germany,Europe,84282880,14915,2194594
2021-01-29,germany,Europe,84282880,12799,2207393
2021-01-30,germany,Europe,84282880,9841,2217234
2021-01-31,germany,Europe,84282880,8452,2225686
2021-02-01,germany,Europe,84282880,6630,2232316
2021-02-02,germany,Europe,84282880,7652,2239968
2021-02-03,germany,Europe,84282880,12579,2252547
2021-02-04,germany,Europe,84282880,12947,2265494
2021-02-05,germany,Europe,84282880,10877,2276371
2021-02-06,germany,Europe,84282880,8628,2284999
2021-02-07,germany,Europe,84282880,6511,2291510
2021-02-08,germany,Europe,84282880,4816,2296326
2021-02-09,germany,Europe,84282880,5725,2302051
2021-02-10,germany,Europe,84282880,9246,2311297
2021-02-11,germany,Europe,84282880,9918,2321215
2021-02-12,germany,Europe,84282880,9207,2330422
2021-02-13,germany,Europe,84282880,6483,2336905
2021-02-14,germany,Europe,84282880,4801,2341706
2021-02-15,germany,Europe,84282880,5164,2346870
2021-02-16,germany,Europe,84282880,5896,2352766
2021-02-17,germany,Europe,84282880,9618,2362384
2021-02-18,germany,Europe,84282880,9825,2372209
2021-02-19,germany,Europe,84282880,9050,2381259
2021-02-20,germany,Europe,84282880,7158,2388417
2021-02-21,germany,Europe,84282880,6167,2394584
2021-02-22,germany,Europe,84282880,4916,2399500
2021-02-23,germany,Europe,84282880,5763,2405263
2021-02-24,germany,Europe,84282880,10774,2416037
2021-02-25,germany,Europe,84282880,10782,2426819
2021-02-26,germany,Europe,84282880,9687,2436506
2021-02-27,germany,Europe,84282880,7671,2444177
2021-02-28,germany,Europe,84282880,6185,2450362
2021-03-01,germany,Europe,84282880,5207,2455569
2021-03-02,germany,Europe,84282880,6492,2462061
2021-03-03,germany,Europe,84282880,10835,2472896
2021-03-04,germany,Europe,84282880,11410,2484306
2021-03-05,germany,Europe,84282880,9581,2493887
2021-03-06,germany,Europe,84282880,8235,2502122
2021-03-07,germany,Europe,84282880,6533,2508655
2021-03-08,germany,Europe,84282880,5113,2513768
2021-03-09,germany,Europe,84282880,6841,2520609
2021-03-10,germany,Europe,84282880,12246,2532855
2021-03-11,germany,Europe,84282880,13655,2546510
2021-03-12,germany,Europe,84282880,12786,2559296
2021-03-13,germany,Europe,84282880,10554,2569850
2021-03-14,germany,Europe,84282880,8985,2578835
2021-03-15,germany,Europe,84282880,6550,2585385
2021-03-16,germany,Europe,84282880,9290,2594675
2021-03-17,germany,Europe,84282880,16094,2610769
2021-03-18,germany,Europe,84282880,17860,2628629
2021-03-19,germany,Europe,84282880,16557,2645186
2021-03-20,germany,Europe,84282880,13665,2658851
2021-03-21,germany,Europe,84282880,11149,2670000
2021-03-22,germany,Europe,84282880,8262,2678262
2021-03-23,germany,Europe,84282880,10943,2689205
2021-03-24,germany,Europe,84282880,20667,2709872
2021-03-25,germany,Europe,84282880,22258,2732130
2021-03-26,germany,Europe,84282880,21872,2754002
2021-03-27,germany,Europe,84282880,18692,2772694
2021-03-28,germany,Europe,84282880,13651,2786345
2021-03-29,germany,Europe,84282880,10055,2796400
2021-03-30,germany,Europe,84282880,13110,2809510
2021-03-31,germany,Europe,84282880,20825,2830335
2021-04-01,germany,Europe,84282880,23802,2854137
2021-04-02,germany,Europe,84282880,18242,2872379
2021-04-03,germany,Europe,84282880,13641,2886020
2021-04-04,germany,Europe,84282880,9611,2895631
2021-04-05,germany,Europe,84282880,7405,2903036
2021-04-06,germany,Europe,84282880,9600,2912636
2021-04-07,germany,Europe,84282880,14936,2927572
2021-04-08,germany,Europe,84282880,24257,2951829
2021-04-09,germany,Europe,84282880,22281,2974110
2021-04-10,germany,Europe,84282880,18693,2992803
2021-04-11,germany,Europe,84282880,16738,3009541
2021-04-12,germany,Europe,84282880,11523,3021064
2021-04-13,germany,Europe,84282880,10772,3031836
2021-04-14,germany,Europe,84282880,32546,3064382
2021-04-15,germany,Europe,84282880,30634,3095016
2021-04-16,germany,Europe,84282880,21934,3116950
2021-04-17,germany,Europe,84282880,20957,3137907
2021-04-18,germany,Europe,84282880,13123,3151030
2021-04-19,germany,Europe,84282880,13417,3164447
2021-04-20,germany,Europe,84282880,16363,3180810
2021-04-21,germany,Europe,84282880,27862,3208672
2021-04-22,germany,Europe,84282880,29382,3238054
2021-04-23,germany,Europe,84282880,23710,3261764
2021-04-24,germany,Europe,84282880,24423,3286187
2021-04-25,germany,Europe,84282880,12014,3298201
2021-04-26,germany,Europe,84282880,9568,3307769
2021-04-27,germany,Europe,84282880,19009,3326778
2021-04-28,germany,Europe,84282880,24696,3351474
2021-04-29,germany,Europe,84282880,27913,3379387
2021-04-30,germany,Europe,84282880,12845,3392232
2021-05-01,germany,Europe,84282880,20141,3412373
2021-05-02,germany,Europe,84282880,13225,3425598
2021-05-03,germany,Europe,84282880,10279,3435877
2021-05-04,germany,Europe,84282880,12305,3448182
2021-05-05,germany,Europe,84282880,21266,3469448
2021-05-06,germany,Europe,84282880,17014,3486462
2021-05-07,germany,Europe,84282880,17550,3504012
2021-05-08,germany,Europe,84282880,15238,3519250
2021-05-09,germany,Europe,84282880,8290,3527540
2021-05-10,germany,Europe,84282880,7814,3535354
2021-05-11,germany,Europe,84282880,8961,3544315
2021-05-12,germany,Europe,84282880,13833,3558148
2021-05-13,germany,Europe,84282880,17496,3575644
2021-05-14,germany,Europe,84282880,10247,3585891
2021-05-15,germany,Europe,84282880,9981,3595872
2021-05-16,germany,Europe,84282880,7067,3602939
2021-05-17,germany,Europe,84282880,5353,3608292
2021-05-18,germany,Europe,84282880,7604,3615896
2021-05-19,germany,Europe,84282880,11881,3627777
2021-05-20,germany,Europe,84282880,10727,3638504
2021-05-21,germany,Europe,84282880,8096,3646600
2021-05-22,germany,Europe,84282880,6419,3653019
2021-05-23,germany,Europe,84282880,1182,3654201
2021-05-24,germany,Europe,84282880,5789,3659990
2021-05-25,germany,Europe,84282880,2578,3662568
2021-05-26,germany,Europe,84282880,4473,3667041
2021-05-27,germany,Europe,84282880,6928,3673969
2021-05-28,germany,Europe,84282880,6190,3680159
2021-05-29,germany,Europe,84282880,4513,3684672
2021-05-30,germany,Europe,84282880,3043,3687715
2021-05-31,germany,Europe,84282880,2203,3689918
2021-06-01,germany,Europe,84282880,2990,3692908
2021-06-02,germany,Europe,84282880,5096,3698004
2021-06-03,germany,Europe,84282880,3686,3701690
2021-06-04,germany,Europe,84282880,2995,3704685
2021-06-05,germany,Europe,84282880,2249,3706934
2021-06-06,germany,Europe,84282880,1845,3708779
2021-06-07,germany,Europe,84282880,1562,3710341
2021-06-08,germany,Europe,84282880,2254,3712595
2021-06-09,germany,Europe,84282880,3275,3715870
2021-06-10,germany,Europe,84282880,2747,3718617
2021-06-11,germany,Europe,84282880,2194,3720811
2021-06-12,germany,Europe,84282880,1484,3722295
2021-06-13,germany,Europe,84282880,999,3723294
2021-06-14,germany,Europe,84282880,907,3724201
2021-06-15,germany,Europe,84282880,1102,3725303
2021-06-16,germany,Europe,84282880,1428,3726731
2021-06-17,germany,Europe,84282880,608,3727339
2021-06-18,germany,Europe,84282880,1244,3728583
2021-06-19,germany,Europe,84282880,974,3729557
2021-06-20,germany,Europe,84282880,558,3730115
2021-06-21,germany,Europe,84282880,484,3730599
2021-06-22,germany,Europe,84282880,688,3731287
2021-06-23,germany,Europe,84282880,1114,3732401
2021-06-24,germany,Europe,84282880,444,3732845
2021-06-25,germany,Europe,84282880,797,3733642
2021-06-26,germany,Europe,84282880,494,3734136
2021-06-27,germany,Europe,84282880,336,3734472
2021-06-28,germany,Europe,84282880,340,3734812
2021-06-29,germany,Europe,84282880,570,3735382
2021-06-30,germany,Europe,84282880,841,3736223
2021-07-01,germany,Europe,84282880,717,3736940
2021-07-02,germany,Europe,84282880,671,3737611
2021-07-03,germany,Europe,84282880,429,3738040
2021-07-04,germany,Europe,84282880,411,3738451
2021-07-05,germany,Europe,84282880,392,3738843
2021-07-06,germany,Europe,84282880,712,3739555
2021-07-07,germany,Europe,84282880,986,3740541
2021-07-08,germany,Europe,84282880,910,3741451
2021-07-09,germany,Europe,84282880,884,3742335
2021-07-10,germany,Europe,84282880,803,3743138
2021-07-11,germany,Europe,84282880,575,3743713
2021-07-12,germany,Europe,84282880,554,3744267
2021-07-13,germany,Europe,84282880,1020,3745287
2021-07-14,germany,Europe,84282880,1629,3746916
2021-07-15,germany,Europe,84282880,1451,3748367
2021-07-16,germany,Europe,84282880,1555,3749922
2021-07-17,germany,Europe,84282880,1312,3751234
2020-03-22,ghana,Africa,32280617,2,23
2020-03-23,ghana,Africa,32280617,4,27
2020-03-24,ghana,Africa,32280617,26,53
2020-03-25,ghana,Africa,32280617,15,68
2020-03-26,ghana,Africa,32280617,64,132
2020-03-27,ghana,Africa,32280617,5,137
2020-03-28,ghana,Africa,32280617,4,141
2020-03-29,ghana,Africa,32280617,11,152
2020-03-30,ghana,Africa,32280617,0,152
2020-03-31,ghana,Africa,32280617,9,161
2020-04-01,ghana,Africa,32280617,34,195
2020-04-02,ghana,Africa,32280617,9,204
2020-04-03,ghana,Africa,32280617,1,205
2020-04-04,ghana,Africa,32280617,0,205
2020-04-05,ghana,Africa,32280617,9,214
2020-04-06,ghana,Africa,32280617,0,214
2020-04-07,ghana,Africa,32280617,73,287
2020-04-08,ghana,Africa,32280617,26,313
2020-04-09,ghana,Africa,32280617,65,378
2020-04-10,ghana,Africa,32280617,0,378
2020-04-11,ghana,Africa,32280617,30,408
2020-04-12,ghana,Africa,32280617,158,566
2020-04-13,ghana,Africa,32280617,0,566
2020-04-14,ghana,Africa,32280617,70,636
2020-04-15,ghana,Africa,32280617,5,641
2020-04-16,ghana,Africa,32280617,0,641
2020-04-17,ghana,Africa,32280617,0,641
2020-04-18,ghana,Africa,32280617,193,834
2020-04-19,ghana,Africa,32280617,208,1042
2020-04-20,ghana,Africa,32280617,0,1042
2020-04-21,ghana,Africa,32280617,0,1042
2020-04-22,ghana,Africa,32280617,112,1154
2020-04-23,ghana,Africa,32280617,0,1154
2020-04-24,ghana,Africa,32280617,125,1279
2020-04-25,ghana,Africa,32280617,0,1279
2020-04-26,ghana,Africa,32280617,271,1550
2020-04-27,ghana,Africa,32280617,0,1550
2020-04-28,ghana,Africa,32280617,121,1671
2020-04-29,ghana,Africa,32280617,0,1671
2020-04-30,ghana,Africa,32280617,403,2074
2020-05-01,ghana,Africa,32280617,0,2074
2020-05-02,ghana,Africa,32280617,95,2169
2020-05-03,ghana,Africa,32280617,0,2169
2020-05-04,ghana,Africa,32280617,550,2719
2020-05-05,ghana,Africa,32280617,0,2719
2020-05-06,ghana,Africa,32280617,372,3091
2020-05-07,ghana,Africa,32280617,0,3091
2020-05-08,ghana,Africa,32280617,921,4012
2020-05-09,ghana,Africa,32280617,251,4263
2020-05-10,ghana,Africa,32280617,0,4263
2020-05-11,ghana,Africa,32280617,437,4700
2020-05-12,ghana,Africa,32280617,427,5127
2020-05-13,ghana,Africa,32280617,281,5408
2020-05-14,ghana,Africa,32280617,122,5530
2020-05-15,ghana,Africa,32280617,108,5638
2020-05-16,ghana,Africa,32280617,97,5735
2020-05-17,ghana,Africa,32280617,0,5735
2020-05-18,ghana,Africa,32280617,0,5735
2020-05-19,ghana,Africa,32280617,361,6096
2020-05-20,ghana,Africa,32280617,173,6269
2020-05-21,ghana,Africa,32280617,0,6269
2020-05-22,ghana,Africa,32280617,217,6486
2020-05-23,ghana,Africa,32280617,131,6617
2020-05-24,ghana,Africa,32280617,66,6683
2020-05-25,ghana,Africa,32280617,125,6808
2020-05-26,ghana,Africa,32280617,309,7117
2020-05-27,ghana,Africa,32280617,186,7303
2020-05-28,ghana,Africa,32280617,0,7303
2020-05-29,ghana,Africa,32280617,313,7616
2020-05-30,ghana,Africa,32280617,152,7768
2020-05-31,ghana,Africa,32280617,113,7881
2020-06-01,ghana,Africa,32280617,189,8070
2020-06-02,ghana,Africa,32280617,227,8297
2020-06-03,ghana,Africa,32280617,251,8548
2020-06-04,ghana,Africa,32280617,337,8885
2020-06-05,ghana,Africa,32280617,283,9168
2020-06-06,ghana,Africa,32280617,294,9462
2020-06-07,ghana,Africa,32280617,176,9638
2020-06-08,ghana,Africa,32280617,272,9910
2020-06-09,ghana,Africa,32280617,291,10201
2020-06-10,ghana,Africa,32280617,0,10201
2020-06-11,ghana,Africa,32280617,157,10358
2020-06-12,ghana,Africa,32280617,498,10856
2020-06-13,ghana,Africa,32280617,262,11118
2020-06-14,ghana,Africa,32280617,846,11964
2020-06-15,ghana,Africa,32280617,0,11964
2020-06-16,ghana,Africa,32280617,229,12193
2020-06-17,ghana,Africa,32280617,397,12590
2020-06-18,ghana,Africa,32280617,339,12929
2020-06-19,ghana,Africa,32280617,274,13203
2020-06-20,ghana,Africa,32280617,514,13717
2020-06-21,ghana,Africa,32280617,290,14007
2020-06-22,ghana,Africa,32280617,147,14154
2020-06-23,ghana,Africa,32280617,414,14568
2020-06-24,ghana,Africa,32280617,445,15013
2020-06-25,ghana,Africa,32280617,460,15473
2020-06-26,ghana,Africa,32280617,361,15834
2020-06-27,ghana,Africa,32280617,597,16431
2020-06-28,ghana,Africa,32280617,311,16742
2020-06-29,ghana,Africa,32280617,609,17351
2020-06-30,ghana,Africa,32280617,390,17741
2020-07-01,ghana,Africa,32280617,393,18134
2020-07-02,ghana,Africa,32280617,0,18134
2020-07-03,ghana,Africa,32280617,1254,19388
2020-07-04,ghana,Africa,32280617,0,19388
2020-07-05,ghana,Africa,32280617,697,20085
2020-07-06,ghana,Africa,32280617,992,21077
2020-07-07,ghana,Africa,32280617,891,21968
2020-07-08,ghana,Africa,32280617,854,22822
2020-07-09,ghana,Africa,32280617,641,23463
2020-07-10,ghana,Africa,32280617,371,23834
2020-07-11,ghana,Africa,32280617,414,24248
2020-07-12,ghana,Africa,32280617,270,24518
2020-07-13,ghana,Africa,32280617,470,24988
2020-07-14,ghana,Africa,32280617,0,24988
2020-07-15,ghana,Africa,32280617,442,25430
2020-07-16,ghana,Africa,32280617,695,26125
2020-07-17,ghana,Africa,32280617,447,26572
2020-07-18,ghana,Africa,32280617,488,27060
2020-07-19,ghana,Africa,32280617,607,27667
2020-07-20,ghana,Africa,32280617,763,28430
2020-07-21,ghana,Africa,32280617,559,28989
2020-07-22,ghana,Africa,32280617,683,29672
2020-07-23,ghana,Africa,32280617,0,29672
2020-07-24,ghana,Africa,32280617,1385,31057
2020-07-25,ghana,Africa,32280617,794,31851
2020-07-26,ghana,Africa,32280617,1118,32969
2020-07-27,ghana,Africa,32280617,655,33624
2020-07-28,ghana,Africa,32280617,782,34406
2020-07-29,ghana,Africa,32280617,736,35142
2020-07-30,ghana,Africa,32280617,0,35142
2020-07-31,ghana,Africa,32280617,359,35501
2020-08-01,ghana,Africa,32280617,1513,37014
2020-08-02,ghana,Africa,32280617,0,37014
2020-08-03,ghana,Africa,32280617,798,37812
2020-08-04,ghana,Africa,32280617,0,37812
2020-08-05,ghana,Africa,32280617,1263,39075
2020-08-06,ghana,Africa,32280617,567,39642
2020-08-07,ghana,Africa,32280617,455,40097
2020-08-08,ghana,Africa,32280617,436,40533
2020-08-09,ghana,Africa,32280617,470,41003
2020-08-10,ghana,Africa,32280617,209,41212
2020-08-11,ghana,Africa,32280617,192,41404
2020-08-12,ghana,Africa,32280617,168,41572
2020-08-13,ghana,Africa,32280617,153,41725
2020-08-14,ghana,Africa,32280617,122,41847
2020-08-15,ghana,Africa,32280617,363,42210
2020-08-16,ghana,Africa,32280617,322,42532
2020-08-17,ghana,Africa,32280617,121,42653
2020-08-18,ghana,Africa,32280617,340,42993
2020-08-19,ghana,Africa,32280617,101,43094
2020-08-20,ghana,Africa,32280617,166,43260
2020-08-21,ghana,Africa,32280617,65,43325
2020-08-22,ghana,Africa,32280617,180,43505
2020-08-23,ghana,Africa,32280617,0,43505
2020-08-24,ghana,Africa,32280617,117,43622
2020-08-25,ghana,Africa,32280617,95,43717
2020-08-26,ghana,Africa,32280617,52,43769
2020-08-27,ghana,Africa,32280617,72,43841
2020-08-28,ghana,Africa,32280617,108,43949
2020-08-29,ghana,Africa,32280617,169,44118
2020-08-30,ghana,Africa,32280617,87,44205
2020-08-31,ghana,Africa,32280617,93,44298
2020-09-01,ghana,Africa,32280617,162,44460
2020-09-02,ghana,Africa,32280617,198,44658
2020-09-03,ghana,Africa,32280617,55,44713
2020-09-04,ghana,Africa,32280617,64,44777
2020-09-05,ghana,Africa,32280617,0,44777
2020-09-06,ghana,Africa,32280617,0,44777
2020-09-07,ghana,Africa,32280617,92,44869
2020-09-08,ghana,Africa,32280617,143,45012
2020-09-09,ghana,Africa,32280617,301,45313
2020-09-10,ghana,Africa,32280617,0,45313
2020-09-11,ghana,Africa,32280617,75,45388
2020-09-12,ghana,Africa,32280617,46,45434
2020-09-13,ghana,Africa,32280617,0,45434
2020-09-14,ghana,Africa,32280617,167,45601
2020-09-15,ghana,Africa,32280617,54,45655
2020-09-16,ghana,Africa,32280617,0,45655
2020-09-17,ghana,Africa,32280617,59,45714
2020-09-18,ghana,Africa,32280617,46,45760
2020-09-19,ghana,Africa,32280617,117,45877
2020-09-20,ghana,Africa,32280617,127,46004
2020-09-21,ghana,Africa,32280617,58,46062
2020-09-22,ghana,Africa,32280617,0,46062
2020-09-23,ghana,Africa,32280617,91,46153
2020-09-24,ghana,Africa,32280617,69,46222
2020-09-25,ghana,Africa,32280617,0,46222
2020-09-26,ghana,Africa,32280617,0,46222
2020-09-27,ghana,Africa,32280617,165,46387
2020-09-28,ghana,Africa,32280617,57,46444
2020-09-29,ghana,Africa,32280617,38,46482
2020-09-30,ghana,Africa,32280617,144,46626
2020-10-01,ghana,Africa,32280617,30,46656
2020-10-02,ghana,Africa,32280617,38,46694
2020-10-03,ghana,Africa,32280617,109,46803
2020-10-04,ghana,Africa,32280617,26,46829
2020-10-05,ghana,Africa,32280617,0,46829
2020-10-06,ghana,Africa,32280617,0,46829
2020-10-07,ghana,Africa,32280617,0,46829
2020-10-08,ghana,Africa,32280617,118,46947
2020-10-09,ghana,Africa,32280617,40,46987
2020-10-10,ghana,Africa,32280617,18,47005
2020-10-11,ghana,Africa,32280617,0,47005
2020-10-12,ghana,Africa,32280617,25,47030
2020-10-13,ghana,Africa,32280617,96,47126
2020-10-14,ghana,Africa,32280617,0,47126
2020-10-15,ghana,Africa,32280617,47,47173
2020-10-16,ghana,Africa,32280617,0,47173
2020-10-17,ghana,Africa,32280617,26,47199
2020-10-18,ghana,Africa,32280617,111,47310
2020-10-19,ghana,Africa,32280617,62,47372
2020-10-20,ghana,Africa,32280617,89,47461
2020-10-21,ghana,Africa,32280617,0,47461
2020-10-22,ghana,Africa,32280617,77,47538
2020-10-23,ghana,Africa,32280617,63,47601
2020-10-24,ghana,Africa,32280617,89,47690
2020-10-25,ghana,Africa,32280617,0,47690
2020-10-26,ghana,Africa,32280617,85,47775
2020-10-27,ghana,Africa,32280617,0,47775
2020-10-28,ghana,Africa,32280617,133,47908
2020-10-29,ghana,Africa,32280617,147,48055
2020-10-30,ghana,Africa,32280617,0,48055
2020-10-31,ghana,Africa,32280617,0,48055
2020-11-01,ghana,Africa,32280617,69,48124
2020-11-02,ghana,Africa,32280617,76,48200
2020-11-03,ghana,Africa,32280617,311,48511
2020-11-04,ghana,Africa,32280617,132,48643
2020-11-05,ghana,Africa,32280617,145,48788
2020-11-06,ghana,Africa,32280617,0,48788
2020-11-07,ghana,Africa,32280617,116,48904
2020-11-08,ghana,Africa,32280617,298,49202
2020-11-09,ghana,Africa,32280617,0,49202
2020-11-10,ghana,Africa,32280617,100,49302
2020-11-11,ghana,Africa,32280617,270,49572
2020-11-12,ghana,Africa,32280617,385,49957
2020-11-13,ghana,Africa,32280617,61,50018
2020-11-14,ghana,Africa,32280617,0,50018
2020-11-15,ghana,Africa,32280617,105,50123
2020-11-16,ghana,Africa,32280617,253,50376
2020-11-17,ghana,Africa,32280617,0,50376
2020-11-18,ghana,Africa,32280617,81,50457
2020-11-19,ghana,Africa,32280617,174,50631
2020-11-20,ghana,Africa,32280617,0,50631
2020-11-21,ghana,Africa,32280617,86,50717
2020-11-22,ghana,Africa,32280617,157,50874
2020-11-23,ghana,Africa,32280617,67,50941
2020-11-24,ghana,Africa,32280617,243,51184
2020-11-25,ghana,Africa,32280617,41,51225
2020-11-26,ghana,Africa,32280617,0,51225
2020-11-27,ghana,Africa,32280617,49,51274
2020-11-28,ghana,Africa,32280617,105,51379
2020-11-29,ghana,Africa,32280617,190,51569
2020-11-30,ghana,Africa,32280617,98,51667
2020-12-01,ghana,Africa,32280617,0,51667
2020-12-02,ghana,Africa,32280617,0,51667
2020-12-03,ghana,Africa,32280617,0,51667
2020-12-04,ghana,Africa,32280617,429,52096
2020-12-05,ghana,Africa,32280617,0,52096
2020-12-06,ghana,Africa,32280617,178,52274
2020-12-07,ghana,Africa,32280617,0,52274
2020-12-08,ghana,Africa,32280617,226,52500
2020-12-09,ghana,Africa,32280617,122,52622
2020-12-10,ghana,Africa,32280617,116,52738
2020-12-11,ghana,Africa,32280617,0,52738
2020-12-12,ghana,Africa,32280617,195,52933
2020-12-13,ghana,Africa,32280617,0,52933
2020-12-14,ghana,Africa,32280617,227,53160
2020-12-15,ghana,Africa,32280617,110,53270
2020-12-16,ghana,Africa,32280617,116,53386
2020-12-17,ghana,Africa,32280617,167,53553
2020-12-18,ghana,Africa,32280617,100,53653
2020-12-19,ghana,Africa,32280617,0,53653
2020-12-20,ghana,Africa,32280617,203,53856
2020-12-21,ghana,Africa,32280617,98,53954
2020-12-22,ghana,Africa,32280617,0,53954
2020-12-23,ghana,Africa,32280617,89,54043
2020-12-24,ghana,Africa,32280617,0,54043
2020-12-25,ghana,Africa,32280617,178,54221
2020-12-26,ghana,Africa,32280617,65,54286
2020-12-27,ghana,Africa,32280617,115,54401
2020-12-28,ghana,Africa,32280617,102,54503
2020-12-29,ghana,Africa,32280617,178,54681
2020-12-30,ghana,Africa,32280617,90,54771
2020-12-31,ghana,Africa,32280617,0,54771
2021-01-01,ghana,Africa,32280617,159,54930
2021-01-02,ghana,Africa,32280617,134,55064
2021-01-03,ghana,Africa,32280617,104,55168
2021-01-04,ghana,Africa,32280617,0,55168
2021-01-05,ghana,Africa,32280617,0,55168
2021-01-06,ghana,Africa,32280617,160,55328
2021-01-07,ghana,Africa,32280617,133,55461
2021-01-08,ghana,Africa,32280617,0,55461
2021-01-09,ghana,Africa,32280617,311,55772
2021-01-10,ghana,Africa,32280617,0,55772
2021-01-11,ghana,Africa,32280617,458,56230
2021-01-12,ghana,Africa,32280617,191,56421
2021-01-13,ghana,Africa,32280617,560,56981
2021-01-14,ghana,Africa,32280617,0,56981
2021-01-15,ghana,Africa,32280617,0,56981
2021-01-16,ghana,Africa,32280617,436,57417
2021-01-17,ghana,Africa,32280617,297,57714
2021-01-18,ghana,Africa,32280617,351,58065
2021-01-19,ghana,Africa,32280617,366,58431
2021-01-20,ghana,Africa,32280617,391,58822
2021-01-21,ghana,Africa,32280617,658,59480
2021-01-22,ghana,Africa,32280617,635,60115
2021-01-23,ghana,Africa,32280617,679,60794
2021-01-24,ghana,Africa,32280617,695,61489
2021-01-25,ghana,Africa,32280617,646,62135
2021-01-26,ghana,Africa,32280617,616,62751
2021-01-27,ghana,Africa,32280617,507,63258
2021-01-28,ghana,Africa,32280617,625,63883
2021-01-29,ghana,Africa,32280617,747,64630
2021-01-30,ghana,Africa,32280617,797,65427
2021-01-31,ghana,Africa,32280617,1583,67010
2021-02-01,ghana,Africa,32280617,0,67010
2021-02-02,ghana,Africa,32280617,772,67782
2021-02-03,ghana,Africa,32280617,777,68559
2021-02-04,ghana,Africa,32280617,696,69255
2021-02-05,ghana,Africa,32280617,791,70046
2021-02-06,ghana,Africa,32280617,722,70768
2021-02-07,ghana,Africa,32280617,765,71533
2021-02-08,ghana,Africa,32280617,795,72328
2021-02-09,ghana,Africa,32280617,675,73003
2021-02-10,ghana,Africa,32280617,0,73003
2021-02-11,ghana,Africa,32280617,554,73557
2021-02-12,ghana,Africa,32280617,790,74347
2021-02-13,ghana,Africa,32280617,1489,75836
2021-02-14,ghana,Africa,32280617,0,75836
2021-02-15,ghana,Africa,32280617,656,76492
2021-02-16,ghana,Africa,32280617,554,77046
2021-02-17,ghana,Africa,32280617,1225,78271
2021-02-18,ghana,Africa,32280617,418,78689
2021-02-19,ghana,Africa,32280617,476,79165
2021-02-20,ghana,Africa,32280617,490,79655
2021-02-21,ghana,Africa,32280617,598,80253
2021-02-22,ghana,Africa,32280617,506,80759
2021-02-23,ghana,Africa,32280617,0,80759
2021-02-24,ghana,Africa,32280617,486,81245
2021-02-25,ghana,Africa,32280617,428,81673
2021-02-26,ghana,Africa,32280617,913,82586
2021-02-27,ghana,Africa,32280617,626,83212
2021-02-28,ghana,Africa,32280617,811,84023
2021-03-01,ghana,Africa,32280617,0,84023
2021-03-02,ghana,Africa,32280617,0,84023
2021-03-03,ghana,Africa,32280617,326,84349
2021-03-04,ghana,Africa,32280617,890,85239
2021-03-05,ghana,Africa,32280617,503,85742
2021-03-06,ghana,Africa,32280617,350,86092
2021-03-07,ghana,Africa,32280617,373,86465
2021-03-08,ghana,Africa,32280617,0,86465
2021-03-09,ghana,Africa,32280617,272,86737
2021-03-10,ghana,Africa,32280617,0,86737
2021-03-11,ghana,Africa,32280617,0,86737
2021-03-12,ghana,Africa,32280617,236,86973
2021-03-13,ghana,Africa,32280617,507,87480
2021-03-14,ghana,Africa,32280617,282,87762
2021-03-15,ghana,Africa,32280617,223,87985
2021-03-16,ghana,Africa,32280617,243,88228
2021-03-17,ghana,Africa,32280617,193,88421
2021-03-18,ghana,Africa,32280617,0,88421
2021-03-19,ghana,Africa,32280617,587,89008
2021-03-20,ghana,Africa,32280617,268,89276
2021-03-21,ghana,Africa,32280617,406,89682
2021-03-22,ghana,Africa,32280617,0,89682
2021-03-23,ghana,Africa,32280617,211,89893
2021-03-24,ghana,Africa,32280617,0,89893
2021-03-25,ghana,Africa,32280617,106,89999
2021-03-26,ghana,Africa,32280617,288,90287
2021-03-27,ghana,Africa,32280617,0,90287
2021-03-28,ghana,Africa,32280617,72,90359
2021-03-29,ghana,Africa,32280617,70,90429
2021-03-30,ghana,Africa,32280617,70,90499
2021-03-31,ghana,Africa,32280617,84,90583
2021-04-01,ghana,Africa,32280617,0,90583
2021-04-02,ghana,Africa,32280617,91,90674
2021-04-03,ghana,Africa,32280617,108,90782
2021-04-04,ghana,Africa,32280617,0,90782
2021-04-05,ghana,Africa,32280617,118,90900
2021-04-06,ghana,Africa,32280617,46,90946
2021-04-07,ghana,Africa,32280617,63,91009
2021-04-08,ghana,Africa,32280617,100,91109
2021-04-09,ghana,Africa,32280617,0,91109
2021-04-10,ghana,Africa,32280617,151,91260
2021-04-11,ghana,Africa,32280617,0,91260
2021-04-12,ghana,Africa,32280617,75,91335
2021-04-13,ghana,Africa,32280617,75,91410
2021-04-14,ghana,Africa,32280617,67,91477
2021-04-15,ghana,Africa,32280617,68,91545
2021-04-16,ghana,Africa,32280617,74,91619
2021-04-17,ghana,Africa,32280617,44,91663
2021-04-18,ghana,Africa,32280617,46,91709
2021-04-19,ghana,Africa,32280617,0,91709
2021-04-20,ghana,Africa,32280617,0,91709
2021-04-21,ghana,Africa,32280617,74,91783
2021-04-22,ghana,Africa,32280617,145,91928
2021-04-23,ghana,Africa,32280617,0,91928
2021-04-24,ghana,Africa,32280617,53,91981
2021-04-25,ghana,Africa,32280617,185,92166
2021-04-26,ghana,Africa,32280617,180,92346
2021-04-27,ghana,Africa,32280617,118,92464
2021-04-28,ghana,Africa,32280617,49,92513
2021-04-29,ghana,Africa,32280617,49,92562
2021-04-30,ghana,Africa,32280617,0,92562
2021-05-01,ghana,Africa,32280617,39,92601
2021-05-02,ghana,Africa,32280617,34,92635
2021-05-03,ghana,Africa,32280617,48,92683
2021-05-04,ghana,Africa,32280617,57,92740
2021-05-05,ghana,Africa,32280617,88,92828
2021-05-06,ghana,Africa,32280617,0,92828
2021-05-07,ghana,Africa,32280617,28,92856
2021-05-08,ghana,Africa,32280617,0,92856
2021-05-09,ghana,Africa,32280617,95,92951
2021-05-10,ghana,Africa,32280617,60,93011
2021-05-11,ghana,Africa,32280617,0,93011
2021-05-12,ghana,Africa,32280617,114,93125
2021-05-13,ghana,Africa,32280617,34,93159
2021-05-14,ghana,Africa,32280617,84,93243
2021-05-15,ghana,Africa,32280617,0,93243
2021-05-16,ghana,Africa,32280617,0,93243
2021-05-17,ghana,Africa,32280617,90,93333
2021-05-18,ghana,Africa,32280617,57,93390
2021-05-19,ghana,Africa,32280617,66,93456
2021-05-20,ghana,Africa,32280617,0,93456
2021-05-21,ghana,Africa,32280617,65,93521
2021-05-22,ghana,Africa,32280617,62,93583
2021-05-23,ghana,Africa,32280617,37,93620
2021-05-24,ghana,Africa,32280617,64,93684
2021-05-25,ghana,Africa,32280617,27,93711
2021-05-26,ghana,Africa,32280617,0,93711
2021-05-27,ghana,Africa,32280617,12,93723
2021-05-28,ghana,Africa,32280617,52,93775
2021-05-29,ghana,Africa,32280617,0,93775
2021-05-30,ghana,Africa,32280617,123,93898
2021-05-31,ghana,Africa,32280617,64,93962
2021-06-01,ghana,Africa,32280617,49,94011
2021-06-02,ghana,Africa,32280617,0,94011
2021-06-03,ghana,Africa,32280617,125,94136
2021-06-04,ghana,Africa,32280617,52,94188
2021-06-05,ghana,Africa,32280617,0,94188
2021-06-06,ghana,Africa,32280617,40,94228
2021-06-07,ghana,Africa,32280617,0,94228
2021-06-08,ghana,Africa,32280617,101,94329
2021-06-09,ghana,Africa,32280617,40,94369
2021-06-10,ghana,Africa,32280617,0,94369
2021-06-11,ghana,Africa,32280617,75,94444
2021-06-12,ghana,Africa,32280617,49,94493
2021-06-13,ghana,Africa,32280617,0,94493
2021-06-14,ghana,Africa,32280617,126,94619
2021-06-15,ghana,Africa,32280617,80,94699
2021-06-16,ghana,Africa,32280617,125,94824
2021-06-17,ghana,Africa,32280617,0,94824
2021-06-18,ghana,Africa,32280617,89,94913
2021-06-19,ghana,Africa,32280617,0,94913
2021-06-20,ghana,Africa,32280617,0,94913
2021-06-21,ghana,Africa,32280617,146,95059
2021-06-22,ghana,Africa,32280617,177,95236
2021-06-23,ghana,Africa,32280617,0,95236
2021-06-24,ghana,Africa,32280617,23,95259
2021-06-25,ghana,Africa,32280617,0,95259
2021-06-26,ghana,Africa,32280617,0,95259
2021-06-27,ghana,Africa,32280617,110,95369
2021-06-28,ghana,Africa,32280617,107,95476
2021-06-29,ghana,Africa,32280617,166,95642
2021-06-30,ghana,Africa,32280617,272,95914
2021-07-01,ghana,Africa,32280617,0,95914
2021-07-02,ghana,Africa,32280617,0,95914
2021-07-03,ghana,Africa,32280617,153,96067
2021-07-04,ghana,Africa,32280617,250,96317
2021-07-05,ghana,Africa,32280617,85,96402
2021-07-06,ghana,Africa,32280617,0,96402
2021-07-07,ghana,Africa,32280617,306,96708
2021-07-08,ghana,Africa,32280617,263,96971
2021-07-09,ghana,Africa,32280617,0,96971
2021-07-10,ghana,Africa,32280617,159,97130
2021-07-11,ghana,Africa,32280617,455,97585
2021-07-12,ghana,Africa,32280617,0,97585
2021-07-13,ghana,Africa,32280617,143,97728
2021-07-14,ghana,Africa,32280617,0,97728
2021-07-15,ghana,Africa,32280617,386,98114
2021-07-16,ghana,Africa,32280617,321,98435
2021-07-17,ghana,Africa,32280617,382,98817
2021-07-18,ghana,Africa,32280617,343,99160
2021-07-19,ghana,Africa,32280617,270,99430
2021-07-21,ghana,Africa,32280617,574,99734
2021-07-22,ghana,Africa,32280617,240,99974
2021-07-23,ghana,Africa,32280617,276,100250
2021-07-24,ghana,Africa,32280617,497,100747
2021-07-25,ghana,Africa,32280617,921,101668
2021-07-26,ghana,Africa,32280617,435,102103
2021-07-27,ghana,Africa,32280617,466,102569
2021-07-28,ghana,Africa,32280617,450,103019
2021-07-29,ghana,Africa,32280617,0,103019
2021-07-30,ghana,Africa,32280617,0,103019
2021-07-31,ghana,Africa,32280617,0,103019
2021-08-01,ghana,Africa,32280617,1311,104330
2021-08-02,ghana,Africa,32280617,664,104994
2021-08-03,ghana,Africa,32280617,518,105512
2021-08-04,ghana,Africa,32280617,541,106053
2021-08-05,ghana,Africa,32280617,381,106434
2021-08-06,ghana,Africa,32280617,0,106434
2021-08-07,ghana,Africa,32280617,316,106750
2021-08-08,ghana,Africa,32280617,1476,108226
2021-08-09,ghana,Africa,32280617,0,108226
2021-08-10,ghana,Africa,32280617,451,108677
2021-08-11,ghana,Africa,32280617,345,109022
2021-08-12,ghana,Africa,32280617,406,109428
2021-08-13,ghana,Africa,32280617,308,109736
2021-08-14,ghana,Africa,32280617,570,110306
2021-08-15,ghana,Africa,32280617,404,110710
2021-08-16,ghana,Africa,32280617,522,111232
2021-08-17,ghana,Africa,32280617,622,111854
2021-08-18,ghana,Africa,32280617,524,112378
2021-08-19,ghana,Africa,32280617,550,112928
2021-08-20,ghana,Africa,32280617,0,112928
2021-08-21,ghana,Africa,32280617,1029,113957
2021-08-22,ghana,Africa,32280617,627,114584
2021-08-23,ghana,Africa,32280617,518,115102
2021-08-24,ghana,Africa,32280617,423,115525
2021-08-25,ghana,Africa,32280617,0,115525
2021-08-26,ghana,Africa,32280617,916,116441
2021-08-27,ghana,Africa,32280617,599,117040
2021-08-28,ghana,Africa,32280617,596,117636
2021-08-29,ghana,Africa,32280617,0,117636
2021-08-30,ghana,Africa,32280617,630,118266
2021-08-31,ghana,Africa,32280617,1170,119436
2021-09-01,ghana,Africa,32280617,360,119796
2021-09-02,ghana,Africa,32280617,207,120003
2021-09-03,ghana,Africa,32280617,449,120452
2021-09-04,ghana,Africa,32280617,0,120452
2021-09-05,ghana,Africa,32280617,0,120452
2021-09-06,ghana,Africa,32280617,855,121307
2021-09-07,ghana,Africa,32280617,850,122157
2021-09-08,ghana,Africa,32280617,386,122543
2021-09-09,ghana,Africa,32280617,0,122543
2021-09-10,ghana,Africa,32280617,236,122779
2021-09-11,ghana,Africa,32280617,0,122779
2021-09-12,ghana,Africa,32280617,742,123521
2021-09-13,ghana,Africa,32280617,353,123874
2021-09-14,ghana,Africa,32280617,0,123874
2021-09-15,ghana,Africa,32280617,0,123874
2021-09-16,ghana,Africa,32280617,530,124404
2021-09-17,ghana,Africa,32280617,336,124740
2021-09-18,ghana,Africa,32280617,265,125005
2021-09-19,ghana,Africa,32280617,256,125261
2021-09-20,ghana,Africa,32280617,304,125565
2021-09-21,ghana,Africa,32280617,0,125565
2021-09-22,ghana,Africa,32280617,265,125830
2021-09-23,ghana,Africa,32280617,316,126146
2021-09-24,ghana,Africa,32280617,167,126313
2021-09-25,ghana,Africa,32280617,308,126621
2021-09-26,ghana,Africa,32280617,185,126806
2021-09-27,ghana,Africa,32280617,210,127016
2021-09-28,ghana,Africa,32280617,0,127016
2021-09-29,ghana,Africa,32280617,0,127016
2021-09-30,ghana,Africa,32280617,466,127482
2021-10-01,ghana,Africa,32280617,0,127482
2021-10-02,ghana,Africa,32280617,0,127482
2021-10-03,ghana,Africa,32280617,0,127482
2021-10-04,ghana,Africa,32280617,168,127650
2021-10-05,ghana,Africa,32280617,228,127878
2021-10-06,ghana,Africa,32280617,281,128159
2021-10-07,ghana,Africa,32280617,209,128368
2021-10-08,ghana,Africa,32280617,0,128368
2021-10-09,ghana,Africa,32280617,0,128368
2021-10-10,ghana,Africa,32280617,0,128368
2021-10-11,ghana,Africa,32280617,0,128368
2021-10-12,ghana,Africa,32280617,0,128368
2021-10-13,ghana,Africa,32280617,0,128368
2021-10-14,ghana,Africa,32280617,0,128368
2021-10-15,ghana,Africa,32280617,0,128368
2021-10-16,ghana,Africa,32280617,890,129258
2021-10-17,ghana,Africa,32280617,182,129440
2021-10-18,ghana,Africa,32280617,94,129534
2021-10-19,ghana,Africa,32280617,58,129592
2021-10-20,ghana,Africa,32280617,0,129592
2021-10-21,ghana,Africa,32280617,0,129592
2021-10-22,ghana,Africa,32280617,0,129592
2021-10-23,ghana,Africa,32280617,213,129805
2021-10-24,ghana,Africa,32280617,0,129805
2021-10-25,ghana,Africa,32280617,143,129948
2021-10-26,ghana,Africa,32280617,60,130008
2021-10-27,ghana,Africa,32280617,33,130041
2021-10-28,ghana,Africa,32280617,36,130077
2021-10-29,ghana,Africa,32280617,0,130077
2021-10-30,ghana,Africa,32280617,0,130077
2021-10-31,ghana,Africa,32280617,0,130077
2021-11-01,ghana,Africa,32280617,0,130077
2021-11-02,ghana,Africa,32280617,210,130287
2021-11-03,ghana,Africa,32280617,0,130287
2021-11-04,ghana,Africa,32280617,0,130287
2021-11-05,ghana,Africa,32280617,104,130391
2021-11-06,ghana,Africa,32280617,0,130391
2021-11-07,ghana,Africa,32280617,0,130391
2021-11-08,ghana,Africa,32280617,0,130391
2021-11-09,ghana,Africa,32280617,217,130608
2021-11-10,ghana,Africa,32280617,0,130608
2021-11-11,ghana,Africa,32280617,41,130649
2021-11-12,ghana,Africa,32280617,0,130649
2021-11-13,ghana,Africa,32280617,0,130649
2021-11-14,ghana,Africa,32280617,0,130649
2021-11-15,ghana,Africa,32280617,61,130710
2021-11-16,ghana,Africa,32280617,17,130727
2021-11-17,ghana,Africa,32280617,0,130727
2021-11-18,ghana,Africa,32280617,0,130727
2021-11-19,ghana,Africa,32280617,0,130727
2021-11-20,ghana,Africa,32280617,0,130727
2021-11-21,ghana,Africa,32280617,100,130827
2021-11-22,ghana,Africa,32280617,0,130827
2021-11-23,ghana,Africa,32280617,93,130920
2021-11-24,ghana,Africa,32280617,0,130920
2021-11-25,ghana,Africa,32280617,0,130920
2021-11-26,ghana,Africa,32280617,0,130920
2021-11-27,ghana,Africa,32280617,0,130920
2021-11-28,ghana,Africa,32280617,0,130920
2021-11-29,ghana,Africa,32280617,0,130920
2021-11-30,ghana,Africa,32280617,0,130920
2021-12-01,ghana,Africa,32280617,0,130920
2021-12-02,ghana,Africa,32280617,0,130920
2021-12-03,ghana,Africa,32280617,0,130920
2021-12-04,ghana,Africa,32280617,0,130920
2021-12-05,ghana,Africa,32280617,0,130920
2021-12-06,ghana,Africa,32280617,326,131246
2021-12-07,ghana,Africa,32280617,0,131246
2021-12-08,ghana,Africa,32280617,0,131246
2021-12-09,ghana,Africa,32280617,0,131246
2021-12-10,ghana,Africa,32280617,0,131246
2021-12-11,ghana,Africa,32280617,166,131412
2021-12-12,ghana,Africa,32280617,135,131547
2021-12-13,ghana,Africa,32280617,0,131547
2021-12-14,ghana,Africa,32280617,0,131547
2021-12-15,ghana,Africa,32280617,293,131840
2021-12-16,ghana,Africa,32280617,71,131911
2021-12-17,ghana,Africa,32280617,0,131911
2021-12-18,ghana,Africa,32280617,0,131911
2021-12-19,ghana,Africa,32280617,0,131911
2021-12-20,ghana,Africa,32280617,221,132132
2021-12-21,ghana,Africa,32280617,477,132609
2021-12-22,ghana,Africa,32280617,946,133555
2021-12-23,ghana,Africa,32280617,1000,134555
2021-12-24,ghana,Africa,32280617,0,134555
2021-12-25,ghana,Africa,32280617,0,134555
2021-12-26,ghana,Africa,32280617,1881,136436
2021-12-27,ghana,Africa,32280617,2521,138957
2021-12-28,ghana,Africa,32280617,1264,140221
2021-12-29,ghana,Africa,32280617,1074,141295
2021-12-30,ghana,Africa,32280617,901,142196
2021-12-31,ghana,Africa,32280617,790,142986
2022-01-01,ghana,Africa,32280617,1011,143997
2022-01-02,ghana,Africa,32280617,1055,145052
2022-01-03,ghana,Africa,32280617,1067,146119
2022-01-04,ghana,Africa,32280617,1084,147203
2022-01-05,ghana,Africa,32280617,876,148079
2022-01-06,ghana,Africa,32280617,0,148079
2022-01-07,ghana,Africa,32280617,0,148079
2022-01-08,ghana,Africa,32280617,1288,149367
2022-01-09,ghana,Africa,32280617,1507,150874
2022-01-10,ghana,Africa,32280617,1369,152243
2022-01-11,ghana,Africa,32280617,0,152243
2022-01-12,ghana,Africa,32280617,486,152729
2022-01-13,ghana,Africa,32280617,0,152729
2022-01-14,ghana,Africa,32280617,0,152729
2022-01-15,ghana,Africa,32280617,785,153514
2022-01-16,ghana,Africa,32280617,0,153514
2022-01-17,ghana,Africa,32280617,0,153514
2022-01-18,ghana,Africa,32280617,676,154190
2022-01-19,ghana,Africa,32280617,424,154614
2022-01-20,ghana,Africa,32280617,277,154891
2022-01-21,ghana,Africa,32280617,0,154891
2022-01-22,ghana,Africa,32280617,0,154891
2022-01-23,ghana,Africa,32280617,605,155496
2022-01-24,ghana,Africa,32280617,169,155665
2022-01-25,ghana,Africa,32280617,418,156083
2022-01-26,ghana,Africa,32280617,189,156272
2022-01-27,ghana,Africa,32280617,120,156392
2022-01-28,ghana,Africa,32280617,123,156515
2022-01-29,ghana,Africa,32280617,175,156690
2022-01-30,ghana,Africa,32280617,115,156805
2022-01-31,ghana,Africa,32280617,115,156920
2022-02-01,ghana,Africa,32280617,0,156920
2022-02-02,ghana,Africa,32280617,0,156920
2022-02-03,ghana,Africa,32280617,300,157220
2022-02-04,ghana,Africa,32280617,0,157220
2022-02-05,ghana,Africa,32280617,321,157541
2022-02-06,ghana,Africa,32280617,0,157541
2022-02-07,ghana,Africa,32280617,210,157751
2022-02-08,ghana,Africa,32280617,0,157751
2022-02-09,ghana,Africa,32280617,0,157751
2022-02-10,ghana,Africa,32280617,0,157751
2022-02-11,ghana,Africa,32280617,0,157751
2022-02-12,ghana,Africa,32280617,0,157751
2022-02-13,ghana,Africa,32280617,0,157751
2022-02-14,ghana,Africa,32280617,166,157917
2022-02-15,ghana,Africa,32280617,121,158038
2022-02-16,ghana,Africa,32280617,121,158159
2022-02-17,ghana,Africa,32280617,61,158220
2022-02-18,ghana,Africa,32280617,0,158220
2020-02-27,greece,Europe,10328255,2,3
2020-02-28,greece,Europe,10328255,1,4
2020-02-29,greece,Europe,10328255,3,7
2020-03-01,greece,Europe,10328255,0,7
2020-03-02,greece,Europe,10328255,0,7
2020-03-03,greece,Europe,10328255,0,7
2020-03-04,greece,Europe,10328255,2,9
2020-03-05,greece,Europe,10328255,22,31
2020-03-06,greece,Europe,10328255,14,45
2020-03-07,greece,Europe,10328255,21,66
2020-03-08,greece,Europe,10328255,7,73
2020-03-09,greece,Europe,10328255,11,84
2020-03-10,greece,Europe,10328255,5,89
2020-03-11,greece,Europe,10328255,10,99
2020-03-12,greece,Europe,10328255,18,117
2020-03-13,greece,Europe,10328255,73,190
2020-03-14,greece,Europe,10328255,38,228
2020-03-15,greece,Europe,10328255,103,331
2020-03-16,greece,Europe,10328255,21,352
2020-03-17,greece,Europe,10328255,35,387
2020-03-18,greece,Europe,10328255,31,418
2020-03-19,greece,Europe,10328255,46,464
2020-03-20,greece,Europe,10328255,31,495
2020-03-21,greece,Europe,10328255,35,530
2020-03-22,greece,Europe,10328255,94,624
2020-03-23,greece,Europe,10328255,71,695
2020-03-24,greece,Europe,10328255,48,743
2020-03-25,greece,Europe,10328255,78,821
2020-03-26,greece,Europe,10328255,71,892
2020-03-27,greece,Europe,10328255,74,966
2020-03-28,greece,Europe,10328255,95,1061
2020-03-29,greece,Europe,10328255,95,1156
2020-03-30,greece,Europe,10328255,56,1212
2020-03-31,greece,Europe,10328255,102,1314
2020-04-01,greece,Europe,10328255,101,1415
2020-04-02,greece,Europe,10328255,129,1544
2020-04-03,greece,Europe,10328255,69,1613
2020-04-04,greece,Europe,10328255,60,1673
2020-04-05,greece,Europe,10328255,62,1735
2020-04-06,greece,Europe,10328255,20,1755
2020-04-07,greece,Europe,10328255,77,1832
2020-04-08,greece,Europe,10328255,52,1884
2020-04-09,greece,Europe,10328255,71,1955
2020-04-10,greece,Europe,10328255,56,2011
2020-04-11,greece,Europe,10328255,70,2081
2020-04-12,greece,Europe,10328255,33,2114
2020-04-13,greece,Europe,10328255,31,2145
2020-04-14,greece,Europe,10328255,25,2170
2020-04-15,greece,Europe,10328255,22,2192
2020-04-16,greece,Europe,10328255,15,2207
2020-04-17,greece,Europe,10328255,17,2224
2020-04-18,greece,Europe,10328255,11,2235
2020-04-19,greece,Europe,10328255,0,2235
2020-04-20,greece,Europe,10328255,10,2245
2020-04-21,greece,Europe,10328255,156,2401
2020-04-22,greece,Europe,10328255,7,2408
2020-04-23,greece,Europe,10328255,55,2463
2020-04-24,greece,Europe,10328255,27,2490
2020-04-25,greece,Europe,10328255,16,2506
2020-04-26,greece,Europe,10328255,11,2517
2020-04-27,greece,Europe,10328255,17,2534
2020-04-28,greece,Europe,10328255,32,2566
2020-04-29,greece,Europe,10328255,10,2576
2020-04-30,greece,Europe,10328255,15,2591
2020-05-01,greece,Europe,10328255,21,2612
2020-05-02,greece,Europe,10328255,8,2620
2020-05-03,greece,Europe,10328255,6,2626
2020-05-04,greece,Europe,10328255,6,2632
2020-05-05,greece,Europe,10328255,10,2642
2020-05-06,greece,Europe,10328255,21,2663
2020-05-07,greece,Europe,10328255,15,2678
2020-05-08,greece,Europe,10328255,13,2691
2020-05-09,greece,Europe,10328255,19,2710
2020-05-10,greece,Europe,10328255,6,2716
2020-05-11,greece,Europe,10328255,10,2726
2020-05-12,greece,Europe,10328255,18,2744
2020-05-13,greece,Europe,10328255,16,2760
2020-05-14,greece,Europe,10328255,10,2770
2020-05-15,greece,Europe,10328255,40,2810
2020-05-16,greece,Europe,10328255,9,2819
2020-05-17,greece,Europe,10328255,15,2834
2020-05-18,greece,Europe,10328255,2,2836
2020-05-19,greece,Europe,10328255,4,2840
2020-05-20,greece,Europe,10328255,10,2850
2020-05-21,greece,Europe,10328255,3,2853
2020-05-22,greece,Europe,10328255,21,2874
2020-05-23,greece,Europe,10328255,2,2876
2020-05-24,greece,Europe,10328255,2,2878
2020-05-25,greece,Europe,10328255,4,2882
2020-05-26,greece,Europe,10328255,10,2892
2020-05-27,greece,Europe,10328255,11,2903
2020-05-28,greece,Europe,10328255,3,2906
2020-05-29,greece,Europe,10328255,3,2909
2020-05-30,greece,Europe,10328255,6,2915
2020-05-31,greece,Europe,10328255,2,2917
2020-06-01,greece,Europe,10328255,1,2918
2020-06-02,greece,Europe,10328255,19,2937
2020-06-03,greece,Europe,10328255,0,2937
2020-06-04,greece,Europe,10328255,15,2952
2020-06-05,greece,Europe,10328255,15,2967
2020-06-06,greece,Europe,10328255,13,2980
2020-06-07,greece,Europe,10328255,17,2997
2020-06-08,greece,Europe,10328255,52,3049
2020-06-09,greece,Europe,10328255,9,3058
2020-06-10,greece,Europe,10328255,10,3068
2020-06-11,greece,Europe,10328255,20,3088
2020-06-12,greece,Europe,10328255,20,3108
2020-06-13,greece,Europe,10328255,4,3112
2020-06-14,greece,Europe,10328255,9,3121
2020-06-15,greece,Europe,10328255,13,3134
2020-06-16,greece,Europe,10328255,14,3148
2020-06-17,greece,Europe,10328255,55,3203
2020-06-18,greece,Europe,10328255,24,3227
2020-06-19,greece,Europe,10328255,10,3237
2020-06-20,greece,Europe,10328255,19,3256
2020-06-21,greece,Europe,10328255,10,3266
2020-06-22,greece,Europe,10328255,21,3287
2020-06-23,greece,Europe,10328255,15,3302
2020-06-24,greece,Europe,10328255,8,3310
2020-06-25,greece,Europe,10328255,11,3321
2020-06-26,greece,Europe,10328255,22,3343
2020-06-27,greece,Europe,10328255,23,3366
2020-06-28,greece,Europe,10328255,10,3376
2020-06-29,greece,Europe,10328255,14,3390
2020-06-30,greece,Europe,10328255,19,3409
2020-07-01,greece,Europe,10328255,23,3432
2020-07-02,greece,Europe,10328255,26,3458
2020-07-03,greece,Europe,10328255,28,3486
2020-07-04,greece,Europe,10328255,25,3511
2020-07-05,greece,Europe,10328255,8,3519
2020-07-06,greece,Europe,10328255,43,3562
2020-07-07,greece,Europe,10328255,27,3589
2020-07-08,greece,Europe,10328255,33,3622
2020-07-09,greece,Europe,10328255,50,3672
2020-07-10,greece,Europe,10328255,60,3732
2020-07-11,greece,Europe,10328255,40,3772
2020-07-12,greece,Europe,10328255,31,3803
2020-07-13,greece,Europe,10328255,23,3826
2020-07-14,greece,Europe,10328255,57,3883
2020-07-15,greece,Europe,10328255,27,3910
2020-07-16,greece,Europe,10328255,29,3939
2020-07-17,greece,Europe,10328255,25,3964
2020-07-18,greece,Europe,10328255,19,3983
2020-07-19,greece,Europe,10328255,24,4007
2020-07-20,greece,Europe,10328255,5,4012
2020-07-21,greece,Europe,10328255,36,4048
2020-07-22,greece,Europe,10328255,29,4077
2020-07-23,greece,Europe,10328255,33,4110
2020-07-24,greece,Europe,10328255,25,4135
2020-07-25,greece,Europe,10328255,31,4166
2020-07-26,greece,Europe,10328255,27,4193
2020-07-27,greece,Europe,10328255,34,4227
2020-07-28,greece,Europe,10328255,52,4279
2020-07-29,greece,Europe,10328255,57,4336
2020-07-30,greece,Europe,10328255,65,4401
2020-07-31,greece,Europe,10328255,76,4477
2020-08-01,greece,Europe,10328255,110,4587
2020-08-02,greece,Europe,10328255,75,4662
2020-08-03,greece,Europe,10328255,75,4737
2020-08-04,greece,Europe,10328255,118,4855
2020-08-05,greece,Europe,10328255,119,4974
2020-08-06,greece,Europe,10328255,145,5119
2020-08-07,greece,Europe,10328255,151,5270
2020-08-08,greece,Europe,10328255,151,5421
2020-08-09,greece,Europe,10328255,202,5623
2020-08-10,greece,Europe,10328255,126,5749
2020-08-11,greece,Europe,10328255,193,5942
2020-08-12,greece,Europe,10328255,235,6177
2020-08-13,greece,Europe,10328255,204,6381
2020-08-14,greece,Europe,10328255,251,6632
2020-08-15,greece,Europe,10328255,226,6858
2020-08-16,greece,Europe,10328255,217,7075
2020-08-17,greece,Europe,10328255,147,7222
2020-08-18,greece,Europe,10328255,250,7472
2020-08-19,greece,Europe,10328255,212,7684
2020-08-20,greece,Europe,10328255,250,7934
2020-08-21,greece,Europe,10328255,204,8138
2020-08-22,greece,Europe,10328255,243,8381
2020-08-23,greece,Europe,10328255,283,8664
2020-08-24,greece,Europe,10328255,155,8819
2020-08-25,greece,Europe,10328255,168,8987
2020-08-26,greece,Europe,10328255,293,9280
2020-08-27,greece,Europe,10328255,251,9531
2020-08-28,greece,Europe,10328255,269,9800
2020-08-29,greece,Europe,10328255,177,9977
2020-08-30,greece,Europe,10328255,157,10134
2020-08-31,greece,Europe,10328255,183,10317
2020-09-01,greece,Europe,10328255,207,10524
2020-09-02,greece,Europe,10328255,233,10757
2020-09-03,greece,Europe,10328255,241,10998
2020-09-04,greece,Europe,10328255,202,11200
2020-09-05,greece,Europe,10328255,186,11386
2020-09-06,greece,Europe,10328255,138,11524
2020-09-07,greece,Europe,10328255,139,11663
2020-09-08,greece,Europe,10328255,169,11832
2020-09-09,greece,Europe,10328255,248,12080
2020-09-10,greece,Europe,10328255,367,12447
2020-09-11,greece,Europe,10328255,287,12734
2020-09-12,greece,Europe,10328255,302,13036
2020-09-13,greece,Europe,10328255,204,13240
2020-09-14,greece,Europe,10328255,180,13420
2020-09-15,greece,Europe,10328255,310,13730
2020-09-16,greece,Europe,10328255,311,14041
2020-09-17,greece,Europe,10328255,359,14400
2020-09-18,greece,Europe,10328255,338,14738
2020-09-19,greece,Europe,10328255,240,14978
2020-09-20,greece,Europe,10328255,164,15142
2020-09-21,greece,Europe,10328255,453,15595
2020-09-22,greece,Europe,10328255,333,15928
2020-09-23,greece,Europe,10328255,358,16286
2020-09-24,greece,Europe,10328255,341,16627
2020-09-25,greece,Europe,10328255,286,16913
2020-09-26,greece,Europe,10328255,315,17228
2020-09-27,greece,Europe,10328255,216,17444
2020-09-28,greece,Europe,10328255,263,17707
2020-09-29,greece,Europe,10328255,416,18123
2020-09-30,greece,Europe,10328255,352,18475
2020-10-01,greece,Europe,10328255,411,18886
2020-10-02,greece,Europe,10328255,460,19346
2020-10-03,greece,Europe,10328255,267,19613
2020-10-04,greece,Europe,10328255,229,19842
2020-10-05,greece,Europe,10328255,300,20142
2020-10-06,greece,Europe,10328255,399,20541
2020-10-07,greece,Europe,10328255,406,20947
2020-10-08,greece,Europe,10328255,434,21381
2020-10-09,greece,Europe,10328255,391,21772
2020-10-10,greece,Europe,10328255,306,22078
2020-10-11,greece,Europe,10328255,280,22358
2020-10-12,greece,Europe,10328255,294,22652
2020-10-13,greece,Europe,10328255,408,23060
2020-10-14,greece,Europe,10328255,435,23495
2020-10-15,greece,Europe,10328255,452,23947
2020-10-16,greece,Europe,10328255,503,24450
2020-10-17,greece,Europe,10328255,482,24932
2020-10-18,greece,Europe,10328255,438,25370
2020-10-19,greece,Europe,10328255,432,25802
2020-10-20,greece,Europe,10328255,667,26469
2020-10-21,greece,Europe,10328255,865,27334
2020-10-22,greece,Europe,10328255,882,28216
2020-10-23,greece,Europe,10328255,841,29057
2020-10-24,greece,Europe,10328255,935,29992
2020-10-25,greece,Europe,10328255,790,30782
2020-10-26,greece,Europe,10328255,714,31496
2020-10-27,greece,Europe,10328255,1256,32752
2020-10-28,greece,Europe,10328255,1547,34299
2020-10-29,greece,Europe,10328255,1211,35510
2020-10-30,greece,Europe,10328255,1686,37196
2020-10-31,greece,Europe,10328255,2055,39251
2020-11-01,greece,Europe,10328255,1678,40929
2020-11-02,greece,Europe,10328255,1151,42080
2020-11-03,greece,Europe,10328255,2166,44246
2020-11-04,greece,Europe,10328255,2646,46892
2020-11-05,greece,Europe,10328255,2915,49807
2020-11-06,greece,Europe,10328255,2447,52254
2020-11-07,greece,Europe,10328255,2555,54809
2020-11-08,greece,Europe,10328255,1889,56698
2020-11-09,greece,Europe,10328255,1489,58187
2020-11-10,greece,Europe,10328255,2383,60570
2020-11-11,greece,Europe,10328255,2751,63321
2020-11-12,greece,Europe,10328255,3316,66637
2020-11-13,greece,Europe,10328255,3038,69675
2020-11-14,greece,Europe,10328255,2835,72510
2020-11-15,greece,Europe,10328255,1695,74205
2020-11-16,greece,Europe,10328255,2198,76403
2020-11-17,greece,Europe,10328255,2422,78825
2020-11-18,greece,Europe,10328255,3209,82034
2020-11-19,greece,Europe,10328255,3227,85261
2020-11-20,greece,Europe,10328255,2551,87812
2020-11-21,greece,Europe,10328255,2309,90121
2020-11-22,greece,Europe,10328255,1498,91619
2020-11-23,greece,Europe,10328255,1387,93006
2020-11-24,greece,Europe,10328255,2131,95137
2020-11-25,greece,Europe,10328255,2151,97288
2020-11-26,greece,Europe,10328255,2018,99306
2020-11-27,greece,Europe,10328255,1981,101287
2020-11-28,greece,Europe,10328255,1747,103034
2020-11-29,greece,Europe,10328255,1193,104227
2020-11-30,greece,Europe,10328255,1044,105271
2020-12-01,greece,Europe,10328255,2199,107470
2020-12-02,greece,Europe,10328255,2185,109655
2020-12-03,greece,Europe,10328255,1882,111537
2020-12-04,greece,Europe,10328255,1648,113185
2020-12-05,greece,Europe,10328255,1383,114568
2020-12-06,greece,Europe,10328255,903,115471
2020-12-07,greece,Europe,10328255,1250,116721
2020-12-08,greece,Europe,10328255,1324,118045
2020-12-09,greece,Europe,10328255,1675,119720
2020-12-10,greece,Europe,10328255,1533,121253
2020-12-11,greece,Europe,10328255,1395,122648
2020-12-12,greece,Europe,10328255,1194,123842
2020-12-13,greece,Europe,10328255,692,124534
2020-12-14,greece,Europe,10328255,639,125173
2020-12-15,greece,Europe,10328255,1199,126372
2020-12-16,greece,Europe,10328255,1185,127557
2020-12-17,greece,Europe,10328255,1153,128710
2020-12-18,greece,Europe,10328255,874,129584
2020-12-19,greece,Europe,10328255,901,130485
2020-12-20,greece,Europe,10328255,587,131072
2020-12-21,greece,Europe,10328255,525,131597
2020-12-22,greece,Europe,10328255,833,132430
2020-12-23,greece,Europe,10328255,935,133365
2020-12-24,greece,Europe,10328255,870,134235
2020-12-25,greece,Europe,10328255,617,134852
2020-12-26,greece,Europe,10328255,262,135114
2020-12-27,greece,Europe,10328255,342,135456
2020-12-28,greece,Europe,10328255,475,135931
2020-12-29,greece,Europe,10328255,1045,136976
2020-12-30,greece,Europe,10328255,942,137918
2020-12-31,greece,Europe,10328255,932,138850
2021-01-01,greece,Europe,10328255,597,139447
2021-01-02,greece,Europe,10328255,262,139709
2021-01-03,greece,Europe,10328255,390,140099
2021-01-04,greece,Europe,10328255,427,140526
2021-01-05,greece,Europe,10328255,927,141453
2021-01-06,greece,Europe,10328255,814,142267
2021-01-07,greece,Europe,10328255,510,142777
2021-01-08,greece,Europe,10328255,717,143494
2021-01-09,greece,Europe,10328255,799,144293
2021-01-10,greece,Europe,10328255,445,144738
2021-01-11,greece,Europe,10328255,441,145179
2021-01-12,greece,Europe,10328255,841,146020
2021-01-13,greece,Europe,10328255,668,146688
2021-01-14,greece,Europe,10328255,595,147283
2021-01-15,greece,Europe,10328255,577,147860
2021-01-16,greece,Europe,10328255,510,148370
2021-01-17,greece,Europe,10328255,237,148607
2021-01-18,greece,Europe,10328255,318,148925
2021-01-19,greece,Europe,10328255,537,149462
2021-01-20,greece,Europe,10328255,511,149973
2021-01-21,greece,Europe,10328255,506,150479
2021-01-22,greece,Europe,10328255,562,151041
2021-01-23,greece,Europe,10328255,605,151646
2021-01-24,greece,Europe,10328255,334,151980
2021-01-25,greece,Europe,10328255,432,152412
2021-01-26,greece,Europe,10328255,814,153226
2021-01-27,greece,Europe,10328255,857,154083
2021-01-28,greece,Europe,10328255,713,154796
2021-01-29,greece,Europe,10328255,882,155678
2021-01-30,greece,Europe,10328255,795,156473
2021-01-31,greece,Europe,10328255,484,156957
2021-02-01,greece,Europe,10328255,538,157495
2021-02-02,greece,Europe,10328255,1221,158716
2021-02-03,greece,Europe,10328255,1150,159866
2021-02-04,greece,Europe,10328255,1069,160935
2021-02-05,greece,Europe,10328255,1172,162107
2021-02-06,greece,Europe,10328255,1106,163213
2021-02-07,greece,Europe,10328255,733,163946
2021-02-08,greece,Europe,10328255,629,164575
2021-02-09,greece,Europe,10328255,1492,166067
2021-02-10,greece,Europe,10328255,1482,167549
2021-02-11,greece,Europe,10328255,1323,168872
2021-02-12,greece,Europe,10328255,1372,170244
2021-02-13,greece,Europe,10328255,1222,171466
2021-02-14,greece,Europe,10328255,662,172128
2021-02-15,greece,Europe,10328255,696,172824
2021-02-16,greece,Europe,10328255,1081,173905
2021-02-17,greece,Europe,10328255,754,174659
2021-02-18,greece,Europe,10328255,1400,176059
2021-02-19,greece,Europe,10328255,1435,177494
2021-02-20,greece,Europe,10328255,1424,178918
2021-02-21,greece,Europe,10328255,884,179802
2021-02-22,greece,Europe,10328255,870,180672
2021-02-23,greece,Europe,10328255,2111,182783
2021-02-24,greece,Europe,10328255,1903,184686
2021-02-25,greece,Europe,10328255,1783,186469
2021-02-26,greece,Europe,10328255,1732,188201
2021-01-04,grenada,North America,113494,0,127
2021-01-05,grenada,North America,113494,0,127
2021-01-06,grenada,North America,113494,0,127
2021-01-07,grenada,North America,113494,1,128
2021-01-08,grenada,North America,113494,4,132
2021-01-09,grenada,North America,113494,0,132
2021-01-10,grenada,North America,113494,0,132
2021-01-11,grenada,North America,113494,0,132
2021-01-12,grenada,North America,113494,0,132
2021-01-13,grenada,North America,113494,0,132
2021-01-14,grenada,North America,113494,0,132
2021-01-15,grenada,North America,113494,7,139
2021-01-16,grenada,North America,113494,0,139
2021-01-17,grenada,North America,113494,0,139
2021-01-18,grenada,North America,113494,0,139
2021-01-19,grenada,North America,113494,0,139
2021-01-20,grenada,North America,113494,0,139
2021-01-21,grenada,North America,113494,0,139
2021-01-22,grenada,North America,113494,0,139
2021-01-23,grenada,North America,113494,8,147
2021-01-24,grenada,North America,113494,0,147
2021-01-25,grenada,North America,113494,1,148
2021-01-26,grenada,North America,113494,0,148
2021-01-27,grenada,North America,113494,0,148
2021-01-28,grenada,North America,113494,0,148
2021-01-29,grenada,North America,113494,0,148
2021-01-30,grenada,North America,113494,0,148
2021-01-31,grenada,North America,113494,0,148
2021-02-01,grenada,North America,113494,0,148
2021-02-02,grenada,North America,113494,0,148
2021-02-03,grenada,North America,113494,0,148
2021-02-04,grenada,North America,113494,0,148
2021-02-05,grenada,North America,113494,0,148
2021-02-06,grenada,North America,113494,0,148
2021-02-07,grenada,North America,113494,0,148
2021-02-08,grenada,North America,113494,0,148
2021-02-09,grenada,North America,113494,0,148
2021-02-10,grenada,North America,113494,0,148
2021-02-11,grenada,North America,113494,0,148
2021-02-12,grenada,North America,113494,0,148
2021-02-13,grenada,North America,113494,0,148
2021-02-14,grenada,North America,113494,0,148
2021-02-15,grenada,North America,113494,0,148
2021-02-16,grenada,North America,113494,0,148
2021-02-17,grenada,North America,113494,0,148
2021-02-18,grenada,North America,113494,0,148
2021-02-19,grenada,North America,113494,0,148
2021-02-20,grenada,North America,113494,0,148
2021-02-21,grenada,North America,113494,0,148
2021-02-22,grenada,North America,113494,0,148
2021-02-23,grenada,North America,113494,0,148
2021-02-24,grenada,North America,113494,0,148
2021-02-25,grenada,North America,113494,0,148
2021-02-26,grenada,North America,113494,0,148
2021-02-27,grenada,North America,113494,0,148
2021-02-28,grenada,North America,113494,0,148
2021-03-01,grenada,North America,113494,0,148
2021-03-02,grenada,North America,113494,0,148
2021-03-03,grenada,North America,113494,0,148
2021-03-04,grenada,North America,113494,0,148
2021-03-05,grenada,North America,113494,0,148
2021-03-06,grenada,North America,113494,0,148
2021-03-07,grenada,North America,113494,0,148
2021-03-08,grenada,North America,113494,0,148
2021-03-09,grenada,North America,113494,0,148
2021-03-10,grenada,North America,113494,0,148
2021-03-11,grenada,North America,113494,0,148
2021-03-12,grenada,North America,113494,0,148
2021-03-13,grenada,North America,113494,0,148
2021-03-14,grenada,North America,113494,0,148
2021-03-15,grenada,North America,113494,6,154
2021-03-16,grenada,North America,113494,0,154
2021-03-17,grenada,North America,113494,0,154
2021-03-18,grenada,North America,113494,0,154
2021-03-19,grenada,North America,113494,0,154
2021-03-20,grenada,North America,113494,0,154
2021-03-21,grenada,North America,113494,0,154
2021-03-22,grenada,North America,113494,0,154
2021-03-23,grenada,North America,113494,0,154
2021-03-24,grenada,North America,113494,0,154
2021-03-25,grenada,North America,113494,0,154
2021-03-26,grenada,North America,113494,1,155
2021-03-27,grenada,North America,113494,0,155
2021-03-28,grenada,North America,113494,0,155
2021-03-29,grenada,North America,113494,0,155
2021-03-30,grenada,North America,113494,0,155
2021-03-31,grenada,North America,113494,0,155
2021-04-01,grenada,North America,113494,0,155
2021-04-02,grenada,North America,113494,0,155
2021-04-03,grenada,North America,113494,0,155
2021-04-04,grenada,North America,113494,0,155
2021-04-05,grenada,North America,113494,0,155
2021-04-06,grenada,North America,113494,0,155
2021-04-07,grenada,North America,113494,0,155
2021-04-08,grenada,North America,113494,0,155
2021-04-09,grenada,North America,113494,0,155
2021-04-10,grenada,North America,113494,0,155
2021-04-11,grenada,North America,113494,0,155
2021-04-12,grenada,North America,113494,0,155
2021-04-13,grenada,North America,113494,0,155
2021-04-14,grenada,North America,113494,0,155
2021-04-15,grenada,North America,113494,0,155
2021-04-16,grenada,North America,113494,0,155
2021-04-17,grenada,North America,113494,0,155
2021-04-18,grenada,North America,113494,0,155
2021-04-19,grenada,North America,113494,2,157
2021-04-20,grenada,North America,113494,0,157
2021-04-21,grenada,North America,113494,0,157
2021-04-22,grenada,North America,113494,2,159
2021-04-23,grenada,North America,113494,0,159
2021-04-24,grenada,North America,113494,0,159
2021-04-25,grenada,North America,113494,0,159
2021-04-26,grenada,North America,113494,1,160
2021-04-27,grenada,North America,113494,0,160
2021-04-28,grenada,North America,113494,0,160
2021-04-29,grenada,North America,113494,0,160
2021-04-30,grenada,North America,113494,0,160
2021-05-01,grenada,North America,113494,0,160
2021-05-02,grenada,North America,113494,0,160
2021-05-03,grenada,North America,113494,0,160
2021-05-04,grenada,North America,113494,0,160
2021-05-05,grenada,North America,113494,0,160
2021-05-06,grenada,North America,113494,0,160
2021-05-07,grenada,North America,113494,0,160
2021-05-08,grenada,North America,113494,0,160
2021-05-09,grenada,North America,113494,0,160
2021-05-10,grenada,North America,113494,0,160
2021-05-11,grenada,North America,113494,0,160
2021-05-12,grenada,North America,113494,1,161
2021-05-13,grenada,North America,113494,0,161
2021-05-14,grenada,North America,113494,0,161
2021-05-15,grenada,North America,113494,0,161
2021-05-16,grenada,North America,113494,0,161
2021-05-17,grenada,North America,113494,0,161
2021-05-18,grenada,North America,113494,0,161
2021-05-19,grenada,North America,113494,0,161
2021-05-20,grenada,North America,113494,0,161
2021-05-21,grenada,North America,113494,0,161
2021-05-22,grenada,North America,113494,0,161
2021-05-23,grenada,North America,113494,0,161
2021-05-24,grenada,North America,113494,0,161
2021-05-25,grenada,North America,113494,0,161
2021-05-26,grenada,North America,113494,0,161
2021-05-27,grenada,North America,113494,0,161
2021-05-28,grenada,North America,113494,0,161
2021-05-29,grenada,North America,113494,0,161
2021-05-30,grenada,North America,113494,0,161
2021-05-31,grenada,North America,113494,0,161
2021-06-01,grenada,North America,113494,0,161
2021-06-02,grenada,North America,113494,0,161
2021-06-03,grenada,North America,113494,0,161
2021-06-04,grenada,North America,113494,0,161
2021-06-05,grenada,North America,113494,0,161
2021-06-06,grenada,North America,113494,0,161
2021-06-07,grenada,North America,113494,0,161
2021-06-08,grenada,North America,113494,0,161
2021-06-09,grenada,North America,113494,0,161
2021-06-10,grenada,North America,113494,0,161
2021-06-11,grenada,North America,113494,0,161
2021-06-12,grenada,North America,113494,0,161
2021-06-13,grenada,North America,113494,0,161
2021-06-14,grenada,North America,113494,0,161
2021-06-15,grenada,North America,113494,0,161
2021-06-16,grenada,North America,113494,0,161
2021-06-17,grenada,North America,113494,0,161
2021-06-18,grenada,North America,113494,0,161
2021-06-19,grenada,North America,113494,0,161
2021-06-20,grenada,North America,113494,0,161
2021-06-21,grenada,North America,113494,0,161
2021-06-22,grenada,North America,113494,0,161
2021-06-23,grenada,North America,113494,0,161
2021-06-24,grenada,North America,113494,0,161
2021-06-25,grenada,North America,113494,0,161
2021-06-26,grenada,North America,113494,0,161
2021-06-27,grenada,North America,113494,0,161
2021-06-28,grenada,North America,113494,0,161
2021-06-29,grenada,North America,113494,0,161
2021-06-30,grenada,North America,113494,0,161
2021-07-01,grenada,North America,113494,0,161
2021-07-02,grenada,North America,113494,0,161
2021-07-03,grenada,North America,113494,0,161
2021-07-04,grenada,North America,113494,0,161
2021-07-05,grenada,North America,113494,0,161
2021-07-06,grenada,North America,113494,0,161
2021-07-07,grenada,North America,113494,0,161
2021-07-08,grenada,North America,113494,0,161
2021-07-09,grenada,North America,113494,0,161
2021-07-10,grenada,North America,113494,0,161
2021-07-11,grenada,North America,113494,0,161
2021-07-12,grenada,North America,113494,0,161
2021-07-13,grenada,North America,113494,0,161
2021-07-14,grenada,North America,113494,0,161
2021-07-15,grenada,North America,113494,0,161
2021-07-16,grenada,North America,113494,0,161
2021-07-17,grenada,North America,113494,0,161
2021-07-18,grenada,North America,113494,0,161
2021-07-19,grenada,North America,113494,0,161
2021-07-20,grenada,North America,113494,3,164
2021-07-21,grenada,North America,113494,0,164
2021-07-22,grenada,North America,113494,0,164
2021-07-23,grenada,North America,113494,0,164
2021-07-24,grenada,North America,113494,0,164
2021-07-25,grenada,North America,113494,0,164
2021-07-26,grenada,North America,113494,0,164
2021-07-27,grenada,North America,113494,0,164
2021-07-28,grenada,North America,113494,0,164
2021-07-29,grenada,North America,113494,0,164
2021-07-30,grenada,North America,113494,0,164
2021-07-31,grenada,North America,113494,0,164
2021-08-01,grenada,North America,113494,0,164
2021-08-02,grenada,North America,113494,0,164
2021-08-03,grenada,North America,113494,0,164
2021-08-04,grenada,North America,113494,0,164
2021-08-05,grenada,North America,113494,0,164
2021-08-06,grenada,North America,113494,0,164
2021-08-07,grenada,North America,113494,0,164
2021-08-08,grenada,North America,113494,14,178
2021-08-09,grenada,North America,113494,0,178
2021-08-10,grenada,North America,113494,2,180
2021-08-11,grenada,North America,113494,0,180
2021-08-12,grenada,North America,113494,0,180
2021-08-13,grenada,North America,113494,2,182
2021-08-14,grenada,North America,113494,4,186
2021-08-15,grenada,North America,113494,2,188
2021-08-16,grenada,North America,113494,0,188
2021-08-17,grenada,North America,113494,0,188
2021-08-18,grenada,North America,113494,6,194
2021-08-19,grenada,North America,113494,2,196
2021-08-20,grenada,North America,113494,0,196
2021-08-21,grenada,North America,113494,16,212
2021-08-22,grenada,North America,113494,10,222
2021-08-23,grenada,North America,113494,8,230
2021-08-24,grenada,North America,113494,0,230
2021-08-25,grenada,North America,113494,36,266
2021-08-26,grenada,North America,113494,30,296
2021-08-27,grenada,North America,113494,21,317
2021-08-28,grenada,North America,113494,0,317
2021-08-29,grenada,North America,113494,40,357
2021-08-30,grenada,North America,113494,104,461
2021-08-31,grenada,North America,113494,78,539
2021-09-01,grenada,North America,113494,125,664
2021-09-02,grenada,North America,113494,153,817
2021-09-03,grenada,North America,113494,281,1098
2021-09-04,grenada,North America,113494,140,1238
2021-09-05,grenada,North America,113494,0,1238
2021-09-06,grenada,North America,113494,235,1473
2021-09-07,grenada,North America,113494,140,1613
2021-09-08,grenada,North America,113494,135,1748
2021-09-09,grenada,North America,113494,199,1947
2021-09-10,grenada,North America,113494,216,2163
2021-09-11,grenada,North America,113494,182,2345
2021-09-12,grenada,North America,113494,41,2386
2021-09-13,grenada,North America,113494,260,2646
2021-09-14,grenada,North America,113494,0,2646
2021-09-15,grenada,North America,113494,94,2740
2021-09-16,grenada,North America,113494,290,3030
2021-09-17,grenada,North America,113494,460,3490
2021-09-18,grenada,North America,113494,351,3841
2021-09-19,grenada,North America,113494,236,4077
2021-09-20,grenada,North America,113494,136,4213
2021-09-21,grenada,North America,113494,143,4356
2021-09-22,grenada,North America,113494,196,4552
2021-09-23,grenada,North America,113494,86,4638
2021-09-24,grenada,North America,113494,128,4766
2021-09-25,grenada,North America,113494,63,4829
2021-09-26,grenada,North America,113494,93,4922
2021-09-27,grenada,North America,113494,83,5005
2021-09-28,grenada,North America,113494,34,5039
2021-09-29,grenada,North America,113494,0,5039
2021-09-30,grenada,North America,113494,101,5140
2021-10-01,grenada,North America,113494,55,5195
2021-10-02,grenada,North America,113494,41,5236
2021-10-03,grenada,North America,113494,58,5294
2021-10-04,grenada,North America,113494,57,5351
2021-10-05,grenada,North America,113494,83,5434
2021-10-06,grenada,North America,113494,50,5484
2021-10-07,grenada,North America,113494,47,5531
2021-10-08,grenada,North America,113494,23,5554
2021-10-09,grenada,North America,113494,37,5591
2021-10-10,grenada,North America,113494,28,5619
2021-10-11,grenada,North America,113494,7,5626
2021-10-12,grenada,North America,113494,27,5653
2021-10-13,grenada,North America,113494,17,5670
2021-10-14,grenada,North America,113494,21,5691
2021-10-15,grenada,North America,113494,13,5704
2021-10-16,grenada,North America,113494,17,5721
2021-10-17,grenada,North America,113494,13,5734
2021-10-18,grenada,North America,113494,12,5746
2021-10-19,grenada,North America,113494,23,5769
2021-10-20,grenada,North America,113494,7,5776
2021-10-21,grenada,North America,113494,14,5790
2021-10-22,grenada,North America,113494,5,5795
2021-10-23,grenada,North America,113494,14,5809
2021-10-24,grenada,North America,113494,6,5815
2021-10-25,grenada,North America,113494,2,5817
2021-10-26,grenada,North America,113494,1,5818
2021-10-27,grenada,North America,113494,6,5824
2021-10-28,grenada,North America,113494,6,5830
2021-10-29,grenada,North America,113494,4,5834
2021-10-30,grenada,North America,113494,5,5839
2021-10-31,grenada,North America,113494,1,5840
2021-11-01,grenada,North America,113494,0,5840
2021-11-02,grenada,North America,113494,10,5850
2021-11-03,grenada,North America,113494,0,5850
2021-11-04,grenada,North America,113494,6,5856
2021-11-05,grenada,North America,113494,1,5857
2021-11-06,grenada,North America,113494,1,5858
2021-11-07,grenada,North America,113494,3,5861
2021-11-08,grenada,North America,113494,0,5861
2021-11-09,grenada,North America,113494,2,5863
2021-11-10,grenada,North America,113494,0,5863
2021-11-11,grenada,North America,113494,0,5863
2021-11-12,grenada,North America,113494,0,5863
2021-11-13,grenada,North America,113494,0,5863
2021-11-14,grenada,North America,113494,0,5863
2021-11-15,grenada,North America,113494,0,5863
2021-11-16,grenada,North America,113494,2,5865
2021-11-17,grenada,North America,113494,0,5865
2021-11-18,grenada,North America,113494,0,5865
2021-11-19,grenada,North America,113494,0,5865
2021-11-20,grenada,North America,113494,1,5866
2021-11-21,grenada,North America,113494,7,5873
2021-11-22,grenada,North America,113494,3,5876
2021-11-23,grenada,North America,113494,2,5878
2021-11-24,grenada,North America,113494,2,5880
2021-11-25,grenada,North America,113494,0,5880
2021-11-26,grenada,North America,113494,4,5884
2021-11-27,grenada,North America,113494,4,5888
2021-11-28,grenada,North America,113494,0,5888
2021-11-29,grenada,North America,113494,0,5888
2021-11-30,grenada,North America,113494,6,5894
2021-12-01,grenada,North America,113494,3,5897
2021-12-02,grenada,North America,113494,1,5898
2021-12-03,grenada,North America,113494,2,5900
2021-12-04,grenada,North America,113494,7,5907
2021-12-05,grenada,North America,113494,1,5908
2021-12-06,grenada,North America,113494,1,5909
2021-12-07,grenada,North America,113494,1,5910
2021-12-08,grenada,North America,113494,0,5910
2021-12-09,grenada,North America,113494,0,5910
2021-12-10,grenada,North America,113494,3,5913
2021-12-11,grenada,North America,113494,2,5915
2021-12-12,grenada,North America,113494,0,5915
2021-12-13,grenada,North America,113494,0,5915
2021-12-14,grenada,North America,113494,3,5918
2021-12-15,grenada,North America,113494,1,5919
2021-12-16,grenada,North America,113494,0,5919
2021-12-17,grenada,North America,113494,0,5919
2021-12-18,grenada,North America,113494,0,5919
2021-12-19,grenada,North America,113494,0,5919
2021-12-20,grenada,North America,113494,1,5920
2021-12-21,grenada,North America,113494,1,5921
2021-12-22,grenada,North America,113494,12,5933
2021-12-23,grenada,North America,113494,7,5940
2021-12-24,grenada,North America,113494,8,5948
2021-12-25,grenada,North America,113494,8,5956
2021-12-26,grenada,North America,113494,0,5956
2021-12-27,grenada,North America,113494,5,5961
2021-12-28,grenada,North America,113494,7,5968
2021-12-29,grenada,North America,113494,41,6009
2021-12-30,grenada,North America,113494,64,6073
2021-12-31,grenada,North America,113494,108,6181
2022-01-01,grenada,North America,113494,118,6299
2022-01-02,grenada,North America,113494,7,6306
2022-01-03,grenada,North America,113494,32,6338
2022-01-04,grenada,North America,113494,193,6531
2022-01-05,grenada,North America,113494,256,6787
2022-01-06,grenada,North America,113494,314,7101
2022-01-07,grenada,North America,113494,276,7377
2022-01-08,grenada,North America,113494,292,7669
2022-01-09,grenada,North America,113494,30,7699
2022-01-10,grenada,North America,113494,72,7771
2022-01-11,grenada,North America,113494,501,8272
2022-01-12,grenada,North America,113494,329,8601
2022-01-13,grenada,North America,113494,365,8966
2022-01-14,grenada,North America,113494,293,9259
2022-01-15,grenada,North America,113494,276,9535
2022-01-16,grenada,North America,113494,166,9701
2022-01-17,grenada,North America,113494,17,9718
2022-01-18,grenada,North America,113494,470,10188
2022-01-19,grenada,North America,113494,239,10427
2022-01-20,grenada,North America,113494,280,10707
2022-01-21,grenada,North America,113494,253,10960
2022-01-22,grenada,North America,113494,230,11190
2022-01-23,grenada,North America,113494,113,11303
2022-01-24,grenada,North America,113494,41,11344
2022-01-25,grenada,North America,113494,322,11666
2022-01-26,grenada,North America,113494,150,11816
2022-01-27,grenada,North America,113494,141,11957
2022-01-28,grenada,North America,113494,133,12090
2022-01-29,grenada,North America,113494,156,12246
2022-01-30,grenada,North America,113494,65,12311
2022-01-31,grenada,North America,113494,25,12336
2022-02-01,grenada,North America,113494,162,12498
2022-02-02,grenada,North America,113494,91,12589
2022-02-03,grenada,North America,113494,109,12698
2022-02-04,grenada,North America,113494,76,12774
2022-02-05,grenada,North America,113494,60,12834
2022-02-06,grenada,North America,113494,28,12862
2022-02-07,grenada,North America,113494,10,12872
2022-02-08,grenada,North America,113494,14,12886
2022-02-09,grenada,North America,113494,155,13041
2022-02-10,grenada,North America,113494,61,13102
2022-02-11,grenada,North America,113494,70,13172
2022-02-12,grenada,North America,113494,70,13242
2022-02-13,grenada,North America,113494,13,13255
2022-02-14,grenada,North America,113494,11,13266
2022-02-15,grenada,North America,113494,107,13373
2022-02-16,grenada,North America,113494,40,13413
2022-02-17,grenada,North America,113494,39,13452
2022-02-18,grenada,North America,113494,39,13491
2022-02-19,grenada,North America,113494,34,13525
2022-02-20,grenada,North America,113494,1,13526
2022-02-21,grenada,North America,113494,6,13532
2022-02-22,grenada,North America,113494,33,13565
2022-02-23,grenada,North America,113494,0,13565
2022-02-24,grenada,North America,113494,33,13598
2022-02-25,grenada,North America,113494,63,13661
2022-02-26,grenada,North America,113494,0,13661
2022-02-27,grenada,North America,113494,18,13679
2022-02-28,grenada,North America,113494,11,13690
2020-03-16,guatemala,North America,18532670,7,8
2020-03-17,guatemala,North America,18532670,0,8
2020-03-18,guatemala,North America,18532670,0,8
2020-03-19,guatemala,North America,18532670,1,9
2020-03-20,guatemala,North America,18532670,3,12
2020-03-21,guatemala,North America,18532670,5,17
2020-03-22,guatemala,North America,18532670,2,19
2020-03-23,guatemala,North America,18532670,1,20
2020-03-24,guatemala,North America,18532670,1,21
2020-03-25,guatemala,North America,18532670,3,24
2020-03-26,guatemala,North America,18532670,1,25
2020-03-27,guatemala,North America,18532670,3,28
2020-03-28,guatemala,North America,18532670,6,34
2020-03-29,guatemala,North America,18532670,0,34
2020-03-30,guatemala,North America,18532670,2,36
2020-03-31,guatemala,North America,18532670,2,38
2020-04-01,guatemala,North America,18532670,1,39
2020-04-02,guatemala,North America,18532670,8,47
2020-04-03,guatemala,North America,18532670,3,50
2020-04-04,guatemala,North America,18532670,11,61
2020-04-05,guatemala,North America,18532670,9,70
2020-04-06,guatemala,North America,18532670,0,70
2020-04-07,guatemala,North America,18532670,7,77
2020-04-08,guatemala,North America,18532670,10,87
2020-04-09,guatemala,North America,18532670,8,95
2020-04-10,guatemala,North America,18532670,31,126
2020-04-11,guatemala,North America,18532670,11,137
2020-04-12,guatemala,North America,18532670,18,155
2020-04-13,guatemala,North America,18532670,1,156
2020-04-14,guatemala,North America,18532670,11,167
2020-04-15,guatemala,North America,18532670,13,180
2020-04-16,guatemala,North America,18532670,16,196
2020-04-17,guatemala,North America,18532670,18,214
2020-04-18,guatemala,North America,18532670,21,235
2020-04-19,guatemala,North America,18532670,22,257
2020-04-20,guatemala,North America,18532670,32,289
2020-04-21,guatemala,North America,18532670,5,294
2020-04-22,guatemala,North America,18532670,22,316
2020-04-23,guatemala,North America,18532670,26,342
2020-04-24,guatemala,North America,18532670,42,384
2020-04-25,guatemala,North America,18532670,46,430
2020-04-26,guatemala,North America,18532670,43,473
2020-04-27,guatemala,North America,18532670,27,500
2020-04-28,guatemala,North America,18532670,30,530
2020-04-29,guatemala,North America,18532670,27,557
2020-04-30,guatemala,North America,18532670,28,585
2020-05-01,guatemala,North America,18532670,14,599
2020-05-02,guatemala,North America,18532670,45,644
2020-05-03,guatemala,North America,18532670,44,688
2020-05-04,guatemala,North America,18532670,15,703
2020-05-05,guatemala,North America,18532670,27,730
2020-05-06,guatemala,North America,18532670,33,763
2020-05-07,guatemala,North America,18532670,35,798
2020-05-08,guatemala,North America,18532670,34,832
2020-05-09,guatemala,North America,18532670,68,900
2020-05-10,guatemala,North America,18532670,67,967
2020-05-11,guatemala,North America,18532670,85,1052
2020-05-12,guatemala,North America,18532670,62,1114
2020-05-13,guatemala,North America,18532670,85,1199
2020-05-14,guatemala,North America,18532670,143,1342
2020-05-15,guatemala,North America,18532670,176,1518
2020-05-16,guatemala,North America,18532670,125,1643
2020-05-17,guatemala,North America,18532670,120,1763
2020-05-18,guatemala,North America,18532670,149,1912
2020-05-19,guatemala,North America,18532670,89,2001
2020-05-20,guatemala,North America,18532670,132,2133
2020-05-21,guatemala,North America,18532670,132,2265
2020-05-22,guatemala,North America,18532670,247,2512
2020-05-23,guatemala,North America,18532670,231,2743
2020-05-24,guatemala,North America,18532670,311,3054
2020-05-25,guatemala,North America,18532670,370,3424
2020-05-26,guatemala,North America,18532670,336,3760
2020-05-27,guatemala,North America,18532670,194,3954
2020-05-28,guatemala,North America,18532670,191,4145
2020-05-29,guatemala,North America,18532670,203,4348
2020-05-30,guatemala,North America,18532670,259,4607
2020-05-31,guatemala,North America,18532670,132,4739
2020-06-01,guatemala,North America,18532670,348,5087
2020-06-02,guatemala,North America,18532670,249,5336
2020-06-03,guatemala,North America,18532670,250,5586
2020-06-04,guatemala,North America,18532670,174,5760
2020-06-05,guatemala,North America,18532670,394,6154
2020-06-06,guatemala,North America,18532670,331,6485
2020-06-07,guatemala,North America,18532670,307,6792
2020-06-08,guatemala,North America,18532670,263,7055
2020-06-09,guatemala,North America,18532670,447,7502
2020-06-10,guatemala,North America,18532670,364,7866
2020-06-11,guatemala,North America,18532670,355,8221
2020-06-12,guatemala,North America,18532670,340,8561
2020-06-13,guatemala,North America,18532670,421,8982
2020-06-14,guatemala,North America,18532670,509,9491
2020-06-15,guatemala,North America,18532670,354,9845
2020-06-16,guatemala,North America,18532670,427,10272
2020-06-17,guatemala,North America,18532670,434,10706
2020-06-18,guatemala,North America,18532670,545,11251
2020-06-19,guatemala,North America,18532670,617,11868
2020-06-20,guatemala,North America,18532670,641,12509
2020-06-21,guatemala,North America,18532670,246,12755
2020-06-22,guatemala,North America,18532670,390,13145
2020-06-23,guatemala,North America,18532670,624,13769
2020-06-24,guatemala,North America,18532670,771,14540
2020-06-25,guatemala,North America,18532670,279,14819
2020-06-26,guatemala,North America,18532670,800,15619
2020-06-27,guatemala,North America,18532670,209,15828
2020-06-28,guatemala,North America,18532670,569,16397
2020-06-29,guatemala,North America,18532670,533,16930
2020-06-30,guatemala,North America,18532670,479,17409
2020-07-01,guatemala,North America,18532670,687,18096
2020-07-02,guatemala,North America,18532670,915,19011
2020-07-03,guatemala,North America,18532670,2282,21293
2020-07-04,guatemala,North America,18532670,1208,22501
2020-07-05,guatemala,North America,18532670,747,23248
2020-07-06,guatemala,North America,18532670,724,23972
2020-07-07,guatemala,North America,18532670,815,24787
2020-07-08,guatemala,North America,18532670,624,25411
2020-07-09,guatemala,North America,18532670,1247,26658
2020-07-10,guatemala,North America,18532670,961,27619
2020-07-11,guatemala,North America,18532670,979,28598
2020-07-12,guatemala,North America,18532670,757,29355
2020-07-13,guatemala,North America,18532670,387,29742
2020-07-14,guatemala,North America,18532670,1130,30872
2020-07-15,guatemala,North America,18532670,1202,32074
2020-07-16,guatemala,North America,18532670,865,32939
2020-07-17,guatemala,North America,18532670,870,33809
2020-07-18,guatemala,North America,18532670,4233,38042
2020-07-19,guatemala,North America,18532670,635,38677
2020-07-20,guatemala,North America,18532670,362,39039
2020-07-21,guatemala,North America,18532670,1190,40229
2020-07-22,guatemala,North America,18532670,906,41135
2020-07-23,guatemala,North America,18532670,1057,42192
2020-07-24,guatemala,North America,18532670,1091,43283
2020-07-25,guatemala,North America,18532670,1209,44492
2020-07-26,guatemala,North America,18532670,561,45053
2020-07-27,guatemala,North America,18532670,256,45309
2020-07-28,guatemala,North America,18532670,1142,46451
2020-07-29,guatemala,North America,18532670,1154,47605
2020-07-30,guatemala,North America,18532670,1221,48826
2020-07-31,guatemala,North America,18532670,963,49789
2020-08-01,guatemala,North America,18532670,1190,50979
2020-08-02,guatemala,North America,18532670,327,51306
2020-04-16,guinea,Africa,13795931,34,438
2020-04-17,guinea,Africa,13795931,39,477
2020-04-18,guinea,Africa,13795931,41,518
2020-04-19,guinea,Africa,13795931,61,579
2020-04-20,guinea,Africa,13795931,43,622
2020-04-21,guinea,Africa,13795931,66,688
2020-04-22,guinea,Africa,13795931,73,761
2020-04-23,guinea,Africa,13795931,101,862
2020-04-24,guinea,Africa,13795931,92,954
2020-04-25,guinea,Africa,13795931,42,996
2020-04-26,guinea,Africa,13795931,0,996
2020-04-27,guinea,Africa,13795931,167,1163
2020-04-28,guinea,Africa,13795931,77,1240
2020-04-29,guinea,Africa,13795931,111,1351
2020-04-30,guinea,Africa,13795931,144,1495
2020-05-01,guinea,Africa,13795931,42,1537
2020-05-02,guinea,Africa,13795931,49,1586
2020-05-03,guinea,Africa,13795931,0,1586
2020-05-04,guinea,Africa,13795931,124,1710
2020-05-05,guinea,Africa,13795931,101,1811
2020-05-06,guinea,Africa,13795931,45,1856
2020-05-07,guinea,Africa,13795931,71,1927
2020-05-08,guinea,Africa,13795931,82,2009
2020-05-09,guinea,Africa,13795931,33,2042
2020-05-10,guinea,Africa,13795931,104,2146
2020-05-11,guinea,Africa,13795931,0,2146
2020-05-12,guinea,Africa,13795931,152,2298
2020-05-13,guinea,Africa,13795931,76,2374
2020-05-14,guinea,Africa,13795931,99,2473
2020-05-15,guinea,Africa,13795931,0,2473
2020-05-16,guinea,Africa,13795931,185,2658
2020-05-17,guinea,Africa,13795931,0,2658
2020-05-18,guinea,Africa,13795931,138,2796
2020-05-19,guinea,Africa,13795931,67,2863
2020-05-20,guinea,Africa,13795931,0,2863
2020-05-21,guinea,Africa,13795931,204,3067
2020-05-22,guinea,Africa,13795931,0,3067
2020-05-23,guinea,Africa,13795931,109,3176
2020-05-24,guinea,Africa,13795931,99,3275
2020-05-25,guinea,Africa,13795931,0,3275
2020-05-26,guinea,Africa,13795931,0,3275
2020-05-27,guinea,Africa,13795931,0,3275
2020-05-28,guinea,Africa,13795931,278,3553
2020-05-29,guinea,Africa,13795931,103,3656
2020-05-30,guinea,Africa,13795931,50,3706
2020-05-31,guinea,Africa,13795931,0,3706
2020-06-01,guinea,Africa,13795931,138,3844
2020-06-02,guinea,Africa,13795931,42,3886
2020-06-03,guinea,Africa,13795931,47,3933
2020-06-04,guinea,Africa,13795931,58,3991
2020-06-05,guinea,Africa,13795931,69,4060
2020-06-06,guinea,Africa,13795931,57,4117
2020-06-07,guinea,Africa,13795931,0,4117
2020-06-08,guinea,Africa,13795931,99,4216
2020-06-09,guinea,Africa,13795931,42,4258
2020-06-10,guinea,Africa,13795931,0,4258
2020-06-11,guinea,Africa,13795931,114,4372
2020-06-12,guinea,Africa,13795931,54,4426
2020-06-13,guinea,Africa,13795931,58,4484
2020-06-14,guinea,Africa,13795931,48,4532
2020-06-15,guinea,Africa,13795931,40,4572
2020-06-16,guinea,Africa,13795931,67,4639
2020-06-17,guinea,Africa,13795931,29,4668
2020-06-18,guinea,Africa,13795931,173,4841
2020-06-19,guinea,Africa,13795931,63,4904
2020-06-20,guinea,Africa,13795931,56,4960
2020-06-21,guinea,Africa,13795931,28,4988
2020-06-22,guinea,Africa,13795931,0,4988
2020-06-23,guinea,Africa,13795931,52,5040
2020-06-24,guinea,Africa,13795931,134,5174
2020-06-25,guinea,Africa,13795931,0,5174
2020-06-26,guinea,Africa,13795931,86,5260
2020-06-27,guinea,Africa,13795931,31,5291
2020-06-28,guinea,Africa,13795931,51,5342
2020-06-29,guinea,Africa,13795931,9,5351
2020-06-30,guinea,Africa,13795931,40,5391
2020-07-01,guinea,Africa,13795931,13,5404
2020-07-02,guinea,Africa,13795931,46,5450
2020-07-03,guinea,Africa,13795931,71,5521
2020-07-04,guinea,Africa,13795931,49,5570
2020-07-05,guinea,Africa,13795931,40,5610
2020-07-06,guinea,Africa,13795931,0,5610
2020-07-07,guinea,Africa,13795931,26,5636
2020-07-08,guinea,Africa,13795931,61,5697
2020-07-09,guinea,Africa,13795931,184,5881
2020-07-10,guinea,Africa,13795931,88,5969
2020-07-11,guinea,Africa,13795931,75,6044
2020-07-12,guinea,Africa,13795931,97,6141
2020-07-13,guinea,Africa,13795931,0,6141
2020-07-14,guinea,Africa,13795931,59,6200
2020-07-15,guinea,Africa,13795931,76,6276
2020-07-16,guinea,Africa,13795931,83,6359
2020-07-17,guinea,Africa,13795931,71,6430
2020-07-18,guinea,Africa,13795931,61,6491
2020-07-19,guinea,Africa,13795931,53,6544
2020-07-20,guinea,Africa,13795931,46,6590
2020-07-21,guinea,Africa,13795931,62,6652
2020-07-22,guinea,Africa,13795931,95,6747
2020-07-23,guinea,Africa,13795931,59,6806
2020-07-24,guinea,Africa,13795931,61,6867
2020-07-25,guinea,Africa,13795931,60,6927
2020-07-26,guinea,Africa,13795931,81,7008
2020-07-27,guinea,Africa,13795931,47,7055
2020-07-28,guinea,Africa,13795931,71,7126
2020-07-29,guinea,Africa,13795931,57,7183
2020-07-30,guinea,Africa,13795931,59,7242
2020-07-31,guinea,Africa,13795931,66,7308
2020-08-01,guinea,Africa,13795931,0,7308
2020-08-02,guinea,Africa,13795931,9,7317
2020-08-03,guinea,Africa,13795931,47,7364
2020-08-04,guinea,Africa,13795931,125,7489
2020-08-05,guinea,Africa,13795931,86,7575
2020-08-06,guinea,Africa,13795931,89,7664
2020-08-07,guinea,Africa,13795931,113,7777
2020-08-08,guinea,Africa,13795931,98,7875
2020-08-09,guinea,Africa,13795931,55,7930
2020-08-10,guinea,Africa,13795931,0,7930
2020-08-11,guinea,Africa,13795931,88,8018
2020-08-12,guinea,Africa,13795931,98,8116
2020-08-13,guinea,Africa,13795931,82,8198
2020-08-14,guinea,Africa,13795931,62,8260
2020-08-15,guinea,Africa,13795931,83,8343
2020-08-16,guinea,Africa,13795931,139,8482
2020-08-17,guinea,Africa,13795931,138,8620
2020-08-18,guinea,Africa,13795931,95,8715
2020-08-19,guinea,Africa,13795931,77,8792
2020-08-20,guinea,Africa,13795931,84,8876
2020-08-21,guinea,Africa,13795931,56,8932
2020-08-22,guinea,Africa,13795931,0,8932
2020-08-23,guinea,Africa,13795931,35,8967
2020-08-24,guinea,Africa,13795931,109,9076
2020-08-25,guinea,Africa,13795931,52,9128
2020-08-26,guinea,Africa,13795931,39,9167
2020-08-27,guinea,Africa,13795931,46,9213
2020-08-28,guinea,Africa,13795931,38,9251
2020-08-29,guinea,Africa,13795931,0,9251
2020-08-30,guinea,Africa,13795931,120,9371
2020-08-31,guinea,Africa,13795931,38,9409
2020-09-01,guinea,Africa,13795931,70,9479
2020-09-02,guinea,Africa,13795931,47,9526
2020-09-03,guinea,Africa,13795931,53,9579
2020-09-04,guinea,Africa,13795931,70,9649
2020-09-05,guinea,Africa,13795931,0,9649
2020-09-06,guinea,Africa,13795931,149,9798
2020-09-07,guinea,Africa,13795931,18,9816
2020-09-08,guinea,Africa,13795931,32,9848
2020-09-09,guinea,Africa,13795931,37,9885
2020-09-10,guinea,Africa,13795931,61,9946
2020-09-11,guinea,Africa,13795931,33,9979
2020-09-12,guinea,Africa,13795931,41,10020
2020-09-13,guinea,Africa,13795931,25,10045
2020-09-14,guinea,Africa,13795931,16,10061
2020-09-15,guinea,Africa,13795931,50,10111
2020-09-16,guinea,Africa,13795931,43,10154
2020-09-17,guinea,Africa,13795931,0,10154
2020-09-18,guinea,Africa,13795931,77,10231
2020-09-19,guinea,Africa,13795931,55,10286
2020-09-20,guinea,Africa,13795931,39,10325
2020-09-21,guinea,Africa,13795931,19,10344
2020-09-22,guinea,Africa,13795931,43,10387
2020-09-23,guinea,Africa,13795931,47,10434
2020-09-24,guinea,Africa,13795931,0,10434
2020-09-25,guinea,Africa,13795931,44,10478
2020-09-26,guinea,Africa,13795931,34,10512
2020-09-27,guinea,Africa,13795931,68,10580
2020-09-28,guinea,Africa,13795931,18,10598
2020-09-29,guinea,Africa,13795931,36,10634
2020-09-30,guinea,Africa,13795931,18,10652
2020-10-01,guinea,Africa,13795931,0,10652
2020-10-02,guinea,Africa,13795931,83,10735
2020-10-03,guinea,Africa,13795931,0,10735
2020-10-04,guinea,Africa,13795931,19,10754
2020-10-05,guinea,Africa,13795931,46,10800
2020-10-06,guinea,Africa,13795931,63,10863
2020-10-07,guinea,Africa,13795931,0,10863
2020-10-08,guinea,Africa,13795931,38,10901
2020-10-09,guinea,Africa,13795931,53,10954
2020-10-10,guinea,Africa,13795931,42,10996
2020-10-11,guinea,Africa,13795931,26,11022
2020-10-12,guinea,Africa,13795931,40,11062
2020-10-13,guinea,Africa,13795931,72,11134
2020-10-14,guinea,Africa,13795931,54,11188
2020-10-15,guinea,Africa,13795931,67,11255
2020-10-16,guinea,Africa,13795931,107,11362
2020-10-17,guinea,Africa,13795931,116,11478
2020-10-18,guinea,Africa,13795931,40,11518
2020-10-19,guinea,Africa,13795931,0,11518
2020-10-20,guinea,Africa,13795931,20,11538
2020-10-21,guinea,Africa,13795931,61,11599
2020-10-22,guinea,Africa,13795931,36,11635
2020-10-23,guinea,Africa,13795931,0,11635
2020-10-24,guinea,Africa,13795931,0,11635
2020-10-25,guinea,Africa,13795931,0,11635
2020-10-26,guinea,Africa,13795931,0,11635
2020-10-27,guinea,Africa,13795931,184,11819
2020-10-28,guinea,Africa,13795931,0,11819
2020-10-29,guinea,Africa,13795931,201,12020
2020-10-30,guinea,Africa,13795931,52,12072
2020-10-31,guinea,Africa,13795931,0,12072
2020-11-01,guinea,Africa,13795931,123,12195
2020-11-02,guinea,Africa,13795931,18,12213
2020-11-03,guinea,Africa,13795931,0,12213
2020-11-04,guinea,Africa,13795931,118,12331
2020-11-05,guinea,Africa,13795931,32,12363
2020-11-06,guinea,Africa,13795931,0,12363
2020-11-07,guinea,Africa,13795931,37,12400
2020-11-08,guinea,Africa,13795931,14,12414
2020-11-09,guinea,Africa,13795931,45,12459
2020-11-10,guinea,Africa,13795931,25,12484
2020-11-11,guinea,Africa,13795931,32,12516
2020-11-12,guinea,Africa,13795931,21,12537
2020-11-13,guinea,Africa,13795931,0,12537
2020-11-14,guinea,Africa,13795931,48,12585
2020-11-15,guinea,Africa,13795931,26,12611
2020-11-16,guinea,Africa,13795931,13,12624
2020-11-17,guinea,Africa,13795931,30,12654
2020-11-18,guinea,Africa,13795931,59,12713
2020-11-19,guinea,Africa,13795931,0,12713
2020-11-20,guinea,Africa,13795931,30,12743
2020-11-21,guinea,Africa,13795931,55,12798
2020-11-22,guinea,Africa,13795931,28,12826
2020-11-23,guinea,Africa,13795931,15,12841
2020-11-24,guinea,Africa,13795931,22,12863
2020-11-25,guinea,Africa,13795931,66,12929
2020-11-26,guinea,Africa,13795931,20,12949
2020-11-27,guinea,Africa,13795931,90,13039
2020-11-28,guinea,Africa,13795931,0,13039
2020-11-29,guinea,Africa,13795931,15,13054
2020-11-30,guinea,Africa,13795931,65,13119
2020-12-01,guinea,Africa,13795931,0,13119
2020-12-02,guinea,Africa,13795931,24,13143
2020-12-03,guinea,Africa,13795931,24,13167
2020-12-04,guinea,Africa,13795931,19,13186
2020-12-05,guinea,Africa,13795931,47,13233
2020-12-06,guinea,Africa,13795931,13,13246
2020-12-07,guinea,Africa,13795931,18,13264
2020-12-08,guinea,Africa,13795931,0,13264
2020-12-09,guinea,Africa,13795931,61,13325
2020-12-10,guinea,Africa,13795931,43,13368
2020-12-11,guinea,Africa,13795931,30,13398
2020-12-12,guinea,Africa,13795931,22,13420
2020-12-13,guinea,Africa,13795931,0,13420
2020-12-14,guinea,Africa,13795931,37,13457
2020-12-15,guinea,Africa,13795931,0,13457
2020-12-16,guinea,Africa,13795931,17,13474
2020-12-17,guinea,Africa,13795931,11,13485
2020-12-18,guinea,Africa,13795931,26,13511
2020-12-19,guinea,Africa,13795931,21,13532
2020-12-20,guinea,Africa,13795931,13,13545
2020-12-21,guinea,Africa,13795931,33,13578
2020-12-22,guinea,Africa,13795931,0,13578
2020-12-23,guinea,Africa,13795931,20,13598
2020-12-24,guinea,Africa,13795931,32,13630
2020-12-25,guinea,Africa,13795931,16,13646
2020-12-26,guinea,Africa,13795931,16,13662
2020-12-27,guinea,Africa,13795931,12,13674
2020-12-28,guinea,Africa,13795931,14,13688
2020-12-29,guinea,Africa,13795931,0,13688
2020-12-30,guinea,Africa,13795931,19,13707
2020-12-31,guinea,Africa,13795931,15,13722
2021-01-01,guinea,Africa,13795931,16,13738
2021-01-02,guinea,Africa,13795931,46,13784
2021-01-03,guinea,Africa,13795931,4,13788
2021-01-04,guinea,Africa,13795931,11,13799
2021-01-05,guinea,Africa,13795931,46,13845
2021-01-06,guinea,Africa,13795931,17,13862
2021-01-07,guinea,Africa,13795931,42,13904
2021-01-08,guinea,Africa,13795931,38,13942
2021-01-09,guinea,Africa,13795931,25,13967
2021-01-10,guinea,Africa,13795931,13,13980
2021-01-11,guinea,Africa,13795931,9,13989
2021-01-12,guinea,Africa,13795931,36,14025
2021-01-13,guinea,Africa,13795931,26,14051
2021-01-14,guinea,Africa,13795931,0,14051
2021-01-15,guinea,Africa,13795931,14,14065
2021-01-16,guinea,Africa,13795931,33,14098
2021-01-17,guinea,Africa,13795931,16,14114
2021-01-18,guinea,Africa,13795931,51,14165
2021-01-19,guinea,Africa,13795931,42,14207
2021-01-20,guinea,Africa,13795931,0,14207
2021-01-21,guinea,Africa,13795931,29,14236
2021-01-22,guinea,Africa,13795931,26,14262
2021-01-23,guinea,Africa,13795931,38,14300
2021-01-24,guinea,Africa,13795931,19,14319
2021-01-25,guinea,Africa,13795931,56,14375
2021-01-26,guinea,Africa,13795931,4,14379
2021-01-27,guinea,Africa,13795931,56,14435
2021-01-28,guinea,Africa,13795931,0,14435
2021-01-29,guinea,Africa,13795931,16,14451
2021-01-30,guinea,Africa,13795931,24,14475
2021-01-31,guinea,Africa,13795931,71,14546
2021-02-01,guinea,Africa,13795931,9,14555
2021-02-02,guinea,Africa,13795931,0,14555
2021-02-03,guinea,Africa,13795931,0,14555
2021-02-04,guinea,Africa,13795931,74,14629
2021-02-05,guinea,Africa,13795931,0,14629
2021-02-06,guinea,Africa,13795931,22,14651
2021-02-07,guinea,Africa,13795931,36,14687
2021-02-08,guinea,Africa,13795931,77,14764
2021-02-09,guinea,Africa,13795931,27,14791
2021-02-10,guinea,Africa,13795931,0,14791
2021-02-11,guinea,Africa,13795931,69,14860
2021-02-12,guinea,Africa,13795931,0,14860
2021-02-13,guinea,Africa,13795931,35,14895
2021-02-14,guinea,Africa,13795931,72,14967
2021-02-15,guinea,Africa,13795931,0,14967
2021-02-16,guinea,Africa,13795931,53,15020
2021-02-17,guinea,Africa,13795931,68,15088
2021-02-18,guinea,Africa,13795931,66,15154
2021-02-19,guinea,Africa,13795931,62,15216
2021-02-20,guinea,Africa,13795931,179,15395
2021-02-21,guinea,Africa,13795931,0,15395
2021-02-22,guinea,Africa,13795931,32,15427
2021-02-23,guinea,Africa,13795931,60,15487
2021-02-24,guinea,Africa,13795931,193,15680
2021-02-25,guinea,Africa,13795931,109,15789
2021-02-26,guinea,Africa,13795931,105,15894
2021-02-27,guinea,Africa,13795931,0,15894
2021-02-28,guinea,Africa,13795931,98,15992
2021-03-01,guinea,Africa,13795931,13,16005
2021-03-02,guinea,Africa,13795931,76,16081
2021-03-03,guinea,Africa,13795931,210,16291
2021-03-04,guinea,Africa,13795931,129,16420
2021-03-05,guinea,Africa,13795931,0,16420
2021-03-06,guinea,Africa,13795931,120,16540
2021-03-07,guinea,Africa,13795931,130,16670
2021-03-08,guinea,Africa,13795931,242,16912
2021-03-09,guinea,Africa,13795931,98,17010
2021-03-10,guinea,Africa,13795931,198,17208
2021-03-11,guinea,Africa,13795931,164,17372
2021-03-12,guinea,Africa,13795931,220,17592
2021-03-13,guinea,Africa,13795931,150,17742
2021-03-14,guinea,Africa,13795931,99,17841
2021-03-15,guinea,Africa,13795931,131,17972
2021-03-16,guinea,Africa,13795931,10,17982
2021-03-17,guinea,Africa,13795931,303,18285
2021-03-18,guinea,Africa,13795931,153,18438
2021-03-19,guinea,Africa,13795931,124,18562
2021-03-20,guinea,Africa,13795931,0,18562
2021-03-21,guinea,Africa,13795931,315,18877
2021-03-22,guinea,Africa,13795931,68,18945
2021-03-23,guinea,Africa,13795931,0,18945
2021-03-24,guinea,Africa,13795931,139,19084
2021-03-25,guinea,Africa,13795931,148,19232
2021-03-26,guinea,Africa,13795931,171,19403
2021-03-27,guinea,Africa,13795931,98,19501
2021-03-28,guinea,Africa,13795931,169,19670
2021-03-29,guinea,Africa,13795931,103,19773
2021-03-30,guinea,Africa,13795931,20,19793
2021-03-31,guinea,Africa,13795931,115,19908
2021-04-01,guinea,Africa,13795931,175,20083
2021-04-02,guinea,Africa,13795931,145,20228
2021-04-03,guinea,Africa,13795931,91,20319
2021-04-04,guinea,Africa,13795931,86,20405
2021-04-05,guinea,Africa,13795931,101,20506
2021-04-06,guinea,Africa,13795931,4,20510
2021-04-07,guinea,Africa,13795931,44,20554
2021-04-08,guinea,Africa,13795931,93,20647
2021-04-09,guinea,Africa,13795931,99,20746
2021-04-10,guinea,Africa,13795931,61,20807
2021-04-11,guinea,Africa,13795931,142,20949
2021-04-12,guinea,Africa,13795931,83,21032
2021-04-13,guinea,Africa,13795931,74,21106
2021-04-14,guinea,Africa,13795931,193,21299
2021-04-15,guinea,Africa,13795931,0,21299
2021-04-16,guinea,Africa,13795931,93,21392
2021-04-17,guinea,Africa,13795931,68,21460
2021-04-18,guinea,Africa,13795931,79,21539
2021-04-19,guinea,Africa,13795931,73,21612
2021-04-20,guinea,Africa,13795931,21,21633
2021-04-21,guinea,Africa,13795931,33,21666
2021-04-22,guinea,Africa,13795931,79,21745
2021-04-23,guinea,Africa,13795931,58,21803
2021-04-24,guinea,Africa,13795931,82,21885
2021-04-25,guinea,Africa,13795931,68,21953
2021-04-26,guinea,Africa,13795931,32,21985
2021-04-27,guinea,Africa,13795931,61,22046
2021-04-28,guinea,Africa,13795931,41,22087
2021-04-29,guinea,Africa,13795931,128,22215
2021-04-30,guinea,Africa,13795931,0,22215
2021-05-01,guinea,Africa,13795931,32,22247
2021-05-02,guinea,Africa,13795931,57,22304
2021-05-03,guinea,Africa,13795931,29,22333
2021-05-04,guinea,Africa,13795931,35,22368
2021-05-05,guinea,Africa,13795931,100,22468
2021-05-06,guinea,Africa,13795931,37,22505
2021-05-07,guinea,Africa,13795931,48,22553
2021-05-08,guinea,Africa,13795931,49,22602
2021-05-09,guinea,Africa,13795931,31,22633
2021-05-10,guinea,Africa,13795931,12,22645
2021-05-11,guinea,Africa,13795931,74,22719
2021-05-12,guinea,Africa,13795931,0,22719
2021-05-13,guinea,Africa,13795931,0,22719
2021-05-14,guinea,Africa,13795931,27,22746
2021-05-15,guinea,Africa,13795931,0,22746
2021-05-16,guinea,Africa,13795931,0,22746
2021-05-17,guinea,Africa,13795931,84,22830
2021-05-18,guinea,Africa,13795931,23,22853
2021-05-19,guinea,Africa,13795931,26,22879
2021-05-20,guinea,Africa,13795931,84,22963
2021-05-21,guinea,Africa,13795931,0,22963
2021-05-22,guinea,Africa,13795931,25,22988
2021-05-23,guinea,Africa,13795931,45,23033
2021-05-24,guinea,Africa,13795931,19,23052
2021-05-25,guinea,Africa,13795931,8,23060
2021-05-26,guinea,Africa,13795931,20,23080
2021-05-27,guinea,Africa,13795931,30,23110
2021-05-28,guinea,Africa,13795931,0,23110
2021-05-29,guinea,Africa,13795931,62,23172
2021-05-30,guinea,Africa,13795931,0,23172
2021-05-31,guinea,Africa,13795931,5,23177
2021-06-01,guinea,Africa,13795931,17,23194
2021-06-02,guinea,Africa,13795931,9,23203
2021-06-03,guinea,Africa,13795931,42,23245
2021-06-04,guinea,Africa,13795931,10,23255
2021-06-05,guinea,Africa,13795931,0,23255
2021-06-06,guinea,Africa,13795931,0,23255
2021-06-07,guinea,Africa,13795931,52,23307
2021-06-08,guinea,Africa,13795931,5,23312
2021-06-09,guinea,Africa,13795931,22,23334
2021-06-10,guinea,Africa,13795931,18,23352
2021-06-11,guinea,Africa,13795931,14,23366
2021-06-12,guinea,Africa,13795931,23,23389
2021-06-13,guinea,Africa,13795931,9,23398
2021-06-14,guinea,Africa,13795931,0,23398
2021-06-15,guinea,Africa,13795931,12,23410
2021-06-16,guinea,Africa,13795931,21,23431
2021-06-17,guinea,Africa,13795931,0,23431
2021-06-18,guinea,Africa,13795931,19,23450
2021-06-19,guinea,Africa,13795931,0,23450
2021-06-20,guinea,Africa,13795931,0,23450
2021-06-21,guinea,Africa,13795931,85,23535
2021-06-22,guinea,Africa,13795931,8,23543
2021-06-23,guinea,Africa,13795931,36,23579
2021-06-24,guinea,Africa,13795931,36,23615
2021-06-25,guinea,Africa,13795931,38,23653
2021-06-26,guinea,Africa,13795931,39,23692
2021-06-27,guinea,Africa,13795931,0,23692
2021-06-28,guinea,Africa,13795931,52,23744
2021-06-29,guinea,Africa,13795931,9,23753
2021-06-30,guinea,Africa,13795931,17,23770
2021-07-01,guinea,Africa,13795931,17,23787
2021-07-02,guinea,Africa,13795931,20,23807
2021-07-03,guinea,Africa,13795931,0,23807
2021-07-04,guinea,Africa,13795931,0,23807
2021-07-05,guinea,Africa,13795931,64,23871
2021-07-06,guinea,Africa,13795931,24,23895
2021-07-07,guinea,Africa,13795931,50,23945
2021-07-08,guinea,Africa,13795931,54,23999
2021-07-09,guinea,Africa,13795931,21,24020
2021-07-10,guinea,Africa,13795931,45,24065
2021-07-11,guinea,Africa,13795931,52,24117
2021-07-12,guinea,Africa,13795931,17,24134
2021-07-13,guinea,Africa,13795931,39,24173
2021-07-14,guinea,Africa,13795931,79,24252
2021-07-15,guinea,Africa,13795931,46,24298
2021-07-16,guinea,Africa,13795931,87,24385
2021-07-17,guinea,Africa,13795931,124,24509
2021-07-18,guinea,Africa,13795931,159,24668
2021-07-19,guinea,Africa,13795931,43,24711
2021-07-20,guinea,Africa,13795931,54,24765
2021-07-21,guinea,Africa,13795931,58,24823
2021-07-22,guinea,Africa,13795931,0,24823
2021-07-23,guinea,Africa,13795931,55,24878
2021-07-24,guinea,Africa,13795931,115,24993
2021-07-25,guinea,Africa,13795931,61,25054
2021-07-26,guinea,Africa,13795931,72,25126
2021-07-27,guinea,Africa,13795931,85,25211
2021-07-28,guinea,Africa,13795931,82,25293
2021-07-29,guinea,Africa,13795931,108,25401
2021-07-30,guinea,Africa,13795931,164,25565
2021-07-31,guinea,Africa,13795931,123,25688
2021-08-01,guinea,Africa,13795931,113,25801
2021-08-02,guinea,Africa,13795931,113,25914
2021-08-03,guinea,Africa,13795931,78,25992
2021-08-04,guinea,Africa,13795931,196,26188
2021-08-05,guinea,Africa,13795931,133,26321
2021-08-06,guinea,Africa,13795931,156,26477
2021-08-07,guinea,Africa,13795931,370,26847
2021-08-08,guinea,Africa,13795931,0,26847
2021-08-09,guinea,Africa,13795931,122,26969
2021-08-10,guinea,Africa,13795931,143,27112
2021-08-11,guinea,Africa,13795931,199,27311
2021-08-12,guinea,Africa,13795931,196,27507
2021-08-13,guinea,Africa,13795931,138,27645
2021-08-14,guinea,Africa,13795931,192,27837
2021-08-15,guinea,Africa,13795931,183,28020
2021-08-16,guinea,Africa,13795931,98,28118
2021-08-17,guinea,Africa,13795931,137,28255
2021-08-18,guinea,Africa,13795931,53,28308
2021-08-19,guinea,Africa,13795931,120,28428
2021-08-20,guinea,Africa,13795931,96,28524
2021-08-21,guinea,Africa,13795931,123,28647
2021-08-22,guinea,Africa,13795931,155,28802
2021-08-23,guinea,Africa,13795931,20,28822
2021-08-24,guinea,Africa,13795931,123,28945
2021-08-25,guinea,Africa,13795931,77,29022
2021-08-26,guinea,Africa,13795931,187,29209
2021-08-27,guinea,Africa,13795931,0,29209
2021-08-28,guinea,Africa,13795931,0,29209
2021-08-29,guinea,Africa,13795931,0,29209
2021-08-30,guinea,Africa,13795931,191,29400
2021-08-31,guinea,Africa,13795931,101,29501
2021-09-01,guinea,Africa,13795931,40,29541
2021-09-02,guinea,Africa,13795931,64,29605
2021-09-03,guinea,Africa,13795931,137,29742
2021-09-04,guinea,Africa,13795931,100,29842
2021-09-05,guinea,Africa,13795931,0,29842
2021-09-06,guinea,Africa,13795931,22,29864
2021-09-07,guinea,Africa,13795931,13,29877
2021-09-08,guinea,Africa,13795931,41,29918
2021-09-09,guinea,Africa,13795931,35,29953
2021-09-10,guinea,Africa,13795931,34,29987
2021-09-11,guinea,Africa,13795931,14,30001
2021-09-12,guinea,Africa,13795931,28,30029
2021-09-13,guinea,Africa,13795931,18,30047
2021-09-14,guinea,Africa,13795931,38,30085
2021-09-15,guinea,Africa,13795931,24,30109
2021-09-16,guinea,Africa,13795931,27,30136
2021-09-17,guinea,Africa,13795931,0,30136
2021-09-18,guinea,Africa,13795931,0,30136
2021-09-19,guinea,Africa,13795931,0,30136
2021-09-20,guinea,Africa,13795931,135,30271
2021-09-21,guinea,Africa,13795931,32,30303
2021-09-22,guinea,Africa,13795931,0,30303
2021-09-23,guinea,Africa,13795931,15,30318
2021-09-24,guinea,Africa,13795931,25,30343
2021-09-25,guinea,Africa,13795931,5,30348
2021-09-26,guinea,Africa,13795931,14,30362
2021-09-27,guinea,Africa,13795931,2,30364
2021-09-28,guinea,Africa,13795931,18,30382
2021-09-29,guinea,Africa,13795931,10,30392
2021-09-30,guinea,Africa,13795931,19,30411
2021-10-01,guinea,Africa,13795931,9,30420
2021-10-02,guinea,Africa,13795931,14,30434
2021-10-03,guinea,Africa,13795931,7,30441
2021-10-04,guinea,Africa,13795931,4,30445
2021-10-05,guinea,Africa,13795931,7,30452
2021-10-06,guinea,Africa,13795931,18,30470
2021-10-07,guinea,Africa,13795931,9,30479
2021-10-08,guinea,Africa,13795931,22,30501
2021-10-09,guinea,Africa,13795931,0,30501
2021-10-10,guinea,Africa,13795931,0,30501
2021-10-11,guinea,Africa,13795931,22,30523
2021-10-12,guinea,Africa,13795931,3,30526
2021-10-13,guinea,Africa,13795931,9,30535
2021-10-14,guinea,Africa,13795931,25,30560
2021-10-15,guinea,Africa,13795931,12,30572
2021-10-16,guinea,Africa,13795931,0,30572
2021-10-17,guinea,Africa,13795931,0,30572
2021-10-18,guinea,Africa,13795931,0,30572
2021-10-19,guinea,Africa,13795931,27,30599
2021-10-20,guinea,Africa,13795931,6,30605
2021-10-21,guinea,Africa,13795931,0,30605
2021-10-22,guinea,Africa,13795931,21,30626
2021-10-23,guinea,Africa,13795931,0,30626
2021-10-24,guinea,Africa,13795931,15,30641
2021-10-25,guinea,Africa,13795931,1,30642
2021-10-26,guinea,Africa,13795931,3,30645
2021-10-27,guinea,Africa,13795931,6,30651
2021-10-28,guinea,Africa,13795931,2,30653
2021-10-29,guinea,Africa,13795931,0,30653
2021-10-30,guinea,Africa,13795931,0,30653
2021-10-31,guinea,Africa,13795931,0,30653
2021-11-01,guinea,Africa,13795931,14,30667
2021-11-02,guinea,Africa,13795931,5,30672
2021-11-03,guinea,Africa,13795931,9,30681
2021-11-04,guinea,Africa,13795931,0,30681
2021-11-05,guinea,Africa,13795931,0,30681
2021-11-06,guinea,Africa,13795931,0,30681
2021-11-07,guinea,Africa,13795931,0,30681
2021-11-08,guinea,Africa,13795931,28,30709
2021-11-09,guinea,Africa,13795931,0,30709
2021-11-10,guinea,Africa,13795931,0,30709
2021-11-11,guinea,Africa,13795931,6,30715
2021-11-12,guinea,Africa,13795931,0,30715
2021-11-13,guinea,Africa,13795931,0,30715
2021-11-14,guinea,Africa,13795931,0,30715
2021-11-15,guinea,Africa,13795931,0,30715
2021-11-16,guinea,Africa,13795931,0,30715
2021-11-17,guinea,Africa,13795931,0,30715
2021-11-18,guinea,Africa,13795931,0,30715
2021-11-19,guinea,Africa,13795931,0,30715
2021-11-20,guinea,Africa,13795931,0,30715
2021-11-21,guinea,Africa,13795931,0,30715
2021-11-22,guinea,Africa,13795931,32,30747
2021-11-23,guinea,Africa,13795931,0,30747
2021-11-24,guinea,Africa,13795931,4,30751
2021-11-25,guinea,Africa,13795931,0,30751
2021-11-26,guinea,Africa,13795931,6,30757
2021-11-27,guinea,Africa,13795931,6,30763
2021-11-28,guinea,Africa,13795931,5,30768
2021-11-29,guinea,Africa,13795931,2,30770
2021-11-30,guinea,Africa,13795931,0,30770
2021-12-01,guinea,Africa,13795931,0,30770
2021-12-02,guinea,Africa,13795931,0,30770
2021-12-03,guinea,Africa,13795931,0,30770
2021-12-04,guinea,Africa,13795931,0,30770
2021-12-05,guinea,Africa,13795931,0,30770
2021-12-06,guinea,Africa,13795931,28,30798
2021-12-07,guinea,Africa,13795931,0,30798
2021-12-08,guinea,Africa,13795931,0,30798
2020-04-27,guinea_bissau,Africa,2054599,20,73
2020-04-28,guinea_bissau,Africa,2054599,0,73
2020-04-29,guinea_bissau,Africa,2054599,132,205
2020-04-30,guinea_bissau,Africa,2054599,0,205
2020-05-01,guinea_bissau,Africa,2054599,52,257
2020-05-02,guinea_bissau,Africa,2054599,0,257
2020-05-03,guinea_bissau,Africa,2054599,0,257
2020-05-04,guinea_bissau,Africa,2054599,156,413
2020-05-05,guinea_bissau,Africa,2054599,0,413
2020-05-06,guinea_bissau,Africa,2054599,62,475
2020-05-07,guinea_bissau,Africa,2054599,89,564
2020-05-08,guinea_bissau,Africa,2054599,30,594
2020-05-09,guinea_bissau,Africa,2054599,47,641
2020-05-10,guinea_bissau,Africa,2054599,85,726
2020-05-11,guinea_bissau,Africa,2054599,35,761
2020-05-12,guinea_bissau,Africa,2054599,59,820
2020-05-13,guinea_bissau,Africa,2054599,16,836
2020-05-14,guinea_bissau,Africa,2054599,77,913
2020-05-15,guinea_bissau,Africa,2054599,0,913
2020-05-16,guinea_bissau,Africa,2054599,56,969
2020-05-17,guinea_bissau,Africa,2054599,21,990
2020-05-18,guinea_bissau,Africa,2054599,42,1032
2020-05-19,guinea_bissau,Africa,2054599,6,1038
2020-05-20,guinea_bissau,Africa,2054599,51,1089
2020-05-21,guinea_bissau,Africa,2054599,20,1109
2020-05-22,guinea_bissau,Africa,2054599,5,1114
2020-05-23,guinea_bissau,Africa,2054599,0,1114
2020-05-24,guinea_bissau,Africa,2054599,0,1114
2020-05-25,guinea_bissau,Africa,2054599,64,1178
2020-05-26,guinea_bissau,Africa,2054599,0,1178
2020-05-27,guinea_bissau,Africa,2054599,17,1195
2020-05-28,guinea_bissau,Africa,2054599,0,1195
2020-05-29,guinea_bissau,Africa,2054599,61,1256
2020-05-30,guinea_bissau,Africa,2054599,0,1256
2020-05-31,guinea_bissau,Africa,2054599,0,1256
2020-06-01,guinea_bissau,Africa,2054599,83,1339
2020-06-02,guinea_bissau,Africa,2054599,0,1339
2020-06-03,guinea_bissau,Africa,2054599,0,1339
2020-06-04,guinea_bissau,Africa,2054599,0,1339
2020-06-05,guinea_bissau,Africa,2054599,29,1368
2020-06-06,guinea_bissau,Africa,2054599,0,1368
2020-06-07,guinea_bissau,Africa,2054599,0,1368
2020-06-08,guinea_bissau,Africa,2054599,21,1389
2020-06-09,guinea_bissau,Africa,2054599,0,1389
2020-06-10,guinea_bissau,Africa,2054599,0,1389
2020-06-11,guinea_bissau,Africa,2054599,0,1389
2020-06-12,guinea_bissau,Africa,2054599,71,1460
2020-06-13,guinea_bissau,Africa,2054599,0,1460
2020-06-14,guinea_bissau,Africa,2054599,0,1460
2020-06-15,guinea_bissau,Africa,2054599,32,1492
2020-06-16,guinea_bissau,Africa,2054599,0,1492
2020-06-17,guinea_bissau,Africa,2054599,0,1492
2020-06-18,guinea_bissau,Africa,2054599,0,1492
2020-06-19,guinea_bissau,Africa,2054599,49,1541
2020-06-20,guinea_bissau,Africa,2054599,0,1541
2020-06-21,guinea_bissau,Africa,2054599,0,1541
2020-06-22,guinea_bissau,Africa,2054599,15,1556
2020-06-23,guinea_bissau,Africa,2054599,0,1556
2020-06-24,guinea_bissau,Africa,2054599,0,1556
2020-06-25,guinea_bissau,Africa,2054599,0,1556
2020-06-26,guinea_bissau,Africa,2054599,58,1614
2020-06-27,guinea_bissau,Africa,2054599,0,1614
2020-06-28,guinea_bissau,Africa,2054599,0,1614
2020-06-29,guinea_bissau,Africa,2054599,40,1654
2020-06-30,guinea_bissau,Africa,2054599,0,1654
2020-07-01,guinea_bissau,Africa,2054599,0,1654
2020-07-02,guinea_bissau,Africa,2054599,0,1654
2020-07-03,guinea_bissau,Africa,2054599,111,1765
2020-07-04,guinea_bissau,Africa,2054599,0,1765
2020-07-05,guinea_bissau,Africa,2054599,0,1765
2020-07-06,guinea_bissau,Africa,2054599,25,1790
2020-07-07,guinea_bissau,Africa,2054599,0,1790
2020-07-08,guinea_bissau,Africa,2054599,0,1790
2020-07-09,guinea_bissau,Africa,2054599,0,1790
2020-07-10,guinea_bissau,Africa,2054599,52,1842
2020-07-11,guinea_bissau,Africa,2054599,0,1842
2020-07-12,guinea_bissau,Africa,2054599,0,1842
2020-07-13,guinea_bissau,Africa,2054599,0,1842
2020-07-14,guinea_bissau,Africa,2054599,0,1842
2020-07-15,guinea_bissau,Africa,2054599,0,1842
2020-07-16,guinea_bissau,Africa,2054599,60,1902
2020-07-17,guinea_bissau,Africa,2054599,25,1927
2020-07-18,guinea_bissau,Africa,2054599,22,1949
2020-07-19,guinea_bissau,Africa,2054599,0,1949
2020-07-20,guinea_bissau,Africa,2054599,0,1949
2020-07-21,guinea_bissau,Africa,2054599,5,1954
2020-07-22,guinea_bissau,Africa,2054599,0,1954
2020-07-23,guinea_bissau,Africa,2054599,0,1954
2020-07-24,guinea_bissau,Africa,2054599,0,1954
2020-07-25,guinea_bissau,Africa,2054599,0,1954
2020-07-26,guinea_bissau,Africa,2054599,0,1954
2020-07-27,guinea_bissau,Africa,2054599,0,1954
2020-07-28,guinea_bissau,Africa,2054599,0,1954
2020-07-29,guinea_bissau,Africa,2054599,0,1954
2020-07-30,guinea_bissau,Africa,2054599,27,1981
2020-07-31,guinea_bissau,Africa,2054599,0,1981
2020-08-01,guinea_bissau,Africa,2054599,0,1981
2020-08-02,guinea_bissau,Africa,2054599,0,1981
2020-08-03,guinea_bissau,Africa,2054599,0,1981
2020-08-04,guinea_bissau,Africa,2054599,0,1981
2020-08-05,guinea_bissau,Africa,2054599,51,2032
2020-08-06,guinea_bissau,Africa,2054599,0,2032
2020-08-07,guinea_bissau,Africa,2054599,0,2032
2020-08-08,guinea_bissau,Africa,2054599,20,2052
2020-08-09,guinea_bissau,Africa,2054599,0,2052
2020-08-10,guinea_bissau,Africa,2054599,0,2052
2020-08-11,guinea_bissau,Africa,2054599,36,2088
2020-08-12,guinea_bissau,Africa,2054599,0,2088
2020-08-13,guinea_bissau,Africa,2054599,0,2088
2020-08-14,guinea_bissau,Africa,2054599,0,2088
2020-08-15,guinea_bissau,Africa,2054599,29,2117
2020-08-16,guinea_bissau,Africa,2054599,0,2117
2020-08-17,guinea_bissau,Africa,2054599,0,2117
2020-08-18,guinea_bissau,Africa,2054599,0,2117
2020-08-19,guinea_bissau,Africa,2054599,0,2117
2020-08-20,guinea_bissau,Africa,2054599,32,2149
2020-08-21,guinea_bissau,Africa,2054599,0,2149
2020-08-22,guinea_bissau,Africa,2054599,0,2149
2020-08-23,guinea_bissau,Africa,2054599,0,2149
2020-08-24,guinea_bissau,Africa,2054599,0,2149
2020-08-25,guinea_bissau,Africa,2054599,0,2149
2020-08-26,guinea_bissau,Africa,2054599,56,2205
2020-08-27,guinea_bissau,Africa,2054599,0,2205
2020-08-28,guinea_bissau,Africa,2054599,0,2205
2020-08-29,guinea_bissau,Africa,2054599,0,2205
2020-08-30,guinea_bissau,Africa,2054599,0,2205
2020-08-31,guinea_bissau,Africa,2054599,0,2205
2020-09-01,guinea_bissau,Africa,2054599,0,2205
2020-09-02,guinea_bissau,Africa,2054599,0,2205
2020-09-03,guinea_bissau,Africa,2054599,0,2205
2020-09-04,guinea_bissau,Africa,2054599,40,2245
2020-09-05,guinea_bissau,Africa,2054599,0,2245
2020-09-06,guinea_bissau,Africa,2054599,0,2245
2020-09-07,guinea_bissau,Africa,2054599,0,2245
2020-09-08,guinea_bissau,Africa,2054599,0,2245
2020-09-09,guinea_bissau,Africa,2054599,0,2245
2020-09-10,guinea_bissau,Africa,2054599,30,2275
2020-09-11,guinea_bissau,Africa,2054599,0,2275
2020-09-12,guinea_bissau,Africa,2054599,0,2275
2020-09-13,guinea_bissau,Africa,2054599,0,2275
2020-09-14,guinea_bissau,Africa,2054599,0,2275
2020-09-15,guinea_bissau,Africa,2054599,0,2275
2020-09-16,guinea_bissau,Africa,2054599,0,2275
2020-09-17,guinea_bissau,Africa,2054599,0,2275
2020-09-18,guinea_bissau,Africa,2054599,28,2303
2020-09-19,guinea_bissau,Africa,2054599,0,2303
2020-09-20,guinea_bissau,Africa,2054599,0,2303
2020-09-21,guinea_bissau,Africa,2054599,0,2303
2020-09-22,guinea_bissau,Africa,2054599,21,2324
2020-09-23,guinea_bissau,Africa,2054599,0,2324
2020-09-24,guinea_bissau,Africa,2054599,0,2324
2020-09-25,guinea_bissau,Africa,2054599,0,2324
2020-09-26,guinea_bissau,Africa,2054599,0,2324
2020-09-27,guinea_bissau,Africa,2054599,0,2324
2020-09-28,guinea_bissau,Africa,2054599,0,2324
2020-09-29,guinea_bissau,Africa,2054599,0,2324
2020-09-30,guinea_bissau,Africa,2054599,0,2324
2020-10-01,guinea_bissau,Africa,2054599,0,2324
2020-10-02,guinea_bissau,Africa,2054599,38,2362
2020-10-03,guinea_bissau,Africa,2054599,0,2362
2020-10-04,guinea_bissau,Africa,2054599,0,2362
2020-10-05,guinea_bissau,Africa,2054599,23,2385
2020-10-06,guinea_bissau,Africa,2054599,0,2385
2020-10-07,guinea_bissau,Africa,2054599,0,2385
2020-10-08,guinea_bissau,Africa,2054599,0,2385
2020-10-09,guinea_bissau,Africa,2054599,0,2385
2020-10-10,guinea_bissau,Africa,2054599,0,2385
2020-10-11,guinea_bissau,Africa,2054599,0,2385
2020-10-12,guinea_bissau,Africa,2054599,4,2389
2020-10-13,guinea_bissau,Africa,2054599,0,2389
2020-10-14,guinea_bissau,Africa,2054599,0,2389
2020-10-15,guinea_bissau,Africa,2054599,0,2389
2020-10-16,guinea_bissau,Africa,2054599,0,2389
2020-10-17,guinea_bissau,Africa,2054599,0,2389
2020-10-18,guinea_bissau,Africa,2054599,0,2389
2020-10-19,guinea_bissau,Africa,2054599,14,2403
2020-10-20,guinea_bissau,Africa,2054599,0,2403
2020-10-21,guinea_bissau,Africa,2054599,0,2403
2020-10-22,guinea_bissau,Africa,2054599,0,2403
2020-10-23,guinea_bissau,Africa,2054599,0,2403
2020-10-24,guinea_bissau,Africa,2054599,0,2403
2020-10-25,guinea_bissau,Africa,2054599,0,2403
2020-10-26,guinea_bissau,Africa,2054599,0,2403
2020-10-27,guinea_bissau,Africa,2054599,0,2403
2020-10-28,guinea_bissau,Africa,2054599,0,2403
2020-10-29,guinea_bissau,Africa,2054599,0,2403
2020-10-30,guinea_bissau,Africa,2054599,0,2403
2020-10-31,guinea_bissau,Africa,2054599,10,2413
2020-11-01,guinea_bissau,Africa,2054599,0,2413
2020-11-02,guinea_bissau,Africa,2054599,0,2413
2020-11-03,guinea_bissau,Africa,2054599,0,2413
2020-11-04,guinea_bissau,Africa,2054599,1,2414
2020-11-05,guinea_bissau,Africa,2054599,0,2414
2020-11-06,guinea_bissau,Africa,2054599,0,2414
2020-11-07,guinea_bissau,Africa,2054599,0,2414
2020-11-08,guinea_bissau,Africa,2054599,0,2414
2020-11-09,guinea_bissau,Africa,2054599,5,2419
2020-11-10,guinea_bissau,Africa,2054599,0,2419
2020-11-11,guinea_bissau,Africa,2054599,0,2419
2020-11-12,guinea_bissau,Africa,2054599,0,2419
2020-11-13,guinea_bissau,Africa,2054599,0,2419
2020-11-14,guinea_bissau,Africa,2054599,0,2419
2020-11-15,guinea_bissau,Africa,2054599,0,2419
2020-11-16,guinea_bissau,Africa,2054599,2,2421
2020-11-17,guinea_bissau,Africa,2054599,0,2421
2020-11-18,guinea_bissau,Africa,2054599,0,2421
2020-11-19,guinea_bissau,Africa,2054599,0,2421
2020-11-20,guinea_bissau,Africa,2054599,0,2421
2020-11-21,guinea_bissau,Africa,2054599,0,2421
2020-11-22,guinea_bissau,Africa,2054599,0,2421
2020-11-23,guinea_bissau,Africa,2054599,1,2422
2020-11-24,guinea_bissau,Africa,2054599,0,2422
2020-11-25,guinea_bissau,Africa,2054599,0,2422
2020-11-26,guinea_bissau,Africa,2054599,0,2422
2020-11-27,guinea_bissau,Africa,2054599,0,2422
2020-11-28,guinea_bissau,Africa,2054599,0,2422
2020-11-29,guinea_bissau,Africa,2054599,0,2422
2020-11-30,guinea_bissau,Africa,2054599,19,2441
2020-12-01,guinea_bissau,Africa,2054599,0,2441
2020-12-02,guinea_bissau,Africa,2054599,0,2441
2020-12-03,guinea_bissau,Africa,2054599,0,2441
2020-12-04,guinea_bissau,Africa,2054599,0,2441
2020-12-05,guinea_bissau,Africa,2054599,0,2441
2020-12-06,guinea_bissau,Africa,2054599,0,2441
2020-12-07,guinea_bissau,Africa,2054599,3,2444
2020-12-08,guinea_bissau,Africa,2054599,0,2444
2020-12-09,guinea_bissau,Africa,2054599,0,2444
2020-12-10,guinea_bissau,Africa,2054599,0,2444
2020-12-11,guinea_bissau,Africa,2054599,0,2444
2020-12-12,guinea_bissau,Africa,2054599,0,2444
2020-12-13,guinea_bissau,Africa,2054599,0,2444
2020-12-14,guinea_bissau,Africa,2054599,0,2444
2020-12-15,guinea_bissau,Africa,2054599,3,2447
2020-12-16,guinea_bissau,Africa,2054599,0,2447
2020-12-17,guinea_bissau,Africa,2054599,0,2447
2020-12-18,guinea_bissau,Africa,2054599,0,2447
2020-12-19,guinea_bissau,Africa,2054599,0,2447
2020-12-20,guinea_bissau,Africa,2054599,0,2447
2020-12-21,guinea_bissau,Africa,2054599,0,2447
2020-12-22,guinea_bissau,Africa,2054599,0,2447
2020-12-23,guinea_bissau,Africa,2054599,0,2447
2020-12-24,guinea_bissau,Africa,2054599,0,2447
2020-12-25,guinea_bissau,Africa,2054599,0,2447
2020-12-26,guinea_bissau,Africa,2054599,0,2447
2020-12-27,guinea_bissau,Africa,2054599,0,2447
2020-12-28,guinea_bissau,Africa,2054599,0,2447
2020-12-29,guinea_bissau,Africa,2054599,0,2447
2020-12-30,guinea_bissau,Africa,2054599,5,2452
2020-12-31,guinea_bissau,Africa,2054599,0,2452
2021-01-01,guinea_bissau,Africa,2054599,0,2452
2021-01-02,guinea_bissau,Africa,2054599,0,2452
2021-01-03,guinea_bissau,Africa,2054599,3,2455
2021-01-04,guinea_bissau,Africa,2054599,0,2455
2021-01-05,guinea_bissau,Africa,2054599,0,2455
2021-01-06,guinea_bissau,Africa,2054599,0,2455
2021-01-07,guinea_bissau,Africa,2054599,0,2455
2021-01-08,guinea_bissau,Africa,2054599,0,2455
2021-01-09,guinea_bissau,Africa,2054599,0,2455
2021-01-10,guinea_bissau,Africa,2054599,23,2478
2021-01-11,guinea_bissau,Africa,2054599,0,2478
2021-01-12,guinea_bissau,Africa,2054599,0,2478
2021-01-13,guinea_bissau,Africa,2054599,0,2478
2021-01-14,guinea_bissau,Africa,2054599,0,2478
2021-01-15,guinea_bissau,Africa,2054599,0,2478
2021-01-16,guinea_bissau,Africa,2054599,0,2478
2021-01-17,guinea_bissau,Africa,2054599,31,2509
2021-01-18,guinea_bissau,Africa,2054599,1,2510
2021-01-19,guinea_bissau,Africa,2054599,0,2510
2021-01-20,guinea_bissau,Africa,2054599,0,2510
2021-01-21,guinea_bissau,Africa,2054599,0,2510
2021-01-22,guinea_bissau,Africa,2054599,0,2510
2021-01-23,guinea_bissau,Africa,2054599,0,2510
2021-01-24,guinea_bissau,Africa,2054599,22,2532
2021-01-25,guinea_bissau,Africa,2054599,0,2532
2021-01-26,guinea_bissau,Africa,2054599,0,2532
2021-01-27,guinea_bissau,Africa,2054599,0,2532
2021-01-28,guinea_bissau,Africa,2054599,0,2532
2021-01-29,guinea_bissau,Africa,2054599,0,2532
2021-01-30,guinea_bissau,Africa,2054599,0,2532
2021-01-31,guinea_bissau,Africa,2054599,102,2634
2021-02-01,guinea_bissau,Africa,2054599,0,2634
2021-02-02,guinea_bissau,Africa,2054599,21,2655
2021-02-03,guinea_bissau,Africa,2054599,7,2662
2021-02-04,guinea_bissau,Africa,2054599,0,2662
2021-02-05,guinea_bissau,Africa,2054599,90,2752
2021-02-06,guinea_bissau,Africa,2054599,20,2772
2021-02-07,guinea_bissau,Africa,2054599,8,2780
2021-02-08,guinea_bissau,Africa,2054599,0,2780
2021-02-09,guinea_bissau,Africa,2054599,30,2810
2021-02-10,guinea_bissau,Africa,2054599,16,2826
2021-02-11,guinea_bissau,Africa,2054599,22,2848
2021-02-12,guinea_bissau,Africa,2054599,21,2869
2021-02-13,guinea_bissau,Africa,2054599,16,2885
2021-02-14,guinea_bissau,Africa,2054599,39,2924
2021-02-15,guinea_bissau,Africa,2054599,0,2924
2021-02-16,guinea_bissau,Africa,2054599,26,2950
2021-02-17,guinea_bissau,Africa,2054599,49,2999
2021-02-18,guinea_bissau,Africa,2054599,26,3025
2021-02-19,guinea_bissau,Africa,2054599,39,3064
2021-02-20,guinea_bissau,Africa,2054599,27,3091
2021-02-21,guinea_bissau,Africa,2054599,24,3115
2021-02-22,guinea_bissau,Africa,2054599,0,3115
2021-02-23,guinea_bissau,Africa,2054599,41,3156
2021-02-24,guinea_bissau,Africa,2054599,15,3171
2021-02-25,guinea_bissau,Africa,2054599,44,3215
2021-02-26,guinea_bissau,Africa,2054599,26,3241
2021-02-27,guinea_bissau,Africa,2054599,6,3247
2021-02-28,guinea_bissau,Africa,2054599,15,3262
2021-03-01,guinea_bissau,Africa,2054599,0,3262
2021-03-02,guinea_bissau,Africa,2054599,9,3271
2021-03-03,guinea_bissau,Africa,2054599,11,3282
2021-03-04,guinea_bissau,Africa,2054599,19,3301
2021-03-05,guinea_bissau,Africa,2054599,2,3303
2021-03-06,guinea_bissau,Africa,2054599,9,3312
2021-03-07,guinea_bissau,Africa,2054599,0,3312
2021-03-08,guinea_bissau,Africa,2054599,0,3312
2021-03-09,guinea_bissau,Africa,2054599,7,3319
2021-03-10,guinea_bissau,Africa,2054599,8,3327
2021-03-11,guinea_bissau,Africa,2054599,53,3380
2021-03-12,guinea_bissau,Africa,2054599,18,3398
2021-03-13,guinea_bissau,Africa,2054599,38,3436
2021-03-14,guinea_bissau,Africa,2054599,11,3447
2021-03-15,guinea_bissau,Africa,2054599,0,3447
2021-03-16,guinea_bissau,Africa,2054599,22,3469
2021-03-17,guinea_bissau,Africa,2054599,19,3488
2021-03-18,guinea_bissau,Africa,2054599,30,3518
2021-03-19,guinea_bissau,Africa,2054599,18,3536
2021-03-20,guinea_bissau,Africa,2054599,22,3558
2021-03-21,guinea_bissau,Africa,2054599,10,3568
2021-03-22,guinea_bissau,Africa,2054599,0,3568
2021-03-23,guinea_bissau,Africa,2054599,18,3586
2021-03-24,guinea_bissau,Africa,2054599,5,3591
2021-03-25,guinea_bissau,Africa,2054599,16,3607
2021-03-26,guinea_bissau,Africa,2054599,8,3615
2021-03-27,guinea_bissau,Africa,2054599,15,3630
2021-03-28,guinea_bissau,Africa,2054599,4,3634
2021-03-29,guinea_bissau,Africa,2054599,0,3634
2021-03-30,guinea_bissau,Africa,2054599,13,3647
2021-03-31,guinea_bissau,Africa,2054599,3,3650
2021-04-01,guinea_bissau,Africa,2054599,11,3661
2021-04-02,guinea_bissau,Africa,2054599,0,3661
2021-04-03,guinea_bissau,Africa,2054599,0,3661
2021-04-04,guinea_bissau,Africa,2054599,1,3662
2021-04-05,guinea_bissau,Africa,2054599,0,3662
2021-04-06,guinea_bissau,Africa,2054599,0,3662
2021-04-07,guinea_bissau,Africa,2054599,1,3663
2021-04-08,guinea_bissau,Africa,2054599,1,3664
2021-04-09,guinea_bissau,Africa,2054599,11,3675
2021-04-10,guinea_bissau,Africa,2054599,3,3678
2021-04-11,guinea_bissau,Africa,2054599,2,3680
2020-04-06,haiti,North America,11661401,3,24
2020-04-07,haiti,North America,11661401,1,25
2020-04-08,haiti,North America,11661401,2,27
2020-04-09,haiti,North America,11661401,3,30
2020-04-10,haiti,North America,11661401,1,31
2020-04-11,haiti,North America,11661401,2,33
2020-04-12,haiti,North America,11661401,0,33
2020-04-13,haiti,North America,11661401,7,40
2020-04-14,haiti,North America,11661401,0,40
2020-04-15,haiti,North America,11661401,1,41
2020-04-16,haiti,North America,11661401,0,41
2020-04-17,haiti,North America,11661401,2,43
2020-04-18,haiti,North America,11661401,1,44
2020-04-19,haiti,North America,11661401,3,47
2020-04-20,haiti,North America,11661401,10,57
2020-04-21,haiti,North America,11661401,0,57
2020-04-22,haiti,North America,11661401,5,62
2020-04-23,haiti,North America,11661401,10,72
2020-04-24,haiti,North America,11661401,0,72
2020-04-25,haiti,North America,11661401,0,72
2020-04-26,haiti,North America,11661401,2,74
2020-04-27,haiti,North America,11661401,0,74
2020-04-28,haiti,North America,11661401,2,76
2020-04-29,haiti,North America,11661401,0,76
2020-04-30,haiti,North America,11661401,5,81
2020-05-01,haiti,North America,11661401,4,85
2020-05-02,haiti,North America,11661401,0,85
2020-05-03,haiti,North America,11661401,0,85
2020-05-04,haiti,North America,11661401,15,100
2020-05-05,haiti,North America,11661401,1,101
2020-05-06,haiti,North America,11661401,0,101
2020-05-07,haiti,North America,11661401,28,129
2020-05-08,haiti,North America,11661401,17,146
2020-05-09,haiti,North America,11661401,5,151
2020-05-10,haiti,North America,11661401,31,182
2020-05-11,haiti,North America,11661401,0,182
2020-05-12,haiti,North America,11661401,27,209
2020-05-13,haiti,North America,11661401,10,219
2020-05-14,haiti,North America,11661401,15,234
2020-05-15,haiti,North America,11661401,39,273
2020-05-16,haiti,North America,11661401,85,358
2020-05-17,haiti,North America,11661401,98,456
2020-05-18,haiti,North America,11661401,77,533
2020-05-19,haiti,North America,11661401,0,533
2020-05-20,haiti,North America,11661401,63,596
2020-05-21,haiti,North America,11661401,67,663
2020-05-22,haiti,North America,11661401,71,734
2020-05-23,haiti,North America,11661401,78,812
2020-05-24,haiti,North America,11661401,53,865
2020-05-25,haiti,North America,11661401,93,958
2020-03-27,honduras,North America,10197959,1,68
2020-03-28,honduras,North America,10197959,27,95
2020-03-29,honduras,North America,10197959,15,110
2020-03-30,honduras,North America,10197959,29,139
2020-03-31,honduras,North America,10197959,2,141
2020-04-01,honduras,North America,10197959,31,172
2020-04-02,honduras,North America,10197959,47,219
2020-04-03,honduras,North America,10197959,3,222
2020-04-04,honduras,North America,10197959,42,264
2020-04-05,honduras,North America,10197959,4,268
2020-04-06,honduras,North America,10197959,30,298
2020-04-07,honduras,North America,10197959,7,305
2020-04-08,honduras,North America,10197959,7,312
2020-04-09,honduras,North America,10197959,31,343
2020-04-10,honduras,North America,10197959,39,382
2020-04-11,honduras,North America,10197959,10,392
2020-04-12,honduras,North America,10197959,1,393
2020-04-13,honduras,North America,10197959,4,397
2020-04-14,honduras,North America,10197959,10,407
2020-04-15,honduras,North America,10197959,12,419
2020-04-16,honduras,North America,10197959,7,426
2020-04-17,honduras,North America,10197959,16,442
2020-04-18,honduras,North America,10197959,15,457
2020-04-19,honduras,North America,10197959,15,472
2020-04-20,honduras,North America,10197959,5,477
2020-04-21,honduras,North America,10197959,17,494
2020-04-22,honduras,North America,10197959,16,510
2020-04-23,honduras,North America,10197959,9,519
2020-04-24,honduras,North America,10197959,43,562
2020-04-25,honduras,North America,10197959,29,591
2020-04-26,honduras,North America,10197959,36,627
2020-04-27,honduras,North America,10197959,34,661
2020-04-28,honduras,North America,10197959,41,702
2020-04-29,honduras,North America,10197959,36,738
2020-04-30,honduras,North America,10197959,33,771
2020-05-01,honduras,North America,10197959,33,804
2020-05-02,honduras,North America,10197959,95,899
2020-05-03,honduras,North America,10197959,111,1010
2020-05-04,honduras,North America,10197959,45,1055
2020-05-05,honduras,North America,10197959,123,1178
2020-05-06,honduras,North America,10197959,92,1270
2020-05-07,honduras,North America,10197959,191,1461
2020-05-08,honduras,North America,10197959,224,1685
2020-05-09,honduras,North America,10197959,86,1771
2020-05-10,honduras,North America,10197959,59,1830
2020-05-11,honduras,North America,10197959,142,1972
2020-05-12,honduras,North America,10197959,108,2080
2020-05-13,honduras,North America,10197959,0,2080
2020-05-14,honduras,North America,10197959,175,2255
2020-05-15,honduras,North America,10197959,63,2318
2020-05-16,honduras,North America,10197959,142,2460
2020-05-17,honduras,North America,10197959,105,2565
2020-05-18,honduras,North America,10197959,81,2646
2020-05-19,honduras,North America,10197959,152,2798
2020-05-20,honduras,North America,10197959,157,2955
2020-05-21,honduras,North America,10197959,145,3100
2020-05-22,honduras,North America,10197959,104,3204
2020-05-23,honduras,North America,10197959,273,3477
2020-05-24,honduras,North America,10197959,266,3743
2020-05-25,honduras,North America,10197959,207,3950
2020-05-26,honduras,North America,10197959,239,4189
2020-05-27,honduras,North America,10197959,212,4401
2020-05-28,honduras,North America,10197959,239,4640
2020-05-29,honduras,North America,10197959,112,4752
2020-05-30,honduras,North America,10197959,134,4886
2020-05-31,honduras,North America,10197959,208,5094
2020-06-01,honduras,North America,10197959,108,5202
2020-06-02,honduras,North America,10197959,160,5362
2020-06-03,honduras,North America,10197959,165,5527
2020-06-04,honduras,North America,10197959,163,5690
2020-06-05,honduras,North America,10197959,190,5880
2020-06-06,honduras,North America,10197959,91,5971
2020-06-07,honduras,North America,10197959,184,6155
2020-06-08,honduras,North America,10197959,172,6327
2020-06-09,honduras,North America,10197959,123,6450
2020-06-10,honduras,North America,10197959,485,6935
2020-06-11,honduras,North America,10197959,425,7360
2020-06-12,honduras,North America,10197959,309,7669
2020-06-13,honduras,North America,10197959,463,8132
2020-06-14,honduras,North America,10197959,323,8455
2020-06-15,honduras,North America,10197959,403,8858
2020-06-16,honduras,North America,10197959,320,9178
2020-06-17,honduras,North America,10197959,478,9656
2020-06-18,honduras,North America,10197959,643,10299
2020-06-19,honduras,North America,10197959,440,10739
2020-06-20,honduras,North America,10197959,519,11258
2020-06-21,honduras,North America,10197959,1048,12306
2020-06-22,honduras,North America,10197959,466,12772
2020-06-23,honduras,North America,10197959,584,13356
2020-06-24,honduras,North America,10197959,587,13943
2020-06-25,honduras,North America,10197959,628,14571
2020-06-26,honduras,North America,10197959,795,15366
2020-06-27,honduras,North America,10197959,628,15994
2020-06-28,honduras,North America,10197959,1013,17007
2020-06-29,honduras,North America,10197959,1075,18082
2020-06-30,honduras,North America,10197959,736,18818
2020-07-01,honduras,North America,10197959,740,19558
2020-07-02,honduras,North America,10197959,704,20262
2020-07-03,honduras,North America,10197959,858,21120
2020-07-04,honduras,North America,10197959,996,22116
2020-07-05,honduras,North America,10197959,805,22921
2020-07-06,honduras,North America,10197959,1022,23943
2020-07-07,honduras,North America,10197959,722,24665
2020-07-08,honduras,North America,10197959,763,25428
2020-07-09,honduras,North America,10197959,550,25978
2020-07-10,honduras,North America,10197959,406,26384
2020-07-11,honduras,North America,10197959,669,27053
2020-07-12,honduras,North America,10197959,530,27583
2020-07-13,honduras,North America,10197959,507,28090
2020-07-14,honduras,North America,10197959,489,28579
2020-07-15,honduras,North America,10197959,527,29106
2020-07-16,honduras,North America,10197959,930,30036
2020-07-17,honduras,North America,10197959,831,30867
2020-07-18,honduras,North America,10197959,878,31745
2020-07-19,honduras,North America,10197959,1048,32793
2020-07-20,honduras,North America,10197959,1042,33835
2020-07-21,honduras,North America,10197959,776,34611
2020-07-22,honduras,North America,10197959,734,35345
2020-07-23,honduras,North America,10197959,757,36102
2020-07-24,honduras,North America,10197959,800,36902
2020-07-25,honduras,North America,10197959,657,37559
2020-07-26,honduras,North America,10197959,879,38438
2020-07-27,honduras,North America,10197959,838,39276
2020-07-28,honduras,North America,10197959,465,39741
2020-07-29,honduras,North America,10197959,719,40460
2020-07-30,honduras,North America,10197959,484,40944
2020-07-31,honduras,North America,10197959,482,41426
2020-08-01,honduras,North America,10197959,588,42014
2020-08-02,honduras,North America,10197959,671,42685
2020-08-03,honduras,North America,10197959,512,43197
2020-08-04,honduras,North America,10197959,597,43794
2020-08-05,honduras,North America,10197959,505,44299
2020-08-06,honduras,North America,10197959,799,45098
2020-08-07,honduras,North America,10197959,657,45755
2020-08-08,honduras,North America,10197959,610,46365
2020-08-09,honduras,North America,10197959,608,46973
2020-08-10,honduras,North America,10197959,481,47454
2020-08-11,honduras,North America,10197959,418,47872
2020-08-12,honduras,North America,10197959,531,48403
2020-08-13,honduras,North America,10197959,254,48657
2020-08-14,honduras,North America,10197959,385,49042
2020-08-15,honduras,North America,10197959,425,49467
2020-08-16,honduras,North America,10197959,512,49979
2020-08-17,honduras,North America,10197959,523,50502
2020-08-18,honduras,North America,10197959,493,50995
2020-08-19,honduras,North America,10197959,675,51670
2020-08-20,honduras,North America,10197959,628,52298
2020-08-21,honduras,North America,10197959,521,52819
2020-08-22,honduras,North America,10197959,562,53381
2020-08-23,honduras,North America,10197959,602,53983
2020-08-24,honduras,North America,10197959,528,54511
2020-08-25,honduras,North America,10197959,968,55479
2020-08-26,honduras,North America,10197959,398,55877
2020-08-27,honduras,North America,10197959,772,56649
2020-08-28,honduras,North America,10197959,1020,57669
2020-08-29,honduras,North America,10197959,1141,58810
2020-08-30,honduras,North America,10197959,835,59645
2020-08-31,honduras,North America,10197959,529,60174
2020-09-01,honduras,North America,10197959,840,61014
2020-09-02,honduras,North America,10197959,755,61769
2020-09-03,honduras,North America,10197959,757,62526
2020-09-04,honduras,North America,10197959,632,63158
2020-09-05,honduras,North America,10197959,640,63798
2020-09-06,honduras,North America,10197959,554,64352
2020-09-07,honduras,North America,10197959,412,64764
2020-09-08,honduras,North America,10197959,50,64814
2020-09-09,honduras,North America,10197959,404,65218
2020-09-10,honduras,North America,10197959,379,65597
2020-09-11,honduras,North America,10197959,205,65802
2020-09-12,honduras,North America,10197959,247,66049
2020-09-13,honduras,North America,10197959,1087,67136
2020-09-14,honduras,North America,10197959,653,67789
2020-09-15,honduras,North America,10197959,831,68620
2020-09-16,honduras,North America,10197959,0,68620
2020-09-17,honduras,North America,10197959,1040,69660
2020-09-18,honduras,North America,10197959,460,70120
2020-09-19,honduras,North America,10197959,491,70611
2020-09-20,honduras,North America,10197959,532,71143
2020-09-21,honduras,North America,10197959,473,71616
2020-09-22,honduras,North America,10197959,459,72075
2020-09-23,honduras,North America,10197959,231,72306
2020-09-24,honduras,North America,10197959,369,72675
2020-09-25,honduras,North America,10197959,518,73193
2020-09-26,honduras,North America,10197959,647,73840
2020-09-27,honduras,North America,10197959,708,74548
2020-09-28,honduras,North America,10197959,561,75109
2020-09-29,honduras,North America,10197959,428,75537
2020-09-30,honduras,North America,10197959,561,76098
2020-10-01,honduras,North America,10197959,802,76900
2020-10-02,honduras,North America,10197959,698,77598
2020-10-03,honduras,North America,10197959,671,78269
2020-10-04,honduras,North America,10197959,519,78788
2020-10-05,honduras,North America,10197959,841,79629
2020-10-06,honduras,North America,10197959,391,80020
2020-10-07,honduras,North America,10197959,642,80662
2020-10-08,honduras,North America,10197959,498,81160
2020-10-09,honduras,North America,10197959,512,81672
2020-10-10,honduras,North America,10197959,880,82552
2020-10-11,honduras,North America,10197959,594,83146
2020-10-12,honduras,North America,10197959,935,84081
2020-10-13,honduras,North America,10197959,332,84413
2020-10-14,honduras,North America,10197959,439,84852
2020-10-15,honduras,North America,10197959,606,85458
2020-10-16,honduras,North America,10197959,631,86089
2020-10-17,honduras,North America,10197959,602,86691
2020-10-18,honduras,North America,10197959,903,87594
2020-10-19,honduras,North America,10197959,831,88425
2020-10-20,honduras,North America,10197959,956,89381
2020-10-21,honduras,North America,10197959,851,90232
2020-10-22,honduras,North America,10197959,846,91078
2020-10-23,honduras,North America,10197959,431,91509
2020-10-24,honduras,North America,10197959,373,91882
2020-10-25,honduras,North America,10197959,842,92724
2020-10-26,honduras,North America,10197959,490,93214
2020-10-27,honduras,North America,10197959,752,93966
2020-10-28,honduras,North America,10197959,657,94623
2020-10-29,honduras,North America,10197959,576,95199
2020-10-30,honduras,North America,10197959,951,96150
2020-10-31,honduras,North America,10197959,738,96888
2020-11-01,honduras,North America,10197959,516,97404
2020-11-02,honduras,North America,10197959,808,98212
2020-11-03,honduras,North America,10197959,193,98405
2020-11-04,honduras,North America,10197959,283,98688
2020-11-05,honduras,North America,10197959,436,99124
2020-11-06,honduras,North America,10197959,223,99347
2020-11-07,honduras,North America,10197959,229,99576
2020-11-08,honduras,North America,10197959,465,100041
2020-11-09,honduras,North America,10197959,467,100508
2020-11-10,honduras,North America,10197959,65,100573
2020-11-11,honduras,North America,10197959,231,100804
2020-11-12,honduras,North America,10197959,365,101169
2020-11-13,honduras,North America,10197959,299,101468
2020-11-14,honduras,North America,10197959,611,102079
2020-11-15,honduras,North America,10197959,476,102555
2020-11-16,honduras,North America,10197959,547,103102
2020-11-17,honduras,North America,10197959,137,103239
2020-11-18,honduras,North America,10197959,249,103488
2020-11-19,honduras,North America,10197959,0,103488
2020-11-20,honduras,North America,10197959,63,103551
2020-11-21,honduras,North America,10197959,628,104179
2020-11-22,honduras,North America,10197959,256,104435
2020-11-23,honduras,North America,10197959,480,104915
2020-11-24,honduras,North America,10197959,296,105211
2020-11-25,honduras,North America,10197959,361,105572
2020-11-26,honduras,North America,10197959,544,106116
2020-11-27,honduras,North America,10197959,565,106681
2020-11-28,honduras,North America,10197959,453,107134
2020-11-29,honduras,North America,10197959,379,107513
2020-11-30,honduras,North America,10197959,375,107888
2020-12-01,honduras,North America,10197959,365,108253
2020-12-02,honduras,North America,10197959,388,108641
2020-12-03,honduras,North America,10197959,503,109144
2020-12-04,honduras,North America,10197959,616,109760
2020-12-05,honduras,North America,10197959,200,109960
2020-12-06,honduras,North America,10197959,763,110723
2020-12-07,honduras,North America,10197959,300,111023
2020-12-08,honduras,North America,10197959,684,111707
2020-12-09,honduras,North America,10197959,468,112175
2020-12-10,honduras,North America,10197959,617,112792
2020-12-11,honduras,North America,10197959,415,113207
2020-12-12,honduras,North America,10197959,501,113708
2020-12-13,honduras,North America,10197959,335,114043
2020-12-14,honduras,North America,10197959,316,114359
2020-12-15,honduras,North America,10197959,283,114642
2020-12-16,honduras,North America,10197959,301,114943
2020-12-17,honduras,North America,10197959,374,115317
2020-12-18,honduras,North America,10197959,157,115474
2020-12-19,honduras,North America,10197959,738,116212
2020-12-20,honduras,North America,10197959,648,116860
2020-12-21,honduras,North America,10197959,162,117022
2020-12-22,honduras,North America,10197959,168,117190
2020-12-23,honduras,North America,10197959,398,117588
2020-12-24,honduras,North America,10197959,448,118036
2020-12-25,honduras,North America,10197959,385,118421
2020-12-26,honduras,North America,10197959,238,118659
2020-12-27,honduras,North America,10197959,438,119097
2020-12-28,honduras,North America,10197959,616,119713
2020-12-29,honduras,North America,10197959,390,120103
2020-12-30,honduras,North America,10197959,809,120912
2020-12-31,honduras,North America,10197959,915,121827
2021-01-01,honduras,North America,10197959,936,122763
2020-03-16,hungary,Europe,9614673,7,39
2020-03-17,hungary,Europe,9614673,11,50
2020-03-18,hungary,Europe,9614673,8,58
2020-03-19,hungary,Europe,9614673,15,73
2020-03-20,hungary,Europe,9614673,12,85
2020-03-21,hungary,Europe,9614673,18,103
2020-03-22,hungary,Europe,9614673,28,131
2020-03-23,hungary,Europe,9614673,36,167
2020-03-24,hungary,Europe,9614673,20,187
2020-03-25,hungary,Europe,9614673,39,226
2020-03-26,hungary,Europe,9614673,35,261
2020-03-27,hungary,Europe,9614673,39,300
2020-03-28,hungary,Europe,9614673,43,343
2020-03-29,hungary,Europe,9614673,65,408
2020-03-30,hungary,Europe,9614673,39,447
2020-03-31,hungary,Europe,9614673,45,492
2020-04-01,hungary,Europe,9614673,33,525
2020-04-02,hungary,Europe,9614673,60,585
2020-04-03,hungary,Europe,9614673,38,623
2020-04-04,hungary,Europe,9614673,55,678
2020-04-05,hungary,Europe,9614673,55,733
2020-04-06,hungary,Europe,9614673,11,744
2020-04-07,hungary,Europe,9614673,73,817
2020-04-08,hungary,Europe,9614673,78,895
2020-04-09,hungary,Europe,9614673,85,980
2020-04-10,hungary,Europe,9614673,210,1190
2020-04-11,hungary,Europe,9614673,120,1310
2020-04-12,hungary,Europe,9614673,100,1410
2020-04-13,hungary,Europe,9614673,48,1458
2020-04-14,hungary,Europe,9614673,54,1512
2020-04-15,hungary,Europe,9614673,67,1579
2020-04-16,hungary,Europe,9614673,73,1652
2020-04-17,hungary,Europe,9614673,111,1763
2020-04-18,hungary,Europe,9614673,71,1834
2020-04-19,hungary,Europe,9614673,82,1916
2020-04-20,hungary,Europe,9614673,68,1984
2020-04-21,hungary,Europe,9614673,114,2098
2020-04-22,hungary,Europe,9614673,70,2168
2020-04-23,hungary,Europe,9614673,116,2284
2020-04-24,hungary,Europe,9614673,99,2383
2020-04-25,hungary,Europe,9614673,60,2443
2020-04-26,hungary,Europe,9614673,57,2500
2020-04-27,hungary,Europe,9614673,83,2583
2020-04-28,hungary,Europe,9614673,66,2649
2020-04-29,hungary,Europe,9614673,78,2727
2020-04-30,hungary,Europe,9614673,48,2775
2020-05-01,hungary,Europe,9614673,88,2863
2020-05-02,hungary,Europe,9614673,79,2942
2020-05-03,hungary,Europe,9614673,56,2998
2020-05-04,hungary,Europe,9614673,37,3035
2020-05-05,hungary,Europe,9614673,30,3065
2020-05-06,hungary,Europe,9614673,46,3111
2020-05-07,hungary,Europe,9614673,39,3150
2020-05-08,hungary,Europe,9614673,28,3178
2020-05-09,hungary,Europe,9614673,35,3213
2020-05-10,hungary,Europe,9614673,50,3263
2020-05-11,hungary,Europe,9614673,21,3284
2020-05-12,hungary,Europe,9614673,29,3313
2020-05-13,hungary,Europe,9614673,28,3341
2020-05-14,hungary,Europe,9614673,39,3380
2020-05-15,hungary,Europe,9614673,37,3417
2020-05-16,hungary,Europe,9614673,56,3473
2020-05-17,hungary,Europe,9614673,36,3509
2020-05-18,hungary,Europe,9614673,26,3535
2020-05-19,hungary,Europe,9614673,21,3556
2020-05-20,hungary,Europe,9614673,42,3598
2020-05-21,hungary,Europe,9614673,43,3641
2020-05-22,hungary,Europe,9614673,37,3678
2020-05-23,hungary,Europe,9614673,35,3713
2020-05-24,hungary,Europe,9614673,28,3741
2020-05-25,hungary,Europe,9614673,15,3756
2020-05-26,hungary,Europe,9614673,15,3771
2020-05-27,hungary,Europe,9614673,22,3793
2020-05-28,hungary,Europe,9614673,23,3816
2020-05-29,hungary,Europe,9614673,25,3841
2020-05-30,hungary,Europe,9614673,26,3867
2020-05-31,hungary,Europe,9614673,9,3876
2020-06-01,hungary,Europe,9614673,16,3892
2020-06-02,hungary,Europe,9614673,29,3921
2020-06-03,hungary,Europe,9614673,10,3931
2020-06-04,hungary,Europe,9614673,23,3954
2020-06-05,hungary,Europe,9614673,16,3970
2020-06-06,hungary,Europe,9614673,20,3990
2020-06-07,hungary,Europe,9614673,18,4008
2020-06-08,hungary,Europe,9614673,6,4014
2020-06-09,hungary,Europe,9614673,3,4017
2020-06-10,hungary,Europe,9614673,10,4027
2020-06-11,hungary,Europe,9614673,12,4039
2020-06-12,hungary,Europe,9614673,14,4053
2020-06-13,hungary,Europe,9614673,11,4064
2020-06-14,hungary,Europe,9614673,5,4069
2020-06-15,hungary,Europe,9614673,7,4076
2020-06-16,hungary,Europe,9614673,1,4077
2020-06-17,hungary,Europe,9614673,1,4078
2020-06-18,hungary,Europe,9614673,1,4079
2020-06-19,hungary,Europe,9614673,2,4081
2020-06-20,hungary,Europe,9614673,5,4086
2020-06-21,hungary,Europe,9614673,8,4094
2020-06-22,hungary,Europe,9614673,8,4102
2020-06-23,hungary,Europe,9614673,5,4107
2020-06-24,hungary,Europe,9614673,7,4114
2020-06-25,hungary,Europe,9614673,9,4123
2020-06-26,hungary,Europe,9614673,4,4127
2020-06-27,hungary,Europe,9614673,11,4138
2020-06-28,hungary,Europe,9614673,4,4142
2020-06-29,hungary,Europe,9614673,3,4145
2020-06-30,hungary,Europe,9614673,10,4155
2020-07-01,hungary,Europe,9614673,2,4157
2020-07-02,hungary,Europe,9614673,9,4166
2020-07-03,hungary,Europe,9614673,6,4172
2020-07-04,hungary,Europe,9614673,2,4174
2020-07-05,hungary,Europe,9614673,9,4183
2020-07-06,hungary,Europe,9614673,6,4189
2020-07-07,hungary,Europe,9614673,16,4205
2020-07-08,hungary,Europe,9614673,5,4210
2020-07-09,hungary,Europe,9614673,10,4220
2020-07-10,hungary,Europe,9614673,3,4223
2020-07-11,hungary,Europe,9614673,6,4229
2020-07-12,hungary,Europe,9614673,5,4234
2020-07-13,hungary,Europe,9614673,13,4247
2020-07-14,hungary,Europe,9614673,11,4258
2020-07-15,hungary,Europe,9614673,5,4263
2020-07-16,hungary,Europe,9614673,16,4279
2020-07-17,hungary,Europe,9614673,14,4293
2020-07-18,hungary,Europe,9614673,22,4315
2020-07-19,hungary,Europe,9614673,18,4333
2020-07-20,hungary,Europe,9614673,6,4339
2020-07-21,hungary,Europe,9614673,8,4347
2020-07-22,hungary,Europe,9614673,19,4366
2020-07-23,hungary,Europe,9614673,14,4380
2020-07-24,hungary,Europe,9614673,18,4398
2020-07-25,hungary,Europe,9614673,26,4424
2020-07-26,hungary,Europe,9614673,11,4435
2020-07-27,hungary,Europe,9614673,13,4448
2020-07-28,hungary,Europe,9614673,8,4456
2020-07-29,hungary,Europe,9614673,9,4465
2020-07-30,hungary,Europe,9614673,19,4484
2020-07-31,hungary,Europe,9614673,21,4505
2020-08-01,hungary,Europe,9614673,21,4526
2020-08-02,hungary,Europe,9614673,9,4535
2020-08-03,hungary,Europe,9614673,9,4544
2020-08-04,hungary,Europe,9614673,9,4553
2020-08-05,hungary,Europe,9614673,11,4564
2020-08-06,hungary,Europe,9614673,33,4597
2020-08-07,hungary,Europe,9614673,24,4621
2020-08-08,hungary,Europe,9614673,32,4653
2020-08-09,hungary,Europe,9614673,43,4696
2020-08-10,hungary,Europe,9614673,35,4731
2020-08-11,hungary,Europe,9614673,15,4746
2020-08-12,hungary,Europe,9614673,22,4768
2020-08-13,hungary,Europe,9614673,45,4813
2020-08-14,hungary,Europe,9614673,40,4853
2020-08-15,hungary,Europe,9614673,24,4877
2020-08-16,hungary,Europe,9614673,39,4916
2020-08-17,hungary,Europe,9614673,30,4946
2020-08-18,hungary,Europe,9614673,24,4970
2020-08-19,hungary,Europe,9614673,32,5002
2020-08-20,hungary,Europe,9614673,44,5046
2020-08-21,hungary,Europe,9614673,52,5098
2020-08-22,hungary,Europe,9614673,35,5133
2020-08-23,hungary,Europe,9614673,22,5155
2020-08-24,hungary,Europe,9614673,36,5191
2020-08-25,hungary,Europe,9614673,24,5215
2020-08-26,hungary,Europe,9614673,73,5288
2020-08-27,hungary,Europe,9614673,91,5379
2020-08-28,hungary,Europe,9614673,132,5511
2020-08-29,hungary,Europe,9614673,158,5669
2020-08-30,hungary,Europe,9614673,292,5961
2020-08-31,hungary,Europe,9614673,178,6139
2020-09-01,hungary,Europe,9614673,118,6257
2020-09-02,hungary,Europe,9614673,365,6622
2020-09-03,hungary,Europe,9614673,301,6923
2020-09-04,hungary,Europe,9614673,459,7382
2020-09-05,hungary,Europe,9614673,510,7892
2020-09-06,hungary,Europe,9614673,495,8387
2020-09-07,hungary,Europe,9614673,576,8963
2020-09-08,hungary,Europe,9614673,341,9304
2020-09-09,hungary,Europe,9614673,411,9715
2020-09-10,hungary,Europe,9614673,476,10191
2020-09-11,hungary,Europe,9614673,718,10909
2020-09-12,hungary,Europe,9614673,916,11825
2020-09-13,hungary,Europe,9614673,484,12309
2020-09-14,hungary,Europe,9614673,844,13153
2020-09-15,hungary,Europe,9614673,726,13879
2020-09-16,hungary,Europe,9614673,581,14460
2020-09-17,hungary,Europe,9614673,710,15170
2020-09-18,hungary,Europe,9614673,941,16111
2020-09-19,hungary,Europe,9614673,809,16920
2020-09-20,hungary,Europe,9614673,1070,17990
2020-09-21,hungary,Europe,9614673,876,18866
2020-09-22,hungary,Europe,9614673,633,19499
2020-09-23,hungary,Europe,9614673,951,20450
2020-09-24,hungary,Europe,9614673,750,21200
2020-09-25,hungary,Europe,9614673,927,22127
2020-09-26,hungary,Europe,9614673,950,23077
2020-09-27,hungary,Europe,9614673,937,24014
2020-09-28,hungary,Europe,9614673,702,24716
2020-09-29,hungary,Europe,9614673,851,25567
2020-09-30,hungary,Europe,9614673,894,26461
2020-10-01,hungary,Europe,9614673,848,27309
2020-10-02,hungary,Europe,9614673,1322,28631
2020-10-03,hungary,Europe,9614673,1086,29717
2020-10-04,hungary,Europe,9614673,858,30575
2020-10-05,hungary,Europe,9614673,905,31480
2020-10-06,hungary,Europe,9614673,818,32298
2020-10-07,hungary,Europe,9614673,816,33114
2020-10-08,hungary,Europe,9614673,932,34046
2020-10-09,hungary,Europe,9614673,1176,35222
2020-10-10,hungary,Europe,9614673,1374,36596
2020-10-11,hungary,Europe,9614673,1068,37664
2020-10-12,hungary,Europe,9614673,1173,38837
2020-10-13,hungary,Europe,9614673,1025,39862
2020-10-14,hungary,Europe,9614673,920,40782
2020-10-15,hungary,Europe,9614673,950,41732
2020-10-16,hungary,Europe,9614673,1293,43025
2020-10-17,hungary,Europe,9614673,1791,44816
2020-10-18,hungary,Europe,9614673,1474,46290
2020-10-19,hungary,Europe,9614673,1478,47768
2020-10-20,hungary,Europe,9614673,989,48757
2020-10-21,hungary,Europe,9614673,1423,50180
2020-10-22,hungary,Europe,9614673,2032,52212
2020-10-23,hungary,Europe,9614673,2066,54278
2020-10-24,hungary,Europe,9614673,1820,56098
2020-10-25,hungary,Europe,9614673,3149,59247
2020-10-26,hungary,Europe,9614673,2316,61563
2020-10-27,hungary,Europe,9614673,2079,63642
2020-10-28,hungary,Europe,9614673,2291,65933
2020-10-29,hungary,Europe,9614673,2194,68127
2020-10-30,hungary,Europe,9614673,3286,71413
2020-10-31,hungary,Europe,9614673,3908,75321
2020-11-01,hungary,Europe,9614673,3878,79199
2020-11-02,hungary,Europe,9614673,3581,82780
2020-11-03,hungary,Europe,9614673,3989,86769
2020-11-04,hungary,Europe,9614673,4219,90988
2020-11-05,hungary,Europe,9614673,3928,94916
2020-11-06,hungary,Europe,9614673,4709,99625
2020-11-07,hungary,Europe,9614673,5318,104943
2020-11-08,hungary,Europe,9614673,4673,109616
2020-11-09,hungary,Europe,9614673,5162,114778
2020-11-10,hungary,Europe,9614673,4140,118918
2020-11-11,hungary,Europe,9614673,3945,122863
2020-11-12,hungary,Europe,9614673,3927,126790
2020-11-13,hungary,Europe,9614673,5097,131887
2020-11-14,hungary,Europe,9614673,4836,136723
2020-11-15,hungary,Europe,9614673,4238,140961
2020-11-16,hungary,Europe,9614673,6495,147456
2020-11-17,hungary,Europe,9614673,5203,152659
2020-11-18,hungary,Europe,9614673,4290,156949
2020-11-19,hungary,Europe,9614673,4512,161461
2020-11-20,hungary,Europe,9614673,4440,165901
2020-11-21,hungary,Europe,9614673,4397,170298
2020-11-22,hungary,Europe,9614673,4320,174618
2020-11-23,hungary,Europe,9614673,3334,177952
2020-11-24,hungary,Europe,9614673,3929,181881
2020-11-25,hungary,Europe,9614673,3806,185687
2020-11-26,hungary,Europe,9614673,6360,192047
2020-11-27,hungary,Europe,9614673,6393,198440
2020-11-28,hungary,Europe,9614673,6268,204708
2020-11-29,hungary,Europe,9614673,6819,211527
2020-11-30,hungary,Europe,9614673,5595,217122
2020-12-01,hungary,Europe,9614673,3951,221073
2020-12-02,hungary,Europe,9614673,4136,225209
2020-12-03,hungary,Europe,9614673,6635,231844
2020-12-04,hungary,Europe,9614673,6212,238056
2020-12-05,hungary,Europe,9614673,5525,243581
2020-12-06,hungary,Europe,9614673,6697,250278
2020-12-07,hungary,Europe,9614673,3870,254148
2020-12-08,hungary,Europe,9614673,2219,256367
2020-12-09,hungary,Europe,9614673,3221,259588
2020-12-10,hungary,Europe,9614673,5415,265003
2020-12-11,hungary,Europe,9614673,6197,271200
2020-12-12,hungary,Europe,9614673,5047,276247
2020-12-13,hungary,Europe,9614673,4153,280400
2020-12-14,hungary,Europe,9614673,3470,283870
2020-12-15,hungary,Europe,9614673,1893,285763
2020-12-16,hungary,Europe,9614673,2804,288567
2020-12-17,hungary,Europe,9614673,2982,291549
2020-12-18,hungary,Europe,9614673,4428,295977
2020-12-19,hungary,Europe,9614673,4045,300022
2020-12-20,hungary,Europe,9614673,2967,302989
2020-12-21,hungary,Europe,9614673,2141,305130
2020-12-22,hungary,Europe,9614673,1238,306368
2020-12-23,hungary,Europe,9614673,1894,308262
2020-12-24,hungary,Europe,9614673,3292,311554
2020-12-25,hungary,Europe,9614673,2610,314164
2020-12-26,hungary,Europe,9614673,1198,315362
2020-12-27,hungary,Europe,9614673,698,316060
2020-12-28,hungary,Europe,9614673,609,316669
2020-12-29,hungary,Europe,9614673,902,317571
2020-12-30,hungary,Europe,9614673,1972,319543
2020-12-31,hungary,Europe,9614673,2971,322514
2021-01-01,hungary,Europe,9614673,2764,325278
2021-01-02,hungary,Europe,9614673,1410,326688
2021-01-03,hungary,Europe,9614673,1307,327995
2021-01-04,hungary,Europe,9614673,856,328851
2021-01-05,hungary,Europe,9614673,870,329721
2021-01-06,hungary,Europe,9614673,2047,331768
2021-01-07,hungary,Europe,9614673,3068,334836
2021-01-08,hungary,Europe,9614673,2907,337743
2021-01-09,hungary,Europe,9614673,2716,340459
2021-01-10,hungary,Europe,9614673,1778,342237
2021-01-11,hungary,Europe,9614673,1419,343656
2021-01-12,hungary,Europe,9614673,696,344352
2021-01-13,hungary,Europe,9614673,1358,345710
2021-01-14,hungary,Europe,9614673,1926,347636
2021-01-15,hungary,Europe,9614673,1513,349149
2021-01-16,hungary,Europe,9614673,1438,350587
2021-01-17,hungary,Europe,9614673,1241,351828
2021-01-18,hungary,Europe,9614673,875,352703
2021-01-19,hungary,Europe,9614673,573,353276
2021-01-20,hungary,Europe,9614673,976,354252
2021-01-21,hungary,Europe,9614673,1410,355662
2021-01-22,hungary,Europe,9614673,1311,356973
2021-01-23,hungary,Europe,9614673,1344,358317
2021-01-24,hungary,Europe,9614673,1257,359574
2021-01-25,hungary,Europe,9614673,844,360418
2021-01-26,hungary,Europe,9614673,459,360877
2021-01-27,hungary,Europe,9614673,1004,361881
2021-01-28,hungary,Europe,9614673,1569,363450
2021-01-29,hungary,Europe,9614673,1459,364909
2021-01-30,hungary,Europe,9614673,1370,366279
2021-01-31,hungary,Europe,9614673,1307,367586
2021-02-01,hungary,Europe,9614673,1124,368710
2021-02-02,hungary,Europe,9614673,578,369288
2021-02-03,hungary,Europe,9614673,1048,370336
2021-02-04,hungary,Europe,9614673,1652,371988
2021-02-05,hungary,Europe,9614673,1576,373564
2021-02-06,hungary,Europe,9614673,1561,375125
2021-02-07,hungary,Europe,9614673,1370,376495
2021-02-08,hungary,Europe,9614673,1160,377655
2021-02-09,hungary,Europe,9614673,1079,378734
2021-02-10,hungary,Europe,9614673,1279,380013
2021-02-11,hungary,Europe,9614673,1862,381875
2021-02-12,hungary,Europe,9614673,1860,383735
2021-02-13,hungary,Europe,9614673,2020,385755
2021-02-14,hungary,Europe,9614673,1707,387462
2021-02-15,hungary,Europe,9614673,1337,388799
2021-02-16,hungary,Europe,9614673,823,389622
2021-02-17,hungary,Europe,9614673,1548,391170
2021-02-18,hungary,Europe,9614673,2853,394023
2021-02-19,hungary,Europe,9614673,3093,397116
2021-02-20,hungary,Europe,9614673,2995,400111
2021-02-21,hungary,Europe,9614673,2912,403023
2021-02-22,hungary,Europe,9614673,2623,405646
2021-02-23,hungary,Europe,9614673,1628,407274
2021-02-24,hungary,Europe,9614673,2855,410129
2021-02-25,hungary,Europe,9614673,4385,414514
2021-02-26,hungary,Europe,9614673,4668,419182
2021-02-27,hungary,Europe,9614673,4948,424130
2021-02-28,hungary,Europe,9614673,4469,428599
2021-03-01,hungary,Europe,9614673,4326,432925
2021-03-02,hungary,Europe,9614673,2764,435689
2021-03-03,hungary,Europe,9614673,4211,439900
2021-03-04,hungary,Europe,9614673,6278,446178
2021-03-05,hungary,Europe,9614673,6369,452547
2021-03-06,hungary,Europe,9614673,7269,459816
2021-03-07,hungary,Europe,9614673,6201,466017
2021-03-08,hungary,Europe,9614673,2696,468713
2021-03-09,hungary,Europe,9614673,6494,475207
2021-03-10,hungary,Europe,9614673,5653,480860
2021-03-11,hungary,Europe,9614673,8312,489172
2021-03-12,hungary,Europe,9614673,9011,498183
2021-03-13,hungary,Europe,9614673,9444,507627
2021-03-14,hungary,Europe,9614673,8863,516490
2021-03-15,hungary,Europe,9614673,7706,524196
2021-03-16,hungary,Europe,9614673,4926,529122
2021-03-17,hungary,Europe,9614673,3456,532578
2021-03-18,hungary,Europe,9614673,6502,539080
2021-03-19,hungary,Europe,9614673,10759,549839
2021-03-20,hungary,Europe,9614673,11132,560971
2021-03-21,hungary,Europe,9614673,10625,571596
2021-03-22,hungary,Europe,9614673,9046,580642
2021-03-23,hungary,Europe,9614673,5481,586123
2021-03-24,hungary,Europe,9614673,7587,593710
2021-03-25,hungary,Europe,9614673,9637,603347
2021-03-26,hungary,Europe,9614673,11265,614612
2021-03-27,hungary,Europe,9614673,10167,624779
2021-03-28,hungary,Europe,9614673,9082,633861
2021-03-29,hungary,Europe,9614673,7263,641124
2021-03-30,hungary,Europe,9614673,4609,645733
2021-03-31,hungary,Europe,9614673,6700,652433
2021-04-01,hungary,Europe,9614673,9288,661721
2021-04-02,hungary,Europe,9614673,9055,670776
2021-04-03,hungary,Europe,9614673,8637,679413
2021-04-04,hungary,Europe,9614673,6566,685979
2021-04-05,hungary,Europe,9614673,3874,689853
2021-04-06,hungary,Europe,9614673,1890,691743
2021-04-07,hungary,Europe,9614673,1933,693676
2021-04-08,hungary,Europe,9614673,4814,698490
2021-04-09,hungary,Europe,9614673,7325,705815
2021-04-10,hungary,Europe,9614673,8053,713868
2021-04-11,hungary,Europe,9614673,6296,720164
2021-04-12,hungary,Europe,9614673,5077,725241
2021-04-13,hungary,Europe,9614673,2837,728078
2021-04-14,hungary,Europe,9614673,3597,731675
2021-04-15,hungary,Europe,9614673,5307,736982
2021-04-16,hungary,Europe,9614673,5216,742198
2021-04-17,hungary,Europe,9614673,4604,746802
2021-04-18,hungary,Europe,9614673,3706,750508
2021-04-19,hungary,Europe,9614673,2680,753188
2021-04-20,hungary,Europe,9614673,1645,754833
2021-04-21,hungary,Europe,9614673,2527,757360
2021-04-22,hungary,Europe,9614673,3607,760967
2021-04-23,hungary,Europe,9614673,3427,764394
2021-04-24,hungary,Europe,9614673,2796,767190
2021-04-25,hungary,Europe,9614673,2328,769518
2021-04-26,hungary,Europe,9614673,1936,771454
2021-04-27,hungary,Europe,9614673,1253,772707
2021-04-28,hungary,Europe,9614673,1692,774399
2021-04-29,hungary,Europe,9614673,2584,776983
2021-04-30,hungary,Europe,9614673,2365,779348
2021-05-01,hungary,Europe,9614673,1951,781299
2021-05-02,hungary,Europe,9614673,1593,782892
2021-05-03,hungary,Europe,9614673,1219,784111
2021-05-04,hungary,Europe,9614673,726,784837
2021-05-05,hungary,Europe,9614673,1130,785967
2021-05-06,hungary,Europe,9614673,1680,787647
2021-05-07,hungary,Europe,9614673,1541,789188
2021-05-08,hungary,Europe,9614673,1376,790564
2021-05-09,hungary,Europe,9614673,1145,791709
2021-05-10,hungary,Europe,9614673,677,792386
2021-05-11,hungary,Europe,9614673,493,792879
2021-05-12,hungary,Europe,9614673,905,793784
2021-05-13,hungary,Europe,9614673,1416,795200
2021-05-14,hungary,Europe,9614673,1190,796390
2021-05-15,hungary,Europe,9614673,1039,797429
2021-05-16,hungary,Europe,9614673,718,798147
2021-05-17,hungary,Europe,9614673,426,798573
2021-05-18,hungary,Europe,9614673,382,798955
2021-05-19,hungary,Europe,9614673,633,799588
2021-05-20,hungary,Europe,9614673,780,800368
2021-05-21,hungary,Europe,9614673,657,801025
2021-05-22,hungary,Europe,9614673,647,801672
2021-05-23,hungary,Europe,9614673,416,802088
2021-05-24,hungary,Europe,9614673,258,802346
2021-05-25,hungary,Europe,9614673,164,802510
2021-05-26,hungary,Europe,9614673,213,802723
2021-05-27,hungary,Europe,9614673,396,803119
2021-05-28,hungary,Europe,9614673,448,803567
2021-05-29,hungary,Europe,9614673,465,804032
2021-05-30,hungary,Europe,9614673,350,804382
2021-05-31,hungary,Europe,9614673,156,804538
2021-06-01,hungary,Europe,9614673,174,804712
2021-06-02,hungary,Europe,9614673,275,804987
2021-06-03,hungary,Europe,9614673,315,805302
2021-06-04,hungary,Europe,9614673,269,805571
2021-06-05,hungary,Europe,9614673,300,805871
2021-06-06,hungary,Europe,9614673,137,806008
2021-06-07,hungary,Europe,9614673,81,806089
2021-06-08,hungary,Europe,9614673,117,806206
2021-06-09,hungary,Europe,9614673,179,806385
2021-06-10,hungary,Europe,9614673,206,806591
2021-06-11,hungary,Europe,9614673,199,806790
2021-06-12,hungary,Europe,9614673,0,806790
2021-06-13,hungary,Europe,9614673,0,806790
2021-06-14,hungary,Europe,9614673,255,807045
2021-06-15,hungary,Europe,9614673,57,807102
2021-06-16,hungary,Europe,9614673,107,807209
2021-06-17,hungary,Europe,9614673,113,807322
2021-06-18,hungary,Europe,9614673,106,807428
2021-06-19,hungary,Europe,9614673,0,807428
2021-06-20,hungary,Europe,9614673,0,807428
2021-06-21,hungary,Europe,9614673,202,807630
2021-06-22,hungary,Europe,9614673,54,807684
2021-06-23,hungary,Europe,9614673,91,807775
2021-06-24,hungary,Europe,9614673,69,807844
2021-06-25,hungary,Europe,9614673,66,807910
2021-06-26,hungary,Europe,9614673,0,807910
2021-06-27,hungary,Europe,9614673,0,807910
2021-06-28,hungary,Europe,9614673,132,808042
2021-06-29,hungary,Europe,9614673,34,808076
2021-06-30,hungary,Europe,9614673,52,808128
2021-07-01,hungary,Europe,9614673,32,808160
2021-07-02,hungary,Europe,9614673,37,808197
2021-07-03,hungary,Europe,9614673,0,808197
2021-07-04,hungary,Europe,9614673,0,808197
2021-07-05,hungary,Europe,9614673,65,808262
2021-07-06,hungary,Europe,9614673,32,808294
2021-07-07,hungary,Europe,9614673,44,808338
2021-07-08,hungary,Europe,9614673,55,808393
2021-07-09,hungary,Europe,9614673,44,808437
2021-07-10,hungary,Europe,9614673,0,808437
2021-07-11,hungary,Europe,9614673,0,808437
2021-07-12,hungary,Europe,9614673,102,808539
2021-07-13,hungary,Europe,9614673,17,808556
2021-07-14,hungary,Europe,9614673,56,808612
2021-07-15,hungary,Europe,9614673,49,808661
2021-07-16,hungary,Europe,9614673,64,808725
2021-07-17,hungary,Europe,9614673,0,808725
2021-07-18,hungary,Europe,9614673,0,808725
2021-07-19,hungary,Europe,9614673,139,808864
2021-07-20,hungary,Europe,9614673,25,808889
2021-07-21,hungary,Europe,9614673,56,808945
2021-07-22,hungary,Europe,9614673,71,809016
2021-07-23,hungary,Europe,9614673,85,809101
2021-07-24,hungary,Europe,9614673,0,809101
2021-07-25,hungary,Europe,9614673,0,809101
2021-07-26,hungary,Europe,9614673,161,809262
2021-07-27,hungary,Europe,9614673,26,809288
2021-07-28,hungary,Europe,9614673,74,809362
2021-07-29,hungary,Europe,9614673,65,809427
2021-07-30,hungary,Europe,9614673,64,809491
2020-02-20,india,Asia,1405273033,0,3
2020-02-21,india,Asia,1405273033,0,3
2020-02-22,india,Asia,1405273033,0,3
2020-02-23,india,Asia,1405273033,0,3
2020-02-24,india,Asia,1405273033,0,3
2020-02-25,india,Asia,1405273033,0,3
2020-02-26,india,Asia,1405273033,0,3
2020-02-27,india,Asia,1405273033,0,3
2020-02-28,india,Asia,1405273033,0,3
2020-02-29,india,Asia,1405273033,0,3
2020-03-01,india,Asia,1405273033,0,3
2020-03-02,india,Asia,1405273033,3,6
2020-03-03,india,Asia,1405273033,1,7
2020-03-04,india,Asia,1405273033,22,29
2020-03-05,india,Asia,1405273033,1,30
2020-03-06,india,Asia,1405273033,1,31
2020-03-07,india,Asia,1405273033,3,34
2020-03-08,india,Asia,1405273033,6,40
2020-03-09,india,Asia,1405273033,7,47
2020-03-10,india,Asia,1405273033,15,62
2020-03-11,india,Asia,1405273033,0,62
2020-03-12,india,Asia,1405273033,12,74
2020-03-13,india,Asia,1405273033,8,82
2020-03-14,india,Asia,1405273033,18,100
2020-03-15,india,Asia,1405273033,14,114
2020-03-16,india,Asia,1405273033,15,129
2020-03-17,india,Asia,1405273033,14,143
2020-03-18,india,Asia,1405273033,26,169
2020-03-19,india,Asia,1405273033,25,194
2020-03-20,india,Asia,1405273033,55,249
2020-03-21,india,Asia,1405273033,83,332
2020-03-22,india,Asia,1405273033,64,396
2020-03-23,india,Asia,1405273033,103,499
2020-03-24,india,Asia,1405273033,37,536
2020-03-25,india,Asia,1405273033,121,657
2020-03-26,india,Asia,1405273033,70,727
2020-03-27,india,Asia,1405273033,160,887
2020-03-28,india,Asia,1405273033,100,987
2020-03-29,india,Asia,1405273033,37,1024
2020-03-30,india,Asia,1405273033,227,1251
2020-03-31,india,Asia,1405273033,146,1397
2020-04-01,india,Asia,1405273033,601,1998
2020-04-02,india,Asia,1405273033,545,2543
2020-04-03,india,Asia,1405273033,516,3059
2020-04-04,india,Asia,1405273033,529,3588
2020-04-05,india,Asia,1405273033,701,4289
2020-04-06,india,Asia,1405273033,489,4778
2020-04-07,india,Asia,1405273033,573,5351
2020-04-08,india,Asia,1405273033,565,5916
2020-04-09,india,Asia,1405273033,809,6725
2020-04-10,india,Asia,1405273033,875,7600
2020-04-11,india,Asia,1405273033,846,8446
2020-04-12,india,Asia,1405273033,759,9205
2020-04-13,india,Asia,1405273033,1248,10453
2020-04-14,india,Asia,1405273033,1034,11487
2020-04-15,india,Asia,1405273033,883,12370
2020-04-16,india,Asia,1405273033,1060,13430
2020-04-17,india,Asia,1405273033,922,14352
2020-04-18,india,Asia,1405273033,2013,16365
2020-04-19,india,Asia,1405273033,1250,17615
2020-04-20,india,Asia,1405273033,924,18539
2020-04-21,india,Asia,1405273033,1541,20080
2020-04-22,india,Asia,1405273033,1290,21370
2020-04-23,india,Asia,1405273033,1669,23039
2020-04-24,india,Asia,1405273033,1408,24447
2020-04-25,india,Asia,1405273033,1836,26283
2020-04-26,india,Asia,1405273033,1607,27890
2020-04-27,india,Asia,1405273033,1561,29451
2020-04-28,india,Asia,1405273033,1873,31324
2020-04-29,india,Asia,1405273033,1738,33062
2020-04-30,india,Asia,1405273033,1801,34863
2020-05-01,india,Asia,1405273033,2394,37257
2020-05-02,india,Asia,1405273033,2442,39699
2020-05-03,india,Asia,1405273033,2806,42505
2020-05-04,india,Asia,1405273033,3932,46437
2020-05-05,india,Asia,1405273033,2963,49400
2020-05-06,india,Asia,1405273033,3587,52987
2020-05-07,india,Asia,1405273033,3364,56351
2020-05-08,india,Asia,1405273033,3344,59695
2020-05-09,india,Asia,1405273033,3113,62808
2020-05-10,india,Asia,1405273033,4353,67161
2020-05-11,india,Asia,1405273033,3607,70768
2020-05-12,india,Asia,1405273033,3524,74292
2020-05-13,india,Asia,1405273033,3763,78055
2020-05-14,india,Asia,1405273033,3942,81997
2020-05-15,india,Asia,1405273033,3787,85784
2020-05-16,india,Asia,1405273033,4864,90648
2020-05-17,india,Asia,1405273033,5050,95698
2020-05-18,india,Asia,1405273033,4630,100328
2020-05-19,india,Asia,1405273033,6147,106475
2020-05-20,india,Asia,1405273033,5553,112028
2020-05-21,india,Asia,1405273033,6198,118226
2020-05-22,india,Asia,1405273033,6568,124794
2020-05-23,india,Asia,1405273033,6629,131423
2020-05-24,india,Asia,1405273033,7113,138536
2020-05-25,india,Asia,1405273033,6414,144950
2020-05-26,india,Asia,1405273033,5843,150793
2020-05-27,india,Asia,1405273033,7293,158086
2020-05-28,india,Asia,1405273033,7300,165386
2020-05-29,india,Asia,1405273033,8105,173491
2020-05-30,india,Asia,1405273033,8336,181827
2020-05-31,india,Asia,1405273033,8782,190609
2020-06-01,india,Asia,1405273033,7761,198370
2020-06-02,india,Asia,1405273033,8821,207191
2020-06-03,india,Asia,1405273033,9633,216824
2020-06-04,india,Asia,1405273033,9889,226713
2020-06-05,india,Asia,1405273033,9471,236184
2020-06-06,india,Asia,1405273033,10438,246622
2020-06-07,india,Asia,1405273033,10864,257486
2020-06-08,india,Asia,1405273033,8442,265928
2020-06-09,india,Asia,1405273033,8852,274780
2020-06-10,india,Asia,1405273033,12375,287155
2020-06-11,india,Asia,1405273033,11128,298283
2020-06-12,india,Asia,1405273033,11320,309603
2020-06-13,india,Asia,1405273033,12023,321626
2020-06-14,india,Asia,1405273033,11157,332783
2020-06-15,india,Asia,1405273033,10243,343026
2020-06-16,india,Asia,1405273033,11135,354161
2020-06-17,india,Asia,1405273033,13103,367264
2020-06-18,india,Asia,1405273033,13827,381091
2020-06-19,india,Asia,1405273033,14721,395812
2020-06-20,india,Asia,1405273033,15915,411727
2020-06-21,india,Asia,1405273033,15183,426910
2020-06-22,india,Asia,1405273033,13540,440450
2020-06-23,india,Asia,1405273033,15665,456115
2020-06-24,india,Asia,1405273033,16870,472985
2020-06-25,india,Asia,1405273033,18185,491170
2020-06-26,india,Asia,1405273033,18276,509446
2020-06-27,india,Asia,1405273033,20131,529577
2020-06-28,india,Asia,1405273033,19620,549197
2020-06-29,india,Asia,1405273033,18339,567536
2020-06-30,india,Asia,1405273033,18256,585792
2020-07-01,india,Asia,1405273033,19428,605220
2020-07-02,india,Asia,1405273033,21948,627168
2020-07-03,india,Asia,1405273033,22721,649889
2020-07-04,india,Asia,1405273033,24015,673904
2020-07-05,india,Asia,1405273033,23932,697836
2020-07-06,india,Asia,1405273033,22510,720346
2020-07-07,india,Asia,1405273033,23135,743481
2020-07-08,india,Asia,1405273033,25571,769052
2020-07-09,india,Asia,1405273033,25790,794842
2020-07-10,india,Asia,1405273033,27761,822603
2020-07-11,india,Asia,1405273033,27755,850358
2020-07-12,india,Asia,1405273033,29108,879466
2020-07-13,india,Asia,1405273033,28179,907645
2020-07-14,india,Asia,1405273033,29842,937487
2020-07-15,india,Asia,1405273033,32682,970169
2020-07-16,india,Asia,1405273033,35468,1005637
2020-07-17,india,Asia,1405273033,34820,1040457
2020-07-18,india,Asia,1405273033,37407,1077864
2020-07-19,india,Asia,1405273033,40243,1118107
2020-07-20,india,Asia,1405273033,36810,1154917
2020-07-21,india,Asia,1405273033,39168,1194085
2020-07-22,india,Asia,1405273033,45599,1239684
2020-07-23,india,Asia,1405273033,48446,1288130
2020-07-24,india,Asia,1405273033,48892,1337022
2020-07-25,india,Asia,1405273033,48472,1385494
2020-07-26,india,Asia,1405273033,50525,1436019
2020-07-27,india,Asia,1405273033,46484,1482503
2020-07-28,india,Asia,1405273033,49632,1532135
2020-07-29,india,Asia,1405273033,52249,1584384
2020-07-30,india,Asia,1405273033,54966,1639350
2020-07-31,india,Asia,1405273033,57704,1697054
2020-08-01,india,Asia,1405273033,54865,1751919
2020-08-02,india,Asia,1405273033,52783,1804702
2020-08-03,india,Asia,1405273033,50629,1855331
2020-08-04,india,Asia,1405273033,51282,1906613
2020-08-05,india,Asia,1405273033,56626,1963239
2020-08-06,india,Asia,1405273033,62170,2025409
2020-08-07,india,Asia,1405273033,61455,2086864
2020-08-08,india,Asia,1405273033,65156,2152020
2020-08-09,india,Asia,1405273033,62117,2214137
2020-08-10,india,Asia,1405273033,53016,2267153
2020-08-11,india,Asia,1405273033,61252,2328405
2020-08-12,india,Asia,1405273033,67066,2395471
2020-08-13,india,Asia,1405273033,64142,2459613
2020-08-14,india,Asia,1405273033,65609,2525222
2020-08-15,india,Asia,1405273033,63986,2589208
2020-08-16,india,Asia,1405273033,58108,2647316
2020-08-17,india,Asia,1405273033,54288,2701604
2020-08-18,india,Asia,1405273033,65022,2766626
2020-08-19,india,Asia,1405273033,69196,2835822
2020-08-20,india,Asia,1405273033,68507,2904329
2020-08-21,india,Asia,1405273033,69039,2973368
2020-08-22,india,Asia,1405273033,70068,3043436
2020-08-23,india,Asia,1405273033,61749,3105185
2020-08-24,india,Asia,1405273033,59696,3164881
2020-08-25,india,Asia,1405273033,66873,3231754
2020-08-26,india,Asia,1405273033,75995,3307749
2020-08-27,india,Asia,1405273033,76826,3384575
2020-08-28,india,Asia,1405273033,76665,3461240
2020-08-29,india,Asia,1405273033,78472,3539712
2020-08-30,india,Asia,1405273033,79457,3619169
2020-08-31,india,Asia,1405273033,68770,3687939
2020-09-01,india,Asia,1405273033,78169,3766108
2020-09-02,india,Asia,1405273033,82860,3848968
2020-09-03,india,Asia,1405273033,84156,3933124
2020-09-04,india,Asia,1405273033,87115,4020239
2020-09-05,india,Asia,1405273033,90600,4110839
2020-09-06,india,Asia,1405273033,91723,4202562
2020-09-07,india,Asia,1405273033,75022,4277584
2020-09-08,india,Asia,1405273033,89852,4367436
2020-09-09,india,Asia,1405273033,95529,4462965
2020-09-10,india,Asia,1405273033,96760,4559725
2020-09-11,india,Asia,1405273033,97654,4657379
2020-09-12,india,Asia,1405273033,94409,4751788
2020-09-13,india,Asia,1405273033,93215,4845003
2020-09-14,india,Asia,1405273033,81911,4926914
2020-09-15,india,Asia,1405273033,91120,5018034
2020-09-16,india,Asia,1405273033,97859,5115893
2020-09-17,india,Asia,1405273033,96793,5212686
2020-09-18,india,Asia,1405273033,92789,5305475
2020-09-19,india,Asia,1405273033,92755,5398230
2020-09-20,india,Asia,1405273033,87382,5485612
2020-09-21,india,Asia,1405273033,74493,5560105
2020-09-22,india,Asia,1405273033,80391,5640496
2020-09-23,india,Asia,1405273033,89688,5730184
2020-09-24,india,Asia,1405273033,85919,5816103
2020-09-25,india,Asia,1405273033,85468,5901571
2020-09-26,india,Asia,1405273033,89010,5990581
2020-09-27,india,Asia,1405273033,82767,6073348
2020-09-28,india,Asia,1405273033,69671,6143019
2020-09-29,india,Asia,1405273033,80500,6223519
2020-09-30,india,Asia,1405273033,86748,6310267
2020-10-01,india,Asia,1405273033,81693,6391960
2020-10-02,india,Asia,1405273033,79974,6471934
2020-10-03,india,Asia,1405273033,75479,6547413
2020-10-04,india,Asia,1405273033,74767,6622180
2020-10-05,india,Asia,1405273033,59893,6682073
2020-10-06,india,Asia,1405273033,72106,6754179
2020-10-07,india,Asia,1405273033,78809,6832988
2020-10-08,india,Asia,1405273033,70824,6903812
2020-10-09,india,Asia,1405273033,73196,6977008
2020-10-10,india,Asia,1405273033,74535,7051543
2020-10-11,india,Asia,1405273033,67757,7119300
2020-10-12,india,Asia,1405273033,54265,7173565
2020-10-13,india,Asia,1405273033,63517,7237082
2020-10-14,india,Asia,1405273033,67988,7305070
2020-10-15,india,Asia,1405273033,60439,7365509
2020-10-16,india,Asia,1405273033,65126,7430635
2020-10-17,india,Asia,1405273033,62092,7492727
2020-10-18,india,Asia,1405273033,55511,7548238
2020-10-19,india,Asia,1405273033,46498,7594736
2020-10-20,india,Asia,1405273033,54422,7649158
2020-10-21,india,Asia,1405273033,56000,7705158
2020-10-22,india,Asia,1405273033,54482,7759640
2020-10-23,india,Asia,1405273033,54028,7813668
2020-10-24,india,Asia,1405273033,50224,7863892
2020-10-25,india,Asia,1405273033,45158,7909050
2020-10-26,india,Asia,1405273033,36838,7945888
2020-10-27,india,Asia,1405273033,42965,7988853
2020-10-28,india,Asia,1405273033,49912,8038765
2020-10-29,india,Asia,1405273033,49281,8088046
2020-10-30,india,Asia,1405273033,48120,8136166
2020-10-31,india,Asia,1405273033,46715,8182881
2020-11-01,india,Asia,1405273033,46441,8229322
2020-11-02,india,Asia,1405273033,37592,8266914
2020-11-03,india,Asia,1405273033,46033,8312947
2020-11-04,india,Asia,1405273033,50465,8363412
2020-11-05,india,Asia,1405273033,47622,8411034
2020-11-06,india,Asia,1405273033,49851,8460885
2020-11-07,india,Asia,1405273033,46318,8507203
2020-11-08,india,Asia,1405273033,46661,8553864
2020-11-09,india,Asia,1405273033,37211,8591075
2020-11-10,india,Asia,1405273033,44679,8635754
2020-11-11,india,Asia,1405273033,48285,8684039
2020-11-12,india,Asia,1405273033,43861,8727900
2020-11-13,india,Asia,1405273033,45343,8773243
2020-11-14,india,Asia,1405273033,41659,8814902
2020-11-15,india,Asia,1405273033,30715,8845617
2020-11-16,india,Asia,1405273033,28555,8874172
2020-11-17,india,Asia,1405273033,38532,8912704
2020-11-18,india,Asia,1405273033,45439,8958143
2020-11-19,india,Asia,1405273033,46182,9004325
2020-11-20,india,Asia,1405273033,46288,9050613
2020-11-21,india,Asia,1405273033,45295,9095908
2020-11-22,india,Asia,1405273033,44404,9140312
2020-11-23,india,Asia,1405273033,37410,9177722
2020-11-24,india,Asia,1405273033,44276,9221998
2020-11-25,india,Asia,1405273033,44699,9266697
2020-11-26,india,Asia,1405273033,43174,9309871
2020-11-27,india,Asia,1405273033,41353,9351224
2020-11-28,india,Asia,1405273033,41815,9393039
2020-11-29,india,Asia,1405273033,39036,9432075
2020-11-30,india,Asia,1405273033,31179,9463254
2020-12-01,india,Asia,1405273033,36456,9499710
2020-12-02,india,Asia,1405273033,33761,9533471
2020-12-03,india,Asia,1405273033,38309,9571780
2020-12-04,india,Asia,1405273033,36638,9608418
2020-12-05,india,Asia,1405273033,36111,9644529
2020-12-06,india,Asia,1405273033,32272,9676801
2020-12-07,india,Asia,1405273033,27107,9703908
2020-12-08,india,Asia,1405273033,32067,9735975
2020-12-09,india,Asia,1405273033,26351,9762326
2020-12-10,india,Asia,1405273033,34666,9796992
2020-12-11,india,Asia,1405273033,30034,9827026
2020-12-12,india,Asia,1405273033,30354,9857380
2020-12-13,india,Asia,1405273033,27336,9884716
2020-12-14,india,Asia,1405273033,21791,9906507
2020-12-15,india,Asia,1405273033,26401,9932908
2020-12-16,india,Asia,1405273033,18164,9951072
2020-12-17,india,Asia,1405273033,26762,9977834
2020-12-18,india,Asia,1405273033,26991,10004825
2020-12-19,india,Asia,1405273033,26834,10031659
2020-12-20,india,Asia,1405273033,24589,10056248
2020-12-21,india,Asia,1405273033,19174,10075422
2020-12-22,india,Asia,1405273033,23886,10099308
2020-12-23,india,Asia,1405273033,24236,10123544
2020-12-24,india,Asia,1405273033,23924,10147468
2020-12-25,india,Asia,1405273033,22350,10169818
2020-12-26,india,Asia,1405273033,18574,10188392
2020-12-27,india,Asia,1405273033,20333,10208725
2020-12-28,india,Asia,1405273033,16072,10224797
2020-12-29,india,Asia,1405273033,20529,10245326
2020-12-30,india,Asia,1405273033,21957,10267283
2020-12-31,india,Asia,1405273033,19046,10286329
2021-01-01,india,Asia,1405273033,17080,10303409
2021-01-02,india,Asia,1405273033,21222,10324631
2021-01-03,india,Asia,1405273033,16660,10341291
2021-01-04,india,Asia,1405273033,16278,10357569
2021-01-05,india,Asia,1405273033,17909,10375478
2021-01-06,india,Asia,1405273033,20460,10395938
2021-01-07,india,Asia,1405273033,18106,10414044
2021-01-08,india,Asia,1405273033,18482,10432526
2021-01-09,india,Asia,1405273033,18820,10451346
2021-01-10,india,Asia,1405273033,16085,10467431
2021-01-11,india,Asia,1405273033,12482,10479913
2021-01-12,india,Asia,1405273033,15903,10495816
2021-01-13,india,Asia,1405273033,17015,10512831
2021-01-14,india,Asia,1405273033,15677,10528508
2021-01-15,india,Asia,1405273033,15151,10543659
2021-01-16,india,Asia,1405273033,15051,10558710
2021-01-17,india,Asia,1405273033,13962,10572672
2021-01-18,india,Asia,1405273033,9975,10582647
2021-01-19,india,Asia,1405273033,13795,10596442
2021-01-20,india,Asia,1405273033,15277,10611719
2021-01-21,india,Asia,1405273033,14481,10626200
2021-01-22,india,Asia,1405273033,14344,10640544
2021-01-23,india,Asia,1405273033,14891,10655435
2021-01-24,india,Asia,1405273033,13239,10668674
2021-01-25,india,Asia,1405273033,9036,10677710
2021-01-26,india,Asia,1405273033,12569,10690279
2021-01-27,india,Asia,1405273033,11752,10702031
2021-01-28,india,Asia,1405273033,18940,10720971
2021-01-29,india,Asia,1405273033,13055,10734026
2021-01-30,india,Asia,1405273033,13065,10747091
2021-01-31,india,Asia,1405273033,11528,10758619
2021-02-01,india,Asia,1405273033,8587,10767206
2021-02-02,india,Asia,1405273033,11000,10778206
2021-02-03,india,Asia,1405273033,12917,10791123
2021-02-04,india,Asia,1405273033,12410,10803533
2021-02-05,india,Asia,1405273033,11689,10815222
2021-02-06,india,Asia,1405273033,11948,10827170
2021-02-07,india,Asia,1405273033,11673,10838843
2021-02-08,india,Asia,1405273033,8947,10847790
2021-02-09,india,Asia,1405273033,10510,10858300
2021-02-10,india,Asia,1405273033,12760,10871060
2021-02-11,india,Asia,1405273033,9353,10880413
2021-02-12,india,Asia,1405273033,12137,10892550
2021-02-13,india,Asia,1405273033,12188,10904738
2021-02-14,india,Asia,1405273033,11434,10916172
2021-02-15,india,Asia,1405273033,9139,10925311
2021-02-16,india,Asia,1405273033,11795,10937106
2021-02-17,india,Asia,1405273033,12440,10949546
2021-02-18,india,Asia,1405273033,12643,10962189
2021-02-19,india,Asia,1405273033,14587,10976776
2021-02-20,india,Asia,1405273033,14315,10991091
2021-02-21,india,Asia,1405273033,13980,11005071
2021-02-22,india,Asia,1405273033,10792,11015863
2021-02-23,india,Asia,1405273033,13463,11029326
2021-02-24,india,Asia,1405273033,17144,11046470
2021-02-25,india,Asia,1405273033,16568,11063038
2021-02-26,india,Asia,1405273033,16056,11079094
2021-02-27,india,Asia,1405273033,17346,11096440
2021-02-28,india,Asia,1405273033,15616,11112056
2021-03-01,india,Asia,1405273033,11563,11123619
2021-03-02,india,Asia,1405273033,15704,11139323
2021-03-03,india,Asia,1405273033,17425,11156748
2021-03-04,india,Asia,1405273033,16824,11173572
2021-03-05,india,Asia,1405273033,18292,11191864
2021-03-06,india,Asia,1405273033,18716,11210580
2021-03-07,india,Asia,1405273033,18691,11229271
2021-03-08,india,Asia,1405273033,15353,11244624
2021-03-09,india,Asia,1405273033,16846,11261470
2021-03-10,india,Asia,1405273033,22841,11284311
2021-03-11,india,Asia,1405273033,21668,11305979
2021-03-12,india,Asia,1405273033,27512,11333491
2021-03-13,india,Asia,1405273033,25153,11358644
2021-03-14,india,Asia,1405273033,26514,11385158
2021-03-15,india,Asia,1405273033,24437,11409595
2021-03-16,india,Asia,1405273033,28869,11438464
2021-03-17,india,Asia,1405273033,35838,11474302
2021-03-18,india,Asia,1405273033,39643,11513945
2021-03-19,india,Asia,1405273033,40950,11554895
2021-03-20,india,Asia,1405273033,43815,11598710
2021-03-21,india,Asia,1405273033,47009,11645719
2021-03-22,india,Asia,1405273033,40611,11686330
2021-03-23,india,Asia,1405273033,47264,11733594
2021-03-24,india,Asia,1405273033,53419,11787013
2021-03-25,india,Asia,1405273033,59069,11846082
2021-03-26,india,Asia,1405273033,62291,11908373
2021-03-27,india,Asia,1405273033,62631,11971004
2021-03-28,india,Asia,1405273033,68206,12039210
2021-03-29,india,Asia,1405273033,56119,12095329
2021-03-30,india,Asia,1405273033,53158,12148487
2021-03-31,india,Asia,1405273033,72182,12220669
2021-04-01,india,Asia,1405273033,81441,12302110
2021-04-02,india,Asia,1405273033,89019,12391129
2021-04-03,india,Asia,1405273033,92998,12484127
2021-04-04,india,Asia,1405273033,103793,12587920
2021-04-05,india,Asia,1405273033,96557,12684477
2021-04-06,india,Asia,1405273033,115269,12799746
2021-04-07,india,Asia,1405273033,126315,12926061
2021-04-08,india,Asia,1405273033,131893,13057954
2021-04-09,india,Asia,1405273033,144829,13202783
2021-04-10,india,Asia,1405273033,152682,13355465
2021-04-11,india,Asia,1405273033,169914,13525379
2021-04-12,india,Asia,1405273033,160694,13686073
2021-04-13,india,Asia,1405273033,185248,13871321
2021-04-14,india,Asia,1405273033,199569,14070890
2021-04-15,india,Asia,1405273033,216850,14287740
2021-04-16,india,Asia,1405273033,233943,14521683
2021-04-17,india,Asia,1405273033,260778,14782461
2021-04-18,india,Asia,1405273033,275306,15057767
2021-04-19,india,Asia,1405273033,256947,15314714
2021-04-20,india,Asia,1405273033,294290,15609004
2021-04-21,india,Asia,1405273033,315802,15924806
2021-04-22,india,Asia,1405273033,332503,16257309
2021-04-23,india,Asia,1405273033,345147,16602456
2021-04-24,india,Asia,1405273033,349313,16951769
2021-04-25,india,Asia,1405273033,354531,17306300
2021-04-26,india,Asia,1405273033,319435,17625735
2021-04-27,india,Asia,1405273033,362902,17988637
2021-04-28,india,Asia,1405273033,379459,18368096
2021-04-29,india,Asia,1405273033,386888,18754984
2021-04-30,india,Asia,1405273033,402110,19157094
2021-05-01,india,Asia,1405273033,392562,19549656
2021-05-02,india,Asia,1405273033,370059,19919715
2021-05-03,india,Asia,1405273033,355828,20275543
2021-05-04,india,Asia,1405273033,382691,20658234
2021-05-05,india,Asia,1405273033,412618,21070852
2021-05-06,india,Asia,1405273033,414433,21485285
2021-05-07,india,Asia,1405273033,401326,21886611
2021-05-08,india,Asia,1405273033,409300,22295911
2021-05-09,india,Asia,1405273033,366499,22662410
2021-05-10,india,Asia,1405273033,329517,22991927
2021-05-11,india,Asia,1405273033,348499,23340426
2021-05-12,india,Asia,1405273033,362406,23702832
2021-05-13,india,Asia,1405273033,343288,24046120
2021-05-14,india,Asia,1405273033,326123,24372243
2021-05-15,india,Asia,1405273033,310822,24683065
2021-05-16,india,Asia,1405273033,281860,24964925
2021-05-17,india,Asia,1405273033,263045,25227970
2021-05-18,india,Asia,1405273033,267174,25495144
2021-05-19,india,Asia,1405273033,276261,25771405
2021-05-20,india,Asia,1405273033,259269,26030674
2021-05-21,india,Asia,1405273033,254395,26285069
2021-05-22,india,Asia,1405273033,243777,26528846
2021-05-23,india,Asia,1405273033,222835,26751681
2021-05-24,india,Asia,1405273033,195815,26947496
2021-05-25,india,Asia,1405273033,208886,27156382
2021-05-26,india,Asia,1405273033,211553,27367935
2021-05-27,india,Asia,1405273033,179770,27547705
2021-05-28,india,Asia,1405273033,171726,27719431
2021-05-29,india,Asia,1405273033,174041,27893472
2021-05-30,india,Asia,1405273033,153485,28046957
2021-05-31,india,Asia,1405273033,126698,28173655
2021-06-01,india,Asia,1405273033,133228,28306883
2021-06-02,india,Asia,1405273033,134105,28440988
2021-06-03,india,Asia,1405273033,131371,28572359
2021-06-04,india,Asia,1405273033,121476,28693835
2021-06-05,india,Asia,1405273033,114537,28808372
2021-06-06,india,Asia,1405273033,101232,28909604
2021-06-07,india,Asia,1405273033,87345,28996949
2021-06-08,india,Asia,1405273033,91227,29088176
2021-06-09,india,Asia,1405273033,93896,29182072
2021-06-10,india,Asia,1405273033,91266,29273338
2021-06-11,india,Asia,1405273033,84695,29358033
2021-06-12,india,Asia,1405273033,81005,29439038
2021-06-13,india,Asia,1405273033,68400,29507438
2021-06-14,india,Asia,1405273033,62597,29570035
2021-06-15,india,Asia,1405273033,62226,29632261
2021-06-16,india,Asia,1405273033,67294,29699555
2021-06-17,india,Asia,1405273033,62409,29761964
2021-06-18,india,Asia,1405273033,60800,29822764
2021-06-19,india,Asia,1405273033,58588,29881352
2021-06-20,india,Asia,1405273033,53009,29934361
2021-06-21,india,Asia,1405273033,39096,29973457
2021-06-22,india,Asia,1405273033,54393,30027850
2021-06-23,india,Asia,1405273033,54319,30082169
2021-06-24,india,Asia,1405273033,51248,30133417
2021-06-25,india,Asia,1405273033,49052,30182469
2021-06-26,india,Asia,1405273033,49851,30232320
2021-06-27,india,Asia,1405273033,46643,30278963
2021-06-28,india,Asia,1405273033,37037,30316000
2021-06-29,india,Asia,1405273033,45699,30361699
2021-06-30,india,Asia,1405273033,48878,30410577
2021-07-01,india,Asia,1405273033,43360,30453937
2021-07-02,india,Asia,1405273033,47252,30501189
2021-07-03,india,Asia,1405273033,43296,30544485
2021-07-04,india,Asia,1405273033,40387,30584872
2021-07-05,india,Asia,1405273033,34067,30618939
2021-07-06,india,Asia,1405273033,43957,30662896
2021-07-07,india,Asia,1405273033,45674,30708570
2021-07-08,india,Asia,1405273033,43538,30752108
2021-07-09,india,Asia,1405273033,42648,30794756
2021-07-10,india,Asia,1405273033,41475,30836231
2021-07-11,india,Asia,1405273033,37676,30873907
2021-07-12,india,Asia,1405273033,30827,30904734
2021-07-13,india,Asia,1405273033,40215,30944949
2021-07-14,india,Asia,1405273033,41854,30986803
2021-07-15,india,Asia,1405273033,39072,31025875
2021-07-16,india,Asia,1405273033,38112,31063987
2021-07-17,india,Asia,1405273033,41283,31105270
2021-07-18,india,Asia,1405273033,38325,31143595
2021-07-19,india,Asia,1405273033,29424,31173019
2021-07-20,india,Asia,1405273033,42123,31215142
2021-07-21,india,Asia,1405273033,41697,31256839
2021-07-22,india,Asia,1405273033,34865,31291704
2021-07-23,india,Asia,1405273033,39498,31331202
2021-07-24,india,Asia,1405273033,40284,31371486
2021-07-25,india,Asia,1405273033,38153,31409639
2021-07-26,india,Asia,1405273033,30844,31440483
2021-07-27,india,Asia,1405273033,42928,31483411
2021-07-28,india,Asia,1405273033,43211,31526622
2021-07-29,india,Asia,1405273033,44673,31571295
2021-07-30,india,Asia,1405273033,41499,31612794
2021-07-31,india,Asia,1405273033,41790,31654584
2021-08-01,india,Asia,1405273033,40784,31695368
2021-08-02,india,Asia,1405273033,30031,31725399
2021-08-03,india,Asia,1405273033,42566,31767965
2021-08-04,india,Asia,1405273033,42817,31810782
2021-08-05,india,Asia,1405273033,45001,31855783
2021-08-06,india,Asia,1405273033,38700,31894483
2021-08-07,india,Asia,1405273033,39070,31933553
2021-08-08,india,Asia,1405273033,36035,31969588
2021-08-09,india,Asia,1405273033,27429,31997017
2021-08-10,india,Asia,1405273033,36316,32033333
2021-08-11,india,Asia,1405273033,43641,32076974
2021-08-12,india,Asia,1405273033,40078,32117052
2021-08-13,india,Asia,1405273033,38775,32155827
2021-08-14,india,Asia,1405273033,36127,32191954
2021-08-15,india,Asia,1405273033,33221,32225175
2021-08-16,india,Asia,1405273033,24725,32249900
2021-08-17,india,Asia,1405273033,35201,32285101
2021-08-18,india,Asia,1405273033,35797,32320898
2021-08-19,india,Asia,1405273033,37312,32358210
2021-08-20,india,Asia,1405273033,34296,32392506
2021-08-21,india,Asia,1405273033,31043,32423549
2021-08-22,india,Asia,1405273033,25420,32448969
2021-08-23,india,Asia,1405273033,11385,32460354
2021-08-24,india,Asia,1405273033,51016,32511370
2021-08-25,india,Asia,1405273033,46397,32557767
2021-08-26,india,Asia,1405273033,44558,32602325
2021-08-27,india,Asia,1405273033,46805,32649130
2021-08-28,india,Asia,1405273033,45058,32694188
2021-08-29,india,Asia,1405273033,43381,32737569
2021-08-30,india,Asia,1405273033,30251,32767820
2021-08-31,india,Asia,1405273033,43072,32810892
2021-09-01,india,Asia,1405273033,45971,32856863
2021-09-02,india,Asia,1405273033,45482,32902345
2021-09-03,india,Asia,1405273033,42346,32944691
2021-09-04,india,Asia,1405273033,42924,32987615
2021-09-05,india,Asia,1405273033,39521,33027136
2021-09-06,india,Asia,1405273033,30184,33057320
2021-09-07,india,Asia,1405273033,38130,33095450
2021-09-08,india,Asia,1405273033,43406,33138856
2021-09-09,india,Asia,1405273033,24148,33163004
2021-09-10,india,Asia,1405273033,37873,33200877
2021-09-11,india,Asia,1405273033,31291,33232168
2021-09-12,india,Asia,1405273033,31374,33263542
2021-09-13,india,Asia,1405273033,24479,33288021
2021-09-14,india,Asia,1405273033,27491,33315512
2021-09-15,india,Asia,1405273033,30361,33345873
2021-09-16,india,Asia,1405273033,34649,33380522
2021-09-17,india,Asia,1405273033,35367,33415889
2021-09-18,india,Asia,1405273033,31121,33447010
2021-09-19,india,Asia,1405273033,30809,33477819
2021-09-20,india,Asia,1405273033,24925,33502744
2021-09-21,india,Asia,1405273033,27333,33530077
2021-09-22,india,Asia,1405273033,31957,33562034
2021-09-23,india,Asia,1405273033,31458,33593492
2021-09-24,india,Asia,1405273033,29580,33623072
2021-09-25,india,Asia,1405273033,28149,33651221
2021-09-26,india,Asia,1405273033,27022,33678243
2021-09-27,india,Asia,1405273033,14905,33693148
2021-09-28,india,Asia,1405273033,21901,33715049
2021-09-29,india,Asia,1405273033,23139,33738188
2021-09-30,india,Asia,1405273033,27300,33765488
2021-10-01,india,Asia,1405273033,23910,33789398
2021-10-02,india,Asia,1405273033,23161,33812559
2021-10-03,india,Asia,1405273033,21684,33834243
2021-10-04,india,Asia,1405273033,16762,33851005
2021-10-05,india,Asia,1405273033,19380,33870385
2021-10-06,india,Asia,1405273033,22617,33893002
2021-10-07,india,Asia,1405273033,21463,33914465
2021-10-08,india,Asia,1405273033,19870,33934335
2021-10-09,india,Asia,1405273033,17940,33952275
2021-10-10,india,Asia,1405273033,19018,33971293
2021-10-11,india,Asia,1405273033,13186,33984479
2021-10-12,india,Asia,1405273033,16021,34000500
2021-10-13,india,Asia,1405273033,19180,34019680
2021-10-14,india,Asia,1405273033,17004,34036684
2021-10-15,india,Asia,1405273033,16003,34052687
2021-10-16,india,Asia,1405273033,14073,34066760
2021-10-17,india,Asia,1405273033,14289,34081049
2021-10-18,india,Asia,1405273033,12338,34093387
2021-10-19,india,Asia,1405273033,14936,34108323
2021-10-20,india,Asia,1405273033,18359,34126682
2021-10-21,india,Asia,1405273033,15759,34142441
2021-10-22,india,Asia,1405273033,16331,34158772
2021-10-23,india,Asia,1405273033,16071,34174843
2021-10-24,india,Asia,1405273033,14641,34189484
2021-10-25,india,Asia,1405273033,11873,34201357
2021-10-26,india,Asia,1405273033,13508,34214865
2021-10-27,india,Asia,1405273033,16342,34231207
2021-10-28,india,Asia,1405273033,14323,34245530
2021-10-29,india,Asia,1405273033,14189,34259719
2021-10-30,india,Asia,1405273033,12958,34272677
2021-10-31,india,Asia,1405273033,12935,34285612
2021-11-01,india,Asia,1405273033,9769,34295381
2021-11-02,india,Asia,1405273033,10796,34306177
2021-11-03,india,Asia,1405273033,13965,34320142
2021-11-04,india,Asia,1405273033,12265,34332407
2021-11-05,india,Asia,1405273033,11680,34344087
2021-11-06,india,Asia,1405273033,10879,34354966
2021-11-07,india,Asia,1405273033,11648,34366614
2021-11-08,india,Asia,1405273033,7841,34374455
2021-11-09,india,Asia,1405273033,12331,34386786
2021-11-10,india,Asia,1405273033,14884,34401670
2021-11-11,india,Asia,1405273033,12516,34414186
2021-11-12,india,Asia,1405273033,11850,34426036
2021-11-13,india,Asia,1405273033,11271,34437307
2021-11-14,india,Asia,1405273033,10229,34447536
2021-11-15,india,Asia,1405273033,8865,34456401
2021-11-16,india,Asia,1405273033,10197,34466598
2021-11-17,india,Asia,1405273033,11919,34478517
2021-11-18,india,Asia,1405273033,11106,34489623
2021-11-19,india,Asia,1405273033,10302,34499925
2021-11-20,india,Asia,1405273033,10488,34510413
2021-11-21,india,Asia,1405273033,8488,34518901
2021-11-22,india,Asia,1405273033,7579,34526480
2021-11-23,india,Asia,1405273033,9283,34535763
2021-11-24,india,Asia,1405273033,9119,34544882
2021-11-25,india,Asia,1405273033,10549,34555431
2021-11-26,india,Asia,1405273033,8318,34563749
2021-11-27,india,Asia,1405273033,8774,34572523
2021-11-28,india,Asia,1405273033,8309,34580832
2021-11-29,india,Asia,1405273033,6990,34587822
2021-11-30,india,Asia,1405273033,8954,34596776
2021-12-01,india,Asia,1405273033,9765,34606541
2021-12-02,india,Asia,1405273033,9216,34615757
2021-12-03,india,Asia,1405273033,8603,34624360
2021-12-04,india,Asia,1405273033,8895,34633255
2021-12-05,india,Asia,1405273033,8306,34641561
2021-12-06,india,Asia,1405273033,6822,34648383
2021-12-07,india,Asia,1405273033,8439,34656822
2021-12-08,india,Asia,1405273033,9419,34666241
2021-12-09,india,Asia,1405273033,8503,34674744
2021-12-10,india,Asia,1405273033,7992,34682736
2021-12-11,india,Asia,1405273033,7774,34690510
2021-12-12,india,Asia,1405273033,7350,34697860
2021-12-13,india,Asia,1405273033,5784,34703644
2021-12-14,india,Asia,1405273033,6986,34710630
2021-12-15,india,Asia,1405273033,8039,34718669
2021-12-16,india,Asia,1405273033,7380,34726049
2021-12-17,india,Asia,1405273033,7145,34733194
2021-12-18,india,Asia,1405273033,7081,34740275
2021-12-19,india,Asia,1405273033,6563,34746838
2021-12-20,india,Asia,1405273033,5326,34752164
2021-12-21,india,Asia,1405273033,6317,34758481
2021-12-22,india,Asia,1405273033,7495,34765976
2021-12-23,india,Asia,1405273033,6681,34772657
2021-12-24,india,Asia,1405273033,7158,34779815
2021-12-25,india,Asia,1405273033,6987,34786802
2021-12-26,india,Asia,1405273033,6531,34793333
2021-12-27,india,Asia,1405273033,6358,34799691
2021-12-28,india,Asia,1405273033,9195,34808886
2021-12-29,india,Asia,1405273033,13154,34822040
2021-12-30,india,Asia,1405273033,16764,34838804
2021-12-31,india,Asia,1405273033,22775,34861579
2022-01-01,india,Asia,1405273033,27553,34889132
2022-01-02,india,Asia,1405273033,33750,34922882
2022-01-03,india,Asia,1405273033,37379,34960261
2022-01-04,india,Asia,1405273033,58097,35018358
2022-01-05,india,Asia,1405273033,90928,35109286
2022-01-06,india,Asia,1405273033,117100,35226386
2022-01-07,india,Asia,1405273033,141986,35368372
2022-01-08,india,Asia,1405273033,159632,35528004
2022-01-09,india,Asia,1405273033,180438,35708442
2022-01-10,india,Asia,1405273033,167348,35875790
2022-01-11,india,Asia,1405273033,194720,36070510
2022-01-12,india,Asia,1405273033,247417,36317927
2022-01-13,india,Asia,1405273033,264202,36582129
2022-01-14,india,Asia,1405273033,268833,36850962
2022-01-15,india,Asia,1405273033,271202,37122164
2022-01-16,india,Asia,1405273033,258089,37380253
2022-01-17,india,Asia,1405273033,238018,37618271
2022-01-18,india,Asia,1405273033,282970,37901241
2022-01-19,india,Asia,1405273033,317532,38218773
2022-01-20,india,Asia,1405273033,347254,38566027
2022-01-21,india,Asia,1405273033,337704,38903731
2022-01-22,india,Asia,1405273033,333533,39237264
2022-01-23,india,Asia,1405273033,306064,39543328
2022-01-24,india,Asia,1405273033,255874,39799202
2022-01-25,india,Asia,1405273033,285914,40085116
2022-01-26,india,Asia,1405273033,286384,40371500
2022-01-27,india,Asia,1405273033,251209,40622709
2022-01-28,india,Asia,1405273033,235532,40858241
2022-01-29,india,Asia,1405273033,234281,41092522
2022-01-30,india,Asia,1405273033,209918,41302440
2022-01-31,india,Asia,1405273033,167059,41469499
2020-02-20,iran,Asia,85995095,3,5
2020-02-21,iran,Asia,85995095,13,18
2020-02-22,iran,Asia,85995095,11,29
2020-02-23,iran,Asia,85995095,14,43
2020-02-24,iran,Asia,85995095,18,61
2020-02-25,iran,Asia,85995095,34,95
2020-02-26,iran,Asia,85995095,44,139
2020-02-27,iran,Asia,85995095,106,245
2020-02-28,iran,Asia,85995095,143,388
2020-02-29,iran,Asia,85995095,205,593
2020-03-01,iran,Asia,85995095,385,978
2020-03-02,iran,Asia,85995095,523,1501
2020-03-03,iran,Asia,85995095,835,2336
2020-03-04,iran,Asia,85995095,586,2922
2020-03-05,iran,Asia,85995095,591,3513
2020-03-06,iran,Asia,85995095,1234,4747
2020-03-07,iran,Asia,85995095,1076,5823
2020-03-08,iran,Asia,85995095,743,6566
2020-03-09,iran,Asia,85995095,595,7161
2020-03-10,iran,Asia,85995095,881,8042
2020-03-11,iran,Asia,85995095,958,9000
2020-03-12,iran,Asia,85995095,1075,10075
2020-03-13,iran,Asia,85995095,1289,11364
2020-03-14,iran,Asia,85995095,1365,12729
2020-03-15,iran,Asia,85995095,1209,13938
2020-03-16,iran,Asia,85995095,1053,14991
2020-03-17,iran,Asia,85995095,1178,16169
2020-03-18,iran,Asia,85995095,1192,17361
2020-03-19,iran,Asia,85995095,1046,18407
2020-03-20,iran,Asia,85995095,1237,19644
2020-03-21,iran,Asia,85995095,966,20610
2020-03-22,iran,Asia,85995095,1028,21638
2020-03-23,iran,Asia,85995095,1411,23049
2020-03-24,iran,Asia,85995095,1762,24811
2020-03-25,iran,Asia,85995095,2206,27017
2020-03-26,iran,Asia,85995095,2389,29406
2020-03-27,iran,Asia,85995095,2926,32332
2020-03-28,iran,Asia,85995095,3076,35408
2020-03-29,iran,Asia,85995095,2901,38309
2020-03-30,iran,Asia,85995095,3186,41495
2020-03-31,iran,Asia,85995095,3110,44605
2020-04-01,iran,Asia,85995095,2988,47593
2020-04-02,iran,Asia,85995095,2875,50468
2020-04-03,iran,Asia,85995095,2715,53183
2020-04-04,iran,Asia,85995095,2560,55743
2020-04-05,iran,Asia,85995095,2483,58226
2020-04-06,iran,Asia,85995095,2274,60500
2020-04-07,iran,Asia,85995095,2089,62589
2020-04-08,iran,Asia,85995095,1997,64586
2020-04-09,iran,Asia,85995095,1634,66220
2020-04-10,iran,Asia,85995095,1972,68192
2020-04-11,iran,Asia,85995095,1837,70029
2020-04-12,iran,Asia,85995095,1657,71686
2020-04-13,iran,Asia,85995095,1617,73303
2020-04-14,iran,Asia,85995095,1574,74877
2020-04-15,iran,Asia,85995095,1512,76389
2020-04-16,iran,Asia,85995095,1606,77995
2020-04-17,iran,Asia,85995095,1499,79494
2020-04-18,iran,Asia,85995095,1374,80868
2020-04-19,iran,Asia,85995095,1343,82211
2020-04-20,iran,Asia,85995095,1294,83505
2020-04-21,iran,Asia,85995095,1297,84802
2020-04-22,iran,Asia,85995095,1194,85996
2020-04-23,iran,Asia,85995095,1030,87026
2020-04-24,iran,Asia,85995095,1168,88194
2020-04-25,iran,Asia,85995095,1134,89328
2020-04-26,iran,Asia,85995095,1153,90481
2020-04-27,iran,Asia,85995095,991,91472
2020-04-28,iran,Asia,85995095,1112,92584
2020-04-29,iran,Asia,85995095,1073,93657
2020-04-30,iran,Asia,85995095,983,94640
2020-05-01,iran,Asia,85995095,1006,95646
2020-05-02,iran,Asia,85995095,802,96448
2020-05-03,iran,Asia,85995095,976,97424
2020-05-04,iran,Asia,85995095,1223,98647
2020-05-05,iran,Asia,85995095,1323,99970
2020-05-06,iran,Asia,85995095,1680,101650
2020-05-07,iran,Asia,85995095,1485,103135
2020-05-08,iran,Asia,85995095,1556,104691
2020-05-09,iran,Asia,85995095,1529,106220
2020-05-10,iran,Asia,85995095,1383,107603
2020-05-11,iran,Asia,85995095,1683,109286
2020-05-12,iran,Asia,85995095,1481,110767
2020-05-13,iran,Asia,85995095,1958,112725
2020-05-14,iran,Asia,85995095,1808,114533
2020-05-15,iran,Asia,85995095,2102,116635
2020-05-16,iran,Asia,85995095,1757,118392
2020-05-17,iran,Asia,85995095,1806,120198
2020-05-18,iran,Asia,85995095,2294,122492
2020-05-19,iran,Asia,85995095,2111,124603
2020-05-20,iran,Asia,85995095,2346,126949
2020-05-21,iran,Asia,85995095,2392,129341
2020-05-22,iran,Asia,85995095,2311,131652
2020-05-23,iran,Asia,85995095,1869,133521
2020-02-25,iraq,Asia,41902979,4,5
2020-02-26,iraq,Asia,41902979,0,5
2020-02-27,iraq,Asia,41902979,2,7
2020-02-28,iraq,Asia,41902979,1,8
2020-02-29,iraq,Asia,41902979,5,13
2020-03-01,iraq,Asia,41902979,6,19
2020-03-02,iraq,Asia,41902979,8,27
2020-03-03,iraq,Asia,41902979,5,32
2020-03-04,iraq,Asia,41902979,5,37
2020-03-05,iraq,Asia,41902979,3,40
2020-03-06,iraq,Asia,41902979,6,46
2020-03-07,iraq,Asia,41902979,8,54
2020-03-08,iraq,Asia,41902979,11,65
2020-03-09,iraq,Asia,41902979,6,71
2020-03-10,iraq,Asia,41902979,0,71
2020-03-11,iraq,Asia,41902979,0,71
2020-03-12,iraq,Asia,41902979,12,83
2020-03-13,iraq,Asia,41902979,18,101
2020-03-14,iraq,Asia,41902979,9,110
2020-03-15,iraq,Asia,41902979,14,124
2020-03-16,iraq,Asia,41902979,9,133
2020-03-17,iraq,Asia,41902979,21,154
2020-03-18,iraq,Asia,41902979,10,164
2020-03-19,iraq,Asia,41902979,28,192
2020-03-20,iraq,Asia,41902979,16,208
2020-03-21,iraq,Asia,41902979,6,214
2020-03-22,iraq,Asia,41902979,19,233
2020-03-23,iraq,Asia,41902979,33,266
2020-03-24,iraq,Asia,41902979,50,316
2020-03-25,iraq,Asia,41902979,30,346
2020-03-26,iraq,Asia,41902979,36,382
2020-03-27,iraq,Asia,41902979,76,458
2020-03-28,iraq,Asia,41902979,48,506
2020-03-29,iraq,Asia,41902979,41,547
2020-03-30,iraq,Asia,41902979,83,630
2020-03-31,iraq,Asia,41902979,64,694
2020-04-01,iraq,Asia,41902979,34,728
2020-04-02,iraq,Asia,41902979,44,772
2020-04-03,iraq,Asia,41902979,48,820
2020-04-04,iraq,Asia,41902979,58,878
2020-04-05,iraq,Asia,41902979,83,961
2020-04-06,iraq,Asia,41902979,70,1031
2020-04-07,iraq,Asia,41902979,91,1122
2020-04-08,iraq,Asia,41902979,80,1202
2020-04-09,iraq,Asia,41902979,30,1232
2020-04-10,iraq,Asia,41902979,47,1279
2020-04-11,iraq,Asia,41902979,39,1318
2020-04-12,iraq,Asia,41902979,34,1352
2020-04-13,iraq,Asia,41902979,26,1378
2020-04-14,iraq,Asia,41902979,22,1400
2020-04-15,iraq,Asia,41902979,15,1415
2020-04-16,iraq,Asia,41902979,19,1434
2020-04-17,iraq,Asia,41902979,48,1482
2020-04-18,iraq,Asia,41902979,31,1513
2020-04-19,iraq,Asia,41902979,26,1539
2020-04-20,iraq,Asia,41902979,35,1574
2020-04-21,iraq,Asia,41902979,28,1602
2020-04-22,iraq,Asia,41902979,29,1631
2020-04-23,iraq,Asia,41902979,46,1677
2020-04-24,iraq,Asia,41902979,31,1708
2020-04-25,iraq,Asia,41902979,55,1763
2020-04-26,iraq,Asia,41902979,57,1820
2020-04-27,iraq,Asia,41902979,27,1847
2020-04-28,iraq,Asia,41902979,81,1928
2020-04-29,iraq,Asia,41902979,75,2003
2020-04-30,iraq,Asia,41902979,82,2085
2020-05-01,iraq,Asia,41902979,68,2153
2020-05-02,iraq,Asia,41902979,66,2219
2020-05-03,iraq,Asia,41902979,77,2296
2020-05-04,iraq,Asia,41902979,50,2346
2020-05-05,iraq,Asia,41902979,85,2431
2020-05-06,iraq,Asia,41902979,49,2480
2020-05-07,iraq,Asia,41902979,63,2543
2020-05-08,iraq,Asia,41902979,60,2603
2020-05-09,iraq,Asia,41902979,76,2679
2020-05-10,iraq,Asia,41902979,88,2767
2020-05-11,iraq,Asia,41902979,51,2818
2020-05-12,iraq,Asia,41902979,95,2913
2020-05-13,iraq,Asia,41902979,119,3032
2020-05-14,iraq,Asia,41902979,111,3143
2020-05-15,iraq,Asia,41902979,50,3193
2020-05-16,iraq,Asia,41902979,67,3260
2020-05-17,iraq,Asia,41902979,144,3404
2020-05-18,iraq,Asia,41902979,150,3554
2020-05-19,iraq,Asia,41902979,57,3611
2020-05-20,iraq,Asia,41902979,113,3724
2020-05-21,iraq,Asia,41902979,153,3877
2020-05-22,iraq,Asia,41902979,87,3964
2020-05-23,iraq,Asia,41902979,308,4272
2020-05-24,iraq,Asia,41902979,197,4469
2020-05-25,iraq,Asia,41902979,163,4632
2020-05-26,iraq,Asia,41902979,216,4848
2020-05-27,iraq,Asia,41902979,287,5135
2020-05-28,iraq,Asia,41902979,322,5457
2020-05-29,iraq,Asia,41902979,416,5873
2020-05-30,iraq,Asia,41902979,306,6179
2020-05-31,iraq,Asia,41902979,260,6439
2020-06-01,iraq,Asia,41902979,429,6868
2020-06-02,iraq,Asia,41902979,519,7387
2020-06-03,iraq,Asia,41902979,781,8168
2020-06-04,iraq,Asia,41902979,672,8840
2020-06-05,iraq,Asia,41902979,1006,9846
2020-06-06,iraq,Asia,41902979,1252,11098
2020-06-07,iraq,Asia,41902979,1268,12366
2020-06-08,iraq,Asia,41902979,1115,13481
2020-06-09,iraq,Asia,41902979,787,14268
2020-06-10,iraq,Asia,41902979,1146,15414
2020-06-11,iraq,Asia,41902979,1261,16675
2020-06-12,iraq,Asia,41902979,1095,17770
2020-06-13,iraq,Asia,41902979,1180,18950
2020-06-14,iraq,Asia,41902979,1259,20209
2020-06-15,iraq,Asia,41902979,1106,21315
2020-06-16,iraq,Asia,41902979,1385,22700
2020-06-17,iraq,Asia,41902979,1554,24254
2020-06-18,iraq,Asia,41902979,1463,25717
2020-06-19,iraq,Asia,41902979,1635,27352
2020-06-20,iraq,Asia,41902979,1870,29222
2020-06-21,iraq,Asia,41902979,1646,30868
2020-06-22,iraq,Asia,41902979,1808,32676
2020-06-23,iraq,Asia,41902979,1826,34502
2020-06-24,iraq,Asia,41902979,2200,36702
2020-06-25,iraq,Asia,41902979,2437,39139
2020-06-26,iraq,Asia,41902979,2054,41193
2020-06-27,iraq,Asia,41902979,2069,43262
2020-06-28,iraq,Asia,41902979,2140,45402
2020-06-29,iraq,Asia,41902979,1749,47151
2020-06-30,iraq,Asia,41902979,1958,49109
2020-07-01,iraq,Asia,41902979,2415,51524
2020-07-02,iraq,Asia,41902979,2184,53708
2020-07-03,iraq,Asia,41902979,2312,56020
2020-07-04,iraq,Asia,41902979,2334,58354
2020-07-05,iraq,Asia,41902979,2125,60479
2020-07-06,iraq,Asia,41902979,1796,62275
2020-07-07,iraq,Asia,41902979,2426,64701
2020-07-08,iraq,Asia,41902979,2741,67442
2020-07-09,iraq,Asia,41902979,2170,69612
2020-07-10,iraq,Asia,41902979,2848,72460
2020-07-11,iraq,Asia,41902979,2734,75194
2020-07-12,iraq,Asia,41902979,2312,77506
2020-07-13,iraq,Asia,41902979,2229,79735
2020-07-14,iraq,Asia,41902979,2022,81757
2020-07-15,iraq,Asia,41902979,2110,83867
2020-07-16,iraq,Asia,41902979,2281,86148
2020-07-17,iraq,Asia,41902979,2023,88171
2020-07-18,iraq,Asia,41902979,2049,90220
2020-07-19,iraq,Asia,41902979,2310,92530
2020-07-20,iraq,Asia,41902979,2163,94693
2020-07-21,iraq,Asia,41902979,2466,97159
2020-07-22,iraq,Asia,41902979,2706,99865
2020-07-23,iraq,Asia,41902979,2361,102226
2020-07-24,iraq,Asia,41902979,2485,104711
2020-07-25,iraq,Asia,41902979,2862,107573
2020-07-26,iraq,Asia,41902979,2459,110032
2020-07-27,iraq,Asia,41902979,2553,112585
2020-07-28,iraq,Asia,41902979,2747,115332
2020-07-29,iraq,Asia,41902979,2968,118300
2020-07-30,iraq,Asia,41902979,2963,121263
2020-07-31,iraq,Asia,41902979,3346,124609
2020-08-01,iraq,Asia,41902979,2095,126704
2020-08-02,iraq,Asia,41902979,2447,129151
2020-08-03,iraq,Asia,41902979,2735,131886
2020-08-04,iraq,Asia,41902979,2836,134722
2020-08-05,iraq,Asia,41902979,2834,137556
2020-08-06,iraq,Asia,41902979,3047,140603
2020-08-07,iraq,Asia,41902979,3461,144064
2020-08-08,iraq,Asia,41902979,3325,147389
2020-08-09,iraq,Asia,41902979,2726,150115
2020-08-10,iraq,Asia,41902979,3484,153599
2020-08-11,iraq,Asia,41902979,3396,156995
2020-08-12,iraq,Asia,41902979,3441,160436
2020-08-13,iraq,Asia,41902979,3841,164277
2020-08-14,iraq,Asia,41902979,4013,168290
2020-08-15,iraq,Asia,41902979,4293,172583
2020-08-16,iraq,Asia,41902979,4348,176931
2020-08-17,iraq,Asia,41902979,3202,180133
2020-08-18,iraq,Asia,41902979,4576,184709
2020-08-19,iraq,Asia,41902979,4093,188802
2020-08-20,iraq,Asia,41902979,3995,192797
2020-08-21,iraq,Asia,41902979,4288,197085
2020-08-22,iraq,Asia,41902979,3965,201050
2020-08-23,iraq,Asia,41902979,3291,204341
2020-08-24,iraq,Asia,41902979,3644,207985
2020-08-25,iraq,Asia,41902979,3962,211947
2020-08-26,iraq,Asia,41902979,3837,215784
2020-08-27,iraq,Asia,41902979,3651,219435
2020-08-28,iraq,Asia,41902979,4177,223612
2020-08-29,iraq,Asia,41902979,3834,227446
2020-08-30,iraq,Asia,41902979,3731,231177
2020-08-31,iraq,Asia,41902979,3757,234934
2020-09-01,iraq,Asia,41902979,3404,238338
2020-09-02,iraq,Asia,41902979,3946,242284
2020-09-03,iraq,Asia,41902979,4755,247039
2020-09-04,iraq,Asia,41902979,5036,252075
2020-09-05,iraq,Asia,41902979,4644,256719
2020-09-06,iraq,Asia,41902979,3651,260370
2020-09-07,iraq,Asia,41902979,4314,264684
2020-09-08,iraq,Asia,41902979,4894,269578
2020-09-09,iraq,Asia,41902979,4243,273821
2020-09-10,iraq,Asia,41902979,4597,278418
2020-09-11,iraq,Asia,41902979,4254,282672
2020-09-12,iraq,Asia,41902979,4106,286778
2020-09-13,iraq,Asia,41902979,3531,290309
2020-09-14,iraq,Asia,41902979,4169,294478
2020-09-15,iraq,Asia,41902979,4224,298702
2020-09-16,iraq,Asia,41902979,4357,303059
2020-09-17,iraq,Asia,41902979,4326,307385
2020-09-18,iraq,Asia,41902979,4305,311690
2020-09-19,iraq,Asia,41902979,3907,315597
2020-09-20,iraq,Asia,41902979,3438,319035
2020-09-21,iraq,Asia,41902979,3821,322856
2020-09-22,iraq,Asia,41902979,4724,327580
2020-09-23,iraq,Asia,41902979,5055,332635
2020-09-24,iraq,Asia,41902979,4471,337106
2020-09-25,iraq,Asia,41902979,4593,341699
2020-09-26,iraq,Asia,41902979,4270,345969
2020-09-27,iraq,Asia,41902979,3481,349450
2020-09-28,iraq,Asia,41902979,4116,353566
2020-09-29,iraq,Asia,41902979,4724,358290
2020-09-30,iraq,Asia,41902979,4691,362981
2020-10-01,iraq,Asia,41902979,4493,367474
2020-10-02,iraq,Asia,41902979,4785,372259
2020-10-03,iraq,Asia,41902979,3672,375931
2020-10-04,iraq,Asia,41902979,3210,379141
2020-10-05,iraq,Asia,41902979,3808,382949
2020-10-06,iraq,Asia,41902979,4172,387121
2020-10-07,iraq,Asia,41902979,3923,391044
2020-10-08,iraq,Asia,41902979,3522,394566
2020-10-09,iraq,Asia,41902979,3214,397780
2020-10-10,iraq,Asia,41902979,2344,400124
2020-10-11,iraq,Asia,41902979,2206,402330
2020-10-12,iraq,Asia,41902979,3107,405437
2020-10-13,iraq,Asia,41902979,3921,409358
2020-10-14,iraq,Asia,41902979,3857,413215
2020-10-15,iraq,Asia,41902979,3587,416802
2020-10-16,iraq,Asia,41902979,3501,420303
2020-10-17,iraq,Asia,41902979,3221,423524
2020-10-18,iraq,Asia,41902979,3110,426634
2020-10-19,iraq,Asia,41902979,4044,430678
2020-10-20,iraq,Asia,41902979,3920,434598
2020-10-21,iraq,Asia,41902979,3667,438265
2020-10-22,iraq,Asia,41902979,3899,442164
2020-10-23,iraq,Asia,41902979,3785,445949
2020-10-24,iraq,Asia,41902979,3204,449153
2020-10-25,iraq,Asia,41902979,2554,451707
2020-10-26,iraq,Asia,41902979,3691,455398
2020-10-27,iraq,Asia,41902979,4510,459908
2020-10-28,iraq,Asia,41902979,4043,463951
2020-10-29,iraq,Asia,41902979,3804,467755
2020-10-30,iraq,Asia,41902979,2878,470633
2020-10-31,iraq,Asia,41902979,1997,472630
2020-11-01,iraq,Asia,41902979,2658,475288
2020-11-02,iraq,Asia,41902979,3413,478701
2020-11-03,iraq,Asia,41902979,3595,482296
2020-11-04,iraq,Asia,41902979,3574,485870
2020-11-05,iraq,Asia,41902979,3701,489571
2020-11-06,iraq,Asia,41902979,3568,493139
2020-11-07,iraq,Asia,41902979,2880,496019
2020-11-08,iraq,Asia,41902979,2530,498549
2020-11-09,iraq,Asia,41902979,3184,501733
2020-11-10,iraq,Asia,41902979,3577,505310
2020-11-11,iraq,Asia,41902979,3198,508508
2020-11-12,iraq,Asia,41902979,3298,511806
2020-11-13,iraq,Asia,41902979,2690,514496
2020-11-14,iraq,Asia,41902979,2419,516915
2020-11-15,iraq,Asia,41902979,2237,519152
2020-11-16,iraq,Asia,41902979,2390,521542
2020-11-17,iraq,Asia,41902979,2961,524503
2020-11-18,iraq,Asia,41902979,2349,526852
2020-11-19,iraq,Asia,41902979,2374,529226
2020-11-20,iraq,Asia,41902979,2543,531769
2020-11-21,iraq,Asia,41902979,1786,533555
2020-11-22,iraq,Asia,41902979,1766,535321
2020-11-23,iraq,Asia,41902979,2136,537457
2020-11-24,iraq,Asia,41902979,2292,539749
2020-11-25,iraq,Asia,41902979,2438,542187
2020-11-26,iraq,Asia,41902979,2483,544670
2020-11-27,iraq,Asia,41902979,2545,547215
2020-11-28,iraq,Asia,41902979,1606,548821
2020-11-29,iraq,Asia,41902979,1614,550435
2020-02-16,ireland,Europe,5040509,0,0
2020-02-17,ireland,Europe,5040509,0,0
2020-02-18,ireland,Europe,5040509,0,0
2020-02-19,ireland,Europe,5040509,0,0
2020-02-20,ireland,Europe,5040509,0,0
2020-02-21,ireland,Europe,5040509,0,0
2020-02-22,ireland,Europe,5040509,0,0
2020-02-23,ireland,Europe,5040509,0,0
2020-02-24,ireland,Europe,5040509,0,0
2020-02-25,ireland,Europe,5040509,0,0
2020-02-26,ireland,Europe,5040509,0,0
2020-02-27,ireland,Europe,5040509,0,0
2020-02-28,ireland,Europe,5040509,0,0
2020-02-29,ireland,Europe,5040509,1,1
2020-03-01,ireland,Europe,5040509,0,1
2020-03-02,ireland,Europe,5040509,0,1
2020-03-03,ireland,Europe,5040509,0,1
2020-03-04,ireland,Europe,5040509,1,2
2020-03-05,ireland,Europe,5040509,3,5
2020-03-06,ireland,Europe,5040509,3,8
2020-03-07,ireland,Europe,5040509,5,13
2020-03-08,ireland,Europe,5040509,3,16
2020-03-09,ireland,Europe,5040509,2,18
2020-03-10,ireland,Europe,5040509,7,25
2020-03-11,ireland,Europe,5040509,12,37
2020-03-12,ireland,Europe,5040509,12,49
2020-03-13,ireland,Europe,5040509,29,78
2020-03-14,ireland,Europe,5040509,32,110
2020-03-15,ireland,Europe,5040509,33,143
2020-03-16,ireland,Europe,5040509,27,170
2020-03-17,ireland,Europe,5040509,98,268
2020-03-18,ireland,Europe,5040509,79,347
2020-03-19,ireland,Europe,5040509,84,431
2020-03-20,ireland,Europe,5040509,142,573
2020-03-21,ireland,Europe,5040509,126,699
2020-03-22,ireland,Europe,5040509,124,823
2020-03-23,ireland,Europe,5040509,128,951
2020-03-24,ireland,Europe,5040509,198,1149
2020-03-25,ireland,Europe,5040509,220,1369
2020-03-26,ireland,Europe,5040509,248,1617
2020-03-27,ireland,Europe,5040509,262,1879
2020-03-28,ireland,Europe,5040509,309,2188
2020-03-29,ireland,Europe,5040509,258,2446
2020-03-30,ireland,Europe,5040509,194,2640
2020-03-31,ireland,Europe,5040509,303,2943
2020-04-01,ireland,Europe,5040509,290,3233
2020-04-02,ireland,Europe,5040509,366,3599
2020-04-03,ireland,Europe,5040509,360,3959
2020-04-04,ireland,Europe,5040509,427,4386
2020-04-05,ireland,Europe,5040509,463,4849
2020-04-06,ireland,Europe,5040509,676,5525
2020-04-07,ireland,Europe,5040509,385,5910
2020-04-08,ireland,Europe,5040509,464,6374
2020-04-09,ireland,Europe,5040509,613,6987
2020-04-10,ireland,Europe,5040509,698,7685
2020-04-11,ireland,Europe,5040509,705,8390
2020-04-12,ireland,Europe,5040509,969,9359
2020-04-13,ireland,Europe,5040509,893,10252
2020-04-14,ireland,Europe,5040509,866,11118
2020-04-15,ireland,Europe,5040509,1130,12248
2020-04-16,ireland,Europe,5040509,580,12828
2020-04-17,ireland,Europe,5040509,721,13549
2020-04-18,ireland,Europe,5040509,853,14402
2020-04-19,ireland,Europe,5040509,555,14957
2020-04-20,ireland,Europe,5040509,266,15223
2020-04-21,ireland,Europe,5040509,395,15618
2020-04-22,ireland,Europe,5040509,510,16128
2020-04-23,ireland,Europe,5040509,946,17074
2020-04-24,ireland,Europe,5040509,537,17611
2020-04-25,ireland,Europe,5040509,449,18060
2020-04-26,ireland,Europe,5040509,664,18724
2020-04-27,ireland,Europe,5040509,399,19123
2020-04-28,ireland,Europe,5040509,367,19490
2020-04-29,ireland,Europe,5040509,366,19856
2020-04-30,ireland,Europe,5040509,396,20252
2020-05-01,ireland,Europe,5040509,271,20523
2020-05-02,ireland,Europe,5040509,351,20874
2020-05-03,ireland,Europe,5040509,383,21257
2020-05-04,ireland,Europe,5040509,205,21462
2020-05-05,ireland,Europe,5040509,249,21711
2020-05-06,ireland,Europe,5040509,281,21992
2020-05-07,ireland,Europe,5040509,137,22129
2020-05-08,ireland,Europe,5040509,186,22315
2020-05-09,ireland,Europe,5040509,158,22473
2020-05-10,ireland,Europe,5040509,261,22734
2020-05-11,ireland,Europe,5040509,181,22915
2020-05-12,ireland,Europe,5040509,85,23000
2020-05-13,ireland,Europe,5040509,124,23124
2020-05-14,ireland,Europe,5040509,363,23487
2020-05-15,ireland,Europe,5040509,233,23720
2020-05-16,ireland,Europe,5040509,105,23825
2020-05-17,ireland,Europe,5040509,84,23909
2020-05-18,ireland,Europe,5040509,130,24039
2020-05-19,ireland,Europe,5040509,42,24081
2020-05-20,ireland,Europe,5040509,75,24156
2020-05-21,ireland,Europe,5040509,75,24231
2020-05-22,ireland,Europe,5040509,95,24326
2020-05-23,ireland,Europe,5040509,115,24441
2020-05-24,ireland,Europe,5040509,39,24480
2020-05-25,ireland,Europe,5040509,40,24520
2020-05-26,ireland,Europe,5040509,105,24625
2020-05-27,ireland,Europe,5040509,68,24693
2020-05-28,ireland,Europe,5040509,40,24733
2020-05-29,ireland,Europe,5040509,37,24770
2020-05-30,ireland,Europe,5040509,55,24825
2020-05-31,ireland,Europe,5040509,66,24891
2020-06-01,ireland,Europe,5040509,75,24966
2020-06-02,ireland,Europe,5040509,10,24976
2020-06-03,ireland,Europe,5040509,40,25016
2020-06-04,ireland,Europe,5040509,36,25052
2020-06-05,ireland,Europe,5040509,26,25078
2020-06-06,ireland,Europe,5040509,22,25100
2020-06-07,ireland,Europe,5040509,23,25123
2020-06-08,ireland,Europe,5040509,9,25132
2020-06-09,ireland,Europe,5040509,9,25141
2020-06-10,ireland,Europe,5040509,18,25159
2020-06-11,ireland,Europe,5040509,8,25167
2020-06-12,ireland,Europe,5040509,13,25180
2020-06-13,ireland,Europe,5040509,45,25225
2020-06-14,ireland,Europe,5040509,8,25233
2020-06-15,ireland,Europe,5040509,18,25251
2020-06-16,ireland,Europe,5040509,14,25265
2020-06-17,ireland,Europe,5040509,8,25273
2020-06-18,ireland,Europe,5040509,16,25289
2020-06-19,ireland,Europe,5040509,13,25302
2020-06-20,ireland,Europe,5040509,21,25323
2020-06-21,ireland,Europe,5040509,5,25328
2020-06-22,ireland,Europe,5040509,4,25332
2020-06-23,ireland,Europe,5040509,10,25342
2020-06-24,ireland,Europe,5040509,4,25346
2020-06-25,ireland,Europe,5040509,9,25355
2020-06-26,ireland,Europe,5040509,11,25366
2020-06-27,ireland,Europe,5040509,20,25386
2020-06-28,ireland,Europe,5040509,3,25389
2020-06-29,ireland,Europe,5040509,24,25413
2020-06-30,ireland,Europe,5040509,11,25424
2020-07-01,ireland,Europe,5040509,6,25430
2020-07-02,ireland,Europe,5040509,15,25445
2020-07-03,ireland,Europe,5040509,9,25454
2020-07-04,ireland,Europe,5040509,11,25465
2020-07-05,ireland,Europe,5040509,17,25482
2020-07-06,ireland,Europe,5040509,3,25485
2020-07-07,ireland,Europe,5040509,24,25509
2020-07-08,ireland,Europe,5040509,11,25520
2020-07-09,ireland,Europe,5040509,23,25543
2020-07-10,ireland,Europe,5040509,25,25568
2020-07-11,ireland,Europe,5040509,23,25591
2020-07-12,ireland,Europe,5040509,17,25608
2020-07-13,ireland,Europe,5040509,11,25619
2020-07-14,ireland,Europe,5040509,32,25651
2020-07-15,ireland,Europe,5040509,13,25664
2020-07-16,ireland,Europe,5040509,22,25686
2020-07-17,ireland,Europe,5040509,33,25719
2020-07-18,ireland,Europe,5040509,19,25738
2020-07-19,ireland,Europe,5040509,9,25747
2020-07-20,ireland,Europe,5040509,6,25753
2020-07-21,ireland,Europe,5040509,34,25787
2020-07-22,ireland,Europe,5040509,16,25803
2020-07-23,ireland,Europe,5040509,7,25810
2020-07-24,ireland,Europe,5040509,20,25830
2020-07-25,ireland,Europe,5040509,23,25853
2020-07-26,ireland,Europe,5040509,12,25865
2020-07-27,ireland,Europe,5040509,10,25875
2020-07-28,ireland,Europe,5040509,39,25914
2020-07-29,ireland,Europe,5040509,14,25928
2020-07-30,ireland,Europe,5040509,84,26012
2020-07-31,ireland,Europe,5040509,41,26053
2020-08-01,ireland,Europe,5040509,43,26096
2020-08-02,ireland,Europe,5040509,53,26149
2020-08-03,ireland,Europe,5040509,45,26194
2020-08-04,ireland,Europe,5040509,44,26238
2020-08-05,ireland,Europe,5040509,47,26285
2020-08-06,ireland,Europe,5040509,70,26355
2020-08-07,ireland,Europe,5040509,97,26452
2020-08-08,ireland,Europe,5040509,170,26622
2020-08-09,ireland,Europe,5040509,67,26689
2020-08-10,ireland,Europe,5040509,57,26746
2020-08-11,ireland,Europe,5040509,33,26779
2020-08-12,ireland,Europe,5040509,40,26819
2020-08-13,ireland,Europe,5040509,87,26906
2020-08-14,ireland,Europe,5040509,67,26973
2020-08-15,ireland,Europe,5040509,198,27171
2020-08-16,ireland,Europe,5040509,64,27235
2020-08-17,ireland,Europe,5040509,53,27288
2020-08-18,ireland,Europe,5040509,184,27472
2020-08-19,ireland,Europe,5040509,54,27526
2020-08-20,ireland,Europe,5040509,135,27661
2020-08-21,ireland,Europe,5040509,75,27736
2020-08-22,ireland,Europe,5040509,150,27886
2020-08-23,ireland,Europe,5040509,60,27946
2020-08-24,ireland,Europe,5040509,146,28092
2020-08-25,ireland,Europe,5040509,91,28183
2020-08-26,ireland,Europe,5040509,162,28345
2020-08-27,ireland,Europe,5040509,93,28438
2020-08-28,ireland,Europe,5040509,124,28562
2020-08-29,ireland,Europe,5040509,140,28702
2020-08-30,ireland,Europe,5040509,40,28742
2020-08-31,ireland,Europe,5040509,53,28795
2020-09-01,ireland,Europe,5040509,214,29009
2020-09-02,ireland,Europe,5040509,89,29098
2020-09-03,ireland,Europe,5040509,93,29191
2020-09-04,ireland,Europe,5040509,96,29287
2020-09-05,ireland,Europe,5040509,229,29516
2020-09-06,ireland,Europe,5040509,138,29654
2020-09-07,ireland,Europe,5040509,100,29754
2020-09-08,ireland,Europe,5040509,306,30060
2020-09-09,ireland,Europe,5040509,82,30142
2020-09-10,ireland,Europe,5040509,195,30337
2020-09-11,ireland,Europe,5040509,207,30544
2020-09-12,ireland,Europe,5040509,158,30702
2020-09-13,ireland,Europe,5040509,255,30957
2020-09-14,ireland,Europe,5040509,204,31161
2020-09-15,ireland,Europe,5040509,350,31511
2020-09-16,ireland,Europe,5040509,245,31756
2020-09-17,ireland,Europe,5040509,238,31994
2020-09-18,ireland,Europe,5040509,248,32242
2020-09-19,ireland,Europe,5040509,270,32512
2020-09-20,ireland,Europe,5040509,391,32903
2020-09-21,ireland,Europe,5040509,184,33087
2020-09-22,ireland,Europe,5040509,328,33415
2020-09-23,ireland,Europe,5040509,227,33642
2020-09-24,ireland,Europe,5040509,320,33962
2020-09-25,ireland,Europe,5040509,324,34286
2020-09-26,ireland,Europe,5040509,248,34534
2020-09-27,ireland,Europe,5040509,428,34962
2020-09-28,ireland,Europe,5040509,383,35345
2020-09-29,ireland,Europe,5040509,357,35702
2020-09-30,ireland,Europe,5040509,428,36130
2020-10-01,ireland,Europe,5040509,439,36569
2020-10-02,ireland,Europe,5040509,458,37027
2020-10-03,ireland,Europe,5040509,604,37631
2020-10-04,ireland,Europe,5040509,361,37992
2020-10-05,ireland,Europe,5040509,516,38508
2020-10-06,ireland,Europe,5040509,426,38934
2020-10-07,ireland,Europe,5040509,601,39535
2020-10-08,ireland,Europe,5040509,503,40038
2020-10-09,ireland,Europe,5040509,613,40651
2020-10-10,ireland,Europe,5040509,999,41650
2020-10-11,ireland,Europe,5040509,798,42448
2020-10-12,ireland,Europe,5040509,816,43264
2020-10-13,ireland,Europe,5040509,806,44070
2020-10-14,ireland,Europe,5040509,1072,45142
2020-10-15,ireland,Europe,5040509,1206,46348
2020-10-16,ireland,Europe,5040509,994,47342
2020-10-17,ireland,Europe,5040509,1267,48609
2020-10-18,ireland,Europe,5040509,1245,49854
2020-10-19,ireland,Europe,5040509,999,50853
2020-10-20,ireland,Europe,5040509,1249,52102
2020-10-21,ireland,Europe,5040509,1155,53257
2020-10-22,ireland,Europe,5040509,1060,54317
2020-10-23,ireland,Europe,5040509,755,55072
2020-10-24,ireland,Europe,5040509,838,55910
2020-10-25,ireland,Europe,5040509,1013,56923
2020-10-26,ireland,Europe,5040509,930,57853
2020-10-27,ireland,Europe,5040509,709,58562
2020-10-28,ireland,Europe,5040509,663,59225
2020-10-29,ireland,Europe,5040509,843,60068
2020-10-30,ireland,Europe,5040509,754,60822
2020-10-31,ireland,Europe,5040509,399,61221
2020-11-01,ireland,Europe,5040509,538,61759
2020-11-02,ireland,Europe,5040509,747,62506
2020-11-03,ireland,Europe,5040509,310,62816
2020-11-04,ireland,Europe,5040509,442,63258
2020-11-05,ireland,Europe,5040509,580,63838
2020-11-06,ireland,Europe,5040509,493,64331
2020-11-07,ireland,Europe,5040509,331,64662
2020-11-08,ireland,Europe,5040509,519,65181
2020-11-09,ireland,Europe,5040509,264,65445
2020-11-10,ireland,Europe,5040509,267,65712
2020-11-11,ireland,Europe,5040509,359,66071
2020-11-12,ireland,Europe,5040509,391,66462
2020-11-13,ireland,Europe,5040509,477,66939
2020-11-14,ireland,Europe,5040509,455,67394
2020-11-15,ireland,Europe,5040509,370,67764
2020-11-16,ireland,Europe,5040509,450,68214
2020-11-17,ireland,Europe,5040509,360,68574
2020-11-18,ireland,Europe,5040509,381,68955
2020-11-19,ireland,Europe,5040509,419,69374
2020-11-20,ireland,Europe,5040509,330,69704
2020-11-21,ireland,Europe,5040509,334,70038
2020-11-22,ireland,Europe,5040509,306,70344
2020-11-23,ireland,Europe,5040509,249,70593
2020-11-24,ireland,Europe,5040509,226,70819
2020-11-25,ireland,Europe,5040509,256,71075
2020-11-26,ireland,Europe,5040509,332,71407
2020-11-27,ireland,Europe,5040509,201,71608
2020-11-28,ireland,Europe,5040509,237,71845
2020-11-29,ireland,Europe,5040509,295,72140
2020-11-30,ireland,Europe,5040509,302,72442
2020-12-01,ireland,Europe,5040509,269,72711
2020-12-02,ireland,Europe,5040509,267,72978
2020-12-03,ireland,Europe,5040509,181,73159
2020-12-04,ireland,Europe,5040509,264,73423
2020-12-05,ireland,Europe,5040509,445,73868
2020-12-06,ireland,Europe,5040509,298,74166
2020-12-07,ireland,Europe,5040509,241,74407
2020-12-08,ireland,Europe,5040509,211,74618
2020-12-09,ireland,Europe,5040509,220,74838
2020-12-10,ireland,Europe,5040509,309,75147
2020-12-11,ireland,Europe,5040509,312,75459
2020-12-12,ireland,Europe,5040509,243,75702
2020-12-13,ireland,Europe,5040509,426,76128
2020-12-14,ireland,Europe,5040509,263,76391
2020-12-15,ireland,Europe,5040509,329,76720
2020-12-16,ireland,Europe,5040509,427,77147
2020-12-17,ireland,Europe,5040509,481,77628
2020-12-18,ireland,Europe,5040509,579,78207
2020-12-19,ireland,Europe,5040509,528,78735
2020-12-20,ireland,Europe,5040509,759,79494
2020-12-21,ireland,Europe,5040509,726,80220
2020-12-22,ireland,Europe,5040509,966,81186
2020-12-23,ireland,Europe,5040509,935,82121
2020-12-24,ireland,Europe,5040509,918,83039
2020-12-25,ireland,Europe,5040509,1017,84056
2020-12-26,ireland,Europe,5040509,1292,85348
2020-12-27,ireland,Europe,5040509,742,86090
2020-12-28,ireland,Europe,5040509,762,86852
2020-12-29,ireland,Europe,5040509,1545,88397
2020-12-30,ireland,Europe,5040509,1720,90117
2020-12-31,ireland,Europe,5040509,1606,91723
2021-01-01,ireland,Europe,5040509,1749,93472
2021-01-02,ireland,Europe,5040509,3382,96854
2021-01-03,ireland,Europe,5040509,4954,101808
2021-01-04,ireland,Europe,5040509,6101,107909
2021-01-05,ireland,Europe,5040509,5303,113212
2021-01-06,ireland,Europe,5040509,7799,121011
2021-01-07,ireland,Europe,5040509,6503,127514
2021-01-08,ireland,Europe,5040509,8236,135750
2021-01-09,ireland,Europe,5040509,4836,140586
2021-01-10,ireland,Europe,5040509,6831,147417
2021-01-11,ireland,Europe,5040509,4886,152303
2021-01-12,ireland,Europe,5040509,3070,155373
2021-01-13,ireland,Europe,5040509,3557,158930
2021-01-14,ireland,Europe,5040509,3946,162876
2021-01-15,ireland,Europe,5040509,3491,166367
2021-01-16,ireland,Europe,5040509,3221,169588
2021-01-17,ireland,Europe,5040509,2937,172525
2021-01-18,ireland,Europe,5040509,2110,174635
2021-01-19,ireland,Europe,5040509,1988,176623
2021-01-20,ireland,Europe,5040509,2473,179096
2021-01-21,ireland,Europe,5040509,2598,181694
2021-01-22,ireland,Europe,5040509,2364,184058
2021-01-23,ireland,Europe,5040509,1903,185961
2021-01-24,ireland,Europe,5040509,1369,187330
2021-01-25,ireland,Europe,5040509,1364,188694
2021-01-26,ireland,Europe,5040509,916,189610
2021-01-27,ireland,Europe,5040509,1327,190937
2021-01-28,ireland,Europe,5040509,1459,192396
2021-01-29,ireland,Europe,5040509,1243,193639
2021-01-30,ireland,Europe,5040509,1362,195001
2021-01-31,ireland,Europe,5040509,1243,196244
2021-02-01,ireland,Europe,5040509,1058,197302
2021-02-02,ireland,Europe,5040509,871,198173
2021-02-03,ireland,Europe,5040509,1007,199180
2021-02-04,ireland,Europe,5040509,1312,200492
2021-02-05,ireland,Europe,5040509,1040,201532
2021-02-06,ireland,Europe,5040509,827,202359
2021-02-07,ireland,Europe,5040509,1023,203382
2021-02-08,ireland,Europe,5040509,826,204208
2021-02-09,ireland,Europe,5040509,553,204761
2021-02-10,ireland,Europe,5040509,1004,205765
2021-02-11,ireland,Europe,5040509,861,206626
2021-02-12,ireland,Europe,5040509,920,207546
2021-02-13,ireland,Europe,5040509,1074,208620
2021-02-14,ireland,Europe,5040509,785,209405
2021-02-15,ireland,Europe,5040509,818,210223
2021-02-16,ireland,Europe,5040509,740,210963
2021-02-17,ireland,Europe,5040509,646,211609
2021-02-18,ireland,Europe,5040509,898,212507
2021-02-19,ireland,Europe,5040509,761,213268
2021-02-20,ireland,Europe,5040509,983,214251
2021-02-21,ireland,Europe,5040509,677,214928
2021-02-22,ireland,Europe,5040509,682,215610
2021-02-23,ireland,Europe,5040509,575,216185
2021-02-24,ireland,Europe,5040509,573,216758
2021-02-25,ireland,Europe,5040509,608,217366
2021-02-26,ireland,Europe,5040509,772,218138
2021-02-27,ireland,Europe,5040509,732,218870
2021-02-28,ireland,Europe,5040509,602,219472
2021-03-01,ireland,Europe,5040509,684,220156
2021-03-02,ireland,Europe,5040509,358,220514
2021-03-03,ireland,Europe,5040509,557,221071
2021-03-04,ireland,Europe,5040509,451,221522
2021-03-05,ireland,Europe,5040509,518,222040
2021-03-06,ireland,Europe,5040509,535,222575
2021-03-07,ireland,Europe,5040509,525,223100
2021-03-08,ireland,Europe,5040509,433,223533
2021-03-09,ireland,Europe,5040509,311,223844
2021-03-10,ireland,Europe,5040509,631,224475
2021-03-11,ireland,Europe,5040509,590,225065
2021-03-12,ireland,Europe,5040509,644,225709
2021-03-13,ireland,Europe,5040509,541,226250
2021-03-14,ireland,Europe,5040509,381,226631
2021-03-15,ireland,Europe,5040509,573,227204
2021-03-16,ireland,Europe,5040509,344,227548
2021-03-17,ireland,Europe,5040509,557,228105
2021-03-18,ireland,Europe,5040509,574,228679
2021-03-19,ireland,Europe,5040509,503,229182
2021-03-20,ireland,Europe,5040509,522,229704
2021-03-21,ireland,Europe,5040509,763,230467
2021-03-22,ireland,Europe,5040509,519,230986
2021-03-23,ireland,Europe,5040509,370,231356
2021-03-24,ireland,Europe,5040509,679,232035
2021-03-25,ireland,Europe,5040509,603,232638
2021-03-26,ireland,Europe,5040509,583,233221
2021-03-27,ireland,Europe,5040509,622,233843
2021-03-28,ireland,Europe,5040509,600,234443
2021-03-29,ireland,Europe,5040509,539,234982
2021-03-30,ireland,Europe,5040509,365,235347
2021-03-31,ireland,Europe,5040509,411,235758
2021-04-01,ireland,Europe,5040509,749,236507
2021-04-02,ireland,Europe,5040509,587,237094
2021-04-03,ireland,Europe,5040509,508,237602
2021-04-04,ireland,Europe,5040509,453,238055
2021-04-05,ireland,Europe,5040509,317,238372
2021-04-06,ireland,Europe,5040509,443,238815
2021-04-07,ireland,Europe,5040509,419,239234
2021-04-08,ireland,Europe,5040509,394,239628
2021-04-09,ireland,Europe,5040509,466,240094
2021-04-10,ireland,Europe,5040509,455,240549
2021-04-11,ireland,Europe,5040509,302,240851
2021-04-12,ireland,Europe,5040509,393,241244
2021-04-13,ireland,Europe,5040509,355,241599
2021-04-14,ireland,Europe,5040509,429,242028
2021-04-15,ireland,Europe,5040509,306,242334
2021-04-16,ireland,Europe,5040509,419,242753
2021-04-17,ireland,Europe,5040509,419,243172
2021-04-18,ireland,Europe,5040509,266,243438
2021-04-19,ireland,Europe,5040509,399,243837
2021-04-20,ireland,Europe,5040509,387,244224
2021-04-21,ireland,Europe,5040509,401,244625
2021-04-22,ireland,Europe,5040509,612,245237
2021-04-23,ireland,Europe,5040509,433,245670
2021-04-24,ireland,Europe,5040509,458,246128
2021-04-25,ireland,Europe,5040509,424,246552
2021-04-26,ireland,Europe,5040509,437,246989
2021-04-27,ireland,Europe,5040509,423,247412
2021-04-28,ireland,Europe,5040509,369,247781
2021-04-29,ireland,Europe,5040509,471,248252
2021-04-30,ireland,Europe,5040509,541,248793
2021-05-01,ireland,Europe,5040509,569,249362
2021-05-02,ireland,Europe,5040509,400,249762
2021-05-03,ireland,Europe,5040509,451,250213
2021-05-04,ireland,Europe,5040509,375,250588
2021-05-05,ireland,Europe,5040509,416,251004
2021-05-06,ireland,Europe,5040509,392,251396
2021-05-07,ireland,Europe,5040509,427,251823
2021-05-08,ireland,Europe,5040509,407,252230
2021-05-09,ireland,Europe,5040509,514,252744
2021-05-10,ireland,Europe,5040509,381,253125
2021-05-11,ireland,Europe,5040509,380,253505
2021-05-12,ireland,Europe,5040509,451,253956
2021-05-13,ireland,Europe,5040509,467,254423
2021-05-14,ireland,Europe,5040509,581,255004
2021-05-15,ireland,Europe,5040509,475,255479
2021-05-16,ireland,Europe,5040509,307,255786
2021-05-17,ireland,Europe,5040509,350,256136
2021-05-18,ireland,Europe,5040509,350,256486
2021-05-19,ireland,Europe,5040509,475,256961
2021-05-20,ireland,Europe,5040509,418,257379
2021-05-21,ireland,Europe,5040509,521,257900
2021-05-22,ireland,Europe,5040509,348,258248
2021-05-23,ireland,Europe,5040509,418,258666
2021-05-24,ireland,Europe,5040509,317,258983
2021-05-25,ireland,Europe,5040509,339,259322
2021-05-26,ireland,Europe,5040509,436,259758
2021-05-27,ireland,Europe,5040509,415,260173
2021-05-28,ireland,Europe,5040509,426,260599
2021-05-29,ireland,Europe,5040509,458,261057
2020-04-02,isle_of_man,Europe,85871,27,95
2020-04-03,isle_of_man,Europe,85871,19,114
2020-04-04,isle_of_man,Europe,85871,12,126
2020-04-05,isle_of_man,Europe,85871,1,127
2020-04-06,isle_of_man,Europe,85871,12,139
2020-04-07,isle_of_man,Europe,85871,11,150
2020-04-08,isle_of_man,Europe,85871,8,158
2020-04-09,isle_of_man,Europe,85871,32,190
2020-04-10,isle_of_man,Europe,85871,11,201
2020-04-11,isle_of_man,Europe,85871,25,226
2020-04-12,isle_of_man,Europe,85871,2,228
2020-04-13,isle_of_man,Europe,85871,14,242
2020-04-14,isle_of_man,Europe,85871,12,254
2020-04-15,isle_of_man,Europe,85871,2,256
2020-04-16,isle_of_man,Europe,85871,28,284
2020-04-17,isle_of_man,Europe,85871,7,291
2020-04-18,isle_of_man,Europe,85871,6,297
2020-04-19,isle_of_man,Europe,85871,1,298
2020-04-20,isle_of_man,Europe,85871,2,300
2020-04-21,isle_of_man,Europe,85871,7,307
2020-04-22,isle_of_man,Europe,85871,0,307
2020-04-23,isle_of_man,Europe,85871,0,307
2020-04-24,isle_of_man,Europe,85871,1,308
2020-04-25,isle_of_man,Europe,85871,0,308
2020-04-26,isle_of_man,Europe,85871,0,308
2020-04-27,isle_of_man,Europe,85871,0,308
2020-04-28,isle_of_man,Europe,85871,1,309
2020-04-29,isle_of_man,Europe,85871,4,313
2020-04-30,isle_of_man,Europe,85871,2,315
2020-05-01,isle_of_man,Europe,85871,1,316
2020-05-02,isle_of_man,Europe,85871,4,320
2020-05-03,isle_of_man,Europe,85871,1,321
2020-05-04,isle_of_man,Europe,85871,4,325
2020-05-05,isle_of_man,Europe,85871,1,326
2020-05-06,isle_of_man,Europe,85871,1,327
2020-05-07,isle_of_man,Europe,85871,2,329
2020-05-08,isle_of_man,Europe,85871,0,329
2020-05-09,isle_of_man,Europe,85871,0,329
2020-05-10,isle_of_man,Europe,85871,1,330
2020-05-11,isle_of_man,Europe,85871,0,330
2020-05-12,isle_of_man,Europe,85871,1,331
2020-05-13,isle_of_man,Europe,85871,1,332
2020-05-14,isle_of_man,Europe,85871,0,332
2020-05-15,isle_of_man,Europe,85871,2,334
2020-05-16,isle_of_man,Europe,85871,1,335
2020-05-17,isle_of_man,Europe,85871,0,335
2020-05-18,isle_of_man,Europe,85871,0,335
2020-05-19,isle_of_man,Europe,85871,0,335
2020-05-20,isle_of_man,Europe,85871,1,336
2020-05-21,isle_of_man,Europe,85871,0,336
2020-05-22,isle_of_man,Europe,85871,0,336
2020-05-23,isle_of_man,Europe,85871,0,336
2020-05-24,isle_of_man,Europe,85871,0,336
2020-05-25,isle_of_man,Europe,85871,0,336
2020-05-26,isle_of_man,Europe,85871,0,336
2020-05-27,isle_of_man,Europe,85871,0,336
2020-05-28,isle_of_man,Europe,85871,0,336
2020-05-29,isle_of_man,Europe,85871,0,336
2020-05-30,isle_of_man,Europe,85871,0,336
2020-05-31,isle_of_man,Europe,85871,0,336
2020-06-01,isle_of_man,Europe,85871,0,336
2020-06-02,isle_of_man,Europe,85871,0,336
2020-06-03,isle_of_man,Europe,85871,0,336
2020-06-04,isle_of_man,Europe,85871,0,336
2020-06-05,isle_of_man,Europe,85871,0,336
2020-06-06,isle_of_man,Europe,85871,0,336
2020-06-07,isle_of_man,Europe,85871,0,336
2020-06-08,isle_of_man,Europe,85871,0,336
2020-06-09,isle_of_man,Europe,85871,0,336
2020-06-10,isle_of_man,Europe,85871,0,336
2020-06-11,isle_of_man,Europe,85871,0,336
2020-06-12,isle_of_man,Europe,85871,0,336
2020-06-13,isle_of_man,Europe,85871,0,336
2020-06-14,isle_of_man,Europe,85871,0,336
2020-06-15,isle_of_man,Europe,85871,0,336
2020-06-16,isle_of_man,Europe,85871,0,336
2020-06-17,isle_of_man,Europe,85871,0,336
2020-06-18,isle_of_man,Europe,85871,0,336
2020-06-19,isle_of_man,Europe,85871,0,336
2020-06-20,isle_of_man,Europe,85871,0,336
2020-06-21,isle_of_man,Europe,85871,0,336
2020-06-22,isle_of_man,Europe,85871,0,336
2020-06-23,isle_of_man,Europe,85871,0,336
2020-06-24,isle_of_man,Europe,85871,0,336
2020-06-25,isle_of_man,Europe,85871,0,336
2020-06-26,isle_of_man,Europe,85871,0,336
2020-06-27,isle_of_man,Europe,85871,0,336
2020-06-28,isle_of_man,Europe,85871,0,336
2020-06-29,isle_of_man,Europe,85871,0,336
2020-06-30,isle_of_man,Europe,85871,0,336
2020-07-01,isle_of_man,Europe,85871,0,336
2020-07-02,isle_of_man,Europe,85871,0,336
2020-07-03,isle_of_man,Europe,85871,0,336
2020-07-04,isle_of_man,Europe,85871,0,336
2020-07-05,isle_of_man,Europe,85871,0,336
2020-07-06,isle_of_man,Europe,85871,0,336
2020-07-07,isle_of_man,Europe,85871,0,336
2020-07-08,isle_of_man,Europe,85871,0,336
2020-07-09,isle_of_man,Europe,85871,0,336
2020-07-10,isle_of_man,Europe,85871,0,336
2020-07-11,isle_of_man,Europe,85871,0,336
2020-07-12,isle_of_man,Europe,85871,0,336
2020-07-13,isle_of_man,Europe,85871,0,336
2020-07-14,isle_of_man,Europe,85871,0,336
2020-07-15,isle_of_man,Europe,85871,0,336
2020-07-16,isle_of_man,Europe,85871,0,336
2020-07-17,isle_of_man,Europe,85871,0,336
2020-07-18,isle_of_man,Europe,85871,0,336
2020-07-19,isle_of_man,Europe,85871,0,336
2020-07-20,isle_of_man,Europe,85871,0,336
2020-07-21,isle_of_man,Europe,85871,0,336
2020-07-22,isle_of_man,Europe,85871,0,336
2020-07-23,isle_of_man,Europe,85871,0,336
2020-07-24,isle_of_man,Europe,85871,0,336
2020-07-25,isle_of_man,Europe,85871,0,336
2020-07-26,isle_of_man,Europe,85871,0,336
2020-07-27,isle_of_man,Europe,85871,0,336
2020-07-28,isle_of_man,Europe,85871,0,336
2020-07-29,isle_of_man,Europe,85871,0,336
2020-07-30,isle_of_man,Europe,85871,0,336
2020-07-31,isle_of_man,Europe,85871,0,336
2020-08-01,isle_of_man,Europe,85871,0,336
2020-08-02,isle_of_man,Europe,85871,0,336
2020-08-03,isle_of_man,Europe,85871,0,336
2020-08-04,isle_of_man,Europe,85871,0,336
2020-08-05,isle_of_man,Europe,85871,0,336
2020-08-06,isle_of_man,Europe,85871,0,336
2020-08-07,isle_of_man,Europe,85871,0,336
2020-08-08,isle_of_man,Europe,85871,0,336
2020-08-09,isle_of_man,Europe,85871,0,336
2020-08-10,isle_of_man,Europe,85871,0,336
2020-08-11,isle_of_man,Europe,85871,0,336
2020-08-12,isle_of_man,Europe,85871,0,336
2020-08-13,isle_of_man,Europe,85871,0,336
2020-08-14,isle_of_man,Europe,85871,0,336
2020-08-15,isle_of_man,Europe,85871,0,336
2020-08-16,isle_of_man,Europe,85871,0,336
2020-08-17,isle_of_man,Europe,85871,0,336
2020-08-18,isle_of_man,Europe,85871,0,336
2020-08-19,isle_of_man,Europe,85871,0,336
2020-08-20,isle_of_man,Europe,85871,0,336
2020-08-21,isle_of_man,Europe,85871,0,336
2020-08-22,isle_of_man,Europe,85871,0,336
2020-08-23,isle_of_man,Europe,85871,0,336
2020-08-24,isle_of_man,Europe,85871,0,336
2020-08-25,isle_of_man,Europe,85871,0,336
2020-08-26,isle_of_man,Europe,85871,0,336
2020-08-27,isle_of_man,Europe,85871,0,336
2020-08-28,isle_of_man,Europe,85871,0,336
2020-08-29,isle_of_man,Europe,85871,0,336
2020-08-30,isle_of_man,Europe,85871,0,336
2020-08-31,isle_of_man,Europe,85871,0,336
2020-09-01,isle_of_man,Europe,85871,0,336
2020-09-02,isle_of_man,Europe,85871,0,336
2020-09-03,isle_of_man,Europe,85871,0,336
2020-09-04,isle_of_man,Europe,85871,0,336
2020-09-05,isle_of_man,Europe,85871,0,336
2020-09-06,isle_of_man,Europe,85871,1,337
2020-09-07,isle_of_man,Europe,85871,0,337
2020-09-08,isle_of_man,Europe,85871,0,337
2020-09-09,isle_of_man,Europe,85871,0,337
2020-09-10,isle_of_man,Europe,85871,0,337
2020-09-11,isle_of_man,Europe,85871,0,337
2020-09-12,isle_of_man,Europe,85871,0,337
2020-09-13,isle_of_man,Europe,85871,0,337
2020-09-14,isle_of_man,Europe,85871,2,339
2020-09-15,isle_of_man,Europe,85871,0,339
2020-09-16,isle_of_man,Europe,85871,0,339
2020-09-17,isle_of_man,Europe,85871,0,339
2020-09-18,isle_of_man,Europe,85871,0,339
2020-09-19,isle_of_man,Europe,85871,0,339
2020-09-20,isle_of_man,Europe,85871,0,339
2020-09-21,isle_of_man,Europe,85871,1,340
2020-09-22,isle_of_man,Europe,85871,0,340
2020-09-23,isle_of_man,Europe,85871,0,340
2020-09-24,isle_of_man,Europe,85871,0,340
2020-09-25,isle_of_man,Europe,85871,0,340
2020-09-26,isle_of_man,Europe,85871,0,340
2020-09-27,isle_of_man,Europe,85871,0,340
2020-09-28,isle_of_man,Europe,85871,0,340
2020-09-29,isle_of_man,Europe,85871,0,340
2020-09-30,isle_of_man,Europe,85871,0,340
2020-10-01,isle_of_man,Europe,85871,0,340
2020-10-02,isle_of_man,Europe,85871,1,341
2020-10-03,isle_of_man,Europe,85871,1,342
2020-10-04,isle_of_man,Europe,85871,0,342
2020-10-05,isle_of_man,Europe,85871,2,344
2020-10-06,isle_of_man,Europe,85871,1,345
2020-10-07,isle_of_man,Europe,85871,0,345
2020-10-08,isle_of_man,Europe,85871,0,345
2020-10-09,isle_of_man,Europe,85871,0,345
2020-10-10,isle_of_man,Europe,85871,0,345
2020-10-11,isle_of_man,Europe,85871,1,346
2020-10-12,isle_of_man,Europe,85871,0,346
2020-10-13,isle_of_man,Europe,85871,0,346
2020-10-14,isle_of_man,Europe,85871,2,348
2020-10-15,isle_of_man,Europe,85871,0,348
2020-10-16,isle_of_man,Europe,85871,0,348
2020-10-17,isle_of_man,Europe,85871,0,348
2020-10-18,isle_of_man,Europe,85871,0,348
2020-10-19,isle_of_man,Europe,85871,0,348
2020-10-20,isle_of_man,Europe,85871,0,348
2020-10-21,isle_of_man,Europe,85871,0,348
2020-10-22,isle_of_man,Europe,85871,0,348
2020-10-23,isle_of_man,Europe,85871,0,348
2020-10-24,isle_of_man,Europe,85871,0,348
2020-10-25,isle_of_man,Europe,85871,0,348
2020-10-26,isle_of_man,Europe,85871,3,351
2020-10-27,isle_of_man,Europe,85871,1,352
2020-10-28,isle_of_man,Europe,85871,0,352
2020-10-29,isle_of_man,Europe,85871,0,352
2020-10-30,isle_of_man,Europe,85871,1,353
2020-10-31,isle_of_man,Europe,85871,0,353
2020-11-01,isle_of_man,Europe,85871,0,353
2020-11-02,isle_of_man,Europe,85871,2,355
2020-11-03,isle_of_man,Europe,85871,1,356
2020-11-04,isle_of_man,Europe,85871,1,357
2020-11-05,isle_of_man,Europe,85871,0,357
2020-11-06,isle_of_man,Europe,85871,0,357
2020-11-07,isle_of_man,Europe,85871,0,357
2020-11-08,isle_of_man,Europe,85871,0,357
2020-11-09,isle_of_man,Europe,85871,0,357
2020-11-10,isle_of_man,Europe,85871,2,359
2020-11-11,isle_of_man,Europe,85871,2,361
2020-11-12,isle_of_man,Europe,85871,2,363
2020-11-13,isle_of_man,Europe,85871,0,363
2020-11-14,isle_of_man,Europe,85871,0,363
2020-11-15,isle_of_man,Europe,85871,0,363
2020-11-16,isle_of_man,Europe,85871,0,363
2020-11-17,isle_of_man,Europe,85871,1,364
2020-11-18,isle_of_man,Europe,85871,0,364
2020-11-19,isle_of_man,Europe,85871,2,366
2020-11-20,isle_of_man,Europe,85871,2,368
2020-11-21,isle_of_man,Europe,85871,0,368
2020-11-22,isle_of_man,Europe,85871,0,368
2020-11-23,isle_of_man,Europe,85871,1,369
2020-11-24,isle_of_man,Europe,85871,0,369
2020-11-25,isle_of_man,Europe,85871,0,369
2020-11-26,isle_of_man,Europe,85871,0,369
2020-11-27,isle_of_man,Europe,85871,0,369
2020-11-28,isle_of_man,Europe,85871,0,369
2020-11-29,isle_of_man,Europe,85871,0,369
2020-11-30,isle_of_man,Europe,85871,0,369
2020-12-01,isle_of_man,Europe,85871,0,369
2020-12-02,isle_of_man,Europe,85871,0,369
2020-12-03,isle_of_man,Europe,85871,0,369
2020-12-04,isle_of_man,Europe,85871,1,370
2020-12-05,isle_of_man,Europe,85871,0,370
2020-12-06,isle_of_man,Europe,85871,0,370
2020-12-07,isle_of_man,Europe,85871,0,370
2020-12-08,isle_of_man,Europe,85871,0,370
2020-12-09,isle_of_man,Europe,85871,0,370
2020-12-10,isle_of_man,Europe,85871,0,370
2020-12-11,isle_of_man,Europe,85871,0,370
2020-12-12,isle_of_man,Europe,85871,0,370
2020-12-13,isle_of_man,Europe,85871,0,370
2020-12-14,isle_of_man,Europe,85871,3,373
2020-12-15,isle_of_man,Europe,85871,0,373
2020-12-16,isle_of_man,Europe,85871,0,373
2020-12-17,isle_of_man,Europe,85871,0,373
2020-12-18,isle_of_man,Europe,85871,0,373
2020-12-19,isle_of_man,Europe,85871,0,373
2020-12-20,isle_of_man,Europe,85871,0,373
2020-12-21,isle_of_man,Europe,85871,1,374
2020-12-22,isle_of_man,Europe,85871,0,374
2020-12-23,isle_of_man,Europe,85871,0,374
2020-12-24,isle_of_man,Europe,85871,0,374
2020-12-25,isle_of_man,Europe,85871,0,374
2020-12-26,isle_of_man,Europe,85871,0,374
2020-12-27,isle_of_man,Europe,85871,0,374
2020-12-28,isle_of_man,Europe,85871,0,374
2020-12-29,isle_of_man,Europe,85871,0,374
2020-12-30,isle_of_man,Europe,85871,3,377
2020-12-31,isle_of_man,Europe,85871,0,377
2021-01-01,isle_of_man,Europe,85871,0,377
2021-01-02,isle_of_man,Europe,85871,3,380
2021-01-03,isle_of_man,Europe,85871,0,380
2021-01-04,isle_of_man,Europe,85871,0,380
2021-01-05,isle_of_man,Europe,85871,6,386
2021-01-06,isle_of_man,Europe,85871,3,389
2021-01-07,isle_of_man,Europe,85871,1,390
2021-01-08,isle_of_man,Europe,85871,2,392
2021-01-09,isle_of_man,Europe,85871,2,394
2021-01-10,isle_of_man,Europe,85871,2,396
2021-01-11,isle_of_man,Europe,85871,7,403
2021-01-12,isle_of_man,Europe,85871,3,406
2021-01-13,isle_of_man,Europe,85871,8,414
2021-01-14,isle_of_man,Europe,85871,3,417
2021-01-15,isle_of_man,Europe,85871,1,418
2021-01-16,isle_of_man,Europe,85871,1,419
2021-01-17,isle_of_man,Europe,85871,9,428
2021-01-18,isle_of_man,Europe,85871,4,432
2021-01-19,isle_of_man,Europe,85871,0,432
2021-01-20,isle_of_man,Europe,85871,0,432
2021-01-21,isle_of_man,Europe,85871,0,432
2021-01-22,isle_of_man,Europe,85871,0,432
2021-01-23,isle_of_man,Europe,85871,0,432
2021-01-24,isle_of_man,Europe,85871,0,432
2021-01-25,isle_of_man,Europe,85871,0,432
2021-01-26,isle_of_man,Europe,85871,0,432
2021-01-27,isle_of_man,Europe,85871,0,432
2021-01-28,isle_of_man,Europe,85871,0,432
2021-01-29,isle_of_man,Europe,85871,2,434
2021-01-30,isle_of_man,Europe,85871,0,434
2021-01-31,isle_of_man,Europe,85871,0,434
2021-02-01,isle_of_man,Europe,85871,0,434
2021-02-02,isle_of_man,Europe,85871,0,434
2021-02-03,isle_of_man,Europe,85871,0,434
2021-02-04,isle_of_man,Europe,85871,0,434
2021-02-05,isle_of_man,Europe,85871,0,434
2021-02-06,isle_of_man,Europe,85871,0,434
2021-02-07,isle_of_man,Europe,85871,0,434
2021-02-08,isle_of_man,Europe,85871,1,435
2021-02-09,isle_of_man,Europe,85871,1,436
2021-02-10,isle_of_man,Europe,85871,0,436
2021-02-11,isle_of_man,Europe,85871,0,436
2021-02-12,isle_of_man,Europe,85871,0,436
2021-02-13,isle_of_man,Europe,85871,0,436
2021-02-14,isle_of_man,Europe,85871,0,436
2021-02-15,isle_of_man,Europe,85871,0,436
2021-02-16,isle_of_man,Europe,85871,1,437
2021-02-17,isle_of_man,Europe,85871,0,437
2021-02-18,isle_of_man,Europe,85871,7,444
2021-02-19,isle_of_man,Europe,85871,5,449
2021-02-20,isle_of_man,Europe,85871,1,450
2021-02-21,isle_of_man,Europe,85871,0,450
2021-02-22,isle_of_man,Europe,85871,6,456
2021-02-23,isle_of_man,Europe,85871,6,462
2021-02-24,isle_of_man,Europe,85871,8,470
2021-02-25,isle_of_man,Europe,85871,5,475
2021-02-26,isle_of_man,Europe,85871,0,475
2021-02-27,isle_of_man,Europe,85871,9,484
2021-02-28,isle_of_man,Europe,85871,0,484
2021-03-01,isle_of_man,Europe,85871,2,486
2021-03-02,isle_of_man,Europe,85871,8,494
2021-03-03,isle_of_man,Europe,85871,16,510
2021-03-04,isle_of_man,Europe,85871,36,546
2021-03-05,isle_of_man,Europe,85871,59,605
2021-03-06,isle_of_man,Europe,85871,71,676
2021-03-07,isle_of_man,Europe,85871,81,757
2021-03-08,isle_of_man,Europe,85871,108,865
2021-03-09,isle_of_man,Europe,85871,87,952
2021-03-10,isle_of_man,Europe,85871,74,1026
2021-03-11,isle_of_man,Europe,85871,65,1091
2021-03-12,isle_of_man,Europe,85871,66,1157
2021-03-13,isle_of_man,Europe,85871,77,1234
2021-03-14,isle_of_man,Europe,85871,44,1278
2021-03-15,isle_of_man,Europe,85871,29,1307
2021-03-16,isle_of_man,Europe,85871,44,1351
2021-03-17,isle_of_man,Europe,85871,32,1383
2021-03-18,isle_of_man,Europe,85871,28,1411
2021-03-19,isle_of_man,Europe,85871,21,1432
2021-03-20,isle_of_man,Europe,85871,30,1462
2021-03-21,isle_of_man,Europe,85871,24,1486
2021-03-22,isle_of_man,Europe,85871,17,1503
2021-03-23,isle_of_man,Europe,85871,13,1516
2021-03-24,isle_of_man,Europe,85871,14,1530
2021-03-25,isle_of_man,Europe,85871,15,1545
2021-03-26,isle_of_man,Europe,85871,6,1551
2021-03-27,isle_of_man,Europe,85871,4,1555
2021-03-28,isle_of_man,Europe,85871,3,1558
2021-03-29,isle_of_man,Europe,85871,8,1566
2021-03-30,isle_of_man,Europe,85871,1,1567
2021-03-31,isle_of_man,Europe,85871,2,1569
2021-04-01,isle_of_man,Europe,85871,1,1570
2021-04-02,isle_of_man,Europe,85871,0,1570
2021-04-03,isle_of_man,Europe,85871,1,1571
2021-04-04,isle_of_man,Europe,85871,0,1571
2021-04-05,isle_of_man,Europe,85871,0,1571
2021-04-06,isle_of_man,Europe,85871,1,1572
2021-04-07,isle_of_man,Europe,85871,0,1572
2021-04-08,isle_of_man,Europe,85871,2,1574
2021-04-09,isle_of_man,Europe,85871,0,1574
2021-04-10,isle_of_man,Europe,85871,1,1575
2021-04-11,isle_of_man,Europe,85871,0,1575
2021-04-12,isle_of_man,Europe,85871,0,1575
2021-04-13,isle_of_man,Europe,85871,0,1575
2021-04-14,isle_of_man,Europe,85871,0,1575
2021-04-15,isle_of_man,Europe,85871,0,1575
2021-04-16,isle_of_man,Europe,85871,0,1575
2021-04-17,isle_of_man,Europe,85871,0,1575
2021-04-18,isle_of_man,Europe,85871,2,1577
2021-04-19,isle_of_man,Europe,85871,0,1577
2021-04-20,isle_of_man,Europe,85871,0,1577
2021-04-21,isle_of_man,Europe,85871,5,1582
2021-04-22,isle_of_man,Europe,85871,2,1584
2021-04-23,isle_of_man,Europe,85871,1,1585
2021-04-24,isle_of_man,Europe,85871,0,1585
2021-04-25,isle_of_man,Europe,85871,1,1586
2021-04-26,isle_of_man,Europe,85871,1,1587
2021-04-27,isle_of_man,Europe,85871,0,1587
2021-04-28,isle_of_man,Europe,85871,0,1587
2021-04-29,isle_of_man,Europe,85871,0,1587
2021-04-30,isle_of_man,Europe,85871,0,1587
2021-05-01,isle_of_man,Europe,85871,2,1589
2021-05-02,isle_of_man,Europe,85871,1,1590
2021-05-03,isle_of_man,Europe,85871,0,1590
2021-05-04,isle_of_man,Europe,85871,0,1590
2021-05-05,isle_of_man,Europe,85871,0,1590
2021-05-06,isle_of_man,Europe,85871,0,1590
2021-05-07,isle_of_man,Europe,85871,0,1590
2021-05-08,isle_of_man,Europe,85871,0,1590
2021-05-09,isle_of_man,Europe,85871,0,1590
2021-05-10,isle_of_man,Europe,85871,0,1590
2021-05-11,isle_of_man,Europe,85871,0,1590
2021-05-12,isle_of_man,Europe,85871,0,1590
2021-05-13,isle_of_man,Europe,85871,0,1590
2021-05-14,isle_of_man,Europe,85871,0,1590
2021-05-15,isle_of_man,Europe,85871,0,1590
2021-05-16,isle_of_man,Europe,85871,0,1590
2021-05-17,isle_of_man,Europe,85871,1,1591
2021-05-18,isle_of_man,Europe,85871,0,1591
2021-05-19,isle_of_man,Europe,85871,0,1591
2021-05-20,isle_of_man,Europe,85871,0,1591
2021-05-21,isle_of_man,Europe,85871,0,1591
2021-05-22,isle_of_man,Europe,85871,0,1591
2021-05-23,isle_of_man,Europe,85871,0,1591
2021-05-24,isle_of_man,Europe,85871,0,1591
2021-05-25,isle_of_man,Europe,85871,0,1591
2021-05-26,isle_of_man,Europe,85871,0,1591
2021-05-27,isle_of_man,Europe,85871,0,1591
2021-05-28,isle_of_man,Europe,85871,1,1592
2021-05-29,isle_of_man,Europe,85871,0,1592
2021-05-30,isle_of_man,Europe,85871,0,1592
2021-05-31,isle_of_man,Europe,85871,0,1592
2021-06-01,isle_of_man,Europe,85871,2,1594
2021-06-02,isle_of_man,Europe,85871,0,1594
2021-06-03,isle_of_man,Europe,85871,1,1595
2021-06-04,isle_of_man,Europe,85871,2,1597
2021-06-05,isle_of_man,Europe,85871,0,1597
2021-06-06,isle_of_man,Europe,85871,1,1598
2021-06-07,isle_of_man,Europe,85871,0,1598
2021-06-08,isle_of_man,Europe,85871,0,1598
2021-06-09,isle_of_man,Europe,85871,1,1599
2021-06-10,isle_of_man,Europe,85871,0,1599
2021-06-11,isle_of_man,Europe,85871,0,1599
2021-06-12,isle_of_man,Europe,85871,0,1599
2021-06-13,isle_of_man,Europe,85871,0,1599
2021-06-14,isle_of_man,Europe,85871,0,1599
2021-06-15,isle_of_man,Europe,85871,0,1599
2021-06-16,isle_of_man,Europe,85871,0,1599
2021-06-17,isle_of_man,Europe,85871,0,1599
2021-06-18,isle_of_man,Europe,85871,0,1599
2021-06-19,isle_of_man,Europe,85871,0,1599
2021-06-20,isle_of_man,Europe,85871,0,1599
2021-06-21,isle_of_man,Europe,85871,0,1599
2021-06-22,isle_of_man,Europe,85871,2,1601
2021-06-23,isle_of_man,Europe,85871,2,1603
2021-06-24,isle_of_man,Europe,85871,0,1603
2021-06-25,isle_of_man,Europe,85871,1,1604
2021-06-26,isle_of_man,Europe,85871,1,1605
2021-06-27,isle_of_man,Europe,85871,3,1608
2021-06-28,isle_of_man,Europe,85871,1,1609
2021-06-29,isle_of_man,Europe,85871,2,1611
2021-06-30,isle_of_man,Europe,85871,2,1613
2021-07-01,isle_of_man,Europe,85871,7,1620
2021-07-02,isle_of_man,Europe,85871,5,1625
2021-07-03,isle_of_man,Europe,85871,7,1632
2021-07-04,isle_of_man,Europe,85871,6,1638
2021-07-05,isle_of_man,Europe,85871,0,1638
2021-07-06,isle_of_man,Europe,85871,5,1643
2021-07-07,isle_of_man,Europe,85871,7,1650
2021-07-08,isle_of_man,Europe,85871,2,1652
2021-07-09,isle_of_man,Europe,85871,7,1659
2021-07-10,isle_of_man,Europe,85871,25,1684
2021-07-11,isle_of_man,Europe,85871,7,1691
2021-07-12,isle_of_man,Europe,85871,18,1709
2021-07-13,isle_of_man,Europe,85871,30,1739
2021-07-14,isle_of_man,Europe,85871,52,1791
2021-07-15,isle_of_man,Europe,85871,116,1907
2021-07-16,isle_of_man,Europe,85871,28,1935
2021-07-17,isle_of_man,Europe,85871,139,2074
2021-07-18,isle_of_man,Europe,85871,233,2307
2021-07-19,isle_of_man,Europe,85871,238,2545
2021-07-20,isle_of_man,Europe,85871,211,2756
2021-07-21,isle_of_man,Europe,85871,234,2990
2021-07-22,isle_of_man,Europe,85871,434,3424
2021-07-23,isle_of_man,Europe,85871,225,3649
2021-07-24,isle_of_man,Europe,85871,114,3763
2021-07-25,isle_of_man,Europe,85871,260,4023
2021-07-26,isle_of_man,Europe,85871,166,4189
2021-07-27,isle_of_man,Europe,85871,85,4274
2021-07-28,isle_of_man,Europe,85871,59,4333
2021-07-29,isle_of_man,Europe,85871,192,4525
2021-07-30,isle_of_man,Europe,85871,141,4666
2021-07-31,isle_of_man,Europe,85871,94,4760
2021-08-01,isle_of_man,Europe,85871,58,4818
2021-08-02,isle_of_man,Europe,85871,94,4912
2021-08-03,isle_of_man,Europe,85871,110,5022
2021-08-04,isle_of_man,Europe,85871,123,5145
2021-08-05,isle_of_man,Europe,85871,90,5235
2021-08-06,isle_of_man,Europe,85871,102,5337
2021-08-07,isle_of_man,Europe,85871,90,5427
2021-08-08,isle_of_man,Europe,85871,75,5502
2021-08-09,isle_of_man,Europe,85871,85,5587
2021-08-10,isle_of_man,Europe,85871,71,5658
2021-08-11,isle_of_man,Europe,85871,59,5717
2021-08-12,isle_of_man,Europe,85871,70,5787
2021-08-13,isle_of_man,Europe,85871,70,5857
2021-08-14,isle_of_man,Europe,85871,58,5915
2021-08-15,isle_of_man,Europe,85871,36,5951
2021-08-16,isle_of_man,Europe,85871,62,6013
2021-08-17,isle_of_man,Europe,85871,57,6070
2021-08-18,isle_of_man,Europe,85871,42,6112
2021-08-19,isle_of_man,Europe,85871,55,6167
2021-08-20,isle_of_man,Europe,85871,65,6232
2021-08-21,isle_of_man,Europe,85871,42,6274
2021-08-22,isle_of_man,Europe,85871,38,6312
2021-08-23,isle_of_man,Europe,85871,54,6366
2021-08-24,isle_of_man,Europe,85871,53,6419
2021-08-25,isle_of_man,Europe,85871,39,6458
2021-08-26,isle_of_man,Europe,85871,50,6508
2021-08-27,isle_of_man,Europe,85871,46,6554
2021-08-28,isle_of_man,Europe,85871,33,6587
2021-08-29,isle_of_man,Europe,85871,42,6629
2021-08-30,isle_of_man,Europe,85871,24,6653
2021-08-31,isle_of_man,Europe,85871,23,6676
2021-09-01,isle_of_man,Europe,85871,18,6694
2021-09-02,isle_of_man,Europe,85871,47,6741
2021-09-03,isle_of_man,Europe,85871,38,6779
2021-09-04,isle_of_man,Europe,85871,30,6809
2021-09-05,isle_of_man,Europe,85871,23,6832
2021-09-06,isle_of_man,Europe,85871,17,6849
2021-09-07,isle_of_man,Europe,85871,34,6883
2021-09-08,isle_of_man,Europe,85871,40,6923
2021-09-09,isle_of_man,Europe,85871,29,6952
2021-09-10,isle_of_man,Europe,85871,28,6980
2021-09-11,isle_of_man,Europe,85871,18,6998
2021-09-12,isle_of_man,Europe,85871,10,7008
2021-09-13,isle_of_man,Europe,85871,20,7028
2021-09-14,isle_of_man,Europe,85871,22,7050
2021-09-15,isle_of_man,Europe,85871,18,7068
2021-09-16,isle_of_man,Europe,85871,26,7094
2021-09-17,isle_of_man,Europe,85871,19,7113
2021-09-18,isle_of_man,Europe,85871,28,7141
2021-09-19,isle_of_man,Europe,85871,25,7166
2021-09-20,isle_of_man,Europe,85871,18,7184
2021-09-21,isle_of_man,Europe,85871,34,7218
2021-09-22,isle_of_man,Europe,85871,47,7265
2021-09-23,isle_of_man,Europe,85871,35,7300
2021-09-24,isle_of_man,Europe,85871,24,7324
2021-09-25,isle_of_man,Europe,85871,40,7364
2021-09-26,isle_of_man,Europe,85871,63,7427
2021-09-27,isle_of_man,Europe,85871,28,7455
2021-09-28,isle_of_man,Europe,85871,55,7510
2021-09-29,isle_of_man,Europe,85871,34,7544
2021-09-30,isle_of_man,Europe,85871,38,7582
2021-10-01,isle_of_man,Europe,85871,29,7611
2021-10-02,isle_of_man,Europe,85871,23,7634
2021-10-03,isle_of_man,Europe,85871,37,7671
2021-10-04,isle_of_man,Europe,85871,27,7698
2021-10-05,isle_of_man,Europe,85871,72,7770
2021-10-06,isle_of_man,Europe,85871,73,7843
2021-10-07,isle_of_man,Europe,85871,56,7899
2021-10-08,isle_of_man,Europe,85871,60,7959
2021-10-09,isle_of_man,Europe,85871,69,8028
2021-10-10,isle_of_man,Europe,85871,45,8073
2021-10-11,isle_of_man,Europe,85871,48,8121
2021-10-12,isle_of_man,Europe,85871,63,8184
2021-10-13,isle_of_man,Europe,85871,70,8254
2021-10-14,isle_of_man,Europe,85871,89,8343
2021-10-15,isle_of_man,Europe,85871,87,8430
2021-10-16,isle_of_man,Europe,85871,68,8498
2021-10-17,isle_of_man,Europe,85871,80,8578
2021-10-18,isle_of_man,Europe,85871,69,8647
2021-10-19,isle_of_man,Europe,85871,95,8742
2021-10-20,isle_of_man,Europe,85871,75,8817
2021-10-21,isle_of_man,Europe,85871,114,8931
2021-10-22,isle_of_man,Europe,85871,111,9042
2021-10-23,isle_of_man,Europe,85871,65,9107
2021-10-24,isle_of_man,Europe,85871,90,9197
2021-10-25,isle_of_man,Europe,85871,61,9258
2021-10-26,isle_of_man,Europe,85871,69,9327
2021-10-27,isle_of_man,Europe,85871,90,9417
2021-10-28,isle_of_man,Europe,85871,100,9517
2021-10-29,isle_of_man,Europe,85871,70,9587
2021-10-30,isle_of_man,Europe,85871,57,9644
2021-10-31,isle_of_man,Europe,85871,47,9691
2021-11-01,isle_of_man,Europe,85871,47,9738
2021-11-02,isle_of_man,Europe,85871,58,9796
2021-11-03,isle_of_man,Europe,85871,48,9844
2021-11-04,isle_of_man,Europe,85871,39,9883
2021-11-05,isle_of_man,Europe,85871,0,9883
2021-11-06,isle_of_man,Europe,85871,59,9942
2021-11-07,isle_of_man,Europe,85871,28,9970
2021-11-08,isle_of_man,Europe,85871,21,9991
2021-11-09,isle_of_man,Europe,85871,55,10046
2021-11-10,isle_of_man,Europe,85871,60,10106
2021-11-11,isle_of_man,Europe,85871,53,10159
2021-11-12,isle_of_man,Europe,85871,35,10194
2021-11-13,isle_of_man,Europe,85871,31,10225
2021-11-14,isle_of_man,Europe,85871,30,10255
2021-11-15,isle_of_man,Europe,85871,41,10296
2021-11-16,isle_of_man,Europe,85871,58,10354
2021-11-17,isle_of_man,Europe,85871,58,10412
2021-11-18,isle_of_man,Europe,85871,43,10455
2021-11-19,isle_of_man,Europe,85871,49,10504
2021-11-20,isle_of_man,Europe,85871,54,10558
2021-11-21,isle_of_man,Europe,85871,52,10610
2021-11-22,isle_of_man,Europe,85871,40,10650
2021-11-23,isle_of_man,Europe,85871,70,10720
2021-11-24,isle_of_man,Europe,85871,77,10797
2021-11-25,isle_of_man,Europe,85871,98,10895
2021-11-26,isle_of_man,Europe,85871,98,10993
2021-11-27,isle_of_man,Europe,85871,92,11085
2021-11-28,isle_of_man,Europe,85871,67,11152
2021-11-29,isle_of_man,Europe,85871,78,11230
2021-11-30,isle_of_man,Europe,85871,109,11339
2021-12-01,isle_of_man,Europe,85871,147,11486
2021-12-02,isle_of_man,Europe,85871,128,11614
2021-12-03,isle_of_man,Europe,85871,150,11764
2021-12-04,isle_of_man,Europe,85871,97,11861
2021-12-05,isle_of_man,Europe,85871,65,11926
2021-12-06,isle_of_man,Europe,85871,109,12035
2021-12-07,isle_of_man,Europe,85871,112,12147
2021-12-08,isle_of_man,Europe,85871,83,12230
2021-12-09,isle_of_man,Europe,85871,116,12346
2021-12-10,isle_of_man,Europe,85871,95,12441
2021-12-11,isle_of_man,Europe,85871,78,12519
2021-12-12,isle_of_man,Europe,85871,61,12580
2021-12-13,isle_of_man,Europe,85871,63,12643
2021-12-14,isle_of_man,Europe,85871,88,12731
2021-12-15,isle_of_man,Europe,85871,81,12812
2021-12-16,isle_of_man,Europe,85871,83,12895
2021-12-17,isle_of_man,Europe,85871,79,12974
2021-12-18,isle_of_man,Europe,85871,63,13037
2021-12-19,isle_of_man,Europe,85871,60,13097
2021-12-20,isle_of_man,Europe,85871,57,13154
2021-12-21,isle_of_man,Europe,85871,104,13258
2021-12-22,isle_of_man,Europe,85871,106,13364
2021-12-23,isle_of_man,Europe,85871,215,13579
2021-12-24,isle_of_man,Europe,85871,161,13740
2021-12-25,isle_of_man,Europe,85871,162,13902
2021-12-26,isle_of_man,Europe,85871,116,14018
2021-12-27,isle_of_man,Europe,85871,197,14215
2021-12-28,isle_of_man,Europe,85871,264,14479
2021-12-29,isle_of_man,Europe,85871,290,14769
2021-12-30,isle_of_man,Europe,85871,576,15345
2021-12-31,isle_of_man,Europe,85871,504,15849
2022-01-01,isle_of_man,Europe,85871,429,16278
2022-01-02,isle_of_man,Europe,85871,292,16570
2022-01-03,isle_of_man,Europe,85871,381,16951
2022-01-04,isle_of_man,Europe,85871,441,17392
2022-01-05,isle_of_man,Europe,85871,513,17905
2022-01-06,isle_of_man,Europe,85871,325,18230
2022-01-07,isle_of_man,Europe,85871,265,18495
2022-01-08,isle_of_man,Europe,85871,239,18734
2022-01-09,isle_of_man,Europe,85871,162,18896
2022-01-10,isle_of_man,Europe,85871,146,19042
2022-01-11,isle_of_man,Europe,85871,306,19348
2020-02-16,italy,Europe,60296265,0,3
2020-02-17,italy,Europe,60296265,0,3
2020-02-18,italy,Europe,60296265,0,3
2020-02-19,italy,Europe,60296265,0,3
2020-02-20,italy,Europe,60296265,1,4
2020-02-21,italy,Europe,60296265,17,21
2020-02-22,italy,Europe,60296265,58,79
2020-02-23,italy,Europe,60296265,78,157
2020-02-24,italy,Europe,60296265,72,229
2020-02-25,italy,Europe,60296265,94,323
2020-02-26,italy,Europe,60296265,147,470
2020-02-27,italy,Europe,60296265,185,655
2020-02-28,italy,Europe,60296265,235,890
2020-02-29,italy,Europe,60296265,241,1131
2020-03-01,italy,Europe,60296265,576,1707
2020-03-02,italy,Europe,60296265,338,2045
2020-03-03,italy,Europe,60296265,468,2513
2020-03-04,italy,Europe,60296265,590,3103
2020-03-05,italy,Europe,60296265,773,3876
2020-03-06,italy,Europe,60296265,782,4658
2020-03-07,italy,Europe,60296265,1253,5911
2020-03-08,italy,Europe,60296265,1501,7412
2020-03-09,italy,Europe,60296265,1807,9219
2020-03-10,italy,Europe,60296265,981,10200
2020-03-11,italy,Europe,60296265,2324,12524
2020-03-12,italy,Europe,60296265,2666,15190
2020-03-13,italy,Europe,60296265,2559,17749
2020-03-14,italy,Europe,60296265,3516,21265
2020-03-15,italy,Europe,60296265,3611,24876
2020-03-16,italy,Europe,60296265,3250,28126
2020-03-17,italy,Europe,60296265,3544,31670
2020-03-18,italy,Europe,60296265,4228,35898
2020-03-19,italy,Europe,60296265,5349,41247
2020-03-20,italy,Europe,60296265,6018,47265
2020-03-21,italy,Europe,60296265,6586,53851
2020-03-22,italy,Europe,60296265,5588,59439
2020-03-23,italy,Europe,60296265,4806,64245
2020-03-24,italy,Europe,60296265,5265,69510
2020-03-25,italy,Europe,60296265,5223,74733
2020-03-26,italy,Europe,60296265,6232,80965
2020-03-27,italy,Europe,60296265,5936,86901
2020-03-28,italy,Europe,60296265,6003,92904
2020-03-29,italy,Europe,60296265,5240,98144
2020-03-30,italy,Europe,60296265,4067,102211
2020-03-31,italy,Europe,60296265,4073,106284
2020-04-01,italy,Europe,60296265,4806,111090
2020-04-02,italy,Europe,60296265,4691,115781
2020-04-03,italy,Europe,60296265,4607,120388
2020-04-04,italy,Europe,60296265,4830,125218
2020-04-05,italy,Europe,60296265,4339,129557
2020-04-06,italy,Europe,60296265,3617,133174
2020-04-07,italy,Europe,60296265,3050,136224
2020-04-08,italy,Europe,60296265,3852,140076
2020-04-09,italy,Europe,60296265,4224,144300
2020-04-10,italy,Europe,60296265,3969,148269
2020-04-11,italy,Europe,60296265,4720,152989
2020-04-12,italy,Europe,60296265,4114,157103
2020-04-13,italy,Europe,60296265,3168,160271
2020-04-14,italy,Europe,60296265,2986,163257
2020-04-15,italy,Europe,60296265,2679,165936
2020-04-16,italy,Europe,60296265,3805,169741
2020-04-17,italy,Europe,60296265,3511,173252
2020-04-18,italy,Europe,60296265,3509,176761
2020-04-19,italy,Europe,60296265,3060,179821
2020-03-19,jamaica,North America,2985238,0,15
2020-03-20,jamaica,North America,2985238,4,19
2020-03-21,jamaica,North America,2985238,0,19
2020-03-22,jamaica,North America,2985238,0,19
2020-03-23,jamaica,North America,2985238,0,19
2020-03-24,jamaica,North America,2985238,2,21
2020-03-25,jamaica,North America,2985238,5,26
2020-03-26,jamaica,North America,2985238,0,26
2020-03-27,jamaica,North America,2985238,0,26
2020-03-28,jamaica,North America,2985238,4,30
2020-03-29,jamaica,North America,2985238,2,32
2020-03-30,jamaica,North America,2985238,4,36
2020-03-31,jamaica,North America,2985238,2,38
2020-04-01,jamaica,North America,2985238,6,44
2020-04-02,jamaica,North America,2985238,3,47
2020-04-03,jamaica,North America,2985238,6,53
2020-04-04,jamaica,North America,2985238,0,53
2020-04-05,jamaica,North America,2985238,5,58
2020-04-06,jamaica,North America,2985238,1,59
2020-04-07,jamaica,North America,2985238,4,63
2020-04-08,jamaica,North America,2985238,0,63
2020-04-09,jamaica,North America,2985238,0,63
2020-04-10,jamaica,North America,2985238,0,63
2020-04-11,jamaica,North America,2985238,6,69
2020-04-12,jamaica,North America,2985238,3,72
2020-04-13,jamaica,North America,2985238,1,73
2020-04-14,jamaica,North America,2985238,32,105
2020-04-15,jamaica,North America,2985238,20,125
2020-04-16,jamaica,North America,2985238,18,143
2020-04-17,jamaica,North America,2985238,0,143
2020-04-18,jamaica,North America,2985238,20,163
2020-04-19,jamaica,North America,2985238,10,173
2020-04-20,jamaica,North America,2985238,50,223
2020-04-21,jamaica,North America,2985238,5,228
2020-04-22,jamaica,North America,2985238,24,252
2020-04-23,jamaica,North America,2985238,0,252
2020-04-24,jamaica,North America,2985238,5,257
2020-04-25,jamaica,North America,2985238,31,288
2020-04-26,jamaica,North America,2985238,17,305
2020-04-27,jamaica,North America,2985238,45,350
2020-04-28,jamaica,North America,2985238,14,364
2020-04-29,jamaica,North America,2985238,32,396
2020-04-30,jamaica,North America,2985238,0,396
2020-05-01,jamaica,North America,2985238,26,422
2020-05-02,jamaica,North America,2985238,10,432
2020-05-03,jamaica,North America,2985238,31,463
2020-05-04,jamaica,North America,2985238,6,469
2020-05-05,jamaica,North America,2985238,2,471
2020-05-06,jamaica,North America,2985238,2,473
2020-05-07,jamaica,North America,2985238,5,478
2020-05-08,jamaica,North America,2985238,10,488
2020-05-09,jamaica,North America,2985238,2,490
2020-05-10,jamaica,North America,2985238,8,498
2020-05-11,jamaica,North America,2985238,4,502
2020-05-12,jamaica,North America,2985238,3,505
2020-05-13,jamaica,North America,2985238,2,507
2020-05-14,jamaica,North America,2985238,2,509
2020-05-15,jamaica,North America,2985238,0,509
2020-05-16,jamaica,North America,2985238,2,511
2020-05-17,jamaica,North America,2985238,6,517
2020-05-18,jamaica,North America,2985238,3,520
2020-05-19,jamaica,North America,2985238,0,520
2020-05-20,jamaica,North America,2985238,0,520
2020-05-21,jamaica,North America,2985238,9,529
2020-05-22,jamaica,North America,2985238,5,534
2020-05-23,jamaica,North America,2985238,10,544
2020-05-24,jamaica,North America,2985238,6,550
2020-05-25,jamaica,North America,2985238,2,552
2020-05-26,jamaica,North America,2985238,4,556
2020-05-27,jamaica,North America,2985238,8,564
2020-05-28,jamaica,North America,2985238,5,569
2020-05-29,jamaica,North America,2985238,0,569
2020-05-30,jamaica,North America,2985238,6,575
2020-05-31,jamaica,North America,2985238,6,581
2020-06-01,jamaica,North America,2985238,5,586
2020-06-02,jamaica,North America,2985238,2,588
2020-06-03,jamaica,North America,2985238,2,590
2020-06-04,jamaica,North America,2985238,1,591
2020-06-05,jamaica,North America,2985238,0,591
2020-06-06,jamaica,North America,2985238,4,595
2020-06-07,jamaica,North America,2985238,1,596
2020-06-08,jamaica,North America,2985238,2,598
2020-06-09,jamaica,North America,2985238,1,599
2020-06-10,jamaica,North America,2985238,6,605
2020-06-11,jamaica,North America,2985238,0,605
2020-06-12,jamaica,North America,2985238,6,611
2020-06-13,jamaica,North America,2985238,3,614
2020-06-14,jamaica,North America,2985238,1,615
2020-06-15,jamaica,North America,2985238,2,617
2020-06-16,jamaica,North America,2985238,4,621
2020-06-17,jamaica,North America,2985238,0,621
2020-06-18,jamaica,North America,2985238,5,626
2020-06-19,jamaica,North America,2985238,12,638
2020-06-20,jamaica,North America,2985238,14,652
2020-06-21,jamaica,North America,2985238,5,657
2020-06-22,jamaica,North America,2985238,2,659
2020-06-23,jamaica,North America,2985238,6,665
2020-06-24,jamaica,North America,2985238,5,670
2020-06-25,jamaica,North America,2985238,8,678
2020-06-26,jamaica,North America,2985238,6,684
2020-06-27,jamaica,North America,2985238,2,686
2020-06-28,jamaica,North America,2985238,4,690
2020-06-29,jamaica,North America,2985238,6,696
2020-06-30,jamaica,North America,2985238,2,698
2020-07-01,jamaica,North America,2985238,4,702
2020-07-02,jamaica,North America,2985238,5,707
2020-07-03,jamaica,North America,2985238,8,715
2020-07-04,jamaica,North America,2985238,6,721
2020-07-05,jamaica,North America,2985238,7,728
2020-07-06,jamaica,North America,2985238,4,732
2020-07-07,jamaica,North America,2985238,5,737
2020-07-08,jamaica,North America,2985238,8,745
2020-07-09,jamaica,North America,2985238,6,751
2020-07-10,jamaica,North America,2985238,2,753
2020-07-11,jamaica,North America,2985238,0,753
2020-07-12,jamaica,North America,2985238,5,758
2020-07-13,jamaica,North America,2985238,0,758
2020-07-14,jamaica,North America,2985238,1,759
2020-07-15,jamaica,North America,2985238,3,762
2020-07-16,jamaica,North America,2985238,1,763
2020-07-17,jamaica,North America,2985238,2,765
2020-07-18,jamaica,North America,2985238,3,768
2020-07-19,jamaica,North America,2985238,6,774
2020-07-20,jamaica,North America,2985238,16,790
2020-07-21,jamaica,North America,2985238,19,809
2020-07-22,jamaica,North America,2985238,1,810
2020-07-23,jamaica,North America,2985238,6,816
2020-07-24,jamaica,North America,2985238,5,821
2020-07-25,jamaica,North America,2985238,10,831
2020-07-26,jamaica,North America,2985238,6,837
2020-07-27,jamaica,North America,2985238,5,842
2020-07-28,jamaica,North America,2985238,11,853
2020-07-29,jamaica,North America,2985238,2,855
2020-07-30,jamaica,North America,2985238,1,856
2020-07-31,jamaica,North America,2985238,8,864
2020-08-01,jamaica,North America,2985238,14,878
2020-08-02,jamaica,North America,2985238,5,883
2020-08-03,jamaica,North America,2985238,11,894
2020-08-04,jamaica,North America,2985238,11,905
2020-08-05,jamaica,North America,2985238,15,920
2020-08-06,jamaica,North America,2985238,8,928
2020-08-07,jamaica,North America,2985238,30,958
2020-08-08,jamaica,North America,2985238,29,987
2020-08-09,jamaica,North America,2985238,16,1003
2020-08-10,jamaica,North America,2985238,20,1023
2020-08-11,jamaica,North America,2985238,8,1031
2020-08-12,jamaica,North America,2985238,16,1047
2020-08-13,jamaica,North America,2985238,18,1065
2020-08-14,jamaica,North America,2985238,6,1071
2020-08-15,jamaica,North America,2985238,11,1082
2020-08-16,jamaica,North America,2985238,24,1106
2020-08-17,jamaica,North America,2985238,7,1113
2020-08-18,jamaica,North America,2985238,16,1129
2020-08-19,jamaica,North America,2985238,17,1146
2020-08-20,jamaica,North America,2985238,46,1192
2020-08-21,jamaica,North America,2985238,98,1290
2020-08-22,jamaica,North America,2985238,56,1346
2020-08-23,jamaica,North America,2985238,67,1413
2020-08-24,jamaica,North America,2985238,116,1529
2020-08-25,jamaica,North America,2985238,83,1612
2020-08-26,jamaica,North America,2985238,120,1732
2020-08-27,jamaica,North America,2985238,72,1804
2020-08-28,jamaica,North America,2985238,66,1870
2020-08-29,jamaica,North America,2985238,141,2011
2020-08-30,jamaica,North America,2985238,102,2113
2020-08-31,jamaica,North America,2985238,244,2357
2020-09-01,jamaica,North America,2985238,102,2459
2020-09-02,jamaica,North America,2985238,224,2683
2020-09-03,jamaica,North America,2985238,139,2822
2020-09-04,jamaica,North America,2985238,74,2896
2020-09-05,jamaica,North America,2985238,68,2964
2020-09-06,jamaica,North America,2985238,60,3024
2020-09-07,jamaica,North America,2985238,79,3103
2020-09-08,jamaica,North America,2985238,80,3183
2020-09-09,jamaica,North America,2985238,140,3323
2020-09-10,jamaica,North America,2985238,114,3437
2020-09-11,jamaica,North America,2985238,74,3511
2020-09-12,jamaica,North America,2985238,112,3623
2020-09-13,jamaica,North America,2985238,148,3771
2020-09-14,jamaica,North America,2985238,162,3933
2020-09-15,jamaica,North America,2985238,109,4042
2020-09-16,jamaica,North America,2985238,122,4164
2020-09-17,jamaica,North America,2985238,210,4374
2020-09-18,jamaica,North America,2985238,197,4571
2020-09-19,jamaica,North America,2985238,187,4758
2020-09-20,jamaica,North America,2985238,230,4988
2020-09-21,jamaica,North America,2985238,155,5143
2020-09-22,jamaica,North America,2985238,127,5270
2020-09-23,jamaica,North America,2985238,125,5395
2020-09-24,jamaica,North America,2985238,193,5588
2020-09-25,jamaica,North America,2985238,135,5723
2020-09-26,jamaica,North America,2985238,131,5854
2020-09-27,jamaica,North America,2985238,163,6017
2020-09-28,jamaica,North America,2985238,153,6170
2020-09-29,jamaica,North America,2985238,238,6408
2020-09-30,jamaica,North America,2985238,74,6482
2020-10-01,jamaica,North America,2985238,73,6555
2020-10-02,jamaica,North America,2985238,149,6704
2020-10-03,jamaica,North America,2985238,91,6795
2020-10-04,jamaica,North America,2985238,100,6895
2020-10-05,jamaica,North America,2985238,117,7012
2020-10-06,jamaica,North America,2985238,97,7109
2020-10-07,jamaica,North America,2985238,82,7191
2020-10-08,jamaica,North America,2985238,82,7273
2020-10-09,jamaica,North America,2985238,90,7363
2020-10-10,jamaica,North America,2985238,196,7559
2020-10-11,jamaica,North America,2985238,159,7718
2020-10-12,jamaica,North America,2985238,95,7813
2020-10-13,jamaica,North America,2985238,97,7910
2020-10-14,jamaica,North America,2985238,79,7989
2020-10-15,jamaica,North America,2985238,78,8067
2020-10-16,jamaica,North America,2985238,65,8132
2020-10-17,jamaica,North America,2985238,63,8195
2020-10-18,jamaica,North America,2985238,79,8274
2020-10-19,jamaica,North America,2985238,47,8321
2020-10-20,jamaica,North America,2985238,53,8374
2020-10-21,jamaica,North America,2985238,71,8445
2020-10-22,jamaica,North America,2985238,155,8600
2020-10-23,jamaica,North America,2985238,38,8638
2020-10-24,jamaica,North America,2985238,32,8670
2020-10-25,jamaica,North America,2985238,44,8714
2020-10-26,jamaica,North America,2985238,35,8749
2020-10-27,jamaica,North America,2985238,38,8787
2020-10-28,jamaica,North America,2985238,64,8851
2020-10-29,jamaica,North America,2985238,76,8927
2020-10-30,jamaica,North America,2985238,78,9005
2020-10-31,jamaica,North America,2985238,89,9094
2020-11-01,jamaica,North America,2985238,37,9131
2020-11-02,jamaica,North America,2985238,126,9257
2020-11-03,jamaica,North America,2985238,39,9296
2020-11-04,jamaica,North America,2985238,30,9326
2020-11-05,jamaica,North America,2985238,47,9373
2020-11-06,jamaica,North America,2985238,53,9426
2020-11-07,jamaica,North America,2985238,46,9472
2020-11-08,jamaica,North America,2985238,34,9506
2020-11-09,jamaica,North America,2985238,36,9542
2020-11-10,jamaica,North America,2985238,31,9573
2020-11-11,jamaica,North America,2985238,8,9581
2020-11-12,jamaica,North America,2985238,53,9634
2020-11-13,jamaica,North America,2985238,89,9723
2020-11-14,jamaica,North America,2985238,57,9780
2020-11-15,jamaica,North America,2985238,104,9884
2020-11-16,jamaica,North America,2985238,45,9929
2020-11-17,jamaica,North America,2985238,30,9959
2020-11-18,jamaica,North America,2985238,60,10019
2020-02-16,japan,Asia,125755488,6,59
2020-02-17,japan,Asia,125755488,7,66
2020-02-18,japan,Asia,125755488,8,74
2020-02-19,japan,Asia,125755488,10,84
2020-02-20,japan,Asia,125755488,10,94
2020-02-21,japan,Asia,125755488,15,109
2020-02-22,japan,Asia,125755488,25,134
2020-02-23,japan,Asia,125755488,12,146
2020-02-24,japan,Asia,125755488,13,159
2020-02-25,japan,Asia,125755488,2,161
2020-02-26,japan,Asia,125755488,11,172
2020-02-27,japan,Asia,125755488,42,214
2020-02-28,japan,Asia,125755488,19,233
2020-02-29,japan,Asia,125755488,8,241
2020-03-01,japan,Asia,125755488,15,256
2020-03-02,japan,Asia,125755488,18,274
2020-03-03,japan,Asia,125755488,19,293
2020-03-04,japan,Asia,125755488,38,331
2020-03-05,japan,Asia,125755488,33,364
2020-03-06,japan,Asia,125755488,56,420
2020-03-07,japan,Asia,125755488,41,461
2020-03-08,japan,Asia,125755488,41,502
2020-03-09,japan,Asia,125755488,28,530
2020-03-10,japan,Asia,125755488,57,587
2020-03-11,japan,Asia,125755488,52,639
2020-03-12,japan,Asia,125755488,52,691
2020-03-13,japan,Asia,125755488,43,734
2020-03-14,japan,Asia,125755488,70,804
2020-03-15,japan,Asia,125755488,29,833
2020-03-16,japan,Asia,125755488,17,850
2020-03-17,japan,Asia,125755488,28,878
2020-03-18,japan,Asia,125755488,36,914
2020-03-19,japan,Asia,125755488,29,943
2020-03-20,japan,Asia,125755488,64,1007
2020-03-21,japan,Asia,125755488,47,1054
2020-03-22,japan,Asia,125755488,47,1101
2020-03-23,japan,Asia,125755488,27,1128
2020-03-24,japan,Asia,125755488,65,1193
2020-03-25,japan,Asia,125755488,114,1307
2020-03-26,japan,Asia,125755488,80,1387
2020-03-27,japan,Asia,125755488,112,1499
2020-03-28,japan,Asia,125755488,194,1693
2020-03-29,japan,Asia,125755488,173,1866
2020-03-30,japan,Asia,125755488,87,1953
2020-03-31,japan,Asia,125755488,226,2179
2020-04-01,japan,Asia,125755488,206,2385
2020-04-02,japan,Asia,125755488,234,2619
2020-04-03,japan,Asia,125755488,319,2938
2020-04-04,japan,Asia,125755488,204,3142
2020-04-05,japan,Asia,125755488,516,3658
2020-04-06,japan,Asia,125755488,253,3911
2020-04-07,japan,Asia,125755488,352,4263
2020-04-08,japan,Asia,125755488,411,4674
2020-04-09,japan,Asia,125755488,682,5356
2020-04-10,japan,Asia,125755488,660,6016
2020-04-11,japan,Asia,125755488,745,6761
2020-04-12,japan,Asia,125755488,624,7385
2020-04-13,japan,Asia,125755488,249,7634
2020-04-14,japan,Asia,125755488,268,7902
2020-04-15,japan,Asia,125755488,743,8645
2020-04-16,japan,Asia,125755488,606,9251
2020-04-17,japan,Asia,125755488,557,9808
2020-04-18,japan,Asia,125755488,510,10318
2020-04-19,japan,Asia,125755488,502,10820
2020-04-20,japan,Asia,125755488,339,11159
2020-04-21,japan,Asia,125755488,378,11537
2020-04-22,japan,Asia,125755488,439,11976
2020-04-23,japan,Asia,125755488,419,12395
2020-04-24,japan,Asia,125755488,345,12740
2020-04-25,japan,Asia,125755488,520,13260
2020-04-26,japan,Asia,125755488,219,13479
2020-04-27,japan,Asia,125755488,165,13644
2020-04-28,japan,Asia,125755488,122,13766
2020-04-29,japan,Asia,125755488,159,13925
2020-04-30,japan,Asia,125755488,193,14118
2020-05-01,japan,Asia,125755488,218,14336
2020-05-02,japan,Asia,125755488,267,14603
2020-05-03,japan,Asia,125755488,307,14910
2020-05-04,japan,Asia,125755488,201,15111
2020-05-05,japan,Asia,125755488,175,15286
2020-05-06,japan,Asia,125755488,0,15286
2020-05-07,japan,Asia,125755488,225,15511
2020-05-08,japan,Asia,125755488,98,15609
2020-05-09,japan,Asia,125755488,88,15697
2020-05-10,japan,Asia,125755488,114,15811
2020-05-11,japan,Asia,125755488,70,15881
2020-05-12,japan,Asia,125755488,121,16002
2020-05-13,japan,Asia,125755488,81,16083
2020-05-14,japan,Asia,125755488,71,16154
2020-05-15,japan,Asia,125755488,83,16237
2020-05-16,japan,Asia,125755488,34,16271
2020-05-17,japan,Asia,125755488,48,16319
2020-05-18,japan,Asia,125755488,20,16339
2020-05-19,japan,Asia,125755488,62,16401
2020-05-20,japan,Asia,125755488,18,16419
2020-05-21,japan,Asia,125755488,39,16458
2020-05-22,japan,Asia,125755488,89,16547
2020-05-23,japan,Asia,125755488,23,16570
2020-05-24,japan,Asia,125755488,14,16584
2020-05-25,japan,Asia,125755488,31,16615
2020-05-26,japan,Asia,125755488,42,16657
2020-05-27,japan,Asia,125755488,28,16685
2020-05-28,japan,Asia,125755488,32,16717
2020-05-29,japan,Asia,125755488,36,16753
2020-05-30,japan,Asia,125755488,85,16838
2020-05-31,japan,Asia,125755488,47,16885
2020-06-01,japan,Asia,125755488,33,16918
2020-06-02,japan,Asia,125755488,46,16964
2020-06-03,japan,Asia,125755488,56,17020
2020-06-04,japan,Asia,125755488,32,17052
2020-06-05,japan,Asia,125755488,46,17098
2020-06-06,japan,Asia,125755488,39,17137
2020-06-07,japan,Asia,125755488,38,17175
2020-06-08,japan,Asia,125755488,33,17208
2020-06-09,japan,Asia,125755488,36,17244
2020-06-10,japan,Asia,125755488,41,17285
2020-06-11,japan,Asia,125755488,41,17326
2020-06-12,japan,Asia,125755488,40,17366
2020-06-13,japan,Asia,125755488,50,17416
2020-06-14,japan,Asia,125755488,47,17463
2020-06-15,japan,Asia,125755488,73,17536
2020-06-16,japan,Asia,125755488,85,17621
2020-06-17,japan,Asia,125755488,41,17662
2020-06-18,japan,Asia,125755488,40,17702
2020-06-19,japan,Asia,125755488,72,17774
2020-06-20,japan,Asia,125755488,59,17833
2020-06-21,japan,Asia,125755488,65,17898
2020-06-22,japan,Asia,125755488,52,17950
2020-06-23,japan,Asia,125755488,52,18002
2020-06-24,japan,Asia,125755488,56,18058
2020-06-25,japan,Asia,125755488,86,18144
2020-06-26,japan,Asia,125755488,87,18231
2020-06-27,japan,Asia,125755488,100,18331
2020-06-28,japan,Asia,125755488,93,18424
2020-06-29,japan,Asia,125755488,86,18510
2020-06-30,japan,Asia,125755488,117,18627
2020-07-01,japan,Asia,125755488,130,18757
2020-07-02,japan,Asia,125755488,151,18908
2020-07-03,japan,Asia,125755488,194,19102
2020-07-04,japan,Asia,125755488,215,19317
2020-07-05,japan,Asia,125755488,241,19558
2020-07-06,japan,Asia,125755488,254,19812
2020-07-07,japan,Asia,125755488,206,20018
2020-07-08,japan,Asia,125755488,193,20211
2020-07-09,japan,Asia,125755488,197,20408
2020-07-10,japan,Asia,125755488,349,20757
2020-07-11,japan,Asia,125755488,411,21168
2020-07-12,japan,Asia,125755488,374,21542
2020-07-13,japan,Asia,125755488,367,21909
2020-07-14,japan,Asia,125755488,353,22262
2020-07-15,japan,Asia,125755488,289,22551
2020-07-16,japan,Asia,125755488,383,22934
2020-07-17,japan,Asia,125755488,584,23518
2020-07-18,japan,Asia,125755488,661,24179
2020-07-19,japan,Asia,125755488,511,24690
2020-07-20,japan,Asia,125755488,455,25145
2020-07-21,japan,Asia,125755488,642,25787
2020-07-22,japan,Asia,125755488,568,26355
2020-07-23,japan,Asia,125755488,728,27083
2020-07-24,japan,Asia,125755488,929,28012
2020-07-25,japan,Asia,125755488,832,28844
2020-07-26,japan,Asia,125755488,597,29441
2020-07-27,japan,Asia,125755488,608,30049
2020-07-28,japan,Asia,125755488,974,31023
2020-07-29,japan,Asia,125755488,942,31965
2020-07-30,japan,Asia,125755488,1151,33116
2020-07-31,japan,Asia,125755488,1326,34442
2020-08-01,japan,Asia,125755488,1468,35910
2020-08-02,japan,Asia,125755488,855,36765
2020-08-03,japan,Asia,125755488,2003,38768
2020-08-04,japan,Asia,125755488,1174,39942
2020-08-05,japan,Asia,125755488,1274,41216
2020-08-06,japan,Asia,125755488,1137,42353
2020-08-07,japan,Asia,125755488,1556,43909
2020-08-08,japan,Asia,125755488,1628,45537
2020-08-09,japan,Asia,125755488,1347,46884
2020-08-10,japan,Asia,125755488,1210,48094
2020-08-11,japan,Asia,125755488,940,49034
2020-08-12,japan,Asia,125755488,1285,50319
2020-08-13,japan,Asia,125755488,939,51258
2020-08-14,japan,Asia,125755488,1073,52331
2020-08-15,japan,Asia,125755488,1363,53694
2020-08-16,japan,Asia,125755488,1140,54834
2020-08-17,japan,Asia,125755488,955,55789
2020-08-18,japan,Asia,125755488,1020,56809
2020-08-19,japan,Asia,125755488,867,57676
2020-08-20,japan,Asia,125755488,953,58629
2020-08-21,japan,Asia,125755488,1223,59852
2020-08-22,japan,Asia,125755488,1014,60866
2020-08-23,japan,Asia,125755488,1016,61882
2020-08-24,japan,Asia,125755488,762,62644
2020-08-25,japan,Asia,125755488,615,63259
2020-08-26,japan,Asia,125755488,703,63962
2020-08-27,japan,Asia,125755488,848,64810
2020-08-28,japan,Asia,125755488,907,65717
2020-08-29,japan,Asia,125755488,852,66569
2020-08-30,japan,Asia,125755488,843,67412
2020-08-31,japan,Asia,125755488,602,68014
2020-09-01,japan,Asia,125755488,528,68542
2020-09-02,japan,Asia,125755488,610,69152
2020-09-03,japan,Asia,125755488,599,69751
2020-09-04,japan,Asia,125755488,671,70422
2020-09-05,japan,Asia,125755488,609,71031
2020-09-06,japan,Asia,125755488,544,71575
2020-09-07,japan,Asia,125755488,438,72013
2020-09-08,japan,Asia,125755488,379,72392
2020-09-09,japan,Asia,125755488,493,72885
2020-09-10,japan,Asia,125755488,496,73381
2020-09-11,japan,Asia,125755488,682,74063
2020-09-12,japan,Asia,125755488,645,74708
2020-09-13,japan,Asia,125755488,676,75384
2020-09-14,japan,Asia,125755488,440,75824
2020-09-15,japan,Asia,125755488,302,76126
2020-09-16,japan,Asia,125755488,491,76617
2020-09-17,japan,Asia,125755488,562,77179
2020-09-18,japan,Asia,125755488,486,77665
2020-09-19,japan,Asia,125755488,580,78245
2020-09-20,japan,Asia,125755488,585,78830
2020-09-21,japan,Asia,125755488,484,79314
2020-09-22,japan,Asia,125755488,299,79613
2020-09-23,japan,Asia,125755488,331,79944
2020-09-24,japan,Asia,125755488,274,80218
2020-09-25,japan,Asia,125755488,457,80675
2020-09-26,japan,Asia,125755488,559,81234
2020-09-27,japan,Asia,125755488,637,81871
2020-09-28,japan,Asia,125755488,442,82313
2020-09-29,japan,Asia,125755488,364,82677
2020-09-30,japan,Asia,125755488,517,83194
2020-10-01,japan,Asia,125755488,554,83748
2020-10-02,japan,Asia,125755488,654,84402
2020-10-03,japan,Asia,125755488,554,84956
2020-10-04,japan,Asia,125755488,572,85528
2020-10-05,japan,Asia,125755488,401,85929
2020-10-06,japan,Asia,125755488,309,86238
2020-10-07,japan,Asia,125755488,497,86735
2020-10-08,japan,Asia,125755488,478,87213
2020-10-09,japan,Asia,125755488,620,87833
2020-10-10,japan,Asia,125755488,595,88428
2020-10-11,japan,Asia,125755488,681,89109
2020-10-12,japan,Asia,125755488,436,89545
2020-10-13,japan,Asia,125755488,327,89872
2020-10-14,japan,Asia,125755488,468,90340
2020-10-15,japan,Asia,125755488,571,90911
2020-10-16,japan,Asia,125755488,723,91634
2020-10-17,japan,Asia,125755488,634,92268
2020-10-18,japan,Asia,125755488,594,92862
2020-10-19,japan,Asia,125755488,472,93334
2020-10-20,japan,Asia,125755488,354,93688
2020-10-21,japan,Asia,125755488,454,94142
2020-10-22,japan,Asia,125755488,592,94734
2020-10-23,japan,Asia,125755488,615,95349
2020-10-24,japan,Asia,125755488,699,96048
2020-10-25,japan,Asia,125755488,701,96749
2020-10-26,japan,Asia,125755488,541,97290
2020-10-27,japan,Asia,125755488,425,97715
2020-10-28,japan,Asia,125755488,619,98334
2020-10-29,japan,Asia,125755488,738,99072
2020-10-30,japan,Asia,125755488,772,99844
2020-10-31,japan,Asia,125755488,772,100616
2020-11-01,japan,Asia,125755488,756,101372
2020-11-02,japan,Asia,125755488,669,102041
2020-11-03,japan,Asia,125755488,469,102510
2020-11-04,japan,Asia,125755488,620,103130
2020-11-05,japan,Asia,125755488,940,104070
2020-11-06,japan,Asia,125755488,946,105016
2020-11-07,japan,Asia,125755488,1135,106151
2020-11-08,japan,Asia,125755488,1175,107326
2020-11-09,japan,Asia,125755488,1000,108326
2020-11-10,japan,Asia,125755488,901,109227
2020-11-11,japan,Asia,125755488,1176,110403
2020-11-12,japan,Asia,125755488,1559,111962
2020-11-13,japan,Asia,125755488,1591,113553
2020-11-14,japan,Asia,125755488,1689,115242
2020-11-15,japan,Asia,125755488,1698,116940
2020-11-16,japan,Asia,125755488,1463,118403
2020-11-17,japan,Asia,125755488,1193,119596
2020-11-18,japan,Asia,125755488,1493,121089
2020-11-19,japan,Asia,125755488,2156,123245
2020-11-20,japan,Asia,125755488,2307,125552
2020-11-21,japan,Asia,125755488,2404,127956
2020-11-22,japan,Asia,125755488,2520,130476
2020-11-23,japan,Asia,125755488,2184,132660
2020-11-24,japan,Asia,125755488,1575,134235
2020-11-25,japan,Asia,125755488,1475,135710
2020-11-26,japan,Asia,125755488,1865,137575
2020-11-27,japan,Asia,125755488,2235,139810
2020-11-28,japan,Asia,125755488,2583,142393
2020-11-29,japan,Asia,125755488,2591,144984
2020-11-30,japan,Asia,125755488,2112,147096
2020-12-01,japan,Asia,125755488,1939,149035
2020-12-02,japan,Asia,125755488,1696,150731
2020-12-03,japan,Asia,125755488,2447,153178
2020-12-04,japan,Asia,125755488,2411,155589
2020-12-05,japan,Asia,125755488,2448,158037
2020-12-06,japan,Asia,125755488,2430,160467
2020-12-07,japan,Asia,125755488,1974,162441
2020-12-08,japan,Asia,125755488,1867,164308
2020-12-09,japan,Asia,125755488,1916,166224
2020-12-10,japan,Asia,125755488,2740,168964
2020-12-11,japan,Asia,125755488,2976,171940
2020-12-12,japan,Asia,125755488,2764,174704
2020-12-13,japan,Asia,125755488,2995,177699
2020-12-14,japan,Asia,125755488,2372,180071
2020-12-15,japan,Asia,125755488,2222,182293
2020-12-16,japan,Asia,125755488,2177,184470
2020-12-17,japan,Asia,125755488,3068,187538
2020-12-18,japan,Asia,125755488,3042,190580
2020-12-19,japan,Asia,125755488,2900,193480
2020-12-20,japan,Asia,125755488,2856,196336
2020-12-21,japan,Asia,125755488,2649,198985
2020-12-22,japan,Asia,125755488,2140,201125
2020-12-23,japan,Asia,125755488,2461,203586
2020-12-24,japan,Asia,125755488,3033,206619
2020-12-25,japan,Asia,125755488,3850,210469
2020-12-26,japan,Asia,125755488,3576,214045
2020-12-27,japan,Asia,125755488,3774,217819
2020-12-28,japan,Asia,125755488,2931,220750
2020-12-29,japan,Asia,125755488,2891,223641
2020-12-30,japan,Asia,125755488,3484,227125
2020-12-31,japan,Asia,125755488,3717,230842
2021-01-01,japan,Asia,125755488,4101,234943
2021-01-02,japan,Asia,125755488,3626,238569
2021-01-03,japan,Asia,125755488,2949,241518
2021-01-04,japan,Asia,125755488,2900,244418
2021-01-05,japan,Asia,125755488,4123,248541
2021-01-06,japan,Asia,125755488,4368,252909
2021-01-07,japan,Asia,125755488,6091,259000
2021-01-08,japan,Asia,125755488,6923,265923
2021-01-09,japan,Asia,125755488,7874,273797
2021-01-10,japan,Asia,125755488,7639,281436
2021-01-11,japan,Asia,125755488,5991,287427
2021-01-12,japan,Asia,125755488,5473,292900
2021-01-13,japan,Asia,125755488,5115,298015
2021-01-14,japan,Asia,125755488,5321,303336
2021-01-15,japan,Asia,125755488,6607,309943
2021-01-16,japan,Asia,125755488,6712,316655
2021-01-17,japan,Asia,125755488,6401,323056
2021-01-18,japan,Asia,125755488,6012,329068
2021-01-19,japan,Asia,125755488,6049,335117
2021-01-20,japan,Asia,125755488,5459,340576
2021-01-21,japan,Asia,125755488,5460,346036
2021-01-22,japan,Asia,125755488,5813,351849
2021-01-23,japan,Asia,125755488,5066,356915
2021-01-24,japan,Asia,125755488,4598,361513
2021-01-25,japan,Asia,125755488,4162,365675
2021-01-26,japan,Asia,125755488,3338,369013
2021-01-27,japan,Asia,125755488,3546,372559
2021-01-28,japan,Asia,125755488,3936,376495
2021-01-29,japan,Asia,125755488,3918,380413
2021-01-30,japan,Asia,125755488,3576,383989
2021-01-31,japan,Asia,125755488,3668,387657
2021-02-01,japan,Asia,125755488,2783,390440
2021-02-02,japan,Asia,125755488,2113,392553
2021-02-03,japan,Asia,125755488,2215,394768
2021-02-04,japan,Asia,125755488,2599,397367
2021-02-05,japan,Asia,125755488,2625,399992
2021-02-06,japan,Asia,125755488,2313,402305
2021-02-07,japan,Asia,125755488,2085,404390
2021-02-08,japan,Asia,125755488,1559,405949
2021-02-09,japan,Asia,125755488,1780,407729
2021-02-10,japan,Asia,125755488,1423,409152
2021-02-11,japan,Asia,125755488,1830,410982
2021-02-12,japan,Asia,125755488,1743,412725
2021-02-13,japan,Asia,125755488,1406,414131
2021-02-14,japan,Asia,125755488,1321,415452
2021-02-15,japan,Asia,125755488,1313,416765
2021-02-16,japan,Asia,125755488,1988,418753
2021-02-17,japan,Asia,125755488,1253,420006
2021-02-18,japan,Asia,125755488,1396,421402
2021-02-19,japan,Asia,125755488,1563,422965
2021-02-20,japan,Asia,125755488,1347,424312
2021-02-21,japan,Asia,125755488,1199,425511
2021-02-22,japan,Asia,125755488,1093,426604
2021-02-23,japan,Asia,125755488,861,427465
2021-02-24,japan,Asia,125755488,1013,428478
2021-02-25,japan,Asia,125755488,1089,429567
2021-02-26,japan,Asia,125755488,921,430488
2021-02-27,japan,Asia,125755488,1070,431558
2021-02-28,japan,Asia,125755488,1204,432762
2021-03-01,japan,Asia,125755488,1035,433797
2021-03-02,japan,Asia,125755488,733,434530
2021-03-03,japan,Asia,125755488,854,435384
2021-03-04,japan,Asia,125755488,1195,436579
2021-03-05,japan,Asia,125755488,1183,437762
2021-03-06,japan,Asia,125755488,1167,438929
2021-03-07,japan,Asia,125755488,1067,439996
2021-03-08,japan,Asia,125755488,1039,441035
2021-03-09,japan,Asia,125755488,681,441716
2021-03-10,japan,Asia,125755488,1061,442777
2021-03-11,japan,Asia,125755488,1275,444052
2021-03-12,japan,Asia,125755488,1291,445343
2021-03-13,japan,Asia,125755488,1299,446642
2021-03-14,japan,Asia,125755488,1291,447933
2021-03-15,japan,Asia,125755488,1035,448968
2021-03-16,japan,Asia,125755488,784,449752
2021-03-17,japan,Asia,125755488,1027,450779
2021-03-18,japan,Asia,125755488,1477,452256
2021-03-19,japan,Asia,125755488,1520,453776
2021-03-20,japan,Asia,125755488,1460,455236
2021-03-21,japan,Asia,125755488,1484,456720
2021-03-22,japan,Asia,125755488,1146,457866
2021-03-23,japan,Asia,125755488,975,458841
2021-03-24,japan,Asia,125755488,1292,460133
2021-03-25,japan,Asia,125755488,1858,461991
2021-03-26,japan,Asia,125755488,1948,463939
2021-03-27,japan,Asia,125755488,2031,465970
2021-03-28,japan,Asia,125755488,1988,467958
2021-03-29,japan,Asia,125755488,1769,469727
2021-03-30,japan,Asia,125755488,1565,471292
2021-03-31,japan,Asia,125755488,1942,473234
2021-04-01,japan,Asia,125755488,2667,475901
2021-04-02,japan,Asia,125755488,2691,478592
2021-04-03,japan,Asia,125755488,2714,481306
2021-04-04,japan,Asia,125755488,2709,484015
2021-04-05,japan,Asia,125755488,2464,486479
2021-04-06,japan,Asia,125755488,2225,488704
2021-04-07,japan,Asia,125755488,2036,490740
2021-04-08,japan,Asia,125755488,3307,494047
2021-04-09,japan,Asia,125755488,3339,497386
2021-04-10,japan,Asia,125755488,3596,500982
2021-04-11,japan,Asia,125755488,3619,504601
2021-04-12,japan,Asia,125755488,2890,507491
2021-04-13,japan,Asia,125755488,2522,510013
2021-04-14,japan,Asia,125755488,3375,513388
2021-04-15,japan,Asia,125755488,4010,517398
2021-04-16,japan,Asia,125755488,4587,521985
2021-04-17,japan,Asia,125755488,4484,526469
2021-04-18,japan,Asia,125755488,4622,531091
2021-04-19,japan,Asia,125755488,4591,535682
2021-04-20,japan,Asia,125755488,2752,538434
2021-04-21,japan,Asia,125755488,3990,542424
2021-04-22,japan,Asia,125755488,5312,547736
2021-04-23,japan,Asia,125755488,5481,553217
2021-04-24,japan,Asia,125755488,4813,558030
2021-04-25,japan,Asia,125755488,5452,563482
2021-04-26,japan,Asia,125755488,5593,569075
2021-04-27,japan,Asia,125755488,3327,572402
2021-04-28,japan,Asia,125755488,4163,576565
2021-04-29,japan,Asia,125755488,5862,582427
2021-04-30,japan,Asia,125755488,5911,588338
2021-05-01,japan,Asia,125755488,4462,592800
2021-05-02,japan,Asia,125755488,5880,598680
2021-05-03,japan,Asia,125755488,5621,604301
2021-05-04,japan,Asia,125755488,5436,609737
2021-05-05,japan,Asia,125755488,4085,613822
2021-05-06,japan,Asia,125755488,4300,618122
2021-05-07,japan,Asia,125755488,3827,621949
2021-05-08,japan,Asia,125755488,5576,627525
2021-05-09,japan,Asia,125755488,7785,635310
2021-05-10,japan,Asia,125755488,7099,642409
2021-05-11,japan,Asia,125755488,4592,647001
2021-05-12,japan,Asia,125755488,6126,653127
2021-05-13,japan,Asia,125755488,7119,660246
2021-05-14,japan,Asia,125755488,6913,667159
2021-05-15,japan,Asia,125755488,6008,673167
2021-05-16,japan,Asia,125755488,6364,679531
2021-05-17,japan,Asia,125755488,6248,685779
2021-05-18,japan,Asia,125755488,3336,689115
2020-03-03,jordan,Asia,10391780,0,1
2020-03-04,jordan,Asia,10391780,0,1
2020-03-05,jordan,Asia,10391780,0,1
2020-03-06,jordan,Asia,10391780,0,1
2020-03-07,jordan,Asia,10391780,0,1
2020-03-08,jordan,Asia,10391780,0,1
2020-03-09,jordan,Asia,10391780,0,1
2020-03-10,jordan,Asia,10391780,0,1
2020-03-11,jordan,Asia,10391780,0,1
2020-03-12,jordan,Asia,10391780,0,1
2020-03-13,jordan,Asia,10391780,0,1
2020-03-14,jordan,Asia,10391780,0,1
2020-03-15,jordan,Asia,10391780,11,12
2020-03-16,jordan,Asia,10391780,17,29
2020-03-17,jordan,Asia,10391780,19,48
2020-03-18,jordan,Asia,10391780,8,56
2020-03-19,jordan,Asia,10391780,13,69
2020-03-20,jordan,Asia,10391780,15,84
2020-03-21,jordan,Asia,10391780,16,100
2020-03-22,jordan,Asia,10391780,12,112
2020-03-23,jordan,Asia,10391780,15,127
2020-03-24,jordan,Asia,10391780,27,154
2020-03-25,jordan,Asia,10391780,18,172
2020-03-26,jordan,Asia,10391780,40,212
2020-03-27,jordan,Asia,10391780,23,235
2020-03-28,jordan,Asia,10391780,11,246
2020-03-29,jordan,Asia,10391780,13,259
2020-03-30,jordan,Asia,10391780,9,268
2020-03-31,jordan,Asia,10391780,6,274
2020-04-01,jordan,Asia,10391780,4,278
2020-04-02,jordan,Asia,10391780,21,299
2020-04-03,jordan,Asia,10391780,11,310
2020-04-04,jordan,Asia,10391780,13,323
2020-04-05,jordan,Asia,10391780,22,345
2020-04-06,jordan,Asia,10391780,4,349
2020-04-07,jordan,Asia,10391780,4,353
2020-04-08,jordan,Asia,10391780,5,358
2020-04-09,jordan,Asia,10391780,14,372
2020-04-10,jordan,Asia,10391780,0,372
2020-04-11,jordan,Asia,10391780,9,381
2020-04-12,jordan,Asia,10391780,8,389
2020-04-13,jordan,Asia,10391780,2,391
2020-04-14,jordan,Asia,10391780,6,397
2020-04-15,jordan,Asia,10391780,4,401
2020-04-16,jordan,Asia,10391780,1,402
2020-04-17,jordan,Asia,10391780,5,407
2020-04-18,jordan,Asia,10391780,6,413
2020-04-19,jordan,Asia,10391780,4,417
2020-04-20,jordan,Asia,10391780,8,425
2020-04-21,jordan,Asia,10391780,3,428
2020-04-22,jordan,Asia,10391780,7,435
2020-04-23,jordan,Asia,10391780,2,437
2020-04-24,jordan,Asia,10391780,4,441
2020-04-25,jordan,Asia,10391780,3,444
2020-04-26,jordan,Asia,10391780,3,447
2020-04-27,jordan,Asia,10391780,2,449
2020-04-28,jordan,Asia,10391780,0,449
2020-04-29,jordan,Asia,10391780,2,451
2020-04-30,jordan,Asia,10391780,2,453
2020-05-01,jordan,Asia,10391780,6,459
2020-05-02,jordan,Asia,10391780,1,460
2020-05-03,jordan,Asia,10391780,1,461
2020-05-04,jordan,Asia,10391780,4,465
2020-05-05,jordan,Asia,10391780,6,471
2020-05-06,jordan,Asia,10391780,2,473
2020-05-07,jordan,Asia,10391780,21,494
2020-05-08,jordan,Asia,10391780,14,508
2020-05-09,jordan,Asia,10391780,14,522
2020-05-10,jordan,Asia,10391780,18,540
2020-05-11,jordan,Asia,10391780,22,562
2020-05-12,jordan,Asia,10391780,14,576
2020-05-13,jordan,Asia,10391780,6,582
2020-05-14,jordan,Asia,10391780,4,586
2020-05-15,jordan,Asia,10391780,10,596
2020-05-16,jordan,Asia,10391780,11,607
2020-05-17,jordan,Asia,10391780,6,613
2020-05-18,jordan,Asia,10391780,16,629
2020-05-19,jordan,Asia,10391780,20,649
2020-05-20,jordan,Asia,10391780,23,672
2020-05-21,jordan,Asia,10391780,12,684
2020-05-22,jordan,Asia,10391780,16,700
2020-05-23,jordan,Asia,10391780,4,704
2020-05-24,jordan,Asia,10391780,4,708
2020-05-25,jordan,Asia,10391780,3,711
2020-05-26,jordan,Asia,10391780,7,718
2020-05-27,jordan,Asia,10391780,2,720
2020-05-28,jordan,Asia,10391780,8,728
2020-05-29,jordan,Asia,10391780,2,730
2020-05-30,jordan,Asia,10391780,4,734
2020-05-31,jordan,Asia,10391780,5,739
2020-06-01,jordan,Asia,10391780,7,746
2020-06-02,jordan,Asia,10391780,9,755
2020-06-03,jordan,Asia,10391780,2,757
2020-06-04,jordan,Asia,10391780,8,765
2020-06-05,jordan,Asia,10391780,19,784
2020-06-06,jordan,Asia,10391780,11,795
2020-06-07,jordan,Asia,10391780,13,808
2020-06-08,jordan,Asia,10391780,23,831
2020-06-09,jordan,Asia,10391780,14,845
2020-06-10,jordan,Asia,10391780,18,863
2020-06-11,jordan,Asia,10391780,27,890
2020-06-12,jordan,Asia,10391780,25,915
2020-06-13,jordan,Asia,10391780,38,953
2020-06-14,jordan,Asia,10391780,8,961
2020-06-15,jordan,Asia,10391780,18,979
2020-06-16,jordan,Asia,10391780,2,981
2020-06-17,jordan,Asia,10391780,6,987
2020-06-18,jordan,Asia,10391780,14,1001
2020-06-19,jordan,Asia,10391780,7,1008
2020-06-20,jordan,Asia,10391780,7,1015
2020-06-21,jordan,Asia,10391780,18,1033
2020-06-22,jordan,Asia,10391780,9,1042
2020-06-23,jordan,Asia,10391780,5,1047
2020-06-24,jordan,Asia,10391780,24,1071
2020-06-25,jordan,Asia,10391780,15,1086
2020-06-26,jordan,Asia,10391780,18,1104
2020-06-27,jordan,Asia,10391780,7,1111
2020-06-28,jordan,Asia,10391780,10,1121
2020-06-29,jordan,Asia,10391780,7,1128
2020-06-30,jordan,Asia,10391780,4,1132
2020-07-01,jordan,Asia,10391780,1,1133
2020-07-02,jordan,Asia,10391780,3,1136
2020-07-03,jordan,Asia,10391780,11,1147
2020-07-04,jordan,Asia,10391780,3,1150
2020-07-05,jordan,Asia,10391780,14,1164
2020-07-06,jordan,Asia,10391780,3,1167
2020-07-07,jordan,Asia,10391780,2,1169
2020-07-08,jordan,Asia,10391780,0,1169
2020-07-09,jordan,Asia,10391780,0,1169
2020-07-10,jordan,Asia,10391780,4,1173
2020-07-11,jordan,Asia,10391780,3,1176
2020-07-12,jordan,Asia,10391780,3,1179
2020-07-13,jordan,Asia,10391780,4,1183
2020-07-14,jordan,Asia,10391780,15,1198
2020-07-15,jordan,Asia,10391780,3,1201
2020-07-16,jordan,Asia,10391780,5,1206
2020-07-17,jordan,Asia,10391780,3,1209
2020-07-18,jordan,Asia,10391780,5,1214
2020-07-19,jordan,Asia,10391780,4,1218
2020-07-20,jordan,Asia,10391780,5,1223
2020-07-22,jordan,Asia,10391780,7,1120
2020-07-23,jordan,Asia,10391780,11,1131
2020-07-24,jordan,Asia,10391780,15,1146
2020-07-25,jordan,Asia,10391780,8,1154
2020-07-26,jordan,Asia,10391780,14,1168
2020-07-27,jordan,Asia,10391780,8,1176
2020-07-28,jordan,Asia,10391780,6,1182
2020-07-29,jordan,Asia,10391780,5,1187
2020-07-30,jordan,Asia,10391780,4,1191
2020-07-31,jordan,Asia,10391780,2,1193
2020-08-01,jordan,Asia,10391780,15,1208
2020-08-02,jordan,Asia,10391780,5,1213
2020-08-03,jordan,Asia,10391780,5,1218
2020-08-04,jordan,Asia,10391780,6,1224
2020-08-05,jordan,Asia,10391780,7,1231
2020-08-06,jordan,Asia,10391780,1,1232
2020-08-07,jordan,Asia,10391780,5,1237
2020-08-08,jordan,Asia,10391780,9,1246
2020-08-09,jordan,Asia,10391780,6,1252
2020-08-10,jordan,Asia,10391780,16,1268
2020-08-11,jordan,Asia,10391780,15,1283
2020-08-12,jordan,Asia,10391780,20,1303
2020-08-13,jordan,Asia,10391780,17,1320
2020-08-14,jordan,Asia,10391780,9,1329
2020-08-15,jordan,Asia,10391780,10,1339
2020-08-16,jordan,Asia,10391780,39,1378
2020-08-17,jordan,Asia,10391780,20,1398
2020-08-18,jordan,Asia,10391780,40,1438
2020-08-19,jordan,Asia,10391780,44,1482
2020-08-20,jordan,Asia,10391780,16,1498
2020-08-21,jordan,Asia,10391780,34,1532
2020-08-22,jordan,Asia,10391780,44,1576
2020-08-23,jordan,Asia,10391780,33,1609
2020-08-24,jordan,Asia,10391780,30,1639
2020-08-25,jordan,Asia,10391780,77,1716
2020-08-26,jordan,Asia,10391780,40,1756
2020-08-27,jordan,Asia,10391780,45,1801
2020-08-28,jordan,Asia,10391780,68,1869
2020-08-29,jordan,Asia,10391780,24,1893
2020-08-30,jordan,Asia,10391780,73,1966
2020-08-31,jordan,Asia,10391780,68,2034
2020-09-01,jordan,Asia,10391780,63,2097
2020-09-02,jordan,Asia,10391780,64,2161
2020-09-03,jordan,Asia,10391780,72,2233
2020-09-04,jordan,Asia,10391780,68,2301
2020-09-05,jordan,Asia,10391780,52,2353
2020-09-06,jordan,Asia,10391780,58,2411
2020-09-07,jordan,Asia,10391780,67,2478
2020-09-08,jordan,Asia,10391780,103,2581
2020-09-09,jordan,Asia,10391780,78,2659
2020-09-10,jordan,Asia,10391780,80,2739
2020-09-11,jordan,Asia,10391780,206,2945
2020-09-12,jordan,Asia,10391780,117,3062
2020-09-13,jordan,Asia,10391780,252,3314
2020-09-14,jordan,Asia,10391780,214,3528
2020-09-15,jordan,Asia,10391780,149,3677
2020-09-16,jordan,Asia,10391780,175,3852
2020-09-17,jordan,Asia,10391780,279,4131
2020-09-18,jordan,Asia,10391780,213,4344
2020-09-19,jordan,Asia,10391780,196,4540
2020-09-20,jordan,Asia,10391780,239,4779
2020-09-21,jordan,Asia,10391780,266,5045
2020-09-22,jordan,Asia,10391780,634,5679
2020-09-23,jordan,Asia,10391780,363,6042
2020-09-24,jordan,Asia,10391780,549,6591
2020-09-25,jordan,Asia,10391780,620,7211
2020-09-26,jordan,Asia,10391780,850,8061
2020-09-27,jordan,Asia,10391780,431,8492
2020-09-28,jordan,Asia,10391780,734,9226
2020-09-29,jordan,Asia,10391780,823,10049
2020-09-30,jordan,Asia,10391780,1776,11825
2020-10-01,jordan,Asia,10391780,1276,13101
2020-10-02,jordan,Asia,10391780,549,13650
2020-10-03,jordan,Asia,10391780,1099,14749
2020-10-04,jordan,Asia,10391780,891,15640
2020-10-05,jordan,Asia,10391780,1824,17464
2020-10-06,jordan,Asia,10391780,1537,19001
2020-10-07,jordan,Asia,10391780,1199,20200
2020-10-08,jordan,Asia,10391780,1317,21517
2020-10-09,jordan,Asia,10391780,1246,22763
2020-10-10,jordan,Asia,10391780,1235,23998
2020-10-11,jordan,Asia,10391780,928,24926
2020-10-12,jordan,Asia,10391780,1147,26073
2020-10-13,jordan,Asia,10391780,2054,28127
2020-10-14,jordan,Asia,10391780,2423,30550
2020-10-15,jordan,Asia,10391780,2459,33009
2020-10-16,jordan,Asia,10391780,1539,34548
2020-10-17,jordan,Asia,10391780,1505,36053
2020-10-18,jordan,Asia,10391780,1520,37573
2020-10-19,jordan,Asia,10391780,1364,38937
2020-10-20,jordan,Asia,10391780,2035,40972
2020-10-21,jordan,Asia,10391780,2648,43620
2020-10-22,jordan,Asia,10391780,2821,46441
2020-10-23,jordan,Asia,10391780,2489,48930
2020-10-24,jordan,Asia,10391780,1820,50750
2020-10-25,jordan,Asia,10391780,2337,53087
2020-10-26,jordan,Asia,10391780,1968,55055
2020-10-27,jordan,Asia,10391780,3800,58855
2020-10-28,jordan,Asia,10391780,3087,61942
2020-10-29,jordan,Asia,10391780,3443,65385
2020-10-30,jordan,Asia,10391780,3921,69306
2020-10-31,jordan,Asia,10391780,3301,72607
2020-11-01,jordan,Asia,10391780,3259,75866
2020-11-02,jordan,Asia,10391780,5877,81743
2020-11-03,jordan,Asia,10391780,4833,86576
2020-11-04,jordan,Asia,10391780,4658,91234
2020-11-05,jordan,Asia,10391780,4630,95864
2020-11-06,jordan,Asia,10391780,5384,101248
2020-11-07,jordan,Asia,10391780,3554,104802
2020-11-08,jordan,Asia,10391780,4519,109321
2020-11-09,jordan,Asia,10391780,5665,114986
2020-11-10,jordan,Asia,10391780,5996,120982
2020-11-11,jordan,Asia,10391780,5419,126401
2020-11-12,jordan,Asia,10391780,5685,132086
2020-11-13,jordan,Asia,10391780,4469,136555
2020-11-14,jordan,Asia,10391780,4750,141305
2020-11-15,jordan,Asia,10391780,2373,143678
2020-11-16,jordan,Asia,10391780,5861,149539
2020-11-17,jordan,Asia,10391780,6454,155993
2020-11-18,jordan,Asia,10391780,7933,163926
2020-11-19,jordan,Asia,10391780,5469,169395
2020-11-20,jordan,Asia,10391780,4940,174335
2020-11-21,jordan,Asia,10391780,3826,178161
2020-11-22,jordan,Asia,10391780,5268,183429
2020-11-23,jordan,Asia,10391780,4981,188410
2020-11-24,jordan,Asia,10391780,4586,192996
2020-11-25,jordan,Asia,10391780,5025,198021
2020-11-26,jordan,Asia,10391780,5000,203021
2020-11-27,jordan,Asia,10391780,4580,207601
2020-11-28,jordan,Asia,10391780,3108,210709
2020-11-29,jordan,Asia,10391780,3598,214307
2020-11-30,jordan,Asia,10391780,5123,219430
2020-12-01,jordan,Asia,10391780,4187,223617
2020-12-02,jordan,Asia,10391780,3591,227208
2020-12-03,jordan,Asia,10391780,4029,231237
2020-12-04,jordan,Asia,10391780,3116,234353
2020-12-05,jordan,Asia,10391780,3160,237513
2020-12-06,jordan,Asia,10391780,2576,240089
2020-12-07,jordan,Asia,10391780,3980,244069
2020-12-08,jordan,Asia,10391780,3062,247131
2020-12-09,jordan,Asia,10391780,3088,250219
2020-12-10,jordan,Asia,10391780,2902,253121
2020-12-11,jordan,Asia,10391780,2338,255459
2020-12-12,jordan,Asia,10391780,1816,257275
2020-12-13,jordan,Asia,10391780,2339,259614
2020-12-14,jordan,Asia,10391780,2863,262477
2020-12-15,jordan,Asia,10391780,2547,265024
2020-12-16,jordan,Asia,10391780,2561,267585
2020-12-17,jordan,Asia,10391780,2221,269806
2020-12-18,jordan,Asia,10391780,1708,271514
2020-12-19,jordan,Asia,10391780,1283,272797
2020-12-20,jordan,Asia,10391780,2152,274949
2020-12-21,jordan,Asia,10391780,2499,277448
2020-12-22,jordan,Asia,10391780,2444,279892
2020-12-23,jordan,Asia,10391780,2091,281983
2020-12-24,jordan,Asia,10391780,1707,283690
2020-12-25,jordan,Asia,10391780,1616,285306
2020-12-26,jordan,Asia,10391780,1050,286356
2020-12-27,jordan,Asia,10391780,1590,287946
2020-12-28,jordan,Asia,10391780,1802,289748
2020-12-29,jordan,Asia,10391780,1645,291393
2020-12-30,jordan,Asia,10391780,1674,293067
2020-12-31,jordan,Asia,10391780,1427,294494
2021-01-01,jordan,Asia,10391780,1271,295765
2021-01-02,jordan,Asia,10391780,903,296668
2021-01-03,jordan,Asia,10391780,1540,298208
2021-01-04,jordan,Asia,10391780,1623,299831
2021-01-05,jordan,Asia,10391780,1472,301303
2021-01-06,jordan,Asia,10391780,1553,302856
2021-01-07,jordan,Asia,10391780,1215,304071
2021-01-08,jordan,Asia,10391780,1092,305163
2021-01-09,jordan,Asia,10391780,796,305959
2021-01-10,jordan,Asia,10391780,1250,307209
2021-01-11,jordan,Asia,10391780,1461,308670
2021-01-12,jordan,Asia,10391780,1176,309846
2021-01-13,jordan,Asia,10391780,1122,310968
2021-01-14,jordan,Asia,10391780,1075,312043
2021-01-15,jordan,Asia,10391780,808,312851
2021-01-16,jordan,Asia,10391780,706,313557
2021-01-17,jordan,Asia,10391780,957,314514
2021-01-18,jordan,Asia,10391780,1030,315544
2021-01-19,jordan,Asia,10391780,883,316427
2021-01-20,jordan,Asia,10391780,978,317405
2021-01-21,jordan,Asia,10391780,776,318181
2021-01-22,jordan,Asia,10391780,730,318911
2021-01-23,jordan,Asia,10391780,608,319519
2021-01-24,jordan,Asia,10391780,934,320453
2021-01-25,jordan,Asia,10391780,845,321298
2021-01-26,jordan,Asia,10391780,943,322241
2021-01-27,jordan,Asia,10391780,870,323111
2021-01-28,jordan,Asia,10391780,1058,324169
2021-01-29,jordan,Asia,10391780,864,325033
2021-01-30,jordan,Asia,10391780,641,325674
2021-01-31,jordan,Asia,10391780,1181,326855
2021-02-01,jordan,Asia,10391780,1207,328062
2021-02-02,jordan,Asia,10391780,1132,329194
2021-02-03,jordan,Asia,10391780,1280,330474
2021-02-04,jordan,Asia,10391780,1294,331768
2021-02-05,jordan,Asia,10391780,1222,332990
2021-02-06,jordan,Asia,10391780,865,333855
2021-02-07,jordan,Asia,10391780,1299,335154
2021-02-08,jordan,Asia,10391780,1685,336839
2021-02-09,jordan,Asia,10391780,1483,338322
2021-02-10,jordan,Asia,10391780,1855,340177
2021-02-11,jordan,Asia,10391780,1807,341984
2021-02-12,jordan,Asia,10391780,1579,343563
2021-02-13,jordan,Asia,10391780,1240,344803
2021-02-14,jordan,Asia,10391780,2447,347250
2021-02-15,jordan,Asia,10391780,2312,349562
2021-02-16,jordan,Asia,10391780,2657,352219
2021-02-17,jordan,Asia,10391780,2887,355106
2021-02-18,jordan,Asia,10391780,1638,356744
2021-02-19,jordan,Asia,10391780,867,357611
2021-02-20,jordan,Asia,10391780,2200,359811
2021-02-21,jordan,Asia,10391780,3917,363728
2021-02-22,jordan,Asia,10391780,4550,368278
2021-02-23,jordan,Asia,10391780,4139,372417
2021-02-24,jordan,Asia,10391780,4024,376441
2021-02-25,jordan,Asia,10391780,3827,380268
2021-02-26,jordan,Asia,10391780,3644,383912
2021-02-27,jordan,Asia,10391780,2584,386496
2021-02-28,jordan,Asia,10391780,4594,391090
2021-03-01,jordan,Asia,10391780,6068,397158
2021-03-02,jordan,Asia,10391780,5124,402282
2021-03-03,jordan,Asia,10391780,5335,407617
2021-03-04,jordan,Asia,10391780,5733,413350
2021-03-05,jordan,Asia,10391780,4584,417934
2021-03-06,jordan,Asia,10391780,3481,421415
2021-03-07,jordan,Asia,10391780,6302,427717
2021-03-08,jordan,Asia,10391780,7413,435130
2021-03-09,jordan,Asia,10391780,7072,442202
2021-03-10,jordan,Asia,10391780,6649,448851
2021-03-11,jordan,Asia,10391780,8300,457151
2021-03-12,jordan,Asia,10391780,7705,464856
2021-03-13,jordan,Asia,10391780,4144,469000
2021-03-14,jordan,Asia,10391780,8053,477053
2021-03-15,jordan,Asia,10391780,9417,486470
2021-03-16,jordan,Asia,10391780,8910,495380
2021-03-17,jordan,Asia,10391780,9535,504915
2021-03-18,jordan,Asia,10391780,9192,514107
2021-03-19,jordan,Asia,10391780,7354,521461
2021-03-20,jordan,Asia,10391780,5205,526666
2021-03-21,jordan,Asia,10391780,8789,535455
2021-03-22,jordan,Asia,10391780,9269,544724
2021-03-23,jordan,Asia,10391780,9003,553727
2021-03-24,jordan,Asia,10391780,9130,562857
2021-03-25,jordan,Asia,10391780,8433,571290
2021-03-26,jordan,Asia,10391780,6444,577734
2021-03-27,jordan,Asia,10391780,4399,582133
2021-03-28,jordan,Asia,10391780,7183,589316
2021-03-29,jordan,Asia,10391780,7940,597256
2021-03-30,jordan,Asia,10391780,7751,605007
2021-03-31,jordan,Asia,10391780,6570,611577
2021-04-01,jordan,Asia,10391780,6482,618059
2021-04-02,jordan,Asia,10391780,4774,622833
2021-04-03,jordan,Asia,10391780,4042,626875
2021-04-04,jordan,Asia,10391780,6032,632907
2021-04-05,jordan,Asia,10391780,6537,639444
2021-04-06,jordan,Asia,10391780,6005,645449
2021-04-07,jordan,Asia,10391780,5232,650681
2021-04-08,jordan,Asia,10391780,4775,655456
2021-04-09,jordan,Asia,10391780,3794,659250
2021-04-10,jordan,Asia,10391780,3145,662395
2021-04-11,jordan,Asia,10391780,3340,665735
2021-04-12,jordan,Asia,10391780,3565,669300
2021-04-13,jordan,Asia,10391780,2790,672090
2021-04-14,jordan,Asia,10391780,4085,676175
2021-04-15,jordan,Asia,10391780,2963,679138
2021-04-16,jordan,Asia,10391780,2732,681870
2021-04-17,jordan,Asia,10391780,1596,683466
2021-04-18,jordan,Asia,10391780,2507,685973
2021-04-19,jordan,Asia,10391780,3509,689482
2021-04-20,jordan,Asia,10391780,2699,692181
2021-04-21,jordan,Asia,10391780,3209,695390
2021-04-22,jordan,Asia,10391780,2097,697487
2021-04-23,jordan,Asia,10391780,1677,699164
2021-04-24,jordan,Asia,10391780,1259,700423
2021-04-25,jordan,Asia,10391780,1731,702154
2021-04-26,jordan,Asia,10391780,2386,704540
2021-04-27,jordan,Asia,10391780,1815,706355
2021-04-28,jordan,Asia,10391780,1910,708265
2021-04-29,jordan,Asia,10391780,1552,709817
2021-04-30,jordan,Asia,10391780,1556,711373
2021-05-01,jordan,Asia,10391780,704,712077
2021-05-02,jordan,Asia,10391780,824,712901
2021-05-03,jordan,Asia,10391780,1272,714173
2021-05-04,jordan,Asia,10391780,1530,715703
2021-05-05,jordan,Asia,10391780,1220,716923
2021-05-06,jordan,Asia,10391780,1007,717930
2021-05-07,jordan,Asia,10391780,702,718632
2021-05-08,jordan,Asia,10391780,601,719233
2021-05-09,jordan,Asia,10391780,743,719976
2021-05-10,jordan,Asia,10391780,1022,720998
2021-05-11,jordan,Asia,10391780,855,721853
2021-05-12,jordan,Asia,10391780,483,722336
2021-05-13,jordan,Asia,10391780,418,722754
2021-05-14,jordan,Asia,10391780,315,723069
2021-05-15,jordan,Asia,10391780,276,723345
2021-05-16,jordan,Asia,10391780,809,724154
2021-05-17,jordan,Asia,10391780,1104,725258
2021-05-18,jordan,Asia,10391780,1174,726432
2021-05-19,jordan,Asia,10391780,1180,727612
2021-05-20,jordan,Asia,10391780,937,728549
2021-05-21,jordan,Asia,10391780,636,729185
2021-05-22,jordan,Asia,10391780,521,729706
2021-05-23,jordan,Asia,10391780,840,730546
2021-05-24,jordan,Asia,10391780,890,731436
2021-05-25,jordan,Asia,10391780,920,732356
2021-05-26,jordan,Asia,10391780,842,733198
2021-05-27,jordan,Asia,10391780,841,734039
2021-05-28,jordan,Asia,10391780,620,734659
2021-05-29,jordan,Asia,10391780,480,735139
2021-05-30,jordan,Asia,10391780,672,735811
2021-05-31,jordan,Asia,10391780,723,736534
2021-06-01,jordan,Asia,10391780,750,737284
2021-06-02,jordan,Asia,10391780,604,737888
2021-06-03,jordan,Asia,10391780,633,738521
2021-06-04,jordan,Asia,10391780,494,739015
2021-06-05,jordan,Asia,10391780,304,739319
2021-06-06,jordan,Asia,10391780,528,739847
2021-06-07,jordan,Asia,10391780,655,740502
2021-06-08,jordan,Asia,10391780,599,741101
2021-06-09,jordan,Asia,10391780,598,741699
2021-06-10,jordan,Asia,10391780,479,742178
2021-06-11,jordan,Asia,10391780,343,742521
2021-06-12,jordan,Asia,10391780,310,742831
2021-06-13,jordan,Asia,10391780,500,743331
2021-06-14,jordan,Asia,10391780,546,743877
2021-06-15,jordan,Asia,10391780,500,744377
2021-06-16,jordan,Asia,10391780,467,744844
2021-06-17,jordan,Asia,10391780,522,745366
2021-06-18,jordan,Asia,10391780,301,745667
2021-06-19,jordan,Asia,10391780,311,745978
2021-06-20,jordan,Asia,10391780,502,746480
2021-06-21,jordan,Asia,10391780,520,747000
2021-06-22,jordan,Asia,10391780,504,747504
2021-06-23,jordan,Asia,10391780,599,748103
2021-06-24,jordan,Asia,10391780,582,748685
2021-06-25,jordan,Asia,10391780,361,749046
2021-06-26,jordan,Asia,10391780,273,749319
2021-06-27,jordan,Asia,10391780,465,749784
2021-06-28,jordan,Asia,10391780,605,750389
2021-06-29,jordan,Asia,10391780,497,750886
2021-06-30,jordan,Asia,10391780,518,751404
2021-07-01,jordan,Asia,10391780,533,751937
2021-07-02,jordan,Asia,10391780,458,752395
2021-07-03,jordan,Asia,10391780,222,752617
2021-07-04,jordan,Asia,10391780,575,753192
2021-07-05,jordan,Asia,10391780,584,753776
2021-07-06,jordan,Asia,10391780,505,754281
2021-07-07,jordan,Asia,10391780,646,754927
2021-07-08,jordan,Asia,10391780,553,755480
2021-07-09,jordan,Asia,10391780,468,755948
2021-07-10,jordan,Asia,10391780,406,756354
2021-07-11,jordan,Asia,10391780,569,756923
2021-07-12,jordan,Asia,10391780,767,757690
2021-07-13,jordan,Asia,10391780,601,758291
2021-07-14,jordan,Asia,10391780,734,759025
2021-07-15,jordan,Asia,10391780,661,759686
2021-07-16,jordan,Asia,10391780,475,760161
2021-07-17,jordan,Asia,10391780,389,760550
2021-07-18,jordan,Asia,10391780,675,761225
2021-07-19,jordan,Asia,10391780,803,762028
2021-07-20,jordan,Asia,10391780,392,762420
2021-07-21,jordan,Asia,10391780,286,762706
2021-07-22,jordan,Asia,10391780,400,763106
2021-07-23,jordan,Asia,10391780,331,763437
2021-07-24,jordan,Asia,10391780,485,763922
2021-07-25,jordan,Asia,10391780,1061,764983
2021-07-26,jordan,Asia,10391780,1131,766114
2021-07-27,jordan,Asia,10391780,1213,767327
2021-07-28,jordan,Asia,10391780,1055,768382
2021-07-29,jordan,Asia,10391780,1008,769390
2021-07-30,jordan,Asia,10391780,760,770150
2021-07-31,jordan,Asia,10391780,562,770712
2021-08-01,jordan,Asia,10391780,1041,771753
2021-08-02,jordan,Asia,10391780,990,772743
2021-08-03,jordan,Asia,10391780,914,773657
2021-08-04,jordan,Asia,10391780,897,774554
2021-08-05,jordan,Asia,10391780,697,775251
2021-08-06,jordan,Asia,10391780,531,775782
2021-08-07,jordan,Asia,10391780,396,776178
2021-08-08,jordan,Asia,10391780,986,777164
2021-08-09,jordan,Asia,10391780,929,778093
2021-08-10,jordan,Asia,10391780,926,779019
2021-08-11,jordan,Asia,10391780,511,779530
2021-08-12,jordan,Asia,10391780,1012,780542
2021-08-13,jordan,Asia,10391780,1010,781552
2021-08-14,jordan,Asia,10391780,658,782210
2021-08-15,jordan,Asia,10391780,1238,783448
2021-08-16,jordan,Asia,10391780,1183,784631
2021-08-17,jordan,Asia,10391780,1066,785697
2021-08-18,jordan,Asia,10391780,888,786585
2021-08-19,jordan,Asia,10391780,782,787367
2021-08-20,jordan,Asia,10391780,721,788088
2021-08-21,jordan,Asia,10391780,428,788516
2021-08-22,jordan,Asia,10391780,958,789474
2021-08-23,jordan,Asia,10391780,976,790450
2021-08-24,jordan,Asia,10391780,1016,791466
2021-08-25,jordan,Asia,10391780,812,792278
2021-08-26,jordan,Asia,10391780,904,793182
2021-08-27,jordan,Asia,10391780,787,793969
2021-08-28,jordan,Asia,10391780,381,794350
2021-08-29,jordan,Asia,10391780,811,795161
2021-08-30,jordan,Asia,10391780,1098,796259
2021-08-31,jordan,Asia,10391780,867,797126
2021-09-01,jordan,Asia,10391780,965,798091
2021-09-02,jordan,Asia,10391780,893,798984
2021-09-03,jordan,Asia,10391780,841,799825
2021-09-04,jordan,Asia,10391780,415,800240
2021-09-05,jordan,Asia,10391780,1048,801288
2021-09-06,jordan,Asia,10391780,1061,802349
2021-09-07,jordan,Asia,10391780,1002,803351
2021-09-08,jordan,Asia,10391780,975,804326
2021-09-09,jordan,Asia,10391780,888,805214
2021-09-10,jordan,Asia,10391780,798,806012
2021-09-11,jordan,Asia,10391780,489,806501
2021-09-12,jordan,Asia,10391780,883,807384
2021-09-13,jordan,Asia,10391780,1086,808470
2021-09-14,jordan,Asia,10391780,973,809443
2021-09-15,jordan,Asia,10391780,1116,810559
2021-09-16,jordan,Asia,10391780,904,811463
2021-09-17,jordan,Asia,10391780,790,812253
2021-09-18,jordan,Asia,10391780,428,812681
2021-09-19,jordan,Asia,10391780,920,813601
2021-09-20,jordan,Asia,10391780,1075,814676
2021-09-21,jordan,Asia,10391780,870,815546
2021-09-22,jordan,Asia,10391780,1028,816574
2021-09-23,jordan,Asia,10391780,913,817487
2021-09-24,jordan,Asia,10391780,871,818358
2021-09-25,jordan,Asia,10391780,438,818796
2021-09-26,jordan,Asia,10391780,987,819783
2021-09-27,jordan,Asia,10391780,1015,820798
2021-09-28,jordan,Asia,10391780,1042,821840
2021-09-29,jordan,Asia,10391780,1052,822892
2021-09-30,jordan,Asia,10391780,1027,823919
2021-10-01,jordan,Asia,10391780,778,824697
2021-10-02,jordan,Asia,10391780,548,825245
2021-10-03,jordan,Asia,10391780,1037,826282
2021-10-04,jordan,Asia,10391780,1222,827504
2021-10-05,jordan,Asia,10391780,1068,828572
2021-10-06,jordan,Asia,10391780,1316,829888
2021-10-07,jordan,Asia,10391780,1056,830944
2021-10-08,jordan,Asia,10391780,888,831832
2021-10-09,jordan,Asia,10391780,567,832399
2021-10-10,jordan,Asia,10391780,1072,833471
2021-10-11,jordan,Asia,10391780,1307,834778
2021-10-12,jordan,Asia,10391780,1191,835969
2021-10-13,jordan,Asia,10391780,1286,837255
2021-10-14,jordan,Asia,10391780,1268,838523
2021-10-15,jordan,Asia,10391780,1021,839544
2021-10-16,jordan,Asia,10391780,573,840117
2021-10-17,jordan,Asia,10391780,1372,841489
2021-10-18,jordan,Asia,10391780,1715,843204
2021-10-19,jordan,Asia,10391780,1597,844801
2021-10-20,jordan,Asia,10391780,1232,846033
2021-10-21,jordan,Asia,10391780,1473,847506
2021-10-22,jordan,Asia,10391780,1494,849000
2021-10-23,jordan,Asia,10391780,758,849758
2021-10-24,jordan,Asia,10391780,1652,851410
2021-10-25,jordan,Asia,10391780,1602,853012
2021-10-26,jordan,Asia,10391780,1746,854758
2021-10-27,jordan,Asia,10391780,1692,856450
2021-10-28,jordan,Asia,10391780,1892,858342
2021-10-29,jordan,Asia,10391780,1454,859796
2021-10-30,jordan,Asia,10391780,1022,860818
2021-10-31,jordan,Asia,10391780,1723,862541
2021-11-01,jordan,Asia,10391780,2120,864661
2021-11-02,jordan,Asia,10391780,1790,866451
2021-11-03,jordan,Asia,10391780,2042,868493
2021-11-04,jordan,Asia,10391780,2012,870505
2021-11-05,jordan,Asia,10391780,2080,872585
2021-11-06,jordan,Asia,10391780,1122,873707
2021-11-07,jordan,Asia,10391780,2097,875804
2021-11-08,jordan,Asia,10391780,2562,878366
2021-11-09,jordan,Asia,10391780,2577,880943
2021-11-10,jordan,Asia,10391780,2503,883446
2021-11-11,jordan,Asia,10391780,2596,886042
2021-11-12,jordan,Asia,10391780,2393,888435
2021-11-13,jordan,Asia,10391780,1236,889671
2021-11-14,jordan,Asia,10391780,2452,892123
2021-11-15,jordan,Asia,10391780,3441,895564
2021-11-16,jordan,Asia,10391780,3118,898682
2021-11-17,jordan,Asia,10391780,3317,901999
2021-11-18,jordan,Asia,10391780,3739,905738
2021-11-19,jordan,Asia,10391780,3677,909415
2021-11-20,jordan,Asia,10391780,1855,911270
2021-11-21,jordan,Asia,10391780,3579,914849
2021-11-22,jordan,Asia,10391780,4324,919173
2021-11-23,jordan,Asia,10391780,4549,923722
2021-11-24,jordan,Asia,10391780,4534,928256
2021-11-25,jordan,Asia,10391780,4283,932539
2021-11-26,jordan,Asia,10391780,4080,936619
2021-11-27,jordan,Asia,10391780,2674,939293
2021-11-28,jordan,Asia,10391780,4012,943305
2021-11-29,jordan,Asia,10391780,5661,948966
2021-11-30,jordan,Asia,10391780,4977,953943
2021-12-01,jordan,Asia,10391780,5047,958990
2020-03-27,kenya,Africa,55976553,0,31
2020-03-28,kenya,Africa,55976553,7,38
2020-03-29,kenya,Africa,55976553,4,42
2020-03-30,kenya,Africa,55976553,8,50
2020-03-31,kenya,Africa,55976553,9,59
2020-04-01,kenya,Africa,55976553,22,81
2020-04-02,kenya,Africa,55976553,29,110
2020-04-03,kenya,Africa,55976553,12,122
2020-04-04,kenya,Africa,55976553,4,126
2020-04-05,kenya,Africa,55976553,16,142
2020-04-06,kenya,Africa,55976553,16,158
2020-04-07,kenya,Africa,55976553,14,172
2020-04-08,kenya,Africa,55976553,7,179
2020-04-09,kenya,Africa,55976553,5,184
2020-04-10,kenya,Africa,55976553,5,189
2020-04-11,kenya,Africa,55976553,2,191
2020-04-12,kenya,Africa,55976553,6,197
2020-04-13,kenya,Africa,55976553,11,208
2020-04-14,kenya,Africa,55976553,8,216
2020-04-15,kenya,Africa,55976553,9,225
2020-04-16,kenya,Africa,55976553,9,234
2020-04-17,kenya,Africa,55976553,12,246
2020-04-18,kenya,Africa,55976553,16,262
2020-04-19,kenya,Africa,55976553,8,270
2020-04-20,kenya,Africa,55976553,11,281
2020-04-21,kenya,Africa,55976553,15,296
2020-04-22,kenya,Africa,55976553,7,303
2020-04-23,kenya,Africa,55976553,17,320
2020-04-24,kenya,Africa,55976553,16,336
2020-04-25,kenya,Africa,55976553,7,343
2020-04-26,kenya,Africa,55976553,12,355
2020-04-27,kenya,Africa,55976553,8,363
2020-04-28,kenya,Africa,55976553,11,374
2020-04-29,kenya,Africa,55976553,10,384
2020-04-30,kenya,Africa,55976553,12,396
2020-05-01,kenya,Africa,55976553,15,411
2020-05-02,kenya,Africa,55976553,24,435
2020-05-03,kenya,Africa,55976553,30,465
2020-05-04,kenya,Africa,55976553,25,490
2020-05-05,kenya,Africa,55976553,45,535
2020-05-06,kenya,Africa,55976553,47,582
2020-05-07,kenya,Africa,55976553,25,607
2020-05-08,kenya,Africa,55976553,14,621
2020-05-09,kenya,Africa,55976553,28,649
2020-05-10,kenya,Africa,55976553,23,672
2020-05-11,kenya,Africa,55976553,28,700
2020-05-12,kenya,Africa,55976553,15,715
2020-05-13,kenya,Africa,55976553,22,737
2020-05-14,kenya,Africa,55976553,21,758
2020-05-15,kenya,Africa,55976553,23,781
2020-02-25,kuwait,Asia,4388186,6,11
2020-02-26,kuwait,Asia,4388186,15,26
2020-02-27,kuwait,Asia,4388186,17,43
2020-02-28,kuwait,Asia,4388186,2,45
2020-02-29,kuwait,Asia,4388186,0,45
2020-03-01,kuwait,Asia,4388186,1,46
2020-03-02,kuwait,Asia,4388186,10,56
2020-03-03,kuwait,Asia,4388186,0,56
2020-03-04,kuwait,Asia,4388186,0,56
2020-03-05,kuwait,Asia,4388186,2,58
2020-03-06,kuwait,Asia,4388186,0,58
2020-03-07,kuwait,Asia,4388186,3,61
2020-03-08,kuwait,Asia,4388186,3,64
2020-03-09,kuwait,Asia,4388186,1,65
2020-03-10,kuwait,Asia,4388186,4,69
2020-03-11,kuwait,Asia,4388186,3,72
2020-03-12,kuwait,Asia,4388186,8,80
2020-03-13,kuwait,Asia,4388186,20,100
2020-03-14,kuwait,Asia,4388186,4,104
2020-03-15,kuwait,Asia,4388186,8,112
2020-03-16,kuwait,Asia,4388186,11,123
2020-03-17,kuwait,Asia,4388186,7,130
2020-03-18,kuwait,Asia,4388186,12,142
2020-03-19,kuwait,Asia,4388186,6,148
2020-03-20,kuwait,Asia,4388186,11,159
2020-03-21,kuwait,Asia,4388186,17,176
2020-03-22,kuwait,Asia,4388186,12,188
2020-03-23,kuwait,Asia,4388186,1,189
2020-03-24,kuwait,Asia,4388186,2,191
2020-03-25,kuwait,Asia,4388186,4,195
2020-03-26,kuwait,Asia,4388186,13,208
2020-03-27,kuwait,Asia,4388186,17,225
2020-03-28,kuwait,Asia,4388186,10,235
2020-03-29,kuwait,Asia,4388186,20,255
2020-03-30,kuwait,Asia,4388186,11,266
2020-03-31,kuwait,Asia,4388186,23,289
2020-04-01,kuwait,Asia,4388186,28,317
2020-04-02,kuwait,Asia,4388186,25,342
2020-04-03,kuwait,Asia,4388186,75,417
2020-04-04,kuwait,Asia,4388186,62,479
2020-04-05,kuwait,Asia,4388186,77,556
2020-04-06,kuwait,Asia,4388186,109,665
2020-04-07,kuwait,Asia,4388186,78,743
2020-04-08,kuwait,Asia,4388186,112,855
2020-04-09,kuwait,Asia,4388186,55,910
2020-04-10,kuwait,Asia,4388186,83,993
2020-04-11,kuwait,Asia,4388186,161,1154
2020-04-12,kuwait,Asia,4388186,80,1234
2020-04-13,kuwait,Asia,4388186,66,1300
2020-04-14,kuwait,Asia,4388186,55,1355
2020-04-15,kuwait,Asia,4388186,50,1405
2020-04-16,kuwait,Asia,4388186,119,1524
2020-04-17,kuwait,Asia,4388186,134,1658
2020-04-18,kuwait,Asia,4388186,93,1751
2020-04-19,kuwait,Asia,4388186,164,1915
2020-04-20,kuwait,Asia,4388186,80,1995
2020-04-21,kuwait,Asia,4388186,85,2080
2020-04-22,kuwait,Asia,4388186,168,2248
2020-04-23,kuwait,Asia,4388186,151,2399
2020-04-24,kuwait,Asia,4388186,215,2614
2020-04-25,kuwait,Asia,4388186,278,2892
2020-04-26,kuwait,Asia,4388186,183,3075
2020-04-27,kuwait,Asia,4388186,213,3288
2020-04-28,kuwait,Asia,4388186,152,3440
2020-04-29,kuwait,Asia,4388186,300,3740
2020-04-30,kuwait,Asia,4388186,284,4024
2020-05-01,kuwait,Asia,4388186,353,4377
2020-05-02,kuwait,Asia,4388186,242,4619
2020-05-03,kuwait,Asia,4388186,364,4983
2020-05-04,kuwait,Asia,4388186,295,5278
2020-05-05,kuwait,Asia,4388186,526,5804
2020-05-06,kuwait,Asia,4388186,485,6289
2020-05-07,kuwait,Asia,4388186,278,6567
2020-05-08,kuwait,Asia,4388186,641,7208
2020-05-09,kuwait,Asia,4388186,415,7623
2020-05-10,kuwait,Asia,4388186,1065,8688
2020-05-11,kuwait,Asia,4388186,598,9286
2020-05-12,kuwait,Asia,4388186,991,10277
2020-05-13,kuwait,Asia,4388186,751,11028
2020-05-14,kuwait,Asia,4388186,947,11975
2020-05-15,kuwait,Asia,4388186,885,12860
2020-05-16,kuwait,Asia,4388186,942,13802
2020-05-17,kuwait,Asia,4388186,1048,14850
2020-05-18,kuwait,Asia,4388186,841,15691
2020-05-19,kuwait,Asia,4388186,1073,16764
2020-05-20,kuwait,Asia,4388186,804,17568
2020-05-21,kuwait,Asia,4388186,1041,18609
2020-05-22,kuwait,Asia,4388186,955,19564
2020-05-23,kuwait,Asia,4388186,900,20464
2020-05-24,kuwait,Asia,4388186,838,21302
2020-05-25,kuwait,Asia,4388186,665,21967
2020-05-26,kuwait,Asia,4388186,608,22575
2020-05-27,kuwait,Asia,4388186,692,23267
2020-05-28,kuwait,Asia,4388186,845,24112
2020-05-29,kuwait,Asia,4388186,1072,25184
2020-05-30,kuwait,Asia,4388186,1008,26192
2020-05-31,kuwait,Asia,4388186,851,27043
2020-06-01,kuwait,Asia,4388186,719,27762
2020-06-02,kuwait,Asia,4388186,887,28649
2020-06-03,kuwait,Asia,4388186,710,29359
2020-06-04,kuwait,Asia,4388186,562,29921
2020-06-05,kuwait,Asia,4388186,723,30644
2020-06-06,kuwait,Asia,4388186,487,31131
2020-06-07,kuwait,Asia,4388186,717,31848
2020-06-08,kuwait,Asia,4388186,662,32510
2020-06-09,kuwait,Asia,4388186,630,33140
2020-06-10,kuwait,Asia,4388186,683,33823
2020-06-11,kuwait,Asia,4388186,609,34432
2020-06-12,kuwait,Asia,4388186,520,34952
2020-06-13,kuwait,Asia,4388186,514,35466
2020-06-14,kuwait,Asia,4388186,454,35920
2020-06-15,kuwait,Asia,4388186,511,36431
2020-06-16,kuwait,Asia,4388186,527,36958
2020-06-17,kuwait,Asia,4388186,575,37533
2020-06-18,kuwait,Asia,4388186,541,38074
2020-06-19,kuwait,Asia,4388186,604,38678
2020-06-20,kuwait,Asia,4388186,467,39145
2020-06-21,kuwait,Asia,4388186,505,39650
2020-06-22,kuwait,Asia,4388186,641,40291
2020-06-23,kuwait,Asia,4388186,742,41033
2020-06-24,kuwait,Asia,4388186,846,41879
2020-06-25,kuwait,Asia,4388186,909,42788
2020-06-26,kuwait,Asia,4388186,915,43703
2020-06-27,kuwait,Asia,4388186,688,44391
2020-06-28,kuwait,Asia,4388186,551,44942
2020-06-29,kuwait,Asia,4388186,582,45524
2020-06-30,kuwait,Asia,4388186,671,46195
2020-07-01,kuwait,Asia,4388186,745,46940
2020-07-02,kuwait,Asia,4388186,919,47859
2020-07-03,kuwait,Asia,4388186,813,48672
2020-07-04,kuwait,Asia,4388186,631,49303
2020-07-05,kuwait,Asia,4388186,638,49941
2020-07-06,kuwait,Asia,4388186,703,50644
2020-07-07,kuwait,Asia,4388186,601,51245
2020-07-08,kuwait,Asia,4388186,762,52007
2020-07-09,kuwait,Asia,4388186,833,52840
2020-07-10,kuwait,Asia,4388186,740,53580
2020-07-11,kuwait,Asia,4388186,478,54058
2020-07-12,kuwait,Asia,4388186,836,54894
2020-07-13,kuwait,Asia,4388186,614,55508
2020-07-14,kuwait,Asia,4388186,666,56174
2020-07-15,kuwait,Asia,4388186,703,56877
2020-07-16,kuwait,Asia,4388186,791,57668
2020-07-17,kuwait,Asia,4388186,553,58221
2020-07-18,kuwait,Asia,4388186,683,58904
2020-07-19,kuwait,Asia,4388186,300,59204
2020-07-20,kuwait,Asia,4388186,559,59763
2020-07-21,kuwait,Asia,4388186,671,60434
2020-07-22,kuwait,Asia,4388186,751,61185
2020-07-23,kuwait,Asia,4388186,687,61872
2020-07-24,kuwait,Asia,4388186,753,62625
2020-07-25,kuwait,Asia,4388186,684,63309
2020-07-26,kuwait,Asia,4388186,464,63773
2020-07-27,kuwait,Asia,4388186,606,64379
2020-07-28,kuwait,Asia,4388186,770,65149
2020-07-29,kuwait,Asia,4388186,754,65903
2020-07-30,kuwait,Asia,4388186,626,66529
2020-07-31,kuwait,Asia,4388186,428,66957
2020-08-01,kuwait,Asia,4388186,491,67448
2020-08-02,kuwait,Asia,4388186,463,67911
2020-08-03,kuwait,Asia,4388186,388,68299
2020-08-04,kuwait,Asia,4388186,475,68774
2020-08-05,kuwait,Asia,4388186,651,69425
2020-08-06,kuwait,Asia,4388186,620,70045
2020-08-07,kuwait,Asia,4388186,682,70727
2020-08-08,kuwait,Asia,4388186,472,71199
2020-08-09,kuwait,Asia,4388186,514,71713
2020-08-10,kuwait,Asia,4388186,687,72400
2020-08-11,kuwait,Asia,4388186,668,73068
2020-08-12,kuwait,Asia,4388186,717,73785
2020-08-13,kuwait,Asia,4388186,701,74486
2020-08-14,kuwait,Asia,4388186,699,75185
2020-08-15,kuwait,Asia,4388186,512,75697
2020-08-16,kuwait,Asia,4388186,508,76205
2020-08-17,kuwait,Asia,4388186,622,76827
2020-08-18,kuwait,Asia,4388186,643,77470
2020-04-04,kyrgyzstan,Asia,6724638,26,265
2020-04-05,kyrgyzstan,Asia,6724638,5,270
2020-04-06,kyrgyzstan,Asia,6724638,126,396
2020-04-07,kyrgyzstan,Asia,6724638,22,418
2020-04-08,kyrgyzstan,Asia,6724638,77,495
2020-04-09,kyrgyzstan,Asia,6724638,18,513
2020-04-10,kyrgyzstan,Asia,6724638,33,546
2020-04-11,kyrgyzstan,Asia,6724638,75,621
2020-04-12,kyrgyzstan,Asia,6724638,69,690
2020-04-13,kyrgyzstan,Asia,6724638,77,767
2020-04-14,kyrgyzstan,Asia,6724638,20,787
2020-04-15,kyrgyzstan,Asia,6724638,35,822
2020-04-16,kyrgyzstan,Asia,6724638,31,853
2020-04-17,kyrgyzstan,Asia,6724638,42,895
2020-04-18,kyrgyzstan,Asia,6724638,31,926
2020-04-19,kyrgyzstan,Asia,6724638,88,1014
2020-04-20,kyrgyzstan,Asia,6724638,26,1040
2020-04-21,kyrgyzstan,Asia,6724638,40,1080
2020-04-22,kyrgyzstan,Asia,6724638,40,1120
2020-04-23,kyrgyzstan,Asia,6724638,35,1155
2020-04-24,kyrgyzstan,Asia,6724638,46,1201
2020-04-25,kyrgyzstan,Asia,6724638,16,1217
2020-04-26,kyrgyzstan,Asia,6724638,31,1248
2020-04-27,kyrgyzstan,Asia,6724638,24,1272
2020-04-28,kyrgyzstan,Asia,6724638,24,1296
2020-04-29,kyrgyzstan,Asia,6724638,38,1334
2020-04-30,kyrgyzstan,Asia,6724638,31,1365
2020-05-01,kyrgyzstan,Asia,6724638,18,1383
2020-05-02,kyrgyzstan,Asia,6724638,24,1407
2020-05-03,kyrgyzstan,Asia,6724638,48,1455
2020-05-04,kyrgyzstan,Asia,6724638,64,1519
2020-05-05,kyrgyzstan,Asia,6724638,24,1543
2020-05-06,kyrgyzstan,Asia,6724638,51,1594
2020-05-07,kyrgyzstan,Asia,6724638,44,1638
2020-05-08,kyrgyzstan,Asia,6724638,20,1658
2020-05-09,kyrgyzstan,Asia,6724638,46,1704
2020-05-10,kyrgyzstan,Asia,6724638,130,1834
2020-05-11,kyrgyzstan,Asia,6724638,26,1860
2020-05-12,kyrgyzstan,Asia,6724638,38,1898
2020-05-13,kyrgyzstan,Asia,6724638,13,1911
2020-05-14,kyrgyzstan,Asia,6724638,69,1980
2020-05-15,kyrgyzstan,Asia,6724638,53,2033
2020-05-16,kyrgyzstan,Asia,6724638,11,2044
2020-05-17,kyrgyzstan,Asia,6724638,38,2082
2020-05-18,kyrgyzstan,Asia,6724638,143,2225
2020-05-19,kyrgyzstan,Asia,6724638,49,2274
2020-05-20,kyrgyzstan,Asia,6724638,49,2323
2020-05-21,kyrgyzstan,Asia,6724638,79,2402
2020-05-22,kyrgyzstan,Asia,6724638,68,2470
2020-05-23,kyrgyzstan,Asia,6724638,27,2497
2020-05-24,kyrgyzstan,Asia,6724638,69,2566
2020-05-25,kyrgyzstan,Asia,6724638,55,2621
2020-05-26,kyrgyzstan,Asia,6724638,64,2685
2020-05-27,kyrgyzstan,Asia,6724638,95,2780
2020-05-28,kyrgyzstan,Asia,6724638,135,2915
2020-05-29,kyrgyzstan,Asia,6724638,124,3039
2020-05-30,kyrgyzstan,Asia,6724638,110,3149
2020-05-31,kyrgyzstan,Asia,6724638,48,3197
2020-06-01,kyrgyzstan,Asia,6724638,126,3323
2020-06-02,kyrgyzstan,Asia,6724638,51,3374
2020-06-03,kyrgyzstan,Asia,6724638,48,3422
2020-06-04,kyrgyzstan,Asia,6724638,51,3473
2020-06-05,kyrgyzstan,Asia,6724638,68,3541
2020-06-06,kyrgyzstan,Asia,6724638,69,3610
2020-06-07,kyrgyzstan,Asia,6724638,60,3670
2020-06-08,kyrgyzstan,Asia,6724638,46,3716
2020-06-09,kyrgyzstan,Asia,6724638,42,3758
2020-06-10,kyrgyzstan,Asia,6724638,69,3827
2020-06-11,kyrgyzstan,Asia,6724638,66,3893
2020-06-12,kyrgyzstan,Asia,6724638,68,3961
2020-06-13,kyrgyzstan,Asia,6724638,75,4036
2020-06-14,kyrgyzstan,Asia,6724638,143,4179
2020-06-15,kyrgyzstan,Asia,6724638,159,4338
2020-06-16,kyrgyzstan,Asia,6724638,183,4521
2020-06-17,kyrgyzstan,Asia,6724638,165,4686
2020-06-18,kyrgyzstan,Asia,6724638,174,4860
2020-06-19,kyrgyzstan,Asia,6724638,241,5101
2020-06-20,kyrgyzstan,Asia,6724638,351,5452
2020-06-21,kyrgyzstan,Asia,6724638,311,5763
2020-06-22,kyrgyzstan,Asia,6724638,375,6138
2020-06-23,kyrgyzstan,Asia,6724638,298,6436
2020-06-24,kyrgyzstan,Asia,6724638,378,6814
2020-06-25,kyrgyzstan,Asia,6724638,417,7231
2020-06-26,kyrgyzstan,Asia,6724638,457,7688
2020-06-27,kyrgyzstan,Asia,6724638,565,8253
2020-06-28,kyrgyzstan,Asia,6724638,430,8683
2020-06-29,kyrgyzstan,Asia,6724638,492,9175
2020-06-30,kyrgyzstan,Asia,6724638,510,9685
2020-07-01,kyrgyzstan,Asia,6724638,803,10488
2020-07-02,kyrgyzstan,Asia,6724638,962,11450
2020-07-03,kyrgyzstan,Asia,6724638,925,12375
2020-07-04,kyrgyzstan,Asia,6724638,598,12973
2020-07-05,kyrgyzstan,Asia,6724638,517,13490
2020-07-06,kyrgyzstan,Asia,6724638,574,14064
2020-07-07,kyrgyzstan,Asia,6724638,823,14887
2020-07-08,kyrgyzstan,Asia,6724638,631,15518
2020-07-09,kyrgyzstan,Asia,6724638,660,16178
2020-07-10,kyrgyzstan,Asia,6724638,934,17112
2020-07-11,kyrgyzstan,Asia,6724638,1009,18121
2020-07-12,kyrgyzstan,Asia,6724638,1315,19436
2020-07-13,kyrgyzstan,Asia,6724638,892,20328
2020-07-14,kyrgyzstan,Asia,6724638,598,20926
2020-07-15,kyrgyzstan,Asia,6724638,975,21901
2020-07-16,kyrgyzstan,Asia,6724638,953,22854
2020-07-17,kyrgyzstan,Asia,6724638,803,23657
2020-07-18,kyrgyzstan,Asia,6724638,949,24606
2020-07-19,kyrgyzstan,Asia,6724638,1926,26532
2020-07-20,kyrgyzstan,Asia,6724638,611,27143
2020-07-21,kyrgyzstan,Asia,6724638,1108,28251
2020-07-22,kyrgyzstan,Asia,6724638,1108,29359
2020-07-23,kyrgyzstan,Asia,6724638,990,30349
2020-07-24,kyrgyzstan,Asia,6724638,898,31247
2020-07-25,kyrgyzstan,Asia,6724638,877,32124
2020-07-26,kyrgyzstan,Asia,6724638,689,32813
2020-07-27,kyrgyzstan,Asia,6724638,483,33296
2020-07-28,kyrgyzstan,Asia,6724638,548,33844
2020-07-29,kyrgyzstan,Asia,6724638,748,34592
2020-07-30,kyrgyzstan,Asia,6724638,631,35223
2020-07-31,kyrgyzstan,Asia,6724638,582,35805
2020-08-01,kyrgyzstan,Asia,6724638,494,36299
2020-08-02,kyrgyzstan,Asia,6724638,420,36719
2020-08-03,kyrgyzstan,Asia,6724638,410,37129
2020-08-04,kyrgyzstan,Asia,6724638,412,37541
2020-08-05,kyrgyzstan,Asia,6724638,569,38110
2020-08-06,kyrgyzstan,Asia,6724638,549,38659
2020-08-07,kyrgyzstan,Asia,6724638,503,39162
2020-08-08,kyrgyzstan,Asia,6724638,425,39587
2020-08-09,kyrgyzstan,Asia,6724638,332,39919
2020-08-10,kyrgyzstan,Asia,6724638,258,40177
2020-08-11,kyrgyzstan,Asia,6724638,278,40455
2020-08-12,kyrgyzstan,Asia,6724638,304,40759
2020-08-13,kyrgyzstan,Asia,6724638,310,41069
2020-08-14,kyrgyzstan,Asia,6724638,304,41373
2020-08-15,kyrgyzstan,Asia,6724638,272,41645
2020-08-16,kyrgyzstan,Asia,6724638,211,41856
2020-08-17,kyrgyzstan,Asia,6724638,135,41991
2020-08-18,kyrgyzstan,Asia,6724638,155,42146
2020-08-19,kyrgyzstan,Asia,6724638,179,42325
2020-08-20,kyrgyzstan,Asia,6724638,182,42507
2020-08-21,kyrgyzstan,Asia,6724638,196,42703
2020-08-22,kyrgyzstan,Asia,6724638,186,42889
2020-08-23,kyrgyzstan,Asia,6724638,134,43023
2020-08-24,kyrgyzstan,Asia,6724638,103,43126
2020-08-25,kyrgyzstan,Asia,6724638,119,43245
2020-08-26,kyrgyzstan,Asia,6724638,113,43358
2020-08-27,kyrgyzstan,Asia,6724638,101,43459
2020-08-28,kyrgyzstan,Asia,6724638,128,43587
2020-08-29,kyrgyzstan,Asia,6724638,125,43712
2020-08-30,kyrgyzstan,Asia,6724638,108,43820
2020-08-31,kyrgyzstan,Asia,6724638,78,43898
2020-09-01,kyrgyzstan,Asia,6724638,60,43958
2020-09-02,kyrgyzstan,Asia,6724638,78,44036
2020-09-03,kyrgyzstan,Asia,6724638,99,44135
2020-09-04,kyrgyzstan,Asia,6724638,64,44199
2020-09-05,kyrgyzstan,Asia,6724638,117,44316
2020-09-06,kyrgyzstan,Asia,6724638,87,44403
2020-09-07,kyrgyzstan,Asia,6724638,55,44458
2020-09-08,kyrgyzstan,Asia,6724638,68,44526
2020-09-09,kyrgyzstan,Asia,6724638,87,44613
2020-09-10,kyrgyzstan,Asia,6724638,71,44684
2020-09-11,kyrgyzstan,Asia,6724638,77,44761
2020-09-12,kyrgyzstan,Asia,6724638,67,44828
2020-09-13,kyrgyzstan,Asia,6724638,53,44881
2020-09-14,kyrgyzstan,Asia,6724638,47,44928
2020-09-15,kyrgyzstan,Asia,6724638,71,44999
2020-09-16,kyrgyzstan,Asia,6724638,73,45072
2020-09-17,kyrgyzstan,Asia,6724638,81,45153
2020-09-18,kyrgyzstan,Asia,6724638,91,45244
2020-09-19,kyrgyzstan,Asia,6724638,91,45335
2020-09-20,kyrgyzstan,Asia,6724638,81,45416
2020-09-21,kyrgyzstan,Asia,6724638,55,45471
2020-09-22,kyrgyzstan,Asia,6724638,71,45542
2020-09-23,kyrgyzstan,Asia,6724638,88,45630
2020-09-24,kyrgyzstan,Asia,6724638,127,45757
2020-09-25,kyrgyzstan,Asia,6724638,175,45932
2020-09-26,kyrgyzstan,Asia,6724638,158,46090
2020-09-27,kyrgyzstan,Asia,6724638,161,46251
2020-09-28,kyrgyzstan,Asia,6724638,104,46355
2020-09-29,kyrgyzstan,Asia,6724638,167,46522
2020-09-30,kyrgyzstan,Asia,6724638,147,46669
2020-10-01,kyrgyzstan,Asia,6724638,172,46841
2020-10-02,kyrgyzstan,Asia,6724638,215,47056
2020-10-03,kyrgyzstan,Asia,6724638,128,47184
2020-10-04,kyrgyzstan,Asia,6724638,244,47428
2020-10-05,kyrgyzstan,Asia,6724638,207,47635
2020-10-06,kyrgyzstan,Asia,6724638,164,47799
2020-10-07,kyrgyzstan,Asia,6724638,298,48097
2020-10-08,kyrgyzstan,Asia,6724638,245,48342
2020-10-09,kyrgyzstan,Asia,6724638,275,48617
2020-10-10,kyrgyzstan,Asia,6724638,307,48924
2020-10-11,kyrgyzstan,Asia,6724638,306,49230
2020-10-12,kyrgyzstan,Asia,6724638,298,49528
2020-10-13,kyrgyzstan,Asia,6724638,343,49871
2020-10-14,kyrgyzstan,Asia,6724638,330,50201
2020-10-15,kyrgyzstan,Asia,6724638,388,50589
2020-10-16,kyrgyzstan,Asia,6724638,431,51020
2020-10-17,kyrgyzstan,Asia,6724638,470,51490
2020-10-18,kyrgyzstan,Asia,6724638,554,52044
2020-10-19,kyrgyzstan,Asia,6724638,482,52526
2020-10-20,kyrgyzstan,Asia,6724638,384,52910
2020-10-21,kyrgyzstan,Asia,6724638,549,53459
2020-10-22,kyrgyzstan,Asia,6724638,547,54006
2020-10-23,kyrgyzstan,Asia,6724638,582,54588
2020-10-24,kyrgyzstan,Asia,6724638,556,55144
2020-10-25,kyrgyzstan,Asia,6724638,606,55750
2020-10-26,kyrgyzstan,Asia,6724638,420,56170
2020-10-27,kyrgyzstan,Asia,6724638,568,56738
2020-10-28,kyrgyzstan,Asia,6724638,538,57276
2020-10-29,kyrgyzstan,Asia,6724638,522,57798
2020-10-30,kyrgyzstan,Asia,6724638,596,58394
2020-10-31,kyrgyzstan,Asia,6724638,484,58878
2020-11-01,kyrgyzstan,Asia,6724638,565,59443
2020-11-02,kyrgyzstan,Asia,6724638,436,59879
2020-11-03,kyrgyzstan,Asia,6724638,400,60279
2020-11-04,kyrgyzstan,Asia,6724638,495,60774
2020-11-05,kyrgyzstan,Asia,6724638,535,61309
2020-11-06,kyrgyzstan,Asia,6724638,439,61748
2020-11-07,kyrgyzstan,Asia,6724638,556,62304
2020-11-08,kyrgyzstan,Asia,6724638,515,62819
2020-11-09,kyrgyzstan,Asia,6724638,571,63390
2020-11-10,kyrgyzstan,Asia,6724638,570,63960
2020-11-11,kyrgyzstan,Asia,6724638,400,64360
2020-11-12,kyrgyzstan,Asia,6724638,527,64887
2020-11-13,kyrgyzstan,Asia,6724638,567,65454
2020-11-14,kyrgyzstan,Asia,6724638,499,65953
2020-11-15,kyrgyzstan,Asia,6724638,551,66504
2020-11-16,kyrgyzstan,Asia,6724638,479,66983
2020-11-17,kyrgyzstan,Asia,6724638,486,67469
2020-11-18,kyrgyzstan,Asia,6724638,425,67894
2020-11-19,kyrgyzstan,Asia,6724638,422,68316
2020-11-20,kyrgyzstan,Asia,6724638,386,68702
2020-11-21,kyrgyzstan,Asia,6724638,447,69149
2020-11-22,kyrgyzstan,Asia,6724638,432,69581
2020-11-23,kyrgyzstan,Asia,6724638,304,69885
2020-11-24,kyrgyzstan,Asia,6724638,481,70366
2020-11-25,kyrgyzstan,Asia,6724638,378,70744
2020-11-26,kyrgyzstan,Asia,6724638,427,71171
2020-11-27,kyrgyzstan,Asia,6724638,377,71548
2020-11-28,kyrgyzstan,Asia,6724638,423,71971
2020-11-29,kyrgyzstan,Asia,6724638,456,72427
2020-11-30,kyrgyzstan,Asia,6724638,380,72807
2020-12-01,kyrgyzstan,Asia,6724638,371,73178
2020-12-02,kyrgyzstan,Asia,6724638,335,73513
2020-12-03,kyrgyzstan,Asia,6724638,420,73933
2020-12-04,kyrgyzstan,Asia,6724638,440,74373
2020-12-05,kyrgyzstan,Asia,6724638,401,74774
2020-12-06,kyrgyzstan,Asia,6724638,199,74973
2020-12-07,kyrgyzstan,Asia,6724638,422,75395
2020-12-08,kyrgyzstan,Asia,6724638,295,75690
2020-12-09,kyrgyzstan,Asia,6724638,322,76012
2020-12-10,kyrgyzstan,Asia,6724638,379,76391
2020-12-11,kyrgyzstan,Asia,6724638,327,76718
2020-12-12,kyrgyzstan,Asia,6724638,341,77059
2020-12-13,kyrgyzstan,Asia,6724638,297,77356
2020-12-14,kyrgyzstan,Asia,6724638,318,77674
2020-12-15,kyrgyzstan,Asia,6724638,236,77910
2020-12-16,kyrgyzstan,Asia,6724638,241,78151
2020-12-17,kyrgyzstan,Asia,6724638,264,78415
2020-12-18,kyrgyzstan,Asia,6724638,264,78679
2020-12-19,kyrgyzstan,Asia,6724638,232,78911
2020-12-20,kyrgyzstan,Asia,6724638,211,79122
2020-12-21,kyrgyzstan,Asia,6724638,132,79254
2020-12-22,kyrgyzstan,Asia,6724638,175,79429
2020-12-23,kyrgyzstan,Asia,6724638,230,79659
2020-12-24,kyrgyzstan,Asia,6724638,186,79845
2020-12-25,kyrgyzstan,Asia,6724638,180,80025
2020-12-26,kyrgyzstan,Asia,6724638,157,80182
2020-12-27,kyrgyzstan,Asia,6724638,191,80373
2020-12-28,kyrgyzstan,Asia,6724638,162,80535
2020-12-29,kyrgyzstan,Asia,6724638,119,80654
2020-12-30,kyrgyzstan,Asia,6724638,189,80843
2020-12-31,kyrgyzstan,Asia,6724638,191,81034
2021-01-01,kyrgyzstan,Asia,6724638,122,81156
2021-01-02,kyrgyzstan,Asia,6724638,58,81214
2021-01-03,kyrgyzstan,Asia,6724638,91,81305
2021-01-04,kyrgyzstan,Asia,6724638,83,81388
2021-01-05,kyrgyzstan,Asia,6724638,124,81512
2021-01-06,kyrgyzstan,Asia,6724638,144,81656
2021-01-07,kyrgyzstan,Asia,6724638,170,81826
2021-01-08,kyrgyzstan,Asia,6724638,165,81991
2021-01-09,kyrgyzstan,Asia,6724638,147,82138
2021-01-10,kyrgyzstan,Asia,6724638,135,82273
2021-01-11,kyrgyzstan,Asia,6724638,107,82380
2021-01-12,kyrgyzstan,Asia,6724638,115,82495
2021-01-13,kyrgyzstan,Asia,6724638,92,82587
2021-01-14,kyrgyzstan,Asia,6724638,136,82723
2021-01-15,kyrgyzstan,Asia,6724638,134,82857
2021-01-16,kyrgyzstan,Asia,6724638,129,82986
2021-01-17,kyrgyzstan,Asia,6724638,123,83109
2021-01-18,kyrgyzstan,Asia,6724638,69,83178
2021-01-19,kyrgyzstan,Asia,6724638,90,83268
2021-01-20,kyrgyzstan,Asia,6724638,162,83430
2021-01-21,kyrgyzstan,Asia,6724638,155,83585
2021-01-22,kyrgyzstan,Asia,6724638,118,83703
2021-01-23,kyrgyzstan,Asia,6724638,93,83796
2021-01-24,kyrgyzstan,Asia,6724638,104,83900
2021-01-25,kyrgyzstan,Asia,6724638,71,83971
2021-01-26,kyrgyzstan,Asia,6724638,97,84068
2021-01-27,kyrgyzstan,Asia,6724638,107,84175
2021-01-28,kyrgyzstan,Asia,6724638,128,84303
2021-01-29,kyrgyzstan,Asia,6724638,74,84377
2021-01-30,kyrgyzstan,Asia,6724638,76,84453
2021-01-31,kyrgyzstan,Asia,6724638,76,84529
2021-02-01,kyrgyzstan,Asia,6724638,59,84588
2021-02-02,kyrgyzstan,Asia,6724638,58,84646
2021-02-03,kyrgyzstan,Asia,6724638,116,84762
2021-02-04,kyrgyzstan,Asia,6724638,70,84832
2021-02-05,kyrgyzstan,Asia,6724638,88,84920
2021-02-06,kyrgyzstan,Asia,6724638,72,84992
2021-02-07,kyrgyzstan,Asia,6724638,79,85071
2021-02-08,kyrgyzstan,Asia,6724638,42,85113
2021-02-09,kyrgyzstan,Asia,6724638,58,85171
2021-02-10,kyrgyzstan,Asia,6724638,82,85253
2021-02-11,kyrgyzstan,Asia,6724638,75,85328
2021-02-12,kyrgyzstan,Asia,6724638,70,85398
2021-02-13,kyrgyzstan,Asia,6724638,43,85441
2021-02-14,kyrgyzstan,Asia,6724638,34,85475
2021-02-15,kyrgyzstan,Asia,6724638,41,85516
2021-02-16,kyrgyzstan,Asia,6724638,48,85564
2021-02-17,kyrgyzstan,Asia,6724638,55,85619
2021-02-18,kyrgyzstan,Asia,6724638,70,85689
2021-02-19,kyrgyzstan,Asia,6724638,83,85772
2021-02-20,kyrgyzstan,Asia,6724638,59,85831
2021-02-21,kyrgyzstan,Asia,6724638,54,85885
2021-02-22,kyrgyzstan,Asia,6724638,44,85929
2021-02-23,kyrgyzstan,Asia,6724638,72,86001
2021-02-24,kyrgyzstan,Asia,6724638,24,86025
2021-02-25,kyrgyzstan,Asia,6724638,66,86091
2021-02-26,kyrgyzstan,Asia,6724638,51,86142
2021-02-27,kyrgyzstan,Asia,6724638,43,86185
2021-02-28,kyrgyzstan,Asia,6724638,44,86229
2021-03-01,kyrgyzstan,Asia,6724638,22,86251
2021-03-02,kyrgyzstan,Asia,6724638,57,86308
2021-03-03,kyrgyzstan,Asia,6724638,48,86356
2021-03-04,kyrgyzstan,Asia,6724638,54,86410
2021-03-05,kyrgyzstan,Asia,6724638,41,86451
2021-03-06,kyrgyzstan,Asia,6724638,55,86506
2021-03-07,kyrgyzstan,Asia,6724638,44,86550
2021-03-08,kyrgyzstan,Asia,6724638,33,86583
2021-03-09,kyrgyzstan,Asia,6724638,23,86606
2021-03-10,kyrgyzstan,Asia,6724638,34,86640
2021-03-11,kyrgyzstan,Asia,6724638,52,86692
2021-03-12,kyrgyzstan,Asia,6724638,63,86755
2021-03-13,kyrgyzstan,Asia,6724638,63,86818
2021-03-14,kyrgyzstan,Asia,6724638,32,86850
2021-03-15,kyrgyzstan,Asia,6724638,67,86917
2021-03-16,kyrgyzstan,Asia,6724638,73,86990
2021-03-17,kyrgyzstan,Asia,6724638,55,87045
2021-03-18,kyrgyzstan,Asia,6724638,98,87143
2021-03-19,kyrgyzstan,Asia,6724638,96,87239
2021-03-20,kyrgyzstan,Asia,6724638,82,87321
2021-03-21,kyrgyzstan,Asia,6724638,68,87389
2021-03-22,kyrgyzstan,Asia,6724638,73,87462
2021-03-23,kyrgyzstan,Asia,6724638,75,87537
2021-03-24,kyrgyzstan,Asia,6724638,115,87652
2021-03-25,kyrgyzstan,Asia,6724638,106,87758
2021-03-26,kyrgyzstan,Asia,6724638,100,87858
2021-03-27,kyrgyzstan,Asia,6724638,88,87946
2021-03-28,kyrgyzstan,Asia,6724638,146,88092
2021-03-29,kyrgyzstan,Asia,6724638,71,88163
2021-03-30,kyrgyzstan,Asia,6724638,113,88276
2021-03-31,kyrgyzstan,Asia,6724638,98,88374
2021-04-01,kyrgyzstan,Asia,6724638,164,88538
2021-04-02,kyrgyzstan,Asia,6724638,162,88700
2021-04-03,kyrgyzstan,Asia,6724638,142,88842
2021-04-04,kyrgyzstan,Asia,6724638,172,89014
2020-03-03,latvia,Europe,1847378,0,1
2020-03-04,latvia,Europe,1847378,0,1
2020-03-05,latvia,Europe,1847378,0,1
2020-03-06,latvia,Europe,1847378,0,1
2020-03-07,latvia,Europe,1847378,0,1
2020-03-08,latvia,Europe,1847378,2,3
2020-03-09,latvia,Europe,1847378,3,6
2020-03-10,latvia,Europe,1847378,2,8
2020-03-11,latvia,Europe,1847378,2,10
2020-03-12,latvia,Europe,1847378,6,16
2020-03-13,latvia,Europe,1847378,1,17
2020-03-14,latvia,Europe,1847378,9,26
2020-03-15,latvia,Europe,1847378,4,30
2020-03-16,latvia,Europe,1847378,4,34
2020-03-17,latvia,Europe,1847378,26,60
2020-03-18,latvia,Europe,1847378,11,71
2020-03-19,latvia,Europe,1847378,15,86
2020-03-20,latvia,Europe,1847378,23,109
2020-03-21,latvia,Europe,1847378,12,121
2020-03-22,latvia,Europe,1847378,15,136
2020-03-23,latvia,Europe,1847378,44,180
2020-03-24,latvia,Europe,1847378,17,197
2020-03-25,latvia,Europe,1847378,24,221
2020-03-26,latvia,Europe,1847378,23,244
2020-03-27,latvia,Europe,1847378,36,280
2020-03-28,latvia,Europe,1847378,25,305
2020-03-29,latvia,Europe,1847378,42,347
2020-03-30,latvia,Europe,1847378,29,376
2020-03-31,latvia,Europe,1847378,22,398
2020-04-01,latvia,Europe,1847378,48,446
2020-04-02,latvia,Europe,1847378,12,458
2020-04-03,latvia,Europe,1847378,35,493
2020-04-04,latvia,Europe,1847378,16,509
2020-04-05,latvia,Europe,1847378,24,533
2020-04-06,latvia,Europe,1847378,9,542
2020-04-07,latvia,Europe,1847378,6,548
2020-04-08,latvia,Europe,1847378,29,577
2020-04-09,latvia,Europe,1847378,12,589
2020-04-10,latvia,Europe,1847378,23,612
2020-04-11,latvia,Europe,1847378,18,630
2020-04-12,latvia,Europe,1847378,21,651
2020-04-13,latvia,Europe,1847378,2,653
2020-04-14,latvia,Europe,1847378,4,657
2020-04-15,latvia,Europe,1847378,9,666
2020-04-16,latvia,Europe,1847378,9,675
2020-04-17,latvia,Europe,1847378,7,682
2020-04-18,latvia,Europe,1847378,30,712
2020-04-19,latvia,Europe,1847378,15,727
2020-04-20,latvia,Europe,1847378,12,739
2020-04-21,latvia,Europe,1847378,9,748
2020-04-22,latvia,Europe,1847378,13,761
2020-04-23,latvia,Europe,1847378,17,778
2020-04-24,latvia,Europe,1847378,6,784
2020-04-25,latvia,Europe,1847378,20,804
2020-04-26,latvia,Europe,1847378,8,812
2020-04-27,latvia,Europe,1847378,6,818
2020-04-28,latvia,Europe,1847378,18,836
2020-04-29,latvia,Europe,1847378,13,849
2020-04-30,latvia,Europe,1847378,9,858
2020-05-01,latvia,Europe,1847378,12,870
2020-05-02,latvia,Europe,1847378,1,871
2020-05-03,latvia,Europe,1847378,8,879
2020-05-04,latvia,Europe,1847378,17,896
2020-05-05,latvia,Europe,1847378,0,896
2020-05-06,latvia,Europe,1847378,4,900
2020-05-07,latvia,Europe,1847378,9,909
2020-05-08,latvia,Europe,1847378,19,928
2020-05-09,latvia,Europe,1847378,2,930
2020-05-10,latvia,Europe,1847378,9,939
2020-05-11,latvia,Europe,1847378,7,946
2020-05-12,latvia,Europe,1847378,4,950
2020-05-13,latvia,Europe,1847378,1,951
2020-05-14,latvia,Europe,1847378,11,962
2020-05-15,latvia,Europe,1847378,8,970
2020-05-16,latvia,Europe,1847378,27,997
2020-05-17,latvia,Europe,1847378,11,1008
2020-05-18,latvia,Europe,1847378,1,1009
2020-05-19,latvia,Europe,1847378,3,1012
2020-05-20,latvia,Europe,1847378,4,1016
2020-05-21,latvia,Europe,1847378,9,1025
2020-05-22,latvia,Europe,1847378,5,1030
2020-05-23,latvia,Europe,1847378,16,1046
2020-05-24,latvia,Europe,1847378,1,1047
2020-05-25,latvia,Europe,1847378,2,1049
2020-05-26,latvia,Europe,1847378,4,1053
2020-05-27,latvia,Europe,1847378,4,1057
2020-05-28,latvia,Europe,1847378,4,1061
2020-05-29,latvia,Europe,1847378,3,1064
2020-05-30,latvia,Europe,1847378,1,1065
2020-05-31,latvia,Europe,1847378,1,1066
2020-06-01,latvia,Europe,1847378,0,1066
2020-06-02,latvia,Europe,1847378,5,1071
2020-06-03,latvia,Europe,1847378,8,1079
2020-06-04,latvia,Europe,1847378,3,1082
2020-06-05,latvia,Europe,1847378,3,1085
2020-06-06,latvia,Europe,1847378,1,1086
2020-06-07,latvia,Europe,1847378,2,1088
2020-06-08,latvia,Europe,1847378,0,1088
2020-06-09,latvia,Europe,1847378,1,1089
2020-06-10,latvia,Europe,1847378,3,1092
2020-06-11,latvia,Europe,1847378,2,1094
2020-06-12,latvia,Europe,1847378,2,1096
2020-06-13,latvia,Europe,1847378,1,1097
2020-06-14,latvia,Europe,1847378,0,1097
2020-06-15,latvia,Europe,1847378,0,1097
2020-06-16,latvia,Europe,1847378,1,1098
2020-06-17,latvia,Europe,1847378,6,1104
2020-06-18,latvia,Europe,1847378,4,1108
2020-06-19,latvia,Europe,1847378,2,1110
2020-06-20,latvia,Europe,1847378,1,1111
2020-06-21,latvia,Europe,1847378,0,1111
2020-06-22,latvia,Europe,1847378,0,1111
2020-06-23,latvia,Europe,1847378,0,1111
2020-06-24,latvia,Europe,1847378,0,1111
2020-06-25,latvia,Europe,1847378,0,1111
2020-06-26,latvia,Europe,1847378,1,1112
2020-06-27,latvia,Europe,1847378,3,1115
2020-06-28,latvia,Europe,1847378,1,1116
2020-06-29,latvia,Europe,1847378,1,1117
2020-06-30,latvia,Europe,1847378,1,1118
2020-07-01,latvia,Europe,1847378,3,1121
2020-07-02,latvia,Europe,1847378,1,1122
2020-07-03,latvia,Europe,1847378,0,1122
2020-07-04,latvia,Europe,1847378,1,1123
2020-07-05,latvia,Europe,1847378,1,1124
2020-07-06,latvia,Europe,1847378,3,1127
2020-07-07,latvia,Europe,1847378,7,1134
2020-07-08,latvia,Europe,1847378,7,1141
2020-07-09,latvia,Europe,1847378,13,1154
2020-07-10,latvia,Europe,1847378,11,1165
2020-07-11,latvia,Europe,1847378,8,1173
2020-07-12,latvia,Europe,1847378,0,1173
2020-07-13,latvia,Europe,1847378,1,1174
2020-07-14,latvia,Europe,1847378,0,1174
2020-07-15,latvia,Europe,1847378,4,1178
2020-07-16,latvia,Europe,1847378,1,1179
2020-07-17,latvia,Europe,1847378,6,1185
2020-07-18,latvia,Europe,1847378,4,1189
2020-07-19,latvia,Europe,1847378,3,1192
2020-07-20,latvia,Europe,1847378,0,1192
2020-07-21,latvia,Europe,1847378,1,1193
2020-07-22,latvia,Europe,1847378,4,1197
2020-07-23,latvia,Europe,1847378,6,1203
2020-07-24,latvia,Europe,1847378,2,1205
2020-07-25,latvia,Europe,1847378,1,1206
2020-07-26,latvia,Europe,1847378,13,1219
2020-07-27,latvia,Europe,1847378,0,1219
2020-07-28,latvia,Europe,1847378,1,1220
2020-07-29,latvia,Europe,1847378,4,1224
2020-07-30,latvia,Europe,1847378,4,1228
2020-07-31,latvia,Europe,1847378,3,1231
2020-08-01,latvia,Europe,1847378,7,1238
2020-08-02,latvia,Europe,1847378,5,1243
2020-08-03,latvia,Europe,1847378,3,1246
2020-08-04,latvia,Europe,1847378,3,1249
2020-08-05,latvia,Europe,1847378,8,1257
2020-08-06,latvia,Europe,1847378,18,1275
2020-08-07,latvia,Europe,1847378,6,1281
2020-08-08,latvia,Europe,1847378,7,1288
2020-08-09,latvia,Europe,1847378,2,1290
2020-08-10,latvia,Europe,1847378,0,1290
2020-08-11,latvia,Europe,1847378,3,1293
2020-08-12,latvia,Europe,1847378,10,1303
2020-08-13,latvia,Europe,1847378,4,1307
2020-08-14,latvia,Europe,1847378,1,1308
2020-08-15,latvia,Europe,1847378,7,1315
2020-08-16,latvia,Europe,1847378,7,1322
2020-08-17,latvia,Europe,1847378,1,1323
2020-08-18,latvia,Europe,1847378,0,1323
2020-08-19,latvia,Europe,1847378,3,1326
2020-08-20,latvia,Europe,1847378,1,1327
2020-08-21,latvia,Europe,1847378,3,1330
2020-08-22,latvia,Europe,1847378,3,1333
2020-08-23,latvia,Europe,1847378,4,1337
2020-08-24,latvia,Europe,1847378,0,1337
2020-08-25,latvia,Europe,1847378,5,1342
2020-08-26,latvia,Europe,1847378,18,1360
2020-08-27,latvia,Europe,1847378,6,1366
2020-08-28,latvia,Europe,1847378,9,1375
2020-08-29,latvia,Europe,1847378,6,1381
2020-08-30,latvia,Europe,1847378,12,1393
2020-08-31,latvia,Europe,1847378,3,1396
2020-09-01,latvia,Europe,1847378,8,1404
2020-09-02,latvia,Europe,1847378,2,1406
2020-09-03,latvia,Europe,1847378,4,1410
2020-09-04,latvia,Europe,1847378,6,1416
2020-09-05,latvia,Europe,1847378,9,1425
2020-09-06,latvia,Europe,1847378,3,1428
2020-09-07,latvia,Europe,1847378,1,1429
2020-09-08,latvia,Europe,1847378,3,1432
2020-09-09,latvia,Europe,1847378,11,1443
2020-09-10,latvia,Europe,1847378,5,1448
2020-09-11,latvia,Europe,1847378,11,1459
2020-09-12,latvia,Europe,1847378,5,1464
2020-09-13,latvia,Europe,1847378,10,1474
2020-09-14,latvia,Europe,1847378,3,1477
2020-09-15,latvia,Europe,1847378,5,1482
2020-09-16,latvia,Europe,1847378,4,1486
2020-09-17,latvia,Europe,1847378,8,1494
2020-09-18,latvia,Europe,1847378,4,1498
2020-09-19,latvia,Europe,1847378,17,1515
2020-09-20,latvia,Europe,1847378,10,1525
2020-09-21,latvia,Europe,1847378,1,1526
2020-09-22,latvia,Europe,1847378,34,1560
2020-09-23,latvia,Europe,1847378,12,1572
2020-09-24,latvia,Europe,1847378,22,1594
2020-09-25,latvia,Europe,1847378,31,1625
2020-09-26,latvia,Europe,1847378,29,1654
2020-09-27,latvia,Europe,1847378,22,1676
2020-09-28,latvia,Europe,1847378,21,1697
2020-09-29,latvia,Europe,1847378,32,1729
2020-09-30,latvia,Europe,1847378,95,1824
2020-10-01,latvia,Europe,1847378,44,1868
2020-10-02,latvia,Europe,1847378,77,1945
2020-10-03,latvia,Europe,1847378,74,2019
2020-10-04,latvia,Europe,1847378,67,2086
2020-10-05,latvia,Europe,1847378,40,2126
2020-10-06,latvia,Europe,1847378,68,2194
2020-10-07,latvia,Europe,1847378,67,2261
2020-10-08,latvia,Europe,1847378,109,2370
2020-10-09,latvia,Europe,1847378,137,2507
2020-10-10,latvia,Europe,1847378,89,2596
2020-10-11,latvia,Europe,1847378,74,2670
2020-10-12,latvia,Europe,1847378,95,2765
2020-10-13,latvia,Europe,1847378,75,2840
2020-10-14,latvia,Europe,1847378,102,2942
2020-10-15,latvia,Europe,1847378,114,3056
2020-10-16,latvia,Europe,1847378,148,3204
2020-10-17,latvia,Europe,1847378,188,3392
2020-10-18,latvia,Europe,1847378,58,3450
2020-10-19,latvia,Europe,1847378,44,3494
2020-10-20,latvia,Europe,1847378,115,3609
2020-10-21,latvia,Europe,1847378,188,3797
2020-10-22,latvia,Europe,1847378,161,3958
2020-10-23,latvia,Europe,1847378,250,4208
2020-10-24,latvia,Europe,1847378,259,4467
2020-10-25,latvia,Europe,1847378,211,4678
2020-10-26,latvia,Europe,1847378,79,4757
2020-10-27,latvia,Europe,1847378,136,4893
2020-10-28,latvia,Europe,1847378,251,5144
2020-10-29,latvia,Europe,1847378,251,5395
2020-10-30,latvia,Europe,1847378,284,5679
2020-10-31,latvia,Europe,1847378,215,5894
2020-11-01,latvia,Europe,1847378,242,6136
2020-11-02,latvia,Europe,1847378,132,6268
2020-11-03,latvia,Europe,1847378,171,6439
2020-11-04,latvia,Europe,1847378,313,6752
2020-11-05,latvia,Europe,1847378,367,7119
2020-11-06,latvia,Europe,1847378,357,7476
2020-11-07,latvia,Europe,1847378,404,7880
2020-11-08,latvia,Europe,1847378,215,8095
2020-11-09,latvia,Europe,1847378,92,8187
2020-11-10,latvia,Europe,1847378,208,8395
2020-11-11,latvia,Europe,1847378,453,8848
2020-11-12,latvia,Europe,1847378,533,9381
2020-11-13,latvia,Europe,1847378,455,9836
2020-11-14,latvia,Europe,1847378,395,10231
2020-11-15,latvia,Europe,1847378,316,10547
2020-11-16,latvia,Europe,1847378,89,10636
2020-11-17,latvia,Europe,1847378,278,10914
2020-11-18,latvia,Europe,1847378,442,11356
2020-11-19,latvia,Europe,1847378,366,11722
2020-11-20,latvia,Europe,1847378,380,12102
2020-11-21,latvia,Europe,1847378,642,12744
2020-11-22,latvia,Europe,1847378,376,13120
2020-11-23,latvia,Europe,1847378,116,13236
2020-11-24,latvia,Europe,1847378,457,13693
2020-11-25,latvia,Europe,1847378,580,14273
2020-11-26,latvia,Europe,1847378,898,15171
2020-11-27,latvia,Europe,1847378,637,15808
2020-11-28,latvia,Europe,1847378,753,16561
2020-11-29,latvia,Europe,1847378,414,16975
2020-11-30,latvia,Europe,1847378,100,17075
2020-12-01,latvia,Europe,1847378,612,17687
2020-12-02,latvia,Europe,1847378,690,18377
2020-12-03,latvia,Europe,1847378,930,19307
2020-12-04,latvia,Europe,1847378,686,19993
2020-12-05,latvia,Europe,1847378,794,20787
2020-12-06,latvia,Europe,1847378,526,21313
2020-12-07,latvia,Europe,1847378,207,21520
2020-12-08,latvia,Europe,1847378,584,22104
2020-12-09,latvia,Europe,1847378,712,22816
2020-12-10,latvia,Europe,1847378,890,23706
2020-12-11,latvia,Europe,1847378,680,24386
2020-12-12,latvia,Europe,1847378,660,25046
2020-12-13,latvia,Europe,1847378,629,25675
2020-12-14,latvia,Europe,1847378,210,25885
2020-12-15,latvia,Europe,1847378,587,26472
2020-12-16,latvia,Europe,1847378,1023,27495
2020-12-17,latvia,Europe,1847378,1040,28535
2020-12-18,latvia,Europe,1847378,892,29427
2020-12-19,latvia,Europe,1847378,870,30297
2020-12-20,latvia,Europe,1847378,643,30940
2020-12-21,latvia,Europe,1847378,395,31335
2020-12-22,latvia,Europe,1847378,1004,32339
2020-12-23,latvia,Europe,1847378,1145,33484
2020-12-24,latvia,Europe,1847378,1270,34754
2020-12-25,latvia,Europe,1847378,666,35420
2020-12-26,latvia,Europe,1847378,399,35819
2020-12-27,latvia,Europe,1847378,511,36330
2020-12-28,latvia,Europe,1847378,508,36838
2020-12-29,latvia,Europe,1847378,838,37676
2020-12-30,latvia,Europe,1847378,1367,39043
2020-12-31,latvia,Europe,1847378,1861,40904
2021-01-01,latvia,Europe,1847378,711,41615
2021-01-02,latvia,Europe,1847378,314,41929
2021-01-03,latvia,Europe,1847378,568,42497
2021-01-04,latvia,Europe,1847378,621,43118
2021-01-05,latvia,Europe,1847378,824,43942
2021-01-06,latvia,Europe,1847378,1229,45171
2021-01-07,latvia,Europe,1847378,1374,46545
2021-01-08,latvia,Europe,1847378,1237,47782
2021-01-09,latvia,Europe,1847378,1170,48952
2021-01-10,latvia,Europe,1847378,616,49568
2021-01-11,latvia,Europe,1847378,331,49899
2021-01-12,latvia,Europe,1847378,878,50777
2021-01-13,latvia,Europe,1847378,1255,52032
2021-01-14,latvia,Europe,1847378,950,52982
2021-01-15,latvia,Europe,1847378,1084,54066
2021-01-16,latvia,Europe,1847378,1031,55097
2021-01-17,latvia,Europe,1847378,567,55664
2021-01-18,latvia,Europe,1847378,244,55908
2021-01-19,latvia,Europe,1847378,812,56720
2021-01-20,latvia,Europe,1847378,1088,57808
2021-01-21,latvia,Europe,1847378,902,58710
2021-01-22,latvia,Europe,1847378,876,59586
2021-01-23,latvia,Europe,1847378,910,60496
2021-01-24,latvia,Europe,1847378,512,61008
2021-01-25,latvia,Europe,1847378,223,61231
2021-01-26,latvia,Europe,1847378,693,61924
2021-01-27,latvia,Europe,1847378,1103,63027
2021-01-28,latvia,Europe,1847378,965,63992
2021-01-29,latvia,Europe,1847378,931,64923
2021-01-30,latvia,Europe,1847378,785,65708
2021-01-31,latvia,Europe,1847378,533,66241
2021-02-01,latvia,Europe,1847378,411,66652
2021-02-02,latvia,Europe,1847378,775,67427
2021-02-03,latvia,Europe,1847378,1231,68658
2021-02-04,latvia,Europe,1847378,742,69400
2021-02-05,latvia,Europe,1847378,876,70276
2021-02-06,latvia,Europe,1847378,1044,71320
2021-02-07,latvia,Europe,1847378,480,71800
2021-02-08,latvia,Europe,1847378,288,72088
2021-02-09,latvia,Europe,1847378,781,72869
2021-02-10,latvia,Europe,1847378,990,73859
2021-02-11,latvia,Europe,1847378,842,74701
2021-02-12,latvia,Europe,1847378,808,75509
2021-02-13,latvia,Europe,1847378,773,76282
2021-02-14,latvia,Europe,1847378,424,76706
2021-02-15,latvia,Europe,1847378,278,76984
2021-02-16,latvia,Europe,1847378,713,77697
2021-02-17,latvia,Europe,1847378,946,78643
2021-02-18,latvia,Europe,1847378,708,79351
2021-02-19,latvia,Europe,1847378,689,80040
2021-02-20,latvia,Europe,1847378,1069,81109
2021-02-21,latvia,Europe,1847378,410,81519
2021-02-22,latvia,Europe,1847378,274,81793
2021-02-23,latvia,Europe,1847378,669,82462
2021-02-24,latvia,Europe,1847378,983,83445
2021-02-25,latvia,Europe,1847378,813,84258
2021-02-26,latvia,Europe,1847378,725,84983
2021-02-27,latvia,Europe,1847378,827,85810
2021-02-28,latvia,Europe,1847378,376,86186
2021-03-01,latvia,Europe,1847378,272,86458
2021-03-02,latvia,Europe,1847378,645,87103
2021-03-03,latvia,Europe,1847378,919,88022
2021-03-04,latvia,Europe,1847378,646,88668
2021-03-05,latvia,Europe,1847378,746,89414
2021-03-06,latvia,Europe,1847378,595,90009
2021-03-07,latvia,Europe,1847378,322,90331
2021-03-08,latvia,Europe,1847378,194,90525
2021-03-09,latvia,Europe,1847378,472,90997
2021-03-10,latvia,Europe,1847378,639,91636
2021-03-11,latvia,Europe,1847378,638,92274
2021-03-12,latvia,Europe,1847378,632,92906
2021-03-13,latvia,Europe,1847378,578,93484
2021-03-14,latvia,Europe,1847378,297,93781
2021-03-15,latvia,Europe,1847378,178,93959
2021-03-16,latvia,Europe,1847378,643,94602
2021-03-17,latvia,Europe,1847378,818,95420
2021-03-18,latvia,Europe,1847378,482,95902
2021-03-19,latvia,Europe,1847378,622,96524
2021-03-20,latvia,Europe,1847378,625,97149
2021-03-21,latvia,Europe,1847378,260,97409
2021-03-22,latvia,Europe,1847378,177,97586
2021-03-23,latvia,Europe,1847378,508,98094
2021-03-24,latvia,Europe,1847378,776,98870
2021-03-25,latvia,Europe,1847378,606,99476
2021-03-26,latvia,Europe,1847378,638,100114
2021-03-27,latvia,Europe,1847378,602,100716
2021-03-28,latvia,Europe,1847378,324,101040
2021-03-29,latvia,Europe,1847378,167,101207
2021-03-30,latvia,Europe,1847378,526,101733
2021-03-31,latvia,Europe,1847378,630,102363
2021-04-01,latvia,Europe,1847378,638,103001
2021-04-02,latvia,Europe,1847378,587,103588
2021-04-03,latvia,Europe,1847378,279,103867
2021-04-04,latvia,Europe,1847378,238,104105
2021-04-05,latvia,Europe,1847378,119,104224
2021-04-06,latvia,Europe,1847378,309,104533
2021-04-07,latvia,Europe,1847378,643,105176
2021-04-08,latvia,Europe,1847378,740,105916
2021-04-09,latvia,Europe,1847378,658,106574
2021-04-10,latvia,Europe,1847378,666,107240
2021-04-11,latvia,Europe,1847378,368,107608
2021-04-12,latvia,Europe,1847378,210,107818
2021-04-13,latvia,Europe,1847378,537,108355
2021-04-14,latvia,Europe,1847378,733,109088
2021-04-15,latvia,Europe,1847378,643,109731
2021-04-16,latvia,Europe,1847378,612,110343
2021-04-17,latvia,Europe,1847378,654,110997
2021-04-18,latvia,Europe,1847378,337,111334
2021-04-19,latvia,Europe,1847378,202,111536
2021-04-20,latvia,Europe,1847378,688,112224
2021-04-21,latvia,Europe,1847378,759,112983
2021-04-22,latvia,Europe,1847378,578,113561
2021-04-23,latvia,Europe,1847378,683,114244
2021-04-24,latvia,Europe,1847378,711,114955
2021-04-25,latvia,Europe,1847378,361,115316
2021-04-26,latvia,Europe,1847378,220,115536
2021-04-27,latvia,Europe,1847378,596,116132
2021-04-28,latvia,Europe,1847378,967,117099
2021-04-29,latvia,Europe,1847378,696,117795
2021-04-30,latvia,Europe,1847378,763,118558
2021-05-01,latvia,Europe,1847378,812,119370
2021-05-02,latvia,Europe,1847378,380,119750
2021-05-03,latvia,Europe,1847378,203,119953
2021-05-04,latvia,Europe,1847378,425,120378
2021-05-05,latvia,Europe,1847378,358,120736
2021-05-06,latvia,Europe,1847378,773,121509
2021-05-07,latvia,Europe,1847378,1036,122545
2021-05-08,latvia,Europe,1847378,786,123331
2021-05-09,latvia,Europe,1847378,632,123963
2021-05-10,latvia,Europe,1847378,338,124301
2021-05-11,latvia,Europe,1847378,659,124960
2021-05-12,latvia,Europe,1847378,729,125689
2021-05-13,latvia,Europe,1847378,698,126387
2021-05-14,latvia,Europe,1847378,666,127053
2021-05-15,latvia,Europe,1847378,544,127597
2021-05-16,latvia,Europe,1847378,381,127978
2021-05-17,latvia,Europe,1847378,147,128125
2021-05-18,latvia,Europe,1847378,563,128688
2021-05-19,latvia,Europe,1847378,609,129297
2021-05-20,latvia,Europe,1847378,497,129794
2021-05-21,latvia,Europe,1847378,477,130271
2021-05-22,latvia,Europe,1847378,441,130712
2021-05-23,latvia,Europe,1847378,233,130945
2021-05-24,latvia,Europe,1847378,134,131079
2021-05-25,latvia,Europe,1847378,435,131514
2021-05-26,latvia,Europe,1847378,396,131910
2021-05-27,latvia,Europe,1847378,348,132258
2021-05-28,latvia,Europe,1847378,354,132612
2021-05-29,latvia,Europe,1847378,306,132918
2021-05-30,latvia,Europe,1847378,180,133098
2021-05-31,latvia,Europe,1847378,101,133199
2021-06-01,latvia,Europe,1847378,319,133518
2021-06-02,latvia,Europe,1847378,348,133866
2021-06-03,latvia,Europe,1847378,296,134162
2021-06-04,latvia,Europe,1847378,259,134421
2021-06-05,latvia,Europe,1847378,256,134677
2021-06-06,latvia,Europe,1847378,135,134812
2021-06-07,latvia,Europe,1847378,76,134888
2021-06-08,latvia,Europe,1847378,256,135144
2021-06-09,latvia,Europe,1847378,244,135388
2021-06-10,latvia,Europe,1847378,196,135584
2021-06-11,latvia,Europe,1847378,178,135762
2021-06-12,latvia,Europe,1847378,178,135940
2021-06-13,latvia,Europe,1847378,90,136030
2021-06-14,latvia,Europe,1847378,74,136104
2021-06-15,latvia,Europe,1847378,143,136247
2021-06-16,latvia,Europe,1847378,156,136403
2021-06-17,latvia,Europe,1847378,141,136544
2021-06-18,latvia,Europe,1847378,108,136652
2021-06-19,latvia,Europe,1847378,84,136736
2021-06-20,latvia,Europe,1847378,74,136810
2021-06-21,latvia,Europe,1847378,40,136850
2021-06-22,latvia,Europe,1847378,125,136975
2021-06-23,latvia,Europe,1847378,102,137077
2021-06-24,latvia,Europe,1847378,33,137110
2021-06-25,latvia,Europe,1847378,20,137130
2021-06-26,latvia,Europe,1847378,39,137169
2021-06-27,latvia,Europe,1847378,41,137210
2021-06-28,latvia,Europe,1847378,30,137240
2021-06-29,latvia,Europe,1847378,89,137329
2021-06-30,latvia,Europe,1847378,100,137429
2021-07-01,latvia,Europe,1847378,71,137500
2021-07-02,latvia,Europe,1847378,40,137540
2021-07-03,latvia,Europe,1847378,60,137600
2021-07-04,latvia,Europe,1847378,31,137631
2021-07-05,latvia,Europe,1847378,22,137653
2021-07-06,latvia,Europe,1847378,46,137699
2021-07-07,latvia,Europe,1847378,48,137747
2021-07-08,latvia,Europe,1847378,50,137797
2021-07-09,latvia,Europe,1847378,34,137831
2021-07-10,latvia,Europe,1847378,32,137863
2021-07-11,latvia,Europe,1847378,36,137899
2021-07-12,latvia,Europe,1847378,18,137917
2021-07-13,latvia,Europe,1847378,53,137970
2021-07-14,latvia,Europe,1847378,34,138004
2021-07-15,latvia,Europe,1847378,37,138041
2021-07-16,latvia,Europe,1847378,46,138087
2021-07-17,latvia,Europe,1847378,39,138126
2021-07-18,latvia,Europe,1847378,33,138159
2021-07-19,latvia,Europe,1847378,25,138184
2021-07-20,latvia,Europe,1847378,54,138238
2021-07-21,latvia,Europe,1847378,62,138300
2021-07-22,latvia,Europe,1847378,44,138344
2021-07-23,latvia,Europe,1847378,38,138382
2021-07-24,latvia,Europe,1847378,43,138425
2021-07-25,latvia,Europe,1847378,56,138481
2021-07-26,latvia,Europe,1847378,23,138504
2021-07-27,latvia,Europe,1847378,68,138572
2021-07-28,latvia,Europe,1847378,78,138650
2021-07-29,latvia,Europe,1847378,67,138717
2021-07-30,latvia,Europe,1847378,82,138799
2021-07-31,latvia,Europe,1847378,64,138863
2021-08-01,latvia,Europe,1847378,36,138899
2021-08-02,latvia,Europe,1847378,26,138925
2021-08-03,latvia,Europe,1847378,112,139037
2021-08-04,latvia,Europe,1847378,97,139134
2021-08-05,latvia,Europe,1847378,70,139204
2021-08-06,latvia,Europe,1847378,80,139284
2021-08-07,latvia,Europe,1847378,63,139347
2021-08-08,latvia,Europe,1847378,74,139421
2021-08-09,latvia,Europe,1847378,41,139462
2021-08-10,latvia,Europe,1847378,125,139587
2021-08-11,latvia,Europe,1847378,120,139707
2021-08-12,latvia,Europe,1847378,107,139814
2021-08-13,latvia,Europe,1847378,127,139941
2021-08-14,latvia,Europe,1847378,108,140049
2021-08-15,latvia,Europe,1847378,73,140122
2021-08-16,latvia,Europe,1847378,49,140171
2021-08-17,latvia,Europe,1847378,154,140325
2021-08-18,latvia,Europe,1847378,180,140505
2021-08-19,latvia,Europe,1847378,146,140651
2021-08-20,latvia,Europe,1847378,133,140784
2021-08-21,latvia,Europe,1847378,160,140944
2021-08-22,latvia,Europe,1847378,101,141045
2021-08-23,latvia,Europe,1847378,73,141118
2021-08-24,latvia,Europe,1847378,169,141287
2021-08-25,latvia,Europe,1847378,249,141536
2021-08-26,latvia,Europe,1847378,150,141686
2021-08-27,latvia,Europe,1847378,181,141867
2021-08-28,latvia,Europe,1847378,256,142123
2021-08-29,latvia,Europe,1847378,196,142319
2021-08-30,latvia,Europe,1847378,81,142400
2021-08-31,latvia,Europe,1847378,237,142637
2021-09-01,latvia,Europe,1847378,469,143106
2021-09-02,latvia,Europe,1847378,340,143446
2021-09-03,latvia,Europe,1847378,354,143800
2021-09-04,latvia,Europe,1847378,360,144160
2021-09-05,latvia,Europe,1847378,358,144518
2021-09-06,latvia,Europe,1847378,114,144632
2021-09-07,latvia,Europe,1847378,311,144943
2021-09-08,latvia,Europe,1847378,459,145402
2021-09-09,latvia,Europe,1847378,490,145892
2021-09-10,latvia,Europe,1847378,489,146381
2021-09-11,latvia,Europe,1847378,419,146800
2021-09-12,latvia,Europe,1847378,393,147193
2021-09-13,latvia,Europe,1847378,135,147328
2021-09-14,latvia,Europe,1847378,460,147788
2021-09-15,latvia,Europe,1847378,697,148485
2021-09-16,latvia,Europe,1847378,596,149081
2021-09-17,latvia,Europe,1847378,533,149614
2021-09-18,latvia,Europe,1847378,542,150156
2021-09-19,latvia,Europe,1847378,404,150560
2021-09-20,latvia,Europe,1847378,189,150749
2021-09-21,latvia,Europe,1847378,494,151243
2021-09-22,latvia,Europe,1847378,674,151917
2021-09-23,latvia,Europe,1847378,776,152693
2021-09-24,latvia,Europe,1847378,710,153403
2021-09-25,latvia,Europe,1847378,816,154219
2021-09-26,latvia,Europe,1847378,567,154786
2021-09-27,latvia,Europe,1847378,290,155076
2021-09-28,latvia,Europe,1847378,804,155880
2021-09-29,latvia,Europe,1847378,1203,157083
2021-09-30,latvia,Europe,1847378,1208,158291
2021-10-01,latvia,Europe,1847378,1127,159418
2021-10-02,latvia,Europe,1847378,1190,160608
2021-10-03,latvia,Europe,1847378,1033,161641
2021-10-04,latvia,Europe,1847378,479,162120
2021-10-05,latvia,Europe,1847378,1010,163130
2021-10-06,latvia,Europe,1847378,1671,164801
2021-10-07,latvia,Europe,1847378,1752,166553
2021-10-08,latvia,Europe,1847378,1695,168248
2021-10-09,latvia,Europe,1847378,1669,169917
2021-10-10,latvia,Europe,1847378,1359,171276
2021-10-11,latvia,Europe,1847378,1002,172278
2021-10-12,latvia,Europe,1847378,1376,173654
2021-10-13,latvia,Europe,1847378,2236,175890
2021-10-14,latvia,Europe,1847378,2408,178298
2021-10-15,latvia,Europe,1847378,2142,180440
2021-10-16,latvia,Europe,1847378,2799,183239
2021-10-17,latvia,Europe,1847378,2377,185616
2021-10-18,latvia,Europe,1847378,1253,186869
2020-02-22,lebanon,Asia,6768532,0,1
2020-02-23,lebanon,Asia,6768532,0,1
2020-02-24,lebanon,Asia,6768532,0,1
2020-02-25,lebanon,Asia,6768532,0,1
2020-02-26,lebanon,Asia,6768532,1,2
2020-02-27,lebanon,Asia,6768532,1,3
2020-02-28,lebanon,Asia,6768532,1,4
2020-02-29,lebanon,Asia,6768532,3,7
2020-03-01,lebanon,Asia,6768532,3,10
2020-03-02,lebanon,Asia,6768532,3,13
2020-03-03,lebanon,Asia,6768532,0,13
2020-03-04,lebanon,Asia,6768532,2,15
2020-03-05,lebanon,Asia,6768532,1,16
2020-03-06,lebanon,Asia,6768532,6,22
2020-03-07,lebanon,Asia,6768532,6,28
2020-03-08,lebanon,Asia,6768532,4,32
2020-03-09,lebanon,Asia,6768532,9,41
2020-03-10,lebanon,Asia,6768532,11,52
2020-03-11,lebanon,Asia,6768532,16,68
2020-03-12,lebanon,Asia,6768532,0,68
2020-03-13,lebanon,Asia,6768532,9,77
2020-03-14,lebanon,Asia,6768532,16,93
2020-03-15,lebanon,Asia,6768532,17,110
2020-03-17,lebanon,Asia,6768532,15,124
2020-03-18,lebanon,Asia,6768532,9,133
2020-03-19,lebanon,Asia,6768532,24,157
2020-03-20,lebanon,Asia,6768532,20,177
2020-03-21,lebanon,Asia,6768532,53,230
2020-03-22,lebanon,Asia,6768532,18,248
2020-03-23,lebanon,Asia,6768532,19,267
2020-03-24,lebanon,Asia,6768532,51,318
2020-03-25,lebanon,Asia,6768532,15,333
2020-03-26,lebanon,Asia,6768532,35,368
2020-03-27,lebanon,Asia,6768532,23,391
2020-03-28,lebanon,Asia,6768532,21,412
2020-03-29,lebanon,Asia,6768532,26,438
2020-03-30,lebanon,Asia,6768532,8,446
2020-03-31,lebanon,Asia,6768532,17,463
2020-04-01,lebanon,Asia,6768532,16,479
2020-04-02,lebanon,Asia,6768532,15,494
2020-04-03,lebanon,Asia,6768532,14,508
2020-04-04,lebanon,Asia,6768532,12,520
2020-04-05,lebanon,Asia,6768532,7,527
2020-04-06,lebanon,Asia,6768532,14,541
2020-04-07,lebanon,Asia,6768532,7,548
2020-04-08,lebanon,Asia,6768532,28,576
2020-04-09,lebanon,Asia,6768532,6,582
2020-04-10,lebanon,Asia,6768532,27,609
2020-04-11,lebanon,Asia,6768532,10,619
2020-04-12,lebanon,Asia,6768532,11,630
2020-04-13,lebanon,Asia,6768532,2,632
2020-04-14,lebanon,Asia,6768532,9,641
2020-04-15,lebanon,Asia,6768532,17,658
2020-04-16,lebanon,Asia,6768532,5,663
2020-04-17,lebanon,Asia,6768532,5,668
2020-04-18,lebanon,Asia,6768532,4,672
2020-04-19,lebanon,Asia,6768532,1,673
2020-04-20,lebanon,Asia,6768532,4,677
2020-04-21,lebanon,Asia,6768532,0,677
2020-04-22,lebanon,Asia,6768532,5,682
2020-04-23,lebanon,Asia,6768532,6,688
2020-04-24,lebanon,Asia,6768532,8,696
2020-04-25,lebanon,Asia,6768532,8,704
2020-04-26,lebanon,Asia,6768532,3,707
2020-04-27,lebanon,Asia,6768532,3,710
2020-04-28,lebanon,Asia,6768532,7,717
2020-04-29,lebanon,Asia,6768532,4,721
2020-04-30,lebanon,Asia,6768532,4,725
2020-05-01,lebanon,Asia,6768532,4,729
2020-05-02,lebanon,Asia,6768532,4,733
2020-05-03,lebanon,Asia,6768532,4,737
2020-05-04,lebanon,Asia,6768532,3,740
2020-05-05,lebanon,Asia,6768532,1,741
2020-05-06,lebanon,Asia,6768532,9,750
2020-05-07,lebanon,Asia,6768532,34,784
2020-05-08,lebanon,Asia,6768532,12,796
2020-05-09,lebanon,Asia,6768532,13,809
2020-05-10,lebanon,Asia,6768532,36,845
2020-05-11,lebanon,Asia,6768532,14,859
2020-05-12,lebanon,Asia,6768532,11,870
2020-05-13,lebanon,Asia,6768532,8,878
2020-05-14,lebanon,Asia,6768532,8,886
2020-05-15,lebanon,Asia,6768532,5,891
2020-05-16,lebanon,Asia,6768532,11,902
2020-05-17,lebanon,Asia,6768532,9,911
2020-05-18,lebanon,Asia,6768532,20,931
2020-05-19,lebanon,Asia,6768532,23,954
2020-05-20,lebanon,Asia,6768532,7,961
2020-05-21,lebanon,Asia,6768532,63,1024
2020-05-22,lebanon,Asia,6768532,62,1086
2020-05-23,lebanon,Asia,6768532,11,1097
2020-05-24,lebanon,Asia,6768532,17,1114
2020-05-25,lebanon,Asia,6768532,5,1119
2020-05-26,lebanon,Asia,6768532,21,1140
2020-05-27,lebanon,Asia,6768532,21,1161
2020-05-28,lebanon,Asia,6768532,7,1168
2020-05-29,lebanon,Asia,6768532,4,1172
2020-05-30,lebanon,Asia,6768532,19,1191
2020-05-31,lebanon,Asia,6768532,29,1220
2020-06-01,lebanon,Asia,6768532,13,1233
2020-06-02,lebanon,Asia,6768532,9,1242
2020-06-03,lebanon,Asia,6768532,14,1256
2020-06-04,lebanon,Asia,6768532,50,1306
2020-06-05,lebanon,Asia,6768532,6,1312
2020-06-06,lebanon,Asia,6768532,8,1320
2020-06-07,lebanon,Asia,6768532,11,1331
2020-06-08,lebanon,Asia,6768532,19,1350
2020-06-09,lebanon,Asia,6768532,18,1368
2020-06-10,lebanon,Asia,6768532,20,1388
2020-06-11,lebanon,Asia,6768532,14,1402
2020-06-12,lebanon,Asia,6768532,20,1422
2020-06-13,lebanon,Asia,6768532,20,1442
2020-06-14,lebanon,Asia,6768532,4,1446
2020-06-15,lebanon,Asia,6768532,18,1464
2020-06-16,lebanon,Asia,6768532,9,1473
2020-06-17,lebanon,Asia,6768532,16,1489
2020-06-18,lebanon,Asia,6768532,6,1495
2020-06-19,lebanon,Asia,6768532,15,1510
2020-06-20,lebanon,Asia,6768532,26,1536
2020-06-21,lebanon,Asia,6768532,51,1587
2020-06-22,lebanon,Asia,6768532,16,1603
2020-06-23,lebanon,Asia,6768532,19,1622
2020-06-24,lebanon,Asia,6768532,22,1644
2020-06-25,lebanon,Asia,6768532,18,1662
2020-06-26,lebanon,Asia,6768532,35,1697
2020-06-27,lebanon,Asia,6768532,22,1719
2020-06-28,lebanon,Asia,6768532,21,1740
2020-06-29,lebanon,Asia,6768532,5,1745
2020-06-30,lebanon,Asia,6768532,33,1778
2020-07-01,lebanon,Asia,6768532,10,1788
2020-07-02,lebanon,Asia,6768532,8,1796
2020-07-03,lebanon,Asia,6768532,34,1830
2020-07-04,lebanon,Asia,6768532,25,1855
2020-07-05,lebanon,Asia,6768532,18,1873
2020-07-06,lebanon,Asia,6768532,12,1885
2020-07-07,lebanon,Asia,6768532,22,1907
2020-07-08,lebanon,Asia,6768532,39,1946
2020-07-09,lebanon,Asia,6768532,65,2011
2020-07-10,lebanon,Asia,6768532,71,2082
2020-07-11,lebanon,Asia,6768532,86,2168
2020-07-12,lebanon,Asia,6768532,166,2334
2020-07-13,lebanon,Asia,6768532,85,2419
2020-07-14,lebanon,Asia,6768532,32,2451
2020-07-15,lebanon,Asia,6768532,91,2542
2020-07-16,lebanon,Asia,6768532,57,2599
2020-07-17,lebanon,Asia,6768532,101,2700
2020-07-18,lebanon,Asia,6768532,75,2775
2020-07-19,lebanon,Asia,6768532,84,2859
2020-07-20,lebanon,Asia,6768532,46,2905
2020-07-21,lebanon,Asia,6768532,75,2980
2020-07-22,lebanon,Asia,6768532,124,3104
2020-07-23,lebanon,Asia,6768532,156,3260
2020-07-24,lebanon,Asia,6768532,147,3407
2020-07-25,lebanon,Asia,6768532,175,3582
2020-07-26,lebanon,Asia,6768532,168,3750
2020-07-27,lebanon,Asia,6768532,132,3882
2020-07-28,lebanon,Asia,6768532,141,4023
2020-07-29,lebanon,Asia,6768532,182,4205
2020-07-30,lebanon,Asia,6768532,129,4334
2020-07-31,lebanon,Asia,6768532,221,4555
2020-08-01,lebanon,Asia,6768532,175,4730
2020-08-02,lebanon,Asia,6768532,155,4885
2020-08-03,lebanon,Asia,6768532,177,5062
2020-08-04,lebanon,Asia,6768532,209,5271
2020-08-05,lebanon,Asia,6768532,146,5417
2020-08-06,lebanon,Asia,6768532,255,5672
2020-08-07,lebanon,Asia,6768532,279,5951
2020-08-08,lebanon,Asia,6768532,272,6223
2020-08-09,lebanon,Asia,6768532,294,6517
2020-08-10,lebanon,Asia,6768532,295,6812
2020-08-11,lebanon,Asia,6768532,309,7121
2020-08-12,lebanon,Asia,6768532,292,7413
2020-08-13,lebanon,Asia,6768532,298,7711
2020-08-14,lebanon,Asia,6768532,334,8045
2020-08-15,lebanon,Asia,6768532,397,8442
2020-08-16,lebanon,Asia,6768532,439,8881
2020-08-17,lebanon,Asia,6768532,456,9337
2020-08-18,lebanon,Asia,6768532,421,9758
2020-08-19,lebanon,Asia,6768532,589,10347
2020-08-20,lebanon,Asia,6768532,605,10952
2020-08-21,lebanon,Asia,6768532,628,11580
2020-08-22,lebanon,Asia,6768532,611,12191
2020-08-23,lebanon,Asia,6768532,507,12698
2020-08-24,lebanon,Asia,6768532,457,13155
2020-08-25,lebanon,Asia,6768532,532,13687
2020-08-26,lebanon,Asia,6768532,561,14248
2020-08-27,lebanon,Asia,6768532,689,14937
2020-08-28,lebanon,Asia,6768532,676,15613
2020-08-29,lebanon,Asia,6768532,662,16275
2020-08-30,lebanon,Asia,6768532,595,16870
2020-08-31,lebanon,Asia,6768532,438,17308
2020-09-01,lebanon,Asia,6768532,469,17777
2020-09-02,lebanon,Asia,6768532,598,18375
2020-09-03,lebanon,Asia,6768532,588,18963
2020-09-04,lebanon,Asia,6768532,527,19490
2020-09-05,lebanon,Asia,6768532,521,20011
2020-09-06,lebanon,Asia,6768532,415,20426
2020-09-07,lebanon,Asia,6768532,400,20826
2020-09-08,lebanon,Asia,6768532,498,21324
2020-09-09,lebanon,Asia,6768532,553,21877
2020-09-10,lebanon,Asia,6768532,560,22437
2020-09-11,lebanon,Asia,6768532,546,22983
2020-09-12,lebanon,Asia,6768532,686,23669
2020-09-13,lebanon,Asia,6768532,641,24310
2020-09-14,lebanon,Asia,6768532,547,24857
2020-09-15,lebanon,Asia,6768532,592,25449
2020-09-16,lebanon,Asia,6768532,634,26083
2020-09-17,lebanon,Asia,6768532,685,26768
2020-09-18,lebanon,Asia,6768532,750,27518
2020-09-19,lebanon,Asia,6768532,779,28297
2020-09-20,lebanon,Asia,6768532,1006,29303
2020-09-21,lebanon,Asia,6768532,684,29987
2020-09-22,lebanon,Asia,6768532,865,30852
2020-09-23,lebanon,Asia,6768532,940,31792
2020-09-24,lebanon,Asia,6768532,1027,32819
2020-09-25,lebanon,Asia,6768532,1143,33962
2020-09-26,lebanon,Asia,6768532,1280,35242
2020-09-27,lebanon,Asia,6768532,1012,36254
2020-09-28,lebanon,Asia,6768532,1018,37272
2020-09-29,lebanon,Asia,6768532,1105,38377
2020-09-30,lebanon,Asia,6768532,1257,39634
2020-10-01,lebanon,Asia,6768532,1248,40882
2020-10-02,lebanon,Asia,6768532,1291,42173
2020-10-03,lebanon,Asia,6768532,1321,43494
2020-10-04,lebanon,Asia,6768532,988,44482
2020-10-05,lebanon,Asia,6768532,1175,45657
2020-10-06,lebanon,Asia,6768532,1261,46918
2020-10-07,lebanon,Asia,6768532,1459,48377
2020-10-08,lebanon,Asia,6768532,1367,49744
2020-10-09,lebanon,Asia,6768532,1426,51170
2020-10-10,lebanon,Asia,6768532,1388,52558
2020-10-11,lebanon,Asia,6768532,1010,53568
2020-10-12,lebanon,Asia,6768532,1056,54624
2020-10-13,lebanon,Asia,6768532,1245,55869
2020-10-14,lebanon,Asia,6768532,1377,57246
2020-10-15,lebanon,Asia,6768532,1499,58745
2020-10-16,lebanon,Asia,6768532,1368,60113
2020-10-17,lebanon,Asia,6768532,1171,61284
2020-10-18,lebanon,Asia,6768532,1002,62286
2020-10-19,lebanon,Asia,6768532,658,62944
2020-10-20,lebanon,Asia,6768532,1392,64336
2020-10-21,lebanon,Asia,6768532,1241,65577
2020-10-22,lebanon,Asia,6768532,1450,67027
2020-10-23,lebanon,Asia,6768532,1452,68479
2020-10-24,lebanon,Asia,6768532,1427,69906
2020-10-25,lebanon,Asia,6768532,1484,71390
2020-10-26,lebanon,Asia,6768532,796,72186
2020-10-27,lebanon,Asia,6768532,1809,73995
2020-10-28,lebanon,Asia,6768532,1850,75845
2020-10-29,lebanon,Asia,6768532,1933,77778
2020-10-30,lebanon,Asia,6768532,1751,79529
2020-10-31,lebanon,Asia,6768532,1699,81228
2020-11-01,lebanon,Asia,6768532,1389,82617
2020-11-02,lebanon,Asia,6768532,1080,83697
2020-11-03,lebanon,Asia,6768532,1512,85209
2020-11-04,lebanon,Asia,6768532,1888,87097
2020-11-05,lebanon,Asia,6768532,2089,89186
2020-11-06,lebanon,Asia,6768532,2142,91328
2020-11-07,lebanon,Asia,6768532,1769,93097
2020-11-08,lebanon,Asia,6768532,1139,94236
2020-11-09,lebanon,Asia,6768532,1119,95355
2020-11-10,lebanon,Asia,6768532,1552,96907
2020-11-11,lebanon,Asia,6768532,1922,98829
2020-11-12,lebanon,Asia,6768532,1874,100703
2020-11-13,lebanon,Asia,6768532,1904,102607
2020-11-14,lebanon,Asia,6768532,1660,104267
2020-11-15,lebanon,Asia,6768532,1163,105430
2020-11-16,lebanon,Asia,6768532,1016,106446
2020-11-17,lebanon,Asia,6768532,1507,107953
2020-11-18,lebanon,Asia,6768532,2084,110037
2020-11-19,lebanon,Asia,6768532,1909,111946
2020-11-20,lebanon,Asia,6768532,1709,113655
2020-11-21,lebanon,Asia,6768532,1628,115283
2020-11-22,lebanon,Asia,6768532,1193,116476
2020-11-23,lebanon,Asia,6768532,1041,117517
2020-11-24,lebanon,Asia,6768532,1188,118705
2020-11-25,lebanon,Asia,6768532,1636,120341
2020-11-26,lebanon,Asia,6768532,1859,122200
2020-11-27,lebanon,Asia,6768532,1782,123982
2020-11-28,lebanon,Asia,6768532,1696,125678
2020-11-29,lebanon,Asia,6768532,1266,126944
2020-11-30,lebanon,Asia,6768532,1000,127944
2020-12-01,lebanon,Asia,6768532,1511,129455
2020-12-02,lebanon,Asia,6768532,1842,131297
2020-12-03,lebanon,Asia,6768532,1520,132817
2020-12-04,lebanon,Asia,6768532,1478,134295
2020-12-05,lebanon,Asia,6768532,1581,135876
2020-12-06,lebanon,Asia,6768532,1236,137112
2020-12-07,lebanon,Asia,6768532,984,138096
2020-12-08,lebanon,Asia,6768532,1039,139135
2020-12-09,lebanon,Asia,6768532,1274,140409
2020-12-10,lebanon,Asia,6768532,1778,142187
2020-12-11,lebanon,Asia,6768532,1518,143705
2020-12-12,lebanon,Asia,6768532,1540,145245
2020-12-13,lebanon,Asia,6768532,1275,146520
2020-12-14,lebanon,Asia,6768532,1093,147613
2020-12-15,lebanon,Asia,6768532,1264,148877
2020-12-16,lebanon,Asia,6768532,2056,150933
2020-12-17,lebanon,Asia,6768532,2116,153049
2020-12-18,lebanon,Asia,6768532,1895,154944
2020-12-19,lebanon,Asia,6768532,1626,156570
2020-12-20,lebanon,Asia,6768532,1534,158104
2020-12-21,lebanon,Asia,6768532,1182,159286
2020-12-22,lebanon,Asia,6768532,1693,160979
2020-12-23,lebanon,Asia,6768532,2246,163225
2020-12-24,lebanon,Asia,6768532,2708,165933
2020-12-25,lebanon,Asia,6768532,2136,168069
2020-12-26,lebanon,Asia,6768532,1403,169472
2020-12-27,lebanon,Asia,6768532,1754,171226
2020-12-28,lebanon,Asia,6768532,1594,172820
2020-12-29,lebanon,Asia,6768532,2298,175118
2020-12-30,lebanon,Asia,6768532,2878,177996
2020-12-31,lebanon,Asia,6768532,3507,181503
2021-01-01,lebanon,Asia,6768532,2385,183888
2021-01-02,lebanon,Asia,6768532,2520,186408
2021-01-03,lebanon,Asia,6768532,2870,189278
2021-01-04,lebanon,Asia,6768532,2861,192139
2021-01-05,lebanon,Asia,6768532,3620,195759
2021-01-06,lebanon,Asia,6768532,4166,199925
2021-01-07,lebanon,Asia,6768532,4774,204699
2021-01-08,lebanon,Asia,6768532,5440,210139
2021-01-09,lebanon,Asia,6768532,5414,215553
2021-01-10,lebanon,Asia,6768532,3743,219296
2021-01-11,lebanon,Asia,6768532,3095,222391
2021-01-12,lebanon,Asia,6768532,4557,226948
2021-01-13,lebanon,Asia,6768532,4988,231936
2021-01-14,lebanon,Asia,6768532,5196,237132
2021-01-15,lebanon,Asia,6768532,6154,243286
2021-01-16,lebanon,Asia,6768532,5872,249158
2021-01-17,lebanon,Asia,6768532,3654,252812
2021-01-18,lebanon,Asia,6768532,3144,255956
2021-01-19,lebanon,Asia,6768532,4359,260315
2021-01-20,lebanon,Asia,6768532,4332,264647
2021-01-21,lebanon,Asia,6768532,4594,269241
2021-01-22,lebanon,Asia,6768532,3220,272461
2021-01-23,lebanon,Asia,6768532,4126,276587
2021-01-24,lebanon,Asia,6768532,3010,279597
2021-01-25,lebanon,Asia,6768532,2652,282249
2021-01-26,lebanon,Asia,6768532,3505,285754
2021-01-27,lebanon,Asia,6768532,3906,289660
2021-01-28,lebanon,Asia,6768532,3497,293157
2021-01-29,lebanon,Asia,6768532,3125,296282
2021-01-30,lebanon,Asia,6768532,2631,298913
2021-01-31,lebanon,Asia,6768532,2139,301052
2021-02-01,lebanon,Asia,6768532,2020,303072
2021-02-02,lebanon,Asia,6768532,2770,305842
2021-02-03,lebanon,Asia,6768532,3320,309162
2021-02-04,lebanon,Asia,6768532,3107,312269
2021-02-05,lebanon,Asia,6768532,3071,315340
2021-02-06,lebanon,Asia,6768532,2496,317836
2021-02-07,lebanon,Asia,6768532,2081,319917
2021-02-08,lebanon,Asia,6768532,2063,321980
2021-02-09,lebanon,Asia,6768532,2886,324866
2021-02-10,lebanon,Asia,6768532,3157,328023
2021-02-11,lebanon,Asia,6768532,3136,331159
2021-02-12,lebanon,Asia,6768532,2934,334093
2021-02-13,lebanon,Asia,6768532,2906,336999
2021-02-14,lebanon,Asia,6768532,2130,339129
2021-02-15,lebanon,Asia,6768532,1739,340868
2021-02-16,lebanon,Asia,6768532,2733,343601
2021-02-17,lebanon,Asia,6768532,2479,346080
2021-02-18,lebanon,Asia,6768532,2730,348810
2021-02-19,lebanon,Asia,6768532,2255,351065
2021-02-20,lebanon,Asia,6768532,2306,353371
2021-02-21,lebanon,Asia,6768532,1702,355073
2021-02-22,lebanon,Asia,6768532,1541,356614
2021-02-23,lebanon,Asia,6768532,2723,359337
2021-02-24,lebanon,Asia,6768532,3513,362850
2021-02-25,lebanon,Asia,6768532,3469,366319
2021-02-26,lebanon,Asia,6768532,3373,369692
2021-02-27,lebanon,Asia,6768532,3100,372792
2021-02-28,lebanon,Asia,6768532,2258,375050
2021-03-01,lebanon,Asia,6768532,1888,376938
2021-03-02,lebanon,Asia,6768532,3098,380036
2021-03-03,lebanon,Asia,6768532,3463,383499
2021-03-04,lebanon,Asia,6768532,3369,386868
2021-03-05,lebanon,Asia,6768532,3202,390070
2021-03-06,lebanon,Asia,6768532,3158,393228
2021-03-07,lebanon,Asia,6768532,2376,395604
2021-03-08,lebanon,Asia,6768532,2283,397887
2021-03-09,lebanon,Asia,6768532,3939,401826
2021-03-10,lebanon,Asia,6768532,3565,405391
2021-03-11,lebanon,Asia,6768532,3518,408909
2021-03-12,lebanon,Asia,6768532,2930,411839
2021-03-13,lebanon,Asia,6768532,3523,415362
2021-03-14,lebanon,Asia,6768532,3086,418448
2021-03-15,lebanon,Asia,6768532,1505,419953
2021-03-16,lebanon,Asia,6768532,3480,423433
2021-03-17,lebanon,Asia,6768532,3544,426977
2021-03-18,lebanon,Asia,6768532,3757,430734
2021-03-19,lebanon,Asia,6768532,3588,434322
2021-03-20,lebanon,Asia,6768532,2253,436575
2021-03-21,lebanon,Asia,6768532,2993,439568
2021-03-22,lebanon,Asia,6768532,1446,441014
2021-03-23,lebanon,Asia,6768532,3851,444865
2021-03-24,lebanon,Asia,6768532,3856,448721
2021-03-25,lebanon,Asia,6768532,3560,452281
2021-03-26,lebanon,Asia,6768532,3100,455381
2021-03-27,lebanon,Asia,6768532,2957,458338
2021-03-28,lebanon,Asia,6768532,2724,461062
2021-03-29,lebanon,Asia,6768532,1277,462339
2021-03-30,lebanon,Asia,6768532,2668,465007
2021-03-31,lebanon,Asia,6768532,3393,468400
2021-04-01,lebanon,Asia,6768532,3562,471962
2021-04-02,lebanon,Asia,6768532,2963,474925
2021-04-03,lebanon,Asia,6768532,2188,477113
2021-04-04,lebanon,Asia,6768532,2388,479501
2021-04-05,lebanon,Asia,6768532,1001,480502
2021-04-06,lebanon,Asia,6768532,2296,482798
2021-04-07,lebanon,Asia,6768532,3120,485918
2021-04-08,lebanon,Asia,6768532,3510,489428
2021-04-09,lebanon,Asia,6768532,2500,491928
2021-04-10,lebanon,Asia,6768532,2705,494633
2021-04-11,lebanon,Asia,6768532,2213,496846
2021-04-12,lebanon,Asia,6768532,1008,497854
2021-04-13,lebanon,Asia,6768532,1985,499839
2021-04-14,lebanon,Asia,6768532,2460,502299
2021-04-15,lebanon,Asia,6768532,2501,504800
2021-04-16,lebanon,Asia,6768532,2008,506808
2021-04-17,lebanon,Asia,6768532,1695,508503
2021-04-18,lebanon,Asia,6768532,1900,510403
2021-04-19,lebanon,Asia,6768532,995,511398
2021-04-20,lebanon,Asia,6768532,1608,513006
2021-04-21,lebanon,Asia,6768532,2082,515088
2021-04-22,lebanon,Asia,6768532,1512,516600
2021-04-23,lebanon,Asia,6768532,1504,518104
2021-04-24,lebanon,Asia,6768532,1511,519615
2021-04-25,lebanon,Asia,6768532,1324,520939
2021-04-26,lebanon,Asia,6768532,642,521581
2021-04-27,lebanon,Asia,6768532,1182,522763
2021-04-28,lebanon,Asia,6768532,1478,524241
2021-04-29,lebanon,Asia,6768532,1336,525577
2021-04-30,lebanon,Asia,6768532,1001,526578
2021-05-01,lebanon,Asia,6768532,930,527508
2021-05-02,lebanon,Asia,6768532,700,528208
2021-05-03,lebanon,Asia,6768532,249,528457
2021-05-04,lebanon,Asia,6768532,748,529205
2021-05-05,lebanon,Asia,6768532,1012,530217
2021-05-06,lebanon,Asia,6768532,1017,531234
2021-05-07,lebanon,Asia,6768532,600,531834
2021-05-08,lebanon,Asia,6768532,435,532269
2021-05-09,lebanon,Asia,6768532,570,532839
2021-05-10,lebanon,Asia,6768532,302,533141
2021-05-11,lebanon,Asia,6768532,544,533685
2021-05-12,lebanon,Asia,6768532,703,534388
2021-05-13,lebanon,Asia,6768532,580,534968
2021-05-14,lebanon,Asia,6768532,213,535181
2021-05-15,lebanon,Asia,6768532,265,535446
2021-05-16,lebanon,Asia,6768532,307,535753
2021-05-17,lebanon,Asia,6768532,201,535954
2021-05-18,lebanon,Asia,6768532,600,536554
2021-05-19,lebanon,Asia,6768532,489,537043
2021-05-20,lebanon,Asia,6768532,394,537437
2021-05-21,lebanon,Asia,6768532,450,537887
2021-05-22,lebanon,Asia,6768532,331,538218
2021-05-23,lebanon,Asia,6768532,300,538518
2021-05-24,lebanon,Asia,6768532,150,538668
2021-05-25,lebanon,Asia,6768532,323,538991
2021-05-26,lebanon,Asia,6768532,280,539271
2021-05-27,lebanon,Asia,6768532,319,539590
2021-05-28,lebanon,Asia,6768532,298,539888
2021-05-29,lebanon,Asia,6768532,244,540132
2021-05-30,lebanon,Asia,6768532,145,540277
2021-05-31,lebanon,Asia,6768532,111,540388
2021-06-01,lebanon,Asia,6768532,242,540630
2021-06-02,lebanon,Asia,6768532,214,540844
2021-06-03,lebanon,Asia,6768532,165,541009
2021-06-04,lebanon,Asia,6768532,223,541232
2021-06-05,lebanon,Asia,6768532,191,541423
2021-06-06,lebanon,Asia,6768532,134,541557
2021-06-07,lebanon,Asia,6768532,71,541628
2021-06-08,lebanon,Asia,6768532,173,541801
2021-06-09,lebanon,Asia,6768532,139,541940
2021-06-10,lebanon,Asia,6768532,229,542169
2021-06-11,lebanon,Asia,6768532,206,542375
2021-06-12,lebanon,Asia,6768532,148,542523
2021-06-13,lebanon,Asia,6768532,81,542604
2021-06-14,lebanon,Asia,6768532,45,542649
2021-06-15,lebanon,Asia,6768532,170,542819
2021-06-16,lebanon,Asia,6768532,115,542934
2021-06-17,lebanon,Asia,6768532,165,543099
2021-06-18,lebanon,Asia,6768532,168,543267
2021-06-19,lebanon,Asia,6768532,104,543371
2021-06-20,lebanon,Asia,6768532,134,543505
2021-06-21,lebanon,Asia,6768532,46,543551
2021-06-22,lebanon,Asia,6768532,147,543698
2021-06-23,lebanon,Asia,6768532,167,543865
2021-06-24,lebanon,Asia,6768532,137,544002
2021-06-25,lebanon,Asia,6768532,163,544165
2021-06-26,lebanon,Asia,6768532,126,544291
2021-06-27,lebanon,Asia,6768532,163,544454
2021-06-28,lebanon,Asia,6768532,66,544520
2021-06-29,lebanon,Asia,6768532,185,544705
2021-06-30,lebanon,Asia,6768532,161,544866
2021-07-01,lebanon,Asia,6768532,150,545016
2021-07-02,lebanon,Asia,6768532,210,545226
2021-07-03,lebanon,Asia,6768532,137,545363
2021-07-04,lebanon,Asia,6768532,207,545570
2021-07-05,lebanon,Asia,6768532,101,545671
2021-07-06,lebanon,Asia,6768532,294,545965
2021-07-07,lebanon,Asia,6768532,401,546366
2021-07-08,lebanon,Asia,6768532,400,546766
2021-07-09,lebanon,Asia,6768532,404,547170
2021-07-10,lebanon,Asia,6768532,327,547497
2021-07-11,lebanon,Asia,6768532,314,547811
2021-07-12,lebanon,Asia,6768532,150,547961
2021-07-13,lebanon,Asia,6768532,494,548455
2021-07-14,lebanon,Asia,6768532,517,548972
2021-07-15,lebanon,Asia,6768532,455,549427
2021-07-16,lebanon,Asia,6768532,577,550004
2021-07-17,lebanon,Asia,6768532,488,550492
2021-07-18,lebanon,Asia,6768532,450,550942
2021-07-19,lebanon,Asia,6768532,215,551157
2021-07-20,lebanon,Asia,6768532,632,551789
2021-07-21,lebanon,Asia,6768532,539,552328
2021-07-22,lebanon,Asia,6768532,543,552871
2021-07-23,lebanon,Asia,6768532,744,553615
2021-07-24,lebanon,Asia,6768532,843,554458
2021-07-25,lebanon,Asia,6768532,844,555302
2021-07-26,lebanon,Asia,6768532,341,555643
2021-07-27,lebanon,Asia,6768532,1502,557145
2021-07-28,lebanon,Asia,6768532,1224,558369
2021-07-29,lebanon,Asia,6768532,1104,559473
2021-07-30,lebanon,Asia,6768532,923,560396
2021-07-31,lebanon,Asia,6768532,984,561380
2021-08-01,lebanon,Asia,6768532,1147,562527
2021-08-02,lebanon,Asia,6768532,597,563124
2021-08-03,lebanon,Asia,6768532,1230,564354
2021-08-04,lebanon,Asia,6768532,1542,565896
2021-08-05,lebanon,Asia,6768532,1148,567044
2021-08-06,lebanon,Asia,6768532,1461,568505
2021-08-07,lebanon,Asia,6768532,1593,570098
2021-08-08,lebanon,Asia,6768532,1552,571650
2021-08-09,lebanon,Asia,6768532,751,572401
2021-08-10,lebanon,Asia,6768532,1558,573959
2021-08-11,lebanon,Asia,6768532,2591,576550
2021-08-12,lebanon,Asia,6768532,1817,578367
2021-08-13,lebanon,Asia,6768532,1632,579999
2021-08-14,lebanon,Asia,6768532,1498,581497
2021-08-15,lebanon,Asia,6768532,1515,583012
2021-08-16,lebanon,Asia,6768532,706,583718
2021-08-17,lebanon,Asia,6768532,1178,584896
2021-08-18,lebanon,Asia,6768532,1689,586585
2021-08-19,lebanon,Asia,6768532,1993,588578
2021-08-20,lebanon,Asia,6768532,1019,589597
2021-08-21,lebanon,Asia,6768532,1386,590983
2021-08-22,lebanon,Asia,6768532,1173,592156
2021-08-23,lebanon,Asia,6768532,624,592780
2021-08-24,lebanon,Asia,6768532,1149,593929
2021-08-25,lebanon,Asia,6768532,1593,595522
2021-08-26,lebanon,Asia,6768532,1332,596854
2021-08-27,lebanon,Asia,6768532,1124,597978
2021-08-28,lebanon,Asia,6768532,1320,599298
2021-08-29,lebanon,Asia,6768532,1153,600451
2021-08-30,lebanon,Asia,6768532,775,601226
2021-08-31,lebanon,Asia,6768532,1040,602266
2021-09-01,lebanon,Asia,6768532,1022,603288
2021-09-02,lebanon,Asia,6768532,1121,604409
2021-09-03,lebanon,Asia,6768532,1112,605521
2021-09-04,lebanon,Asia,6768532,1015,606536
2021-09-05,lebanon,Asia,6768532,864,607400
2021-09-06,lebanon,Asia,6768532,641,608041
2021-09-07,lebanon,Asia,6768532,1148,609189
2021-09-08,lebanon,Asia,6768532,1008,610197
2021-09-09,lebanon,Asia,6768532,900,611097
2021-09-10,lebanon,Asia,6768532,815,611912
2021-09-11,lebanon,Asia,6768532,801,612713
2021-09-12,lebanon,Asia,6768532,785,613498
2021-09-13,lebanon,Asia,6768532,484,613982
2021-09-14,lebanon,Asia,6768532,706,614688
2021-09-15,lebanon,Asia,6768532,844,615532
2021-09-16,lebanon,Asia,6768532,647,616179
2021-09-17,lebanon,Asia,6768532,857,617036
2021-09-18,lebanon,Asia,6768532,626,617662
2021-09-19,lebanon,Asia,6768532,616,618278
2021-09-20,lebanon,Asia,6768532,302,618580
2021-09-21,lebanon,Asia,6768532,652,619232
2021-09-22,lebanon,Asia,6768532,718,619950
2021-09-23,lebanon,Asia,6768532,602,620552
2021-09-24,lebanon,Asia,6768532,603,621155
2021-09-25,lebanon,Asia,6768532,580,621735
2021-09-26,lebanon,Asia,6768532,500,622235
2021-09-27,lebanon,Asia,6768532,205,622440
2021-09-28,lebanon,Asia,6768532,543,622983
2021-09-29,lebanon,Asia,6768532,626,623609
2021-09-30,lebanon,Asia,6768532,621,624230
2021-10-01,lebanon,Asia,6768532,513,624743
2021-10-02,lebanon,Asia,6768532,702,625445
2021-10-03,lebanon,Asia,6768532,529,625974
2021-10-04,lebanon,Asia,6768532,224,626198
2021-10-05,lebanon,Asia,6768532,728,626926
2021-10-06,lebanon,Asia,6768532,796,627722
2021-10-07,lebanon,Asia,6768532,519,628241
2021-10-08,lebanon,Asia,6768532,640,628881
2021-10-09,lebanon,Asia,6768532,680,629561
2021-10-10,lebanon,Asia,6768532,619,630180
2021-10-11,lebanon,Asia,6768532,202,630382
2021-10-12,lebanon,Asia,6768532,568,630950
2021-10-13,lebanon,Asia,6768532,692,631642
2021-10-14,lebanon,Asia,6768532,629,632271
2021-10-15,lebanon,Asia,6768532,510,632781
2021-10-16,lebanon,Asia,6768532,574,633355
2021-10-17,lebanon,Asia,6768532,554,633909
2021-10-18,lebanon,Asia,6768532,300,634209
2021-10-19,lebanon,Asia,6768532,460,634669
2021-10-20,lebanon,Asia,6768532,778,635447
2021-10-21,lebanon,Asia,6768532,700,636147
2021-10-22,lebanon,Asia,6768532,538,636685
2021-10-23,lebanon,Asia,6768532,627,637312
2021-10-24,lebanon,Asia,6768532,507,637819
2021-10-25,lebanon,Asia,6768532,235,638054
2021-10-26,lebanon,Asia,6768532,527,638581
2021-10-27,lebanon,Asia,6768532,751,639332
2021-10-28,lebanon,Asia,6768532,663,639995
2021-10-29,lebanon,Asia,6768532,680,640675
2021-10-30,lebanon,Asia,6768532,664,641339
2021-10-31,lebanon,Asia,6768532,685,642024
2021-11-01,lebanon,Asia,6768532,201,642225
2021-11-02,lebanon,Asia,6768532,822,643047
2021-11-03,lebanon,Asia,6768532,702,643749
2021-11-04,lebanon,Asia,6768532,642,644391
2021-11-05,lebanon,Asia,6768532,713,645104
2021-11-06,lebanon,Asia,6768532,701,645805
2021-11-07,lebanon,Asia,6768532,824,646629
2021-11-08,lebanon,Asia,6768532,240,646869
2021-11-09,lebanon,Asia,6768532,909,647778
2021-11-10,lebanon,Asia,6768532,1004,648782
2021-11-11,lebanon,Asia,6768532,914,649696
2021-11-12,lebanon,Asia,6768532,959,650655
2021-11-13,lebanon,Asia,6768532,1133,651788
2021-11-14,lebanon,Asia,6768532,947,652735
2021-11-15,lebanon,Asia,6768532,231,652966
2021-11-16,lebanon,Asia,6768532,1102,654068
2021-11-17,lebanon,Asia,6768532,1106,655174
2021-11-18,lebanon,Asia,6768532,1018,656192
2021-11-19,lebanon,Asia,6768532,1175,657367
2021-11-20,lebanon,Asia,6768532,1100,658467
2021-11-21,lebanon,Asia,6768532,937,659404
2021-11-22,lebanon,Asia,6768532,556,659960
2021-11-23,lebanon,Asia,6768532,482,660442
2021-11-24,lebanon,Asia,6768532,1827,662269
2021-11-25,lebanon,Asia,6768532,1510,663779
2021-11-26,lebanon,Asia,6768532,1474,665253
2021-11-27,lebanon,Asia,6768532,1515,666768
2021-11-28,lebanon,Asia,6768532,1319,668087
2021-11-29,lebanon,Asia,6768532,518,668605
2021-11-30,lebanon,Asia,6768532,2051,670656
2021-12-01,lebanon,Asia,6768532,1892,672548
2021-12-02,lebanon,Asia,6768532,1452,674000
2021-12-03,lebanon,Asia,6768532,1765,675765
2021-12-04,lebanon,Asia,6768532,1382,677147
2021-12-05,lebanon,Asia,6768532,1654,678801
2021-12-06,lebanon,Asia,6768532,824,679625
2021-12-07,lebanon,Asia,6768532,1707,681332
2021-12-08,lebanon,Asia,6768532,1994,683326
2021-12-09,lebanon,Asia,6768532,1836,685162
2021-12-10,lebanon,Asia,6768532,1563,686725
2021-12-11,lebanon,Asia,6768532,1790,688515
2021-12-12,lebanon,Asia,6768532,1539,690054
2021-12-13,lebanon,Asia,6768532,787,690841
2021-12-14,lebanon,Asia,6768532,1474,692315
2021-12-15,lebanon,Asia,6768532,1941,694256
2021-12-16,lebanon,Asia,6768532,1912,696168
2021-12-17,lebanon,Asia,6768532,1606,697774
2021-12-18,lebanon,Asia,6768532,1690,699464
2021-12-19,lebanon,Asia,6768532,1479,700943
2021-12-20,lebanon,Asia,6768532,806,701749
2021-12-21,lebanon,Asia,6768532,1806,703555
2021-12-22,lebanon,Asia,6768532,1922,705477
2021-12-23,lebanon,Asia,6768532,1646,707123
2021-12-24,lebanon,Asia,6768532,2119,709242
2021-12-25,lebanon,Asia,6768532,2017,711259
2021-12-26,lebanon,Asia,6768532,1311,712570
2021-12-27,lebanon,Asia,6768532,1100,713670
2021-12-28,lebanon,Asia,6768532,2280,715950
2021-12-29,lebanon,Asia,6768532,3153,719103
2021-12-30,lebanon,Asia,6768532,4537,723640
2021-12-31,lebanon,Asia,6768532,4290,727930
2022-01-01,lebanon,Asia,6768532,3358,731288
2022-01-02,lebanon,Asia,6768532,1445,732733
2022-01-03,lebanon,Asia,6768532,2994,735727
2022-01-04,lebanon,Asia,6768532,5087,740814
2022-01-05,lebanon,Asia,6768532,5818,746632
2022-01-06,lebanon,Asia,6768532,7247,753879
2022-01-07,lebanon,Asia,6768532,7974,761853
2022-01-08,lebanon,Asia,6768532,7547,769400
2022-01-09,lebanon,Asia,6768532,4780,774180
2022-01-10,lebanon,Asia,6768532,6653,780833
2022-01-11,lebanon,Asia,6768532,6665,787498
2022-01-12,lebanon,Asia,6768532,7246,794744
2022-01-13,lebanon,Asia,6768532,7057,801801
2022-01-14,lebanon,Asia,6768532,6811,808612
2022-01-15,lebanon,Asia,6768532,6019,814631
2022-01-16,lebanon,Asia,6768532,5539,820170
2022-01-17,lebanon,Asia,6768532,6109,826279
2022-01-18,lebanon,Asia,6768532,7592,833871
2022-01-19,lebanon,Asia,6768532,6643,840514
2022-01-20,lebanon,Asia,6768532,7110,847624
2022-01-21,lebanon,Asia,6768532,5628,853252
2022-01-22,lebanon,Asia,6768532,5596,858848
2022-01-23,lebanon,Asia,6768532,6381,865229
2022-01-24,lebanon,Asia,6768532,1665,866894
2022-01-25,lebanon,Asia,6768532,7250,874144
2022-01-26,lebanon,Asia,6768532,8639,882783
2022-01-27,lebanon,Asia,6768532,9199,891982
2022-01-28,lebanon,Asia,6768532,8116,900098
2022-01-29,lebanon,Asia,6768532,7726,907824
2022-01-30,lebanon,Asia,6768532,7105,914929
2022-01-31,lebanon,Asia,6768532,6279,921208
2022-02-01,lebanon,Asia,6768532,7314,928522
2022-02-02,lebanon,Asia,6768532,10760,939282
2022-02-03,lebanon,Asia,6768532,9446,948728
2022-02-04,lebanon,Asia,6768532,8427,957155
2022-02-05,lebanon,Asia,6768532,8472,965627
2022-02-06,lebanon,Asia,6768532,6147,971774
2022-02-07,lebanon,Asia,6768532,6351,978125
2022-02-08,lebanon,Asia,6768532,6482,984607
2022-02-09,lebanon,Asia,6768532,8488,993095
2022-02-10,lebanon,Asia,6768532,6060,999155
2022-02-11,lebanon,Asia,6768532,6954,1006109
2022-02-12,lebanon,Asia,6768532,5935,1012044
2022-02-13,lebanon,Asia,6768532,4443,1016487
2022-02-14,lebanon,Asia,6768532,3717,1020204
2022-02-15,lebanon,Asia,6768532,3731,1023935
2022-02-16,lebanon,Asia,6768532,6063,1029998
2022-02-17,lebanon,Asia,6768532,5211,1035209
2022-02-18,lebanon,Asia,6768532,4090,1039299
2022-02-19,lebanon,Asia,6768532,3729,1043028
2022-02-20,lebanon,Asia,6768532,3145,1046173
2022-02-21,lebanon,Asia,6768532,3101,1049274
2022-02-22,lebanon,Asia,6768532,3978,1053252
2022-02-23,lebanon,Asia,6768532,3748,1057000
2022-02-24,lebanon,Asia,6768532,3152,1060152
2022-02-25,lebanon,Asia,6768532,2727,1062879
2022-02-26,lebanon,Asia,6768532,2428,1065307
2022-02-27,lebanon,Asia,6768532,1533,1066840
2022-02-28,lebanon,Asia,6768532,1870,1068710
2022-03-01,lebanon,Asia,6768532,1986,1070696
2022-03-02,lebanon,Asia,6768532,1841,1072537
2022-03-03,lebanon,Asia,6768532,1835,1074372
2022-03-04,lebanon,Asia,6768532,1602,1075974
2022-03-05,lebanon,Asia,6768532,1268,1077242
2022-03-06,lebanon,Asia,6768532,1007,1078249
2022-03-07,lebanon,Asia,6768532,1126,1079375
2022-03-08,lebanon,Asia,6768532,1006,1080381
2022-03-09,lebanon,Asia,6768532,1082,1081463
2022-03-10,lebanon,Asia,6768532,956,1082419
2022-03-11,lebanon,Asia,6768532,932,1083351
2022-03-12,lebanon,Asia,6768532,763,1084114
2022-03-13,lebanon,Asia,6768532,486,1084600
2022-03-14,lebanon,Asia,6768532,632,1085232
2022-03-15,lebanon,Asia,6768532,614,1085846
2022-03-16,lebanon,Asia,6768532,536,1086382
2022-03-17,lebanon,Asia,6768532,508,1086890
2022-03-18,lebanon,Asia,6768532,497,1087387
2022-03-19,lebanon,Asia,6768532,448,1087835
2022-03-20,lebanon,Asia,6768532,361,1088196
2022-03-21,lebanon,Asia,6768532,399,1088595
2022-03-22,lebanon,Asia,6768532,410,1089005
2022-03-23,lebanon,Asia,6768532,414,1089419
2022-03-24,lebanon,Asia,6768532,411,1089830
2022-03-25,lebanon,Asia,6768532,378,1090208
2022-03-26,lebanon,Asia,6768532,290,1090498
2022-03-27,lebanon,Asia,6768532,284,1090782
2022-03-28,lebanon,Asia,6768532,302,1091084
2022-03-29,lebanon,Asia,6768532,329,1091413
2022-03-30,lebanon,Asia,6768532,364,1091777
2022-03-31,lebanon,Asia,6768532,380,1092157
2022-04-01,lebanon,Asia,6768532,352,1092509
2022-04-02,lebanon,Asia,6768532,298,1092807
2022-04-03,lebanon,Asia,6768532,188,1092995
2022-04-04,lebanon,Asia,6768532,272,1093267
2022-04-05,lebanon,Asia,6768532,284,1093551
2022-04-06,lebanon,Asia,6768532,299,1093850
2022-04-07,lebanon,Asia,6768532,246,1094096
2022-04-08,lebanon,Asia,6768532,218,1094314
2022-04-09,lebanon,Asia,6768532,189,1094503
2022-04-10,lebanon,Asia,6768532,169,1094672
2022-04-11,lebanon,Asia,6768532,131,1094803
2022-04-12,lebanon,Asia,6768532,108,1094911
2022-04-13,lebanon,Asia,6768532,188,1095099
2022-04-14,lebanon,Asia,6768532,0,1095099
2022-04-15,lebanon,Asia,6768532,307,1095406
2022-04-16,lebanon,Asia,6768532,112,1095518
2022-04-17,lebanon,Asia,6768532,95,1095613
2022-04-18,lebanon,Asia,6768532,72,1095685
2022-04-19,lebanon,Asia,6768532,126,1095811
2022-04-20,lebanon,Asia,6768532,148,1095959
2022-04-21,lebanon,Asia,6768532,140,1096099
2022-04-22,lebanon,Asia,6768532,128,1096227
2022-04-23,lebanon,Asia,6768532,93,1096320
2020-04-05,liberia,Africa,5278999,3,13
2020-04-06,liberia,Africa,5278999,1,14
2020-04-07,liberia,Africa,5278999,0,14
2020-04-08,liberia,Africa,5278999,17,31
2020-04-09,liberia,Africa,5278999,0,31
2020-04-10,liberia,Africa,5278999,6,37
2020-04-11,liberia,Africa,5278999,11,48
2020-04-12,liberia,Africa,5278999,2,50
2020-04-13,liberia,Africa,5278999,9,59
2020-04-14,liberia,Africa,5278999,0,59
2020-04-15,liberia,Africa,5278999,0,59
2020-04-16,liberia,Africa,5278999,0,59
2020-04-17,liberia,Africa,5278999,17,76
2020-04-18,liberia,Africa,5278999,0,76
2020-04-19,liberia,Africa,5278999,15,91
2020-04-20,liberia,Africa,5278999,8,99
2020-04-21,liberia,Africa,5278999,2,101
2020-04-22,liberia,Africa,5278999,0,101
2020-04-23,liberia,Africa,5278999,0,101
2020-04-24,liberia,Africa,5278999,16,117
2020-04-25,liberia,Africa,5278999,3,120
2020-04-26,liberia,Africa,5278999,4,124
2020-04-27,liberia,Africa,5278999,0,124
2020-04-28,liberia,Africa,5278999,17,141
2020-04-29,liberia,Africa,5278999,0,141
2020-04-30,liberia,Africa,5278999,0,141
2020-05-01,liberia,Africa,5278999,11,152
2020-05-02,liberia,Africa,5278999,2,154
2020-05-03,liberia,Africa,5278999,4,158
2020-05-04,liberia,Africa,5278999,8,166
2020-05-05,liberia,Africa,5278999,4,170
2020-05-06,liberia,Africa,5278999,8,178
2020-05-07,liberia,Africa,5278999,11,189
2020-05-08,liberia,Africa,5278999,10,199
2020-05-09,liberia,Africa,5278999,0,199
2020-05-10,liberia,Africa,5278999,0,199
2020-05-11,liberia,Africa,5278999,12,211
2020-05-12,liberia,Africa,5278999,0,211
2020-05-13,liberia,Africa,5278999,2,213
2020-05-14,liberia,Africa,5278999,2,215
2020-05-15,liberia,Africa,5278999,4,219
2020-05-16,liberia,Africa,5278999,4,223
2020-05-17,liberia,Africa,5278999,3,226
2020-05-18,liberia,Africa,5278999,3,229
2020-05-19,liberia,Africa,5278999,4,233
2020-05-20,liberia,Africa,5278999,5,238
2020-05-21,liberia,Africa,5278999,2,240
2020-05-22,liberia,Africa,5278999,9,249
2020-05-23,liberia,Africa,5278999,6,255
2020-05-24,liberia,Africa,5278999,10,265
2020-05-25,liberia,Africa,5278999,0,265
2020-05-26,liberia,Africa,5278999,1,266
2020-05-27,liberia,Africa,5278999,0,266
2020-05-28,liberia,Africa,5278999,3,269
2020-05-29,liberia,Africa,5278999,4,273
2020-05-30,liberia,Africa,5278999,7,280
2020-05-31,liberia,Africa,5278999,8,288
2020-06-01,liberia,Africa,5278999,8,296
2020-06-02,liberia,Africa,5278999,15,311
2020-06-03,liberia,Africa,5278999,5,316
2020-06-04,liberia,Africa,5278999,5,321
2020-06-05,liberia,Africa,5278999,13,334
2020-06-06,liberia,Africa,5278999,11,345
2020-06-07,liberia,Africa,5278999,14,359
2020-06-08,liberia,Africa,5278999,11,370
2020-06-09,liberia,Africa,5278999,13,383
2020-06-10,liberia,Africa,5278999,14,397
2020-06-11,liberia,Africa,5278999,13,410
2020-06-12,liberia,Africa,5278999,11,421
2020-06-13,liberia,Africa,5278999,25,446
2020-06-14,liberia,Africa,5278999,12,458
2020-06-15,liberia,Africa,5278999,40,498
2020-06-16,liberia,Africa,5278999,11,509
2020-06-17,liberia,Africa,5278999,7,516
2020-06-18,liberia,Africa,5278999,26,542
2020-06-19,liberia,Africa,5278999,39,581
2020-06-20,liberia,Africa,5278999,20,601
2020-06-21,liberia,Africa,5278999,25,626
2020-06-22,liberia,Africa,5278999,24,650
2020-06-23,liberia,Africa,5278999,2,652
2020-06-24,liberia,Africa,5278999,10,662
2020-06-25,liberia,Africa,5278999,19,681
2020-06-26,liberia,Africa,5278999,3,684
2020-06-27,liberia,Africa,5278999,45,729
2020-06-28,liberia,Africa,5278999,39,768
2020-06-29,liberia,Africa,5278999,2,770
2020-06-30,liberia,Africa,5278999,10,780
2020-07-01,liberia,Africa,5278999,24,804
2020-07-02,liberia,Africa,5278999,15,819
2020-07-03,liberia,Africa,5278999,14,833
2020-07-04,liberia,Africa,5278999,36,869
2020-07-05,liberia,Africa,5278999,5,874
2020-07-06,liberia,Africa,5278999,17,891
2020-07-07,liberia,Africa,5278999,26,917
2020-07-08,liberia,Africa,5278999,9,926
2020-07-09,liberia,Africa,5278999,31,957
2020-07-10,liberia,Africa,5278999,6,963
2020-07-11,liberia,Africa,5278999,35,998
2020-07-12,liberia,Africa,5278999,12,1010
2020-07-13,liberia,Africa,5278999,14,1024
2020-07-14,liberia,Africa,5278999,14,1038
2020-07-15,liberia,Africa,5278999,18,1056
2020-07-16,liberia,Africa,5278999,14,1070
2020-07-17,liberia,Africa,5278999,15,1085
2020-07-18,liberia,Africa,5278999,3,1088
2020-07-19,liberia,Africa,5278999,3,1091
2020-07-20,liberia,Africa,5278999,16,1107
2020-07-21,liberia,Africa,5278999,1,1108
2020-07-22,liberia,Africa,5278999,6,1114
2020-07-23,liberia,Africa,5278999,3,1117
2020-07-24,liberia,Africa,5278999,18,1135
2020-07-25,liberia,Africa,5278999,20,1155
2020-07-26,liberia,Africa,5278999,7,1162
2020-07-27,liberia,Africa,5278999,5,1167
2020-07-28,liberia,Africa,5278999,10,1177
2020-07-29,liberia,Africa,5278999,2,1179
2020-07-30,liberia,Africa,5278999,2,1181
2020-07-31,liberia,Africa,5278999,5,1186
2020-08-01,liberia,Africa,5278999,3,1189
2020-08-02,liberia,Africa,5278999,18,1207
2020-08-03,liberia,Africa,5278999,7,1214
2020-08-04,liberia,Africa,5278999,2,1216
2020-08-05,liberia,Africa,5278999,5,1221
2020-08-06,liberia,Africa,5278999,3,1224
2020-08-07,liberia,Africa,5278999,6,1230
2020-08-08,liberia,Africa,5278999,4,1234
2020-08-09,liberia,Africa,5278999,3,1237
2020-08-10,liberia,Africa,5278999,3,1240
2020-08-11,liberia,Africa,5278999,10,1250
2020-08-12,liberia,Africa,5278999,2,1252
2020-08-13,liberia,Africa,5278999,0,1252
2020-08-14,liberia,Africa,5278999,0,1252
2020-08-15,liberia,Africa,5278999,5,1257
2020-08-16,liberia,Africa,5278999,0,1257
2020-08-17,liberia,Africa,5278999,20,1277
2020-08-18,liberia,Africa,5278999,5,1282
2020-08-19,liberia,Africa,5278999,0,1282
2020-08-20,liberia,Africa,5278999,2,1284
2020-08-21,liberia,Africa,5278999,1,1285
2020-08-22,liberia,Africa,5278999,1,1286
2020-08-23,liberia,Africa,5278999,0,1286
2020-08-24,liberia,Africa,5278999,4,1290
2020-08-25,liberia,Africa,5278999,5,1295
2020-08-26,liberia,Africa,5278999,3,1298
2020-08-27,liberia,Africa,5278999,0,1298
2020-08-28,liberia,Africa,5278999,0,1298
2020-08-29,liberia,Africa,5278999,6,1304
2020-08-30,liberia,Africa,5278999,0,1304
2020-08-31,liberia,Africa,5278999,0,1304
2020-09-01,liberia,Africa,5278999,1,1305
2020-09-02,liberia,Africa,5278999,0,1305
2020-09-03,liberia,Africa,5278999,1,1306
2020-09-04,liberia,Africa,5278999,0,1306
2020-09-05,liberia,Africa,5278999,0,1306
2020-09-06,liberia,Africa,5278999,1,1307
2020-09-07,liberia,Africa,5278999,4,1311
2020-09-08,liberia,Africa,5278999,0,1311
2020-09-09,liberia,Africa,5278999,2,1313
2020-09-10,liberia,Africa,5278999,2,1315
2020-09-11,liberia,Africa,5278999,0,1315
2020-09-12,liberia,Africa,5278999,1,1316
2020-09-13,liberia,Africa,5278999,3,1319
2020-09-14,liberia,Africa,5278999,2,1321
2020-09-15,liberia,Africa,5278999,6,1327
2020-09-16,liberia,Africa,5278999,5,1332
2020-09-17,liberia,Africa,5278999,1,1333
2020-09-18,liberia,Africa,5278999,1,1334
2020-09-19,liberia,Africa,5278999,1,1335
2020-09-20,liberia,Africa,5278999,0,1335
2020-09-21,liberia,Africa,5278999,1,1336
2020-09-22,liberia,Africa,5278999,0,1336
2020-09-23,liberia,Africa,5278999,1,1337
2020-09-24,liberia,Africa,5278999,1,1338
2020-09-25,liberia,Africa,5278999,0,1338
2020-09-26,liberia,Africa,5278999,0,1338
2020-09-27,liberia,Africa,5278999,1,1339
2020-09-28,liberia,Africa,5278999,3,1342
2020-09-29,liberia,Africa,5278999,1,1343
2020-09-30,liberia,Africa,5278999,0,1343
2020-10-01,liberia,Africa,5278999,0,1343
2020-10-02,liberia,Africa,5278999,3,1346
2020-10-03,liberia,Africa,5278999,1,1347
2020-10-04,liberia,Africa,5278999,1,1348
2020-10-05,liberia,Africa,5278999,6,1354
2020-10-06,liberia,Africa,5278999,0,1354
2020-10-07,liberia,Africa,5278999,1,1355
2020-10-08,liberia,Africa,5278999,5,1360
2020-10-09,liberia,Africa,5278999,0,1360
2020-10-10,liberia,Africa,5278999,3,1363
2020-10-11,liberia,Africa,5278999,0,1363
2020-10-12,liberia,Africa,5278999,8,1371
2020-10-13,liberia,Africa,5278999,0,1371
2020-10-14,liberia,Africa,5278999,1,1372
2020-10-15,liberia,Africa,5278999,2,1374
2020-10-16,liberia,Africa,5278999,3,1377
2020-10-17,liberia,Africa,5278999,0,1377
2020-10-18,liberia,Africa,5278999,0,1377
2020-10-19,liberia,Africa,5278999,4,1381
2020-10-20,liberia,Africa,5278999,3,1384
2020-10-21,liberia,Africa,5278999,1,1385
2020-10-22,liberia,Africa,5278999,0,1385
2020-10-23,liberia,Africa,5278999,8,1393
2020-10-24,liberia,Africa,5278999,0,1393
2020-10-25,liberia,Africa,5278999,0,1393
2020-10-26,liberia,Africa,5278999,23,1416
2020-10-27,liberia,Africa,5278999,3,1419
2020-10-28,liberia,Africa,5278999,0,1419
2020-10-29,liberia,Africa,5278999,7,1426
2020-10-30,liberia,Africa,5278999,0,1426
2020-10-31,liberia,Africa,5278999,0,1426
2020-11-01,liberia,Africa,5278999,0,1426
2020-11-02,liberia,Africa,5278999,10,1436
2020-11-03,liberia,Africa,5278999,0,1436
2020-11-04,liberia,Africa,5278999,2,1438
2020-11-05,liberia,Africa,5278999,2,1440
2020-11-06,liberia,Africa,5278999,2,1442
2020-11-07,liberia,Africa,5278999,0,1442
2020-11-08,liberia,Africa,5278999,6,1448
2020-11-09,liberia,Africa,5278999,4,1452
2020-11-10,liberia,Africa,5278999,9,1461
2020-11-11,liberia,Africa,5278999,0,1461
2020-11-12,liberia,Africa,5278999,7,1468
2020-11-13,liberia,Africa,5278999,23,1491
2020-11-14,liberia,Africa,5278999,7,1498
2020-11-15,liberia,Africa,5278999,9,1507
2020-11-16,liberia,Africa,5278999,5,1512
2020-11-17,liberia,Africa,5278999,11,1523
2020-11-18,liberia,Africa,5278999,5,1528
2020-11-19,liberia,Africa,5278999,11,1539
2020-11-20,liberia,Africa,5278999,12,1551
2020-11-21,liberia,Africa,5278999,0,1551
2020-11-22,liberia,Africa,5278999,0,1551
2020-11-23,liberia,Africa,5278999,0,1551
2020-11-24,liberia,Africa,5278999,19,1570
2020-11-25,liberia,Africa,5278999,8,1578
2020-11-26,liberia,Africa,5278999,13,1591
2020-11-27,liberia,Africa,5278999,4,1595
2020-11-28,liberia,Africa,5278999,0,1595
2020-11-29,liberia,Africa,5278999,0,1595
2020-11-30,liberia,Africa,5278999,0,1595
2020-12-01,liberia,Africa,5278999,0,1595
2020-12-02,liberia,Africa,5278999,0,1595
2020-12-03,liberia,Africa,5278999,68,1663
2020-12-04,liberia,Africa,5278999,13,1676
2020-12-05,liberia,Africa,5278999,0,1676
2020-12-06,liberia,Africa,5278999,0,1676
2020-12-07,liberia,Africa,5278999,0,1676
2020-12-08,liberia,Africa,5278999,0,1676
2020-12-09,liberia,Africa,5278999,0,1676
2020-12-10,liberia,Africa,5278999,0,1676
2020-12-11,liberia,Africa,5278999,0,1676
2020-12-12,liberia,Africa,5278999,0,1676
2020-12-13,liberia,Africa,5278999,0,1676
2020-12-14,liberia,Africa,5278999,0,1676
2020-12-15,liberia,Africa,5278999,97,1773
2020-12-16,liberia,Africa,5278999,0,1773
2020-12-17,liberia,Africa,5278999,6,1779
2020-12-18,liberia,Africa,5278999,0,1779
2020-12-19,liberia,Africa,5278999,0,1779
2020-12-20,liberia,Africa,5278999,0,1779
2020-12-21,liberia,Africa,5278999,0,1779
2020-12-22,liberia,Africa,5278999,0,1779
2020-12-23,liberia,Africa,5278999,0,1779
2020-12-24,liberia,Africa,5278999,0,1779
2020-12-25,liberia,Africa,5278999,0,1779
2020-12-26,liberia,Africa,5278999,0,1779
2020-12-27,liberia,Africa,5278999,0,1779
2020-12-28,liberia,Africa,5278999,0,1779
2020-12-29,liberia,Africa,5278999,0,1779
2020-12-30,liberia,Africa,5278999,0,1779
2020-12-31,liberia,Africa,5278999,0,1779
2021-01-01,liberia,Africa,5278999,0,1779
2021-01-02,liberia,Africa,5278999,0,1779
2021-01-03,liberia,Africa,5278999,0,1779
2021-01-04,liberia,Africa,5278999,0,1779
2021-01-05,liberia,Africa,5278999,0,1779
2021-01-06,liberia,Africa,5278999,0,1779
2021-01-07,liberia,Africa,5278999,0,1779
2021-01-08,liberia,Africa,5278999,0,1779
2021-01-09,liberia,Africa,5278999,0,1779
2021-01-10,liberia,Africa,5278999,0,1779
2021-01-11,liberia,Africa,5278999,93,1872
2021-01-12,liberia,Africa,5278999,4,1876
2021-01-13,liberia,Africa,5278999,1,1877
2021-01-14,liberia,Africa,5278999,1,1878
2021-01-15,liberia,Africa,5278999,4,1882
2021-01-16,liberia,Africa,5278999,5,1887
2021-01-17,liberia,Africa,5278999,0,1887
2021-01-18,liberia,Africa,5278999,9,1896
2021-01-19,liberia,Africa,5278999,2,1898
2021-01-20,liberia,Africa,5278999,3,1901
2021-01-21,liberia,Africa,5278999,11,1912
2021-01-22,liberia,Africa,5278999,2,1914
2021-01-23,liberia,Africa,5278999,0,1914
2021-01-24,liberia,Africa,5278999,0,1914
2021-01-25,liberia,Africa,5278999,13,1927
2021-01-26,liberia,Africa,5278999,5,1932
2021-01-27,liberia,Africa,5278999,4,1936
2021-01-28,liberia,Africa,5278999,0,1936
2021-01-29,liberia,Africa,5278999,3,1939
2021-01-30,liberia,Africa,5278999,0,1939
2021-01-31,liberia,Africa,5278999,0,1939
2021-02-01,liberia,Africa,5278999,5,1944
2021-02-02,liberia,Africa,5278999,1,1945
2020-04-03,libya,Africa,7045301,6,17
2020-04-04,libya,Africa,7045301,1,18
2020-04-05,libya,Africa,7045301,0,18
2020-04-06,libya,Africa,7045301,1,19
2020-04-07,libya,Africa,7045301,1,20
2020-04-08,libya,Africa,7045301,1,21
2020-04-09,libya,Africa,7045301,3,24
2020-04-10,libya,Africa,7045301,0,24
2020-04-11,libya,Africa,7045301,1,25
2020-04-12,libya,Africa,7045301,0,25
2020-04-13,libya,Africa,7045301,1,26
2020-04-14,libya,Africa,7045301,9,35
2020-04-15,libya,Africa,7045301,13,48
2020-04-16,libya,Africa,7045301,1,49
2020-04-17,libya,Africa,7045301,0,49
2020-04-18,libya,Africa,7045301,0,49
2020-04-19,libya,Africa,7045301,2,51
2020-04-20,libya,Africa,7045301,0,51
2020-04-21,libya,Africa,7045301,8,59
2020-04-22,libya,Africa,7045301,1,60
2020-04-23,libya,Africa,7045301,0,60
2020-04-24,libya,Africa,7045301,1,61
2020-04-25,libya,Africa,7045301,0,61
2020-04-26,libya,Africa,7045301,0,61
2020-04-27,libya,Africa,7045301,0,61
2020-04-28,libya,Africa,7045301,0,61
2020-04-29,libya,Africa,7045301,0,61
2020-04-30,libya,Africa,7045301,0,61
2020-05-01,libya,Africa,7045301,2,63
2020-05-02,libya,Africa,7045301,0,63
2020-05-03,libya,Africa,7045301,0,63
2020-05-04,libya,Africa,7045301,0,63
2020-05-05,libya,Africa,7045301,0,63
2020-05-06,libya,Africa,7045301,1,64
2020-05-07,libya,Africa,7045301,0,64
2020-05-08,libya,Africa,7045301,0,64
2020-05-09,libya,Africa,7045301,0,64
2020-05-10,libya,Africa,7045301,0,64
2020-05-11,libya,Africa,7045301,0,64
2020-05-12,libya,Africa,7045301,0,64
2020-05-13,libya,Africa,7045301,0,64
2020-05-14,libya,Africa,7045301,0,64
2020-05-15,libya,Africa,7045301,0,64
2020-05-16,libya,Africa,7045301,1,65
2020-05-17,libya,Africa,7045301,0,65
2020-05-18,libya,Africa,7045301,0,65
2020-05-19,libya,Africa,7045301,3,68
2020-05-20,libya,Africa,7045301,1,69
2020-05-21,libya,Africa,7045301,2,71
2020-05-22,libya,Africa,7045301,1,72
2020-05-23,libya,Africa,7045301,3,75
2020-05-24,libya,Africa,7045301,0,75
2020-05-25,libya,Africa,7045301,0,75
2020-05-26,libya,Africa,7045301,2,77
2020-05-27,libya,Africa,7045301,22,99
2020-05-28,libya,Africa,7045301,6,105
2020-05-29,libya,Africa,7045301,13,118
2020-05-30,libya,Africa,7045301,12,130
2020-05-31,libya,Africa,7045301,26,156
2020-06-01,libya,Africa,7045301,12,168
2020-06-02,libya,Africa,7045301,14,182
2020-06-03,libya,Africa,7045301,14,196
2020-06-04,libya,Africa,7045301,13,209
2020-06-05,libya,Africa,7045301,30,239
2020-06-06,libya,Africa,7045301,17,256
2020-06-07,libya,Africa,7045301,0,256
2020-06-08,libya,Africa,7045301,76,332
2020-06-09,libya,Africa,7045301,27,359
2020-06-10,libya,Africa,7045301,19,378
2020-06-11,libya,Africa,7045301,15,393
2020-06-12,libya,Africa,7045301,16,409
2020-06-13,libya,Africa,7045301,9,418
2020-06-14,libya,Africa,7045301,36,454
2020-06-15,libya,Africa,7045301,13,467
2020-06-16,libya,Africa,7045301,17,484
2020-06-17,libya,Africa,7045301,16,500
2020-06-18,libya,Africa,7045301,10,510
2020-06-19,libya,Africa,7045301,10,520
2020-06-20,libya,Africa,7045301,24,544
2020-06-21,libya,Africa,7045301,27,571
2020-06-22,libya,Africa,7045301,24,595
2020-06-23,libya,Africa,7045301,44,639
2020-06-24,libya,Africa,7045301,31,670
2020-06-25,libya,Africa,7045301,28,698
2020-06-26,libya,Africa,7045301,15,713
2020-06-27,libya,Africa,7045301,14,727
2020-06-28,libya,Africa,7045301,35,762
2020-06-29,libya,Africa,7045301,40,802
2020-06-30,libya,Africa,7045301,22,824
2020-07-01,libya,Africa,7045301,50,874
2020-07-02,libya,Africa,7045301,17,891
2020-07-03,libya,Africa,7045301,27,918
2020-07-04,libya,Africa,7045301,71,989
2020-07-05,libya,Africa,7045301,57,1046
2020-07-06,libya,Africa,7045301,71,1117
2020-07-07,libya,Africa,7045301,65,1182
2020-07-08,libya,Africa,7045301,86,1268
2020-07-09,libya,Africa,7045301,74,1342
2020-07-10,libya,Africa,7045301,0,1342
2020-07-11,libya,Africa,7045301,47,1389
2020-07-12,libya,Africa,7045301,44,1433
2020-07-13,libya,Africa,7045301,79,1512
2020-07-14,libya,Africa,7045301,51,1563
2020-07-15,libya,Africa,7045301,26,1589
2020-07-16,libya,Africa,7045301,63,1652
2020-07-17,libya,Africa,7045301,52,1704
2020-07-18,libya,Africa,7045301,87,1791
2020-07-19,libya,Africa,7045301,75,1866
2020-07-20,libya,Africa,7045301,114,1980
2020-07-21,libya,Africa,7045301,108,2088
2020-07-22,libya,Africa,7045301,88,2176
2020-07-23,libya,Africa,7045301,138,2314
2020-07-24,libya,Africa,7045301,110,2424
2020-07-25,libya,Africa,7045301,123,2547
2020-07-26,libya,Africa,7045301,122,2669
2020-07-27,libya,Africa,7045301,158,2827
2020-07-28,libya,Africa,7045301,190,3017
2020-07-29,libya,Africa,7045301,205,3222
2020-07-30,libya,Africa,7045301,216,3438
2020-07-31,libya,Africa,7045301,183,3621
2020-08-01,libya,Africa,7045301,70,3691
2020-08-02,libya,Africa,7045301,146,3837
2020-08-03,libya,Africa,7045301,226,4063
2020-08-04,libya,Africa,7045301,161,4224
2020-08-05,libya,Africa,7045301,251,4475
2020-08-06,libya,Africa,7045301,404,4879
2020-08-07,libya,Africa,7045301,200,5079
2020-08-08,libya,Africa,7045301,153,5232
2020-08-09,libya,Africa,7045301,219,5451
2020-08-10,libya,Africa,7045301,478,5929
2020-08-11,libya,Africa,7045301,373,6302
2020-08-12,libya,Africa,7045301,309,6611
2020-08-13,libya,Africa,7045301,439,7050
2020-08-14,libya,Africa,7045301,277,7327
2020-08-15,libya,Africa,7045301,411,7738
2020-08-16,libya,Africa,7045301,434,8172
2020-08-17,libya,Africa,7045301,407,8579
2020-08-18,libya,Africa,7045301,489,9068
2020-08-19,libya,Africa,7045301,395,9463
2020-08-20,libya,Africa,7045301,244,9707
2020-08-21,libya,Africa,7045301,414,10121
2020-08-22,libya,Africa,7045301,316,10437
2020-08-23,libya,Africa,7045301,0,10437
2020-08-24,libya,Africa,7045301,572,11009
2020-08-25,libya,Africa,7045301,272,11281
2020-08-26,libya,Africa,7045301,553,11834
2020-08-27,libya,Africa,7045301,440,12274
2020-08-28,libya,Africa,7045301,355,12629
2020-08-29,libya,Africa,7045301,329,12958
2020-08-30,libya,Africa,7045301,465,13423
2020-08-31,libya,Africa,7045301,543,13966
2020-09-01,libya,Africa,7045301,658,14624
2020-09-02,libya,Africa,7045301,532,15156
2020-09-03,libya,Africa,7045301,617,15773
2020-09-04,libya,Africa,7045301,672,16445
2020-09-05,libya,Africa,7045301,649,17094
2020-09-06,libya,Africa,7045301,655,17749
2020-09-07,libya,Africa,7045301,1085,18834
2020-09-08,libya,Africa,7045301,749,19583
2020-09-09,libya,Africa,7045301,879,20462
2020-09-10,libya,Africa,7045301,477,20939
2020-09-11,libya,Africa,7045301,969,21908
2020-09-12,libya,Africa,7045301,440,22348
2020-09-13,libya,Africa,7045301,433,22781
2020-09-14,libya,Africa,7045301,734,23515
2020-09-15,libya,Africa,7045301,629,24144
2020-09-16,libya,Africa,7045301,792,24936
2020-09-17,libya,Africa,7045301,886,25822
2020-09-18,libya,Africa,7045301,616,26438
2020-09-19,libya,Africa,7045301,796,27234
2020-09-20,libya,Africa,7045301,715,27949
2020-09-21,libya,Africa,7045301,847,28796
2020-09-22,libya,Africa,7045301,650,29446
2020-09-23,libya,Africa,7045301,651,30097
2020-09-24,libya,Africa,7045301,535,30632
2020-09-25,libya,Africa,7045301,658,31290
2020-09-26,libya,Africa,7045301,538,31828
2020-09-27,libya,Africa,7045301,536,32364
2020-09-28,libya,Africa,7045301,849,33213
2020-09-29,libya,Africa,7045301,801,34014
2020-09-30,libya,Africa,7045301,511,34525
2020-10-01,libya,Africa,7045301,683,35208
2020-10-02,libya,Africa,7045301,509,35717
2020-10-03,libya,Africa,7045301,370,36087
2020-10-04,libya,Africa,7045301,722,36809
2020-10-05,libya,Africa,7045301,628,37437
2020-10-06,libya,Africa,7045301,1031,38468
2020-10-07,libya,Africa,7045301,1045,39513
2020-10-08,libya,Africa,7045301,779,40292
2020-10-09,libya,Africa,7045301,1076,41368
2020-10-10,libya,Africa,7045301,318,41686
2020-10-11,libya,Africa,7045301,1026,42712
2020-10-12,libya,Africa,7045301,1109,43821
2020-10-13,libya,Africa,7045301,1164,44985
2020-10-14,libya,Africa,7045301,836,45821
2020-10-15,libya,Africa,7045301,855,46676
2020-10-16,libya,Africa,7045301,1169,47845
2020-10-17,libya,Africa,7045301,0,47845
2020-10-18,libya,Africa,7045301,945,48790
2020-10-19,libya,Africa,7045301,1159,49949
2020-10-20,libya,Africa,7045301,957,50906
2020-10-21,libya,Africa,7045301,719,51625
2020-10-22,libya,Africa,7045301,995,52620
2020-10-23,libya,Africa,7045301,764,53384
2020-10-24,libya,Africa,7045301,990,54374
2020-10-25,libya,Africa,7045301,1639,56013
2020-10-26,libya,Africa,7045301,1210,57223
2020-10-27,libya,Africa,7045301,752,57975
2020-10-28,libya,Africa,7045301,899,58874
2020-10-29,libya,Africa,7045301,782,59656
2020-10-30,libya,Africa,7045301,972,60628
2020-10-31,libya,Africa,7045301,467,61095
2020-11-01,libya,Africa,7045301,950,62045
2020-11-02,libya,Africa,7045301,862,62907
2020-11-03,libya,Africa,7045301,781,63688
2020-11-04,libya,Africa,7045301,899,64587
2020-11-05,libya,Africa,7045301,853,65440
2020-11-06,libya,Africa,7045301,1004,66444
2020-11-07,libya,Africa,7045301,595,67039
2020-11-08,libya,Africa,7045301,1078,68117
2020-11-09,libya,Africa,7045301,923,69040
2020-11-10,libya,Africa,7045301,970,70010
2020-11-11,libya,Africa,7045301,875,70885
2020-11-12,libya,Africa,7045301,919,71804
2020-11-13,libya,Africa,7045301,824,72628
2020-11-14,libya,Africa,7045301,0,72628
2020-11-15,libya,Africa,7045301,974,73602
2020-11-16,libya,Africa,7045301,722,74324
2020-11-17,libya,Africa,7045301,612,74936
2020-11-18,libya,Africa,7045301,529,75465
2020-11-19,libya,Africa,7045301,541,76006
2020-11-20,libya,Africa,7045301,802,76808
2020-11-21,libya,Africa,7045301,0,76808
2020-11-22,libya,Africa,7045301,1015,77823
2020-11-23,libya,Africa,7045301,650,78473
2020-11-24,libya,Africa,7045301,707,79180
2020-11-25,libya,Africa,7045301,617,79797
2020-11-26,libya,Africa,7045301,610,80407
2020-11-27,libya,Africa,7045301,866,81273
2020-11-28,libya,Africa,7045301,0,81273
2020-11-29,libya,Africa,7045301,1157,82430
2020-11-30,libya,Africa,7045301,379,82809
2020-12-01,libya,Africa,7045301,608,83417
2020-12-02,libya,Africa,7045301,670,84087
2020-12-03,libya,Africa,7045301,762,84849
2020-12-04,libya,Africa,7045301,680,85529
2020-12-05,libya,Africa,7045301,0,85529
2020-12-06,libya,Africa,7045301,1051,86580
2020-12-07,libya,Africa,7045301,517,87097
2020-12-08,libya,Africa,7045301,889,87986
2020-12-09,libya,Africa,7045301,536,88522
2020-12-10,libya,Africa,7045301,661,89183
2020-12-11,libya,Africa,7045301,697,89880
2020-12-12,libya,Africa,7045301,0,89880
2020-12-13,libya,Africa,7045301,899,90779
2020-12-14,libya,Africa,7045301,578,91357
2020-12-15,libya,Africa,7045301,660,92017
2020-12-16,libya,Africa,7045301,560,92577
2020-12-17,libya,Africa,7045301,706,93283
2020-12-18,libya,Africa,7045301,489,93772
2020-12-19,libya,Africa,7045301,0,93772
2020-12-20,libya,Africa,7045301,788,94560
2020-12-21,libya,Africa,7045301,640,95200
2020-12-22,libya,Africa,7045301,506,95706
2020-12-23,libya,Africa,7045301,640,96346
2020-12-24,libya,Africa,7045301,846,97192
2020-12-25,libya,Africa,7045301,461,97653
2020-12-26,libya,Africa,7045301,0,97653
2020-12-27,libya,Africa,7045301,728,98381
2020-12-28,libya,Africa,7045301,532,98913
2020-12-29,libya,Africa,7045301,437,99350
2020-12-30,libya,Africa,7045301,585,99935
2020-12-31,libya,Africa,7045301,342,100277
2021-01-01,libya,Africa,7045301,467,100744
2021-01-02,libya,Africa,7045301,0,100744
2021-01-03,libya,Africa,7045301,670,101414
2021-01-04,libya,Africa,7045301,561,101975
2021-01-05,libya,Africa,7045301,481,102456
2021-01-06,libya,Africa,7045301,424,102880
2021-01-07,libya,Africa,7045301,635,103515
2021-01-08,libya,Africa,7045301,487,104002
2021-01-09,libya,Africa,7045301,0,104002
2021-01-10,libya,Africa,7045301,743,104745
2021-01-11,libya,Africa,7045301,633,105378
2021-01-12,libya,Africa,7045301,652,106030
2021-01-13,libya,Africa,7045301,640,106670
2021-01-14,libya,Africa,7045301,764,107434
2021-01-15,libya,Africa,7045301,583,108017
2021-01-16,libya,Africa,7045301,0,108017
2021-01-17,libya,Africa,7045301,1071,109088
2021-01-18,libya,Africa,7045301,781,109869
2021-01-19,libya,Africa,7045301,596,110465
2021-01-20,libya,Africa,7045301,659,111124
2021-01-21,libya,Africa,7045301,622,111746
2021-01-22,libya,Africa,7045301,794,112540
2021-01-23,libya,Africa,7045301,0,112540
2021-01-24,libya,Africa,7045301,1148,113688
2021-01-25,libya,Africa,7045301,741,114429
2021-01-26,libya,Africa,7045301,870,115299
2021-01-27,libya,Africa,7045301,765,116064
2021-01-28,libya,Africa,7045301,715,116779
2021-01-29,libya,Africa,7045301,871,117650
2021-01-30,libya,Africa,7045301,0,117650
2021-01-31,libya,Africa,7045301,981,118631
2021-02-01,libya,Africa,7045301,771,119402
2021-02-02,libya,Africa,7045301,1032,120434
2021-02-03,libya,Africa,7045301,809,121243
2021-02-04,libya,Africa,7045301,770,122013
2021-02-05,libya,Africa,7045301,881,122894
2021-02-06,libya,Africa,7045301,0,122894
2021-02-07,libya,Africa,7045301,1132,124026
2021-02-08,libya,Africa,7045301,856,124882
2021-02-09,libya,Africa,7045301,679,125561
2021-02-10,libya,Africa,7045301,467,126028
2021-02-11,libya,Africa,7045301,333,126361
2021-02-12,libya,Africa,7045301,520,126881
2021-02-13,libya,Africa,7045301,0,126881
2021-02-14,libya,Africa,7045301,473,127354
2021-02-15,libya,Africa,7045301,351,127705
2021-02-16,libya,Africa,7045301,331,128036
2021-02-17,libya,Africa,7045301,312,128348
2021-02-18,libya,Africa,7045301,392,128740
2021-02-19,libya,Africa,7045301,585,129325
2021-02-20,libya,Africa,7045301,0,129325
2021-02-21,libya,Africa,7045301,472,129797
2021-02-22,libya,Africa,7045301,415,130212
2021-02-23,libya,Africa,7045301,489,130701
2021-02-24,libya,Africa,7045301,561,131262
2021-02-25,libya,Africa,7045301,571,131833
2021-02-26,libya,Africa,7045301,625,132458
2021-02-27,libya,Africa,7045301,0,132458
2021-02-28,libya,Africa,7045301,880,133338
2021-03-01,libya,Africa,7045301,789,134127
2021-03-02,libya,Africa,7045301,840,134967
2021-03-03,libya,Africa,7045301,618,135585
2021-03-04,libya,Africa,7045301,1002,136587
2021-03-05,libya,Africa,7045301,895,137482
2021-03-06,libya,Africa,7045301,0,137482
2021-03-07,libya,Africa,7045301,1158,138640
2021-03-08,libya,Africa,7045301,1018,139658
2021-03-09,libya,Africa,7045301,1030,140688
2021-03-10,libya,Africa,7045301,910,141598
2021-03-11,libya,Africa,7045301,1073,142671
2021-03-12,libya,Africa,7045301,972,143643
2021-03-13,libya,Africa,7045301,0,143643
2021-03-14,libya,Africa,7045301,1350,144993
2021-03-15,libya,Africa,7045301,1087,146080
2021-03-16,libya,Africa,7045301,1041,147121
2021-03-17,libya,Africa,7045301,1054,148175
2021-03-18,libya,Africa,7045301,1032,149207
2021-03-19,libya,Africa,7045301,1134,150341
2021-03-20,libya,Africa,7045301,0,150341
2021-03-21,libya,Africa,7045301,1264,151605
2021-03-22,libya,Africa,7045301,905,152510
2021-03-23,libya,Africa,7045301,901,153411
2021-03-24,libya,Africa,7045301,909,154320
2021-03-25,libya,Africa,7045301,912,155232
2021-03-26,libya,Africa,7045301,884,156116
2021-03-27,libya,Africa,7045301,0,156116
2021-03-28,libya,Africa,7045301,733,156849
2021-03-29,libya,Africa,7045301,696,157545
2021-03-30,libya,Africa,7045301,706,158251
2021-03-31,libya,Africa,7045301,706,158957
2021-04-01,libya,Africa,7045301,1023,159980
2021-04-02,libya,Africa,7045301,1108,161088
2021-04-03,libya,Africa,7045301,0,161088
2021-04-04,libya,Africa,7045301,1206,162294
2021-04-05,libya,Africa,7045301,1148,163442
2021-04-06,libya,Africa,7045301,876,164318
2021-04-07,libya,Africa,7045301,969,165287
2021-04-08,libya,Africa,7045301,869,166156
2021-04-09,libya,Africa,7045301,732,166888
2021-04-10,libya,Africa,7045301,0,166888
2021-04-11,libya,Africa,7045301,937,167825
2021-04-12,libya,Africa,7045301,851,168676
2021-04-13,libya,Africa,7045301,828,169504
2021-04-14,libya,Africa,7045301,541,170045
2021-04-15,libya,Africa,7045301,513,170558
2021-04-16,libya,Africa,7045301,573,171131
2021-04-17,libya,Africa,7045301,0,171131
2021-04-18,libya,Africa,7045301,749,171880
2021-04-19,libya,Africa,7045301,584,172464
2021-04-20,libya,Africa,7045301,625,173089
2021-04-21,libya,Africa,7045301,594,173683
2021-04-22,libya,Africa,7045301,533,174216
2021-04-23,libya,Africa,7045301,536,174752
2021-04-24,libya,Africa,7045301,0,174752
2021-04-25,libya,Africa,7045301,534,175286
2021-04-26,libya,Africa,7045301,467,175753
2021-04-27,libya,Africa,7045301,501,176254
2021-04-28,libya,Africa,7045301,447,176701
2021-04-29,libya,Africa,7045301,371,177072
2021-04-30,libya,Africa,7045301,436,177508
2021-05-01,libya,Africa,7045301,0,177508
2021-05-02,libya,Africa,7045301,363,177871
2021-05-03,libya,Africa,7045301,464,178335
2021-05-04,libya,Africa,7045301,337,178672
2021-05-05,libya,Africa,7045301,255,178927
2021-05-06,libya,Africa,7045301,266,179193
2021-05-07,libya,Africa,7045301,504,179697
2021-05-08,libya,Africa,7045301,0,179697
2021-05-09,libya,Africa,7045301,273,179970
2021-05-10,libya,Africa,7045301,256,180226
2021-05-11,libya,Africa,7045301,466,180692
2021-05-12,libya,Africa,7045301,253,180945
2021-05-13,libya,Africa,7045301,234,181179
2021-05-14,libya,Africa,7045301,0,181179
2021-05-15,libya,Africa,7045301,0,181179
2021-05-16,libya,Africa,7045301,231,181410
2021-05-17,libya,Africa,7045301,304,181714
2021-05-18,libya,Africa,7045301,298,182012
2021-05-19,libya,Africa,7045301,338,182350
2021-05-20,libya,Africa,7045301,299,182649
2021-05-21,libya,Africa,7045301,250,182899
2021-05-22,libya,Africa,7045301,0,182899
2021-05-23,libya,Africa,7045301,412,183311
2021-05-24,libya,Africa,7045301,281,183592
2021-05-25,libya,Africa,7045301,340,183932
2021-05-26,libya,Africa,7045301,219,184151
2021-05-27,libya,Africa,7045301,321,184472
2021-05-28,libya,Africa,7045301,343,184815
2021-05-29,libya,Africa,7045301,0,184815
2021-05-30,libya,Africa,7045301,366,185181
2021-05-31,libya,Africa,7045301,595,185776
2021-06-01,libya,Africa,7045301,296,186072
2021-06-02,libya,Africa,7045301,251,186323
2021-06-03,libya,Africa,7045301,244,186567
2021-06-04,libya,Africa,7045301,386,186953
2021-06-05,libya,Africa,7045301,0,186953
2021-06-06,libya,Africa,7045301,325,187278
2021-06-07,libya,Africa,7045301,407,187685
2021-06-08,libya,Africa,7045301,243,187928
2021-06-09,libya,Africa,7045301,229,188157
2021-06-10,libya,Africa,7045301,229,188386
2021-06-11,libya,Africa,7045301,376,188762
2021-06-12,libya,Africa,7045301,0,188762
2021-06-13,libya,Africa,7045301,297,189059
2021-06-14,libya,Africa,7045301,225,189284
2021-06-15,libya,Africa,7045301,274,189558
2021-06-16,libya,Africa,7045301,330,189888
2021-06-17,libya,Africa,7045301,258,190146
2021-06-18,libya,Africa,7045301,280,190426
2021-06-19,libya,Africa,7045301,0,190426
2021-06-20,libya,Africa,7045301,322,190748
2021-06-21,libya,Africa,7045301,290,191038
2021-06-22,libya,Africa,7045301,215,191253
2021-06-23,libya,Africa,7045301,223,191476
2021-06-24,libya,Africa,7045301,184,191660
2021-06-25,libya,Africa,7045301,469,192129
2021-06-26,libya,Africa,7045301,100,192229
2021-06-27,libya,Africa,7045301,241,192470
2021-06-28,libya,Africa,7045301,316,192786
2021-06-29,libya,Africa,7045301,452,193238
2021-06-30,libya,Africa,7045301,236,193474
2021-07-01,libya,Africa,7045301,431,193905
2021-07-02,libya,Africa,7045301,418,194323
2021-07-03,libya,Africa,7045301,0,194323
2021-07-04,libya,Africa,7045301,719,195042
2021-07-05,libya,Africa,7045301,782,195824
2021-07-06,libya,Africa,7045301,1070,196894
2021-07-07,libya,Africa,7045301,1248,198142
2021-07-08,libya,Africa,7045301,1384,199526
2021-07-09,libya,Africa,7045301,1710,201236
2021-07-10,libya,Africa,7045301,0,201236
2021-07-11,libya,Africa,7045301,2854,204090
2021-07-12,libya,Africa,7045301,2679,206769
2021-07-13,libya,Africa,7045301,2640,209409
2021-07-14,libya,Africa,7045301,2604,212013
2021-07-15,libya,Africa,7045301,2555,214568
2021-07-16,libya,Africa,7045301,2866,217434
2021-07-17,libya,Africa,7045301,0,217434
2021-07-18,libya,Africa,7045301,4061,221495
2021-07-19,libya,Africa,7045301,3425,224920
2021-07-20,libya,Africa,7045301,1781,226701
2021-07-21,libya,Africa,7045301,0,226701
2021-07-22,libya,Africa,7045301,732,227433
2021-07-23,libya,Africa,7045301,2171,229604
2021-07-24,libya,Africa,7045301,0,229604
2021-07-25,libya,Africa,7045301,3845,233449
2021-07-26,libya,Africa,7045301,3512,236961
2021-07-27,libya,Africa,7045301,3348,240309
2021-07-28,libya,Africa,7045301,3161,243470
2021-07-29,libya,Africa,7045301,2730,246200
2021-07-30,libya,Africa,7045301,2914,249114
2021-07-31,libya,Africa,7045301,0,249114
2021-08-01,libya,Africa,7045301,4322,253436
2021-08-02,libya,Africa,7045301,2892,256328
2021-08-03,libya,Africa,7045301,2139,258467
2021-08-04,libya,Africa,7045301,2485,260952
2021-08-05,libya,Africa,7045301,1996,262948
2021-08-06,libya,Africa,7045301,1879,264827
2021-08-07,libya,Africa,7045301,0,264827
2021-08-08,libya,Africa,7045301,3019,267846
2021-08-09,libya,Africa,7045301,2001,269847
2021-08-10,libya,Africa,7045301,2134,271981
2021-08-11,libya,Africa,7045301,2472,274453
2021-08-12,libya,Africa,7045301,2286,276739
2021-08-13,libya,Africa,7045301,2360,279099
2021-08-14,libya,Africa,7045301,0,279099
2021-08-15,libya,Africa,7045301,2831,281930
2021-08-16,libya,Africa,7045301,2688,284618
2021-08-17,libya,Africa,7045301,2276,286894
2021-08-18,libya,Africa,7045301,2325,289219
2021-08-19,libya,Africa,7045301,1949,291168
2021-08-20,libya,Africa,7045301,2364,293532
2021-08-21,libya,Africa,7045301,0,293532
2021-08-22,libya,Africa,7045301,1722,295254
2021-08-23,libya,Africa,7045301,1625,296879
2021-08-24,libya,Africa,7045301,1894,298773
2021-08-25,libya,Africa,7045301,1682,300455
2021-08-26,libya,Africa,7045301,1722,302177
2021-08-27,libya,Africa,7045301,1613,303790
2021-08-28,libya,Africa,7045301,0,303790
2021-08-29,libya,Africa,7045301,2003,305793
2021-08-30,libya,Africa,7045301,1678,307471
2021-08-31,libya,Africa,7045301,1501,308972
2021-09-01,libya,Africa,7045301,1665,310637
2021-09-02,libya,Africa,7045301,1479,312116
2021-09-03,libya,Africa,7045301,1388,313504
2021-09-04,libya,Africa,7045301,0,313504
2021-09-05,libya,Africa,7045301,1914,315418
2021-09-06,libya,Africa,7045301,1379,316797
2021-09-07,libya,Africa,7045301,1272,318069
2021-09-08,libya,Africa,7045301,1499,319568
2021-09-09,libya,Africa,7045301,1802,321370
2021-09-10,libya,Africa,7045301,1117,322487
2021-09-11,libya,Africa,7045301,0,322487
2021-09-12,libya,Africa,7045301,1443,323930
2021-09-13,libya,Africa,7045301,1291,325221
2021-09-14,libya,Africa,7045301,1149,326370
2021-09-15,libya,Africa,7045301,1433,327803
2021-09-16,libya,Africa,7045301,1053,328856
2021-09-17,libya,Africa,7045301,968,329824
2021-09-18,libya,Africa,7045301,0,329824
2020-04-05,liechtenstein,Europe,38332,0,77
2020-04-06,liechtenstein,Europe,38332,0,77
2020-04-07,liechtenstein,Europe,38332,1,78
2020-04-08,liechtenstein,Europe,38332,0,78
2020-04-09,liechtenstein,Europe,38332,0,78
2020-04-10,liechtenstein,Europe,38332,1,79
2020-04-11,liechtenstein,Europe,38332,0,79
2020-04-12,liechtenstein,Europe,38332,0,79
2020-04-13,liechtenstein,Europe,38332,0,79
2020-04-14,liechtenstein,Europe,38332,0,79
2020-04-15,liechtenstein,Europe,38332,1,80
2020-04-16,liechtenstein,Europe,38332,0,80
2020-04-17,liechtenstein,Europe,38332,1,81
2020-04-18,liechtenstein,Europe,38332,0,81
2020-04-19,liechtenstein,Europe,38332,0,81
2020-04-20,liechtenstein,Europe,38332,0,81
2020-04-21,liechtenstein,Europe,38332,0,81
2020-04-22,liechtenstein,Europe,38332,0,81
2020-04-23,liechtenstein,Europe,38332,0,81
2020-04-24,liechtenstein,Europe,38332,0,81
2020-04-25,liechtenstein,Europe,38332,0,81
2020-04-26,liechtenstein,Europe,38332,1,82
2020-04-27,liechtenstein,Europe,38332,0,82
2020-04-28,liechtenstein,Europe,38332,0,82
2020-04-29,liechtenstein,Europe,38332,0,82
2020-04-30,liechtenstein,Europe,38332,0,82
2020-05-01,liechtenstein,Europe,38332,0,82
2020-05-02,liechtenstein,Europe,38332,0,82
2020-05-03,liechtenstein,Europe,38332,0,82
2020-05-04,liechtenstein,Europe,38332,0,82
2020-05-05,liechtenstein,Europe,38332,0,82
2020-05-06,liechtenstein,Europe,38332,0,82
2020-05-07,liechtenstein,Europe,38332,0,82
2020-05-08,liechtenstein,Europe,38332,0,82
2020-05-09,liechtenstein,Europe,38332,0,82
2020-05-10,liechtenstein,Europe,38332,0,82
2020-05-11,liechtenstein,Europe,38332,0,82
2020-05-12,liechtenstein,Europe,38332,0,82
2020-05-13,liechtenstein,Europe,38332,0,82
2020-05-14,liechtenstein,Europe,38332,0,82
2020-05-15,liechtenstein,Europe,38332,0,82
2020-05-16,liechtenstein,Europe,38332,0,82
2020-05-17,liechtenstein,Europe,38332,0,82
2020-05-18,liechtenstein,Europe,38332,0,82
2020-05-19,liechtenstein,Europe,38332,0,82
2020-05-20,liechtenstein,Europe,38332,0,82
2020-05-21,liechtenstein,Europe,38332,0,82
2020-05-22,liechtenstein,Europe,38332,0,82
2020-05-23,liechtenstein,Europe,38332,0,82
2020-05-24,liechtenstein,Europe,38332,0,82
2020-05-25,liechtenstein,Europe,38332,0,82
2020-05-26,liechtenstein,Europe,38332,0,82
2020-05-27,liechtenstein,Europe,38332,0,82
2020-05-28,liechtenstein,Europe,38332,0,82
2020-05-29,liechtenstein,Europe,38332,0,82
2020-05-30,liechtenstein,Europe,38332,0,82
2020-05-31,liechtenstein,Europe,38332,0,82
2020-06-01,liechtenstein,Europe,38332,0,82
2020-06-02,liechtenstein,Europe,38332,0,82
2020-06-03,liechtenstein,Europe,38332,0,82
2020-06-04,liechtenstein,Europe,38332,0,82
2020-06-05,liechtenstein,Europe,38332,0,82
2020-06-06,liechtenstein,Europe,38332,0,82
2020-06-07,liechtenstein,Europe,38332,0,82
2020-06-08,liechtenstein,Europe,38332,0,82
2020-06-09,liechtenstein,Europe,38332,0,82
2020-06-10,liechtenstein,Europe,38332,0,82
2020-06-11,liechtenstein,Europe,38332,0,82
2020-06-12,liechtenstein,Europe,38332,0,82
2020-06-13,liechtenstein,Europe,38332,0,82
2020-06-14,liechtenstein,Europe,38332,0,82
2020-06-15,liechtenstein,Europe,38332,0,82
2020-06-16,liechtenstein,Europe,38332,0,82
2020-06-17,liechtenstein,Europe,38332,0,82
2020-06-18,liechtenstein,Europe,38332,0,82
2020-06-19,liechtenstein,Europe,38332,0,82
2020-06-20,liechtenstein,Europe,38332,0,82
2020-06-21,liechtenstein,Europe,38332,0,82
2020-06-22,liechtenstein,Europe,38332,0,82
2020-06-23,liechtenstein,Europe,38332,0,82
2020-06-24,liechtenstein,Europe,38332,0,82
2020-06-25,liechtenstein,Europe,38332,0,82
2020-06-26,liechtenstein,Europe,38332,0,82
2020-06-27,liechtenstein,Europe,38332,0,82
2020-06-28,liechtenstein,Europe,38332,0,82
2020-06-29,liechtenstein,Europe,38332,0,82
2020-06-30,liechtenstein,Europe,38332,0,82
2020-07-01,liechtenstein,Europe,38332,0,82
2020-07-02,liechtenstein,Europe,38332,1,83
2020-07-03,liechtenstein,Europe,38332,0,83
2020-07-04,liechtenstein,Europe,38332,0,83
2020-07-05,liechtenstein,Europe,38332,0,83
2020-07-06,liechtenstein,Europe,38332,1,84
2020-07-07,liechtenstein,Europe,38332,0,84
2020-07-08,liechtenstein,Europe,38332,0,84
2020-07-09,liechtenstein,Europe,38332,0,84
2020-07-10,liechtenstein,Europe,38332,0,84
2020-07-11,liechtenstein,Europe,38332,0,84
2020-07-12,liechtenstein,Europe,38332,0,84
2020-07-13,liechtenstein,Europe,38332,0,84
2020-07-14,liechtenstein,Europe,38332,0,84
2020-07-15,liechtenstein,Europe,38332,0,84
2020-07-16,liechtenstein,Europe,38332,0,84
2020-07-17,liechtenstein,Europe,38332,1,85
2020-07-18,liechtenstein,Europe,38332,1,86
2020-07-19,liechtenstein,Europe,38332,0,86
2020-07-20,liechtenstein,Europe,38332,0,86
2020-07-21,liechtenstein,Europe,38332,0,86
2020-07-22,liechtenstein,Europe,38332,0,86
2020-07-23,liechtenstein,Europe,38332,0,86
2020-07-24,liechtenstein,Europe,38332,0,86
2020-07-25,liechtenstein,Europe,38332,0,86
2020-07-26,liechtenstein,Europe,38332,0,86
2020-07-27,liechtenstein,Europe,38332,0,86
2020-07-28,liechtenstein,Europe,38332,1,87
2020-07-29,liechtenstein,Europe,38332,1,88
2020-07-30,liechtenstein,Europe,38332,0,88
2020-07-31,liechtenstein,Europe,38332,0,88
2020-08-01,liechtenstein,Europe,38332,0,88
2020-08-02,liechtenstein,Europe,38332,1,89
2020-08-03,liechtenstein,Europe,38332,0,89
2020-08-04,liechtenstein,Europe,38332,0,89
2020-08-05,liechtenstein,Europe,38332,0,89
2020-08-06,liechtenstein,Europe,38332,0,89
2020-08-07,liechtenstein,Europe,38332,0,89
2020-08-08,liechtenstein,Europe,38332,0,89
2020-08-09,liechtenstein,Europe,38332,0,89
2020-08-10,liechtenstein,Europe,38332,0,89
2020-08-11,liechtenstein,Europe,38332,0,89
2020-08-12,liechtenstein,Europe,38332,1,90
2020-08-13,liechtenstein,Europe,38332,0,90
2020-08-14,liechtenstein,Europe,38332,1,91
2020-08-15,liechtenstein,Europe,38332,0,91
2020-08-16,liechtenstein,Europe,38332,0,91
2020-08-17,liechtenstein,Europe,38332,3,94
2020-08-18,liechtenstein,Europe,38332,3,97
2020-08-19,liechtenstein,Europe,38332,1,98
2020-08-20,liechtenstein,Europe,38332,1,99
2020-08-21,liechtenstein,Europe,38332,0,99
2020-08-22,liechtenstein,Europe,38332,0,99
2020-08-23,liechtenstein,Europe,38332,0,99
2020-08-24,liechtenstein,Europe,38332,1,100
2020-08-25,liechtenstein,Europe,38332,2,102
2020-08-26,liechtenstein,Europe,38332,0,102
2020-08-27,liechtenstein,Europe,38332,3,105
2020-08-28,liechtenstein,Europe,38332,1,106
2020-08-29,liechtenstein,Europe,38332,1,107
2020-08-30,liechtenstein,Europe,38332,0,107
2020-08-31,liechtenstein,Europe,38332,0,107
2020-09-01,liechtenstein,Europe,38332,0,107
2020-09-02,liechtenstein,Europe,38332,0,107
2020-09-03,liechtenstein,Europe,38332,0,107
2020-09-04,liechtenstein,Europe,38332,0,107
2020-09-05,liechtenstein,Europe,38332,0,107
2020-09-06,liechtenstein,Europe,38332,0,107
2020-09-07,liechtenstein,Europe,38332,0,107
2020-09-08,liechtenstein,Europe,38332,0,107
2020-09-09,liechtenstein,Europe,38332,1,108
2020-09-10,liechtenstein,Europe,38332,1,109
2020-09-11,liechtenstein,Europe,38332,0,109
2020-09-12,liechtenstein,Europe,38332,2,111
2020-09-13,liechtenstein,Europe,38332,0,111
2020-09-14,liechtenstein,Europe,38332,0,111
2020-09-15,liechtenstein,Europe,38332,0,111
2020-09-16,liechtenstein,Europe,38332,0,111
2020-09-17,liechtenstein,Europe,38332,1,112
2020-09-18,liechtenstein,Europe,38332,0,112
2020-09-19,liechtenstein,Europe,38332,1,113
2020-09-20,liechtenstein,Europe,38332,0,113
2020-09-21,liechtenstein,Europe,38332,1,114
2020-09-22,liechtenstein,Europe,38332,1,115
2020-09-23,liechtenstein,Europe,38332,1,116
2020-09-24,liechtenstein,Europe,38332,0,116
2020-09-25,liechtenstein,Europe,38332,1,117
2020-09-26,liechtenstein,Europe,38332,0,117
2020-09-27,liechtenstein,Europe,38332,0,117
2020-09-28,liechtenstein,Europe,38332,0,117
2020-09-29,liechtenstein,Europe,38332,1,118
2020-09-30,liechtenstein,Europe,38332,0,118
2020-10-01,liechtenstein,Europe,38332,1,119
2020-10-02,liechtenstein,Europe,38332,1,120
2020-10-03,liechtenstein,Europe,38332,3,123
2020-10-04,liechtenstein,Europe,38332,3,126
2020-10-05,liechtenstein,Europe,38332,1,127
2020-10-06,liechtenstein,Europe,38332,3,130
2020-10-07,liechtenstein,Europe,38332,1,131
2020-10-08,liechtenstein,Europe,38332,4,135
2020-10-09,liechtenstein,Europe,38332,4,139
2020-10-10,liechtenstein,Europe,38332,5,144
2020-10-11,liechtenstein,Europe,38332,4,148
2020-10-12,liechtenstein,Europe,38332,0,148
2020-10-13,liechtenstein,Europe,38332,15,163
2020-10-14,liechtenstein,Europe,38332,11,174
2020-10-15,liechtenstein,Europe,38332,9,183
2020-10-16,liechtenstein,Europe,38332,9,192
2020-10-17,liechtenstein,Europe,38332,25,217
2020-10-18,liechtenstein,Europe,38332,7,224
2020-10-19,liechtenstein,Europe,38332,0,224
2020-10-20,liechtenstein,Europe,38332,11,235
2020-10-21,liechtenstein,Europe,38332,17,252
2020-10-22,liechtenstein,Europe,38332,30,282
2020-10-23,liechtenstein,Europe,38332,42,324
2020-10-24,liechtenstein,Europe,38332,16,340
2020-10-25,liechtenstein,Europe,38332,25,365
2020-10-26,liechtenstein,Europe,38332,37,402
2020-10-27,liechtenstein,Europe,38332,26,428
2020-10-28,liechtenstein,Europe,38332,22,450
2020-10-29,liechtenstein,Europe,38332,26,476
2020-10-30,liechtenstein,Europe,38332,37,513
2020-10-31,liechtenstein,Europe,38332,20,533
2020-11-01,liechtenstein,Europe,38332,18,551
2020-11-02,liechtenstein,Europe,38332,47,598
2020-11-03,liechtenstein,Europe,38332,33,631
2020-11-04,liechtenstein,Europe,38332,28,659
2020-11-05,liechtenstein,Europe,38332,33,692
2020-11-06,liechtenstein,Europe,38332,49,741
2020-11-07,liechtenstein,Europe,38332,24,765
2020-11-08,liechtenstein,Europe,38332,23,788
2020-11-09,liechtenstein,Europe,38332,13,801
2020-11-10,liechtenstein,Europe,38332,45,846
2020-11-11,liechtenstein,Europe,38332,31,877
2020-11-12,liechtenstein,Europe,38332,28,905
2020-11-13,liechtenstein,Europe,38332,23,928
2020-11-14,liechtenstein,Europe,38332,42,970
2020-11-15,liechtenstein,Europe,38332,15,985
2020-11-16,liechtenstein,Europe,38332,4,989
2020-11-17,liechtenstein,Europe,38332,13,1002
2020-11-18,liechtenstein,Europe,38332,49,1051
2020-11-19,liechtenstein,Europe,38332,21,1072
2020-11-20,liechtenstein,Europe,38332,22,1094
2020-11-21,liechtenstein,Europe,38332,15,1109
2020-11-22,liechtenstein,Europe,38332,3,1112
2020-11-23,liechtenstein,Europe,38332,44,1156
2020-11-24,liechtenstein,Europe,38332,2,1158
2020-11-25,liechtenstein,Europe,38332,25,1183
2020-11-26,liechtenstein,Europe,38332,25,1208
2020-11-27,liechtenstein,Europe,38332,23,1231
2020-11-28,liechtenstein,Europe,38332,22,1253
2020-11-29,liechtenstein,Europe,38332,0,1253
2020-11-30,liechtenstein,Europe,38332,17,1270
2020-12-01,liechtenstein,Europe,38332,16,1286
2020-12-02,liechtenstein,Europe,38332,32,1318
2020-12-03,liechtenstein,Europe,38332,21,1339
2020-12-04,liechtenstein,Europe,38332,12,1351
2020-12-05,liechtenstein,Europe,38332,27,1378
2020-12-06,liechtenstein,Europe,38332,18,1396
2020-12-07,liechtenstein,Europe,38332,1,1397
2020-12-08,liechtenstein,Europe,38332,7,1404
2020-12-09,liechtenstein,Europe,38332,28,1432
2020-12-10,liechtenstein,Europe,38332,9,1441
2020-12-11,liechtenstein,Europe,38332,25,1466
2020-12-12,liechtenstein,Europe,38332,16,1482
2020-12-13,liechtenstein,Europe,38332,32,1514
2020-12-14,liechtenstein,Europe,38332,52,1566
2020-12-15,liechtenstein,Europe,38332,13,1579
2020-12-16,liechtenstein,Europe,38332,21,1600
2020-12-17,liechtenstein,Europe,38332,35,1635
2020-12-18,liechtenstein,Europe,38332,41,1676
2020-12-19,liechtenstein,Europe,38332,35,1711
2020-12-20,liechtenstein,Europe,38332,47,1758
2020-12-21,liechtenstein,Europe,38332,26,1784
2020-12-22,liechtenstein,Europe,38332,41,1825
2020-12-23,liechtenstein,Europe,38332,32,1857
2020-12-24,liechtenstein,Europe,38332,63,1920
2020-12-25,liechtenstein,Europe,38332,60,1980
2020-12-26,liechtenstein,Europe,38332,20,2000
2020-12-27,liechtenstein,Europe,38332,18,2018
2020-12-28,liechtenstein,Europe,38332,20,2038
2020-12-29,liechtenstein,Europe,38332,31,2069
2020-12-30,liechtenstein,Europe,38332,35,2104
2020-12-31,liechtenstein,Europe,38332,32,2136
2021-01-01,liechtenstein,Europe,38332,39,2175
2021-01-02,liechtenstein,Europe,38332,27,2202
2021-01-03,liechtenstein,Europe,38332,20,2222
2021-01-04,liechtenstein,Europe,38332,2,2224
2021-01-05,liechtenstein,Europe,38332,22,2246
2021-01-06,liechtenstein,Europe,38332,49,2295
2021-01-07,liechtenstein,Europe,38332,14,2309
2021-01-08,liechtenstein,Europe,38332,2,2311
2021-01-09,liechtenstein,Europe,38332,18,2329
2021-01-10,liechtenstein,Europe,38332,11,2340
2021-01-11,liechtenstein,Europe,38332,6,2346
2021-01-12,liechtenstein,Europe,38332,9,2355
2021-01-13,liechtenstein,Europe,38332,15,2370
2021-01-14,liechtenstein,Europe,38332,5,2375
2021-01-15,liechtenstein,Europe,38332,3,2378
2021-01-16,liechtenstein,Europe,38332,5,2383
2021-01-17,liechtenstein,Europe,38332,6,2389
2021-01-18,liechtenstein,Europe,38332,6,2395
2021-01-19,liechtenstein,Europe,38332,3,2398
2021-01-20,liechtenstein,Europe,38332,7,2405
2021-01-21,liechtenstein,Europe,38332,10,2415
2021-01-22,liechtenstein,Europe,38332,17,2432
2021-01-23,liechtenstein,Europe,38332,5,2437
2021-01-24,liechtenstein,Europe,38332,4,2441
2021-01-25,liechtenstein,Europe,38332,13,2454
2021-01-26,liechtenstein,Europe,38332,1,2455
2021-01-27,liechtenstein,Europe,38332,4,2459
2021-01-28,liechtenstein,Europe,38332,16,2475
2021-01-29,liechtenstein,Europe,38332,9,2484
2021-01-30,liechtenstein,Europe,38332,9,2493
2021-01-31,liechtenstein,Europe,38332,0,2493
2021-02-01,liechtenstein,Europe,38332,4,2497
2021-02-02,liechtenstein,Europe,38332,0,2497
2021-02-03,liechtenstein,Europe,38332,12,2509
2021-02-04,liechtenstein,Europe,38332,4,2513
2021-02-05,liechtenstein,Europe,38332,5,2518
2021-02-06,liechtenstein,Europe,38332,0,2518
2021-02-07,liechtenstein,Europe,38332,5,2523
2021-02-08,liechtenstein,Europe,38332,3,2526
2021-02-09,liechtenstein,Europe,38332,1,2527
2021-02-10,liechtenstein,Europe,38332,5,2532
2021-02-11,liechtenstein,Europe,38332,2,2534
2021-02-12,liechtenstein,Europe,38332,3,2537
2021-02-13,liechtenstein,Europe,38332,1,2538
2021-02-14,liechtenstein,Europe,38332,1,2539
2021-02-15,liechtenstein,Europe,38332,1,2540
2021-02-16,liechtenstein,Europe,38332,0,2540
2021-02-17,liechtenstein,Europe,38332,0,2540
2021-02-18,liechtenstein,Europe,38332,2,2542
2021-02-19,liechtenstein,Europe,38332,1,2543
2021-02-20,liechtenstein,Europe,38332,2,2545
2021-02-21,liechtenstein,Europe,38332,1,2546
2021-02-22,liechtenstein,Europe,38332,4,2550
2021-02-23,liechtenstein,Europe,38332,3,2553
2021-02-24,liechtenstein,Europe,38332,0,2553
2021-02-25,liechtenstein,Europe,38332,5,2558
2021-02-26,liechtenstein,Europe,38332,6,2564
2021-02-27,liechtenstein,Europe,38332,2,2566
2021-02-28,liechtenstein,Europe,38332,1,2567
2021-03-01,liechtenstein,Europe,38332,8,2575
2021-03-02,liechtenstein,Europe,38332,1,2576
2021-03-03,liechtenstein,Europe,38332,1,2577
2021-03-04,liechtenstein,Europe,38332,5,2582
2021-03-05,liechtenstein,Europe,38332,6,2588
2021-03-06,liechtenstein,Europe,38332,1,2589
2021-03-07,liechtenstein,Europe,38332,1,2590
2021-03-08,liechtenstein,Europe,38332,2,2592
2021-03-09,liechtenstein,Europe,38332,2,2594
2021-03-10,liechtenstein,Europe,38332,0,2594
2021-03-11,liechtenstein,Europe,38332,2,2596
2021-03-12,liechtenstein,Europe,38332,5,2601
2021-03-13,liechtenstein,Europe,38332,1,2602
2021-03-14,liechtenstein,Europe,38332,10,2612
2021-03-15,liechtenstein,Europe,38332,0,2612
2021-03-16,liechtenstein,Europe,38332,3,2615
2021-03-17,liechtenstein,Europe,38332,1,2616
2021-03-18,liechtenstein,Europe,38332,4,2620
2021-03-19,liechtenstein,Europe,38332,2,2622
2021-03-20,liechtenstein,Europe,38332,5,2627
2021-03-21,liechtenstein,Europe,38332,1,2628
2021-03-22,liechtenstein,Europe,38332,4,2632
2021-03-23,liechtenstein,Europe,38332,2,2634
2021-03-24,liechtenstein,Europe,38332,2,2636
2021-03-25,liechtenstein,Europe,38332,6,2642
2021-03-26,liechtenstein,Europe,38332,3,2645
2021-03-27,liechtenstein,Europe,38332,4,2649
2021-03-28,liechtenstein,Europe,38332,9,2658
2021-03-29,liechtenstein,Europe,38332,6,2664
2021-03-30,liechtenstein,Europe,38332,0,2664
2021-03-31,liechtenstein,Europe,38332,6,2670
2021-04-01,liechtenstein,Europe,38332,5,2675
2021-04-02,liechtenstein,Europe,38332,3,2678
2021-04-03,liechtenstein,Europe,38332,1,2679
2021-04-04,liechtenstein,Europe,38332,6,2685
2021-04-05,liechtenstein,Europe,38332,12,2697
2021-04-06,liechtenstein,Europe,38332,0,2697
2021-04-07,liechtenstein,Europe,38332,5,2702
2021-04-08,liechtenstein,Europe,38332,12,2714
2021-04-09,liechtenstein,Europe,38332,8,2722
2021-04-10,liechtenstein,Europe,38332,16,2738
2021-04-11,liechtenstein,Europe,38332,15,2753
2021-04-12,liechtenstein,Europe,38332,1,2754
2021-04-13,liechtenstein,Europe,38332,14,2768
2021-04-14,liechtenstein,Europe,38332,2,2770
2021-04-15,liechtenstein,Europe,38332,10,2780
2021-04-16,liechtenstein,Europe,38332,10,2790
2021-04-17,liechtenstein,Europe,38332,14,2804
2021-04-18,liechtenstein,Europe,38332,9,2813
2021-04-19,liechtenstein,Europe,38332,10,2823
2021-04-20,liechtenstein,Europe,38332,13,2836
2021-04-21,liechtenstein,Europe,38332,13,2849
2021-04-22,liechtenstein,Europe,38332,2,2851
2021-04-23,liechtenstein,Europe,38332,4,2855
2021-04-24,liechtenstein,Europe,38332,11,2866
2021-04-25,liechtenstein,Europe,38332,18,2884
2021-04-26,liechtenstein,Europe,38332,1,2885
2021-04-27,liechtenstein,Europe,38332,18,2903
2021-04-28,liechtenstein,Europe,38332,5,2908
2021-04-29,liechtenstein,Europe,38332,13,2921
2021-04-30,liechtenstein,Europe,38332,5,2926
2021-05-01,liechtenstein,Europe,38332,10,2936
2021-05-02,liechtenstein,Europe,38332,4,2940
2021-05-03,liechtenstein,Europe,38332,6,2946
2021-05-04,liechtenstein,Europe,38332,2,2948
2021-05-05,liechtenstein,Europe,38332,8,2956
2021-05-06,liechtenstein,Europe,38332,5,2961
2021-05-07,liechtenstein,Europe,38332,2,2963
2021-05-08,liechtenstein,Europe,38332,4,2967
2021-05-09,liechtenstein,Europe,38332,3,2970
2021-05-10,liechtenstein,Europe,38332,4,2974
2021-05-11,liechtenstein,Europe,38332,1,2975
2021-05-12,liechtenstein,Europe,38332,3,2978
2021-05-13,liechtenstein,Europe,38332,2,2980
2021-05-14,liechtenstein,Europe,38332,1,2981
2021-05-15,liechtenstein,Europe,38332,3,2984
2021-05-16,liechtenstein,Europe,38332,1,2985
2021-05-17,liechtenstein,Europe,38332,5,2990
2021-05-18,liechtenstein,Europe,38332,2,2992
2021-05-19,liechtenstein,Europe,38332,1,2993
2021-05-20,liechtenstein,Europe,38332,1,2994
2021-05-21,liechtenstein,Europe,38332,3,2997
2021-05-22,liechtenstein,Europe,38332,1,2998
2021-05-23,liechtenstein,Europe,38332,2,3000
2021-05-24,liechtenstein,Europe,38332,0,3000
2021-05-25,liechtenstein,Europe,38332,2,3002
2021-05-26,liechtenstein,Europe,38332,0,3002
2021-05-27,liechtenstein,Europe,38332,4,3006
2021-05-28,liechtenstein,Europe,38332,0,3006
2021-05-29,liechtenstein,Europe,38332,2,3008
2021-05-30,liechtenstein,Europe,38332,0,3008
2021-05-31,liechtenstein,Europe,38332,4,3012
2021-06-01,liechtenstein,Europe,38332,0,3012
2021-06-02,liechtenstein,Europe,38332,4,3016
2021-06-03,liechtenstein,Europe,38332,1,3017
2021-06-04,liechtenstein,Europe,38332,2,3019
2021-06-05,liechtenstein,Europe,38332,1,3020
2021-06-06,liechtenstein,Europe,38332,2,3022
2021-06-07,liechtenstein,Europe,38332,0,3022
2021-06-08,liechtenstein,Europe,38332,0,3022
2021-06-09,liechtenstein,Europe,38332,0,3022
2021-06-10,liechtenstein,Europe,38332,1,3023
2021-06-11,liechtenstein,Europe,38332,1,3024
2021-06-12,liechtenstein,Europe,38332,2,3026
2021-06-13,liechtenstein,Europe,38332,0,3026
2021-06-14,liechtenstein,Europe,38332,0,3026
2021-06-15,liechtenstein,Europe,38332,0,3026
2021-06-16,liechtenstein,Europe,38332,0,3026
2021-06-17,liechtenstein,Europe,38332,0,3026
2021-06-18,liechtenstein,Europe,38332,0,3026
2021-06-19,liechtenstein,Europe,38332,0,3026
2021-06-20,liechtenstein,Europe,38332,0,3026
2021-06-21,liechtenstein,Europe,38332,2,3028
2021-06-22,liechtenstein,Europe,38332,0,3028
2021-06-23,liechtenstein,Europe,38332,2,3030
2021-06-24,liechtenstein,Europe,38332,1,3031
2021-06-25,liechtenstein,Europe,38332,1,3032
2021-06-26,liechtenstein,Europe,38332,0,3032
2021-06-27,liechtenstein,Europe,38332,0,3032
2021-06-28,liechtenstein,Europe,38332,2,3034
2021-06-29,liechtenstein,Europe,38332,0,3034
2021-06-30,liechtenstein,Europe,38332,2,3036
2021-07-01,liechtenstein,Europe,38332,3,3039
2021-07-02,liechtenstein,Europe,38332,1,3040
2021-07-03,liechtenstein,Europe,38332,2,3042
2021-07-04,liechtenstein,Europe,38332,0,3042
2021-07-05,liechtenstein,Europe,38332,3,3045
2021-07-06,liechtenstein,Europe,38332,2,3047
2021-07-07,liechtenstein,Europe,38332,2,3049
2021-07-08,liechtenstein,Europe,38332,3,3052
2021-07-09,liechtenstein,Europe,38332,2,3054
2021-07-10,liechtenstein,Europe,38332,2,3056
2021-07-11,liechtenstein,Europe,38332,1,3057
2021-07-12,liechtenstein,Europe,38332,1,3058
2021-07-13,liechtenstein,Europe,38332,0,3058
2021-07-14,liechtenstein,Europe,38332,2,3060
2021-07-15,liechtenstein,Europe,38332,1,3061
2021-07-16,liechtenstein,Europe,38332,0,3061
2021-07-17,liechtenstein,Europe,38332,0,3061
2021-07-18,liechtenstein,Europe,38332,0,3061
2021-07-19,liechtenstein,Europe,38332,8,3069
2021-07-20,liechtenstein,Europe,38332,0,3069
2021-07-21,liechtenstein,Europe,38332,1,3070
2021-07-22,liechtenstein,Europe,38332,3,3073
2021-07-23,liechtenstein,Europe,38332,0,3073
2021-07-24,liechtenstein,Europe,38332,2,3075
2021-07-25,liechtenstein,Europe,38332,0,3075
2021-07-26,liechtenstein,Europe,38332,1,3076
2021-07-27,liechtenstein,Europe,38332,4,3080
2021-07-28,liechtenstein,Europe,38332,3,3083
2021-07-29,liechtenstein,Europe,38332,2,3085
2021-07-30,liechtenstein,Europe,38332,0,3085
2021-07-31,liechtenstein,Europe,38332,0,3085
2021-08-01,liechtenstein,Europe,38332,0,3085
2021-08-02,liechtenstein,Europe,38332,2,3087
2021-08-03,liechtenstein,Europe,38332,2,3089
2021-08-04,liechtenstein,Europe,38332,2,3091
2021-08-05,liechtenstein,Europe,38332,1,3092
2021-08-06,liechtenstein,Europe,38332,2,3094
2021-08-07,liechtenstein,Europe,38332,5,3099
2021-08-08,liechtenstein,Europe,38332,2,3101
2021-08-09,liechtenstein,Europe,38332,1,3102
2021-08-10,liechtenstein,Europe,38332,5,3107
2021-08-11,liechtenstein,Europe,38332,12,3119
2021-08-12,liechtenstein,Europe,38332,8,3127
2021-08-13,liechtenstein,Europe,38332,13,3140
2021-08-14,liechtenstein,Europe,38332,6,3146
2021-08-15,liechtenstein,Europe,38332,9,3155
2021-08-16,liechtenstein,Europe,38332,6,3161
2021-08-17,liechtenstein,Europe,38332,14,3175
2021-08-18,liechtenstein,Europe,38332,10,3185
2021-08-19,liechtenstein,Europe,38332,13,3198
2021-08-20,liechtenstein,Europe,38332,11,3209
2021-08-21,liechtenstein,Europe,38332,10,3219
2021-08-22,liechtenstein,Europe,38332,4,3223
2021-08-23,liechtenstein,Europe,38332,5,3228
2021-08-24,liechtenstein,Europe,38332,5,3233
2021-08-25,liechtenstein,Europe,38332,14,3247
2021-08-26,liechtenstein,Europe,38332,3,3250
2021-08-27,liechtenstein,Europe,38332,7,3257
2021-08-28,liechtenstein,Europe,38332,2,3259
2021-08-29,liechtenstein,Europe,38332,4,3263
2021-08-30,liechtenstein,Europe,38332,3,3266
2021-08-31,liechtenstein,Europe,38332,7,3273
2021-09-01,liechtenstein,Europe,38332,5,3278
2021-09-02,liechtenstein,Europe,38332,11,3289
2021-09-03,liechtenstein,Europe,38332,12,3301
2021-09-04,liechtenstein,Europe,38332,13,3314
2021-09-05,liechtenstein,Europe,38332,8,3322
2021-09-06,liechtenstein,Europe,38332,9,3331
2021-09-07,liechtenstein,Europe,38332,12,3343
2021-09-08,liechtenstein,Europe,38332,9,3352
2021-09-09,liechtenstein,Europe,38332,13,3365
2021-09-10,liechtenstein,Europe,38332,5,3370
2021-09-11,liechtenstein,Europe,38332,6,3376
2021-09-12,liechtenstein,Europe,38332,4,3380
2021-09-13,liechtenstein,Europe,38332,6,3386
2021-09-14,liechtenstein,Europe,38332,4,3390
2021-09-15,liechtenstein,Europe,38332,4,3394
2021-09-16,liechtenstein,Europe,38332,0,3394
2021-09-17,liechtenstein,Europe,38332,8,3402
2021-09-18,liechtenstein,Europe,38332,3,3405
2021-09-19,liechtenstein,Europe,38332,0,3405
2021-09-20,liechtenstein,Europe,38332,14,3419
2021-09-21,liechtenstein,Europe,38332,6,3425
2021-09-22,liechtenstein,Europe,38332,4,3429
2021-09-23,liechtenstein,Europe,38332,7,3436
2021-09-24,liechtenstein,Europe,38332,3,3439
2021-09-25,liechtenstein,Europe,38332,0,3439
2021-09-26,liechtenstein,Europe,38332,2,3441
2021-09-27,liechtenstein,Europe,38332,4,3445
2021-09-28,liechtenstein,Europe,38332,0,3445
2021-09-29,liechtenstein,Europe,38332,2,3447
2021-09-30,liechtenstein,Europe,38332,0,3447
2021-10-01,liechtenstein,Europe,38332,1,3448
2021-10-02,liechtenstein,Europe,38332,1,3449
2021-10-03,liechtenstein,Europe,38332,1,3450
2021-10-04,liechtenstein,Europe,38332,1,3451
2021-10-05,liechtenstein,Europe,38332,0,3451
2021-10-06,liechtenstein,Europe,38332,2,3453
2021-10-07,liechtenstein,Europe,38332,4,3457
2021-10-08,liechtenstein,Europe,38332,0,3457
2021-10-09,liechtenstein,Europe,38332,3,3460
2021-10-10,liechtenstein,Europe,38332,0,3460
2021-10-11,liechtenstein,Europe,38332,3,3463
2021-10-12,liechtenstein,Europe,38332,1,3464
2021-10-13,liechtenstein,Europe,38332,4,3468
2021-10-14,liechtenstein,Europe,38332,5,3473
2021-10-15,liechtenstein,Europe,38332,5,3478
2021-10-16,liechtenstein,Europe,38332,9,3487
2021-10-17,liechtenstein,Europe,38332,3,3490
2021-10-18,liechtenstein,Europe,38332,8,3498
2021-10-19,liechtenstein,Europe,38332,2,3500
2021-10-20,liechtenstein,Europe,38332,10,3510
2021-10-21,liechtenstein,Europe,38332,3,3513
2021-10-22,liechtenstein,Europe,38332,8,3521
2021-10-23,liechtenstein,Europe,38332,3,3524
2021-10-24,liechtenstein,Europe,38332,5,3529
2021-10-25,liechtenstein,Europe,38332,0,3529
2021-10-26,liechtenstein,Europe,38332,16,3545
2021-10-27,liechtenstein,Europe,38332,2,3547
2021-10-28,liechtenstein,Europe,38332,4,3551
2021-10-29,liechtenstein,Europe,38332,6,3557
2021-10-30,liechtenstein,Europe,38332,8,3565
2021-10-31,liechtenstein,Europe,38332,11,3576
2021-11-01,liechtenstein,Europe,38332,3,3579
2021-11-02,liechtenstein,Europe,38332,15,3594
2021-11-03,liechtenstein,Europe,38332,4,3598
2021-11-04,liechtenstein,Europe,38332,20,3618
2021-11-05,liechtenstein,Europe,38332,13,3631
2021-11-06,liechtenstein,Europe,38332,12,3643
2021-11-07,liechtenstein,Europe,38332,14,3657
2021-11-08,liechtenstein,Europe,38332,17,3674
2021-11-09,liechtenstein,Europe,38332,29,3703
2021-11-10,liechtenstein,Europe,38332,15,3718
2021-11-11,liechtenstein,Europe,38332,21,3739
2021-11-12,liechtenstein,Europe,38332,25,3764
2021-11-13,liechtenstein,Europe,38332,12,3776
2021-11-14,liechtenstein,Europe,38332,22,3798
2021-11-15,liechtenstein,Europe,38332,24,3822
2021-11-16,liechtenstein,Europe,38332,35,3857
2021-11-17,liechtenstein,Europe,38332,55,3912
2021-11-18,liechtenstein,Europe,38332,64,3976
2021-11-19,liechtenstein,Europe,38332,55,4031
2021-11-20,liechtenstein,Europe,38332,58,4089
2021-11-21,liechtenstein,Europe,38332,55,4144
2021-11-22,liechtenstein,Europe,38332,70,4214
2021-11-23,liechtenstein,Europe,38332,28,4242
2021-11-24,liechtenstein,Europe,38332,63,4305
2021-11-25,liechtenstein,Europe,38332,54,4359
2021-11-26,liechtenstein,Europe,38332,54,4413
2021-11-27,liechtenstein,Europe,38332,47,4460
2021-11-28,liechtenstein,Europe,38332,47,4507
2021-11-29,liechtenstein,Europe,38332,55,4562
2021-11-30,liechtenstein,Europe,38332,71,4633
2021-12-01,liechtenstein,Europe,38332,63,4696
2021-12-02,liechtenstein,Europe,38332,56,4752
2021-12-03,liechtenstein,Europe,38332,27,4779
2021-12-04,liechtenstein,Europe,38332,69,4848
2021-12-05,liechtenstein,Europe,38332,45,4893
2021-12-06,liechtenstein,Europe,38332,48,4941
2021-12-07,liechtenstein,Europe,38332,109,5050
2021-12-08,liechtenstein,Europe,38332,66,5116
2021-12-09,liechtenstein,Europe,38332,70,5186
2021-12-10,liechtenstein,Europe,38332,36,5222
2021-12-11,liechtenstein,Europe,38332,53,5275
2021-12-12,liechtenstein,Europe,38332,52,5327
2021-12-13,liechtenstein,Europe,38332,74,5401
2021-12-14,liechtenstein,Europe,38332,4,5405
2021-12-15,liechtenstein,Europe,38332,67,5472
2021-12-16,liechtenstein,Europe,38332,31,5503
2021-12-17,liechtenstein,Europe,38332,48,5551
2021-12-18,liechtenstein,Europe,38332,45,5596
2021-12-19,liechtenstein,Europe,38332,65,5661
2021-12-20,liechtenstein,Europe,38332,11,5672
2021-12-21,liechtenstein,Europe,38332,56,5728
2021-12-22,liechtenstein,Europe,38332,33,5761
2021-12-23,liechtenstein,Europe,38332,58,5819
2021-12-24,liechtenstein,Europe,38332,35,5854
2021-12-25,liechtenstein,Europe,38332,41,5895
2021-12-26,liechtenstein,Europe,38332,39,5934
2021-12-27,liechtenstein,Europe,38332,6,5940
2021-12-28,liechtenstein,Europe,38332,42,5982
2021-12-29,liechtenstein,Europe,38332,39,6021
2021-12-30,liechtenstein,Europe,38332,45,6066
2021-12-31,liechtenstein,Europe,38332,42,6108
2022-01-01,liechtenstein,Europe,38332,59,6167
2022-01-02,liechtenstein,Europe,38332,41,6208
2022-01-03,liechtenstein,Europe,38332,28,6236
2022-01-04,liechtenstein,Europe,38332,47,6283
2022-01-05,liechtenstein,Europe,38332,68,6351
2022-01-06,liechtenstein,Europe,38332,101,6452
2022-01-07,liechtenstein,Europe,38332,78,6530
2022-01-08,liechtenstein,Europe,38332,61,6591
2022-01-09,liechtenstein,Europe,38332,67,6658
2022-01-10,liechtenstein,Europe,38332,58,6716
2022-01-11,liechtenstein,Europe,38332,66,6782
2022-01-12,liechtenstein,Europe,38332,76,6858
2022-01-13,liechtenstein,Europe,38332,57,6915
2022-01-14,liechtenstein,Europe,38332,55,6970
2022-01-15,liechtenstein,Europe,38332,183,7153
2022-01-16,liechtenstein,Europe,38332,48,7201
2022-01-17,liechtenstein,Europe,38332,64,7265
2022-01-18,liechtenstein,Europe,38332,75,7340
2022-01-19,liechtenstein,Europe,38332,148,7488
2022-01-20,liechtenstein,Europe,38332,109,7597
2022-01-21,liechtenstein,Europe,38332,134,7731
2022-01-22,liechtenstein,Europe,38332,107,7838
2022-01-23,liechtenstein,Europe,38332,83,7921
2022-01-24,liechtenstein,Europe,38332,92,8013
2022-01-25,liechtenstein,Europe,38332,158,8171
2022-01-26,liechtenstein,Europe,38332,125,8296
2022-01-27,liechtenstein,Europe,38332,110,8406
2022-01-28,liechtenstein,Europe,38332,184,8590
2022-01-29,liechtenstein,Europe,38332,185,8775
2022-01-30,liechtenstein,Europe,38332,79,8854
2022-01-31,liechtenstein,Europe,38332,74,8928
2022-02-01,liechtenstein,Europe,38332,102,9030
2022-02-02,liechtenstein,Europe,38332,146,9176
2022-02-03,liechtenstein,Europe,38332,152,9328
2022-02-04,liechtenstein,Europe,38332,141,9469
2022-02-05,liechtenstein,Europe,38332,142,9611
2022-02-06,liechtenstein,Europe,38332,61,9672
2022-02-07,liechtenstein,Europe,38332,92,9764
2022-02-08,liechtenstein,Europe,38332,108,9872
2022-02-09,liechtenstein,Europe,38332,221,10093
2022-02-10,liechtenstein,Europe,38332,145,10238
2022-02-11,liechtenstein,Europe,38332,97,10335
2022-02-12,liechtenstein,Europe,38332,116,10451
2022-02-13,liechtenstein,Europe,38332,72,10523
2022-02-14,liechtenstein,Europe,38332,163,10686
2022-02-15,liechtenstein,Europe,38332,55,10741
2022-02-16,liechtenstein,Europe,38332,81,10822
2022-02-17,liechtenstein,Europe,38332,89,10911
2022-02-18,liechtenstein,Europe,38332,125,11036
2022-02-19,liechtenstein,Europe,38332,77,11113
2022-02-20,liechtenstein,Europe,38332,125,11238
2022-02-21,liechtenstein,Europe,38332,55,11293
2022-02-22,liechtenstein,Europe,38332,9,11302
2022-02-23,liechtenstein,Europe,38332,108,11410
2022-02-24,liechtenstein,Europe,38332,154,11564
2022-02-25,liechtenstein,Europe,38332,107,11671
2022-02-26,liechtenstein,Europe,38332,81,11752
2022-02-27,liechtenstein,Europe,38332,156,11908
2022-02-28,liechtenstein,Europe,38332,93,12001
2022-03-01,liechtenstein,Europe,38332,13,12014
2022-03-02,liechtenstein,Europe,38332,127,12141
2022-03-03,liechtenstein,Europe,38332,178,12319
2022-03-04,liechtenstein,Europe,38332,362,12681
2022-03-05,liechtenstein,Europe,38332,152,12833
2022-03-06,liechtenstein,Europe,38332,99,12932
2022-03-07,liechtenstein,Europe,38332,263,13195
2022-03-08,liechtenstein,Europe,38332,9,13204
2022-03-09,liechtenstein,Europe,38332,267,13471
2022-03-10,liechtenstein,Europe,38332,119,13590
2022-03-11,liechtenstein,Europe,38332,199,13789
2022-03-12,liechtenstein,Europe,38332,236,14025
2022-03-13,liechtenstein,Europe,38332,209,14234
2022-03-14,liechtenstein,Europe,38332,1,14235
2022-03-15,liechtenstein,Europe,38332,189,14424
2022-03-16,liechtenstein,Europe,38332,218,14642
2022-03-17,liechtenstein,Europe,38332,284,14926
2022-03-18,liechtenstein,Europe,38332,117,15043
2022-03-19,liechtenstein,Europe,38332,200,15243
2022-03-20,liechtenstein,Europe,38332,69,15312
2022-03-21,liechtenstein,Europe,38332,146,15458
2022-03-22,liechtenstein,Europe,38332,39,15497
2022-03-23,liechtenstein,Europe,38332,152,15649
2022-03-24,liechtenstein,Europe,38332,112,15761
2022-03-25,liechtenstein,Europe,38332,128,15889
2022-03-26,liechtenstein,Europe,38332,128,16017
2022-03-27,liechtenstein,Europe,38332,81,16098
2022-03-28,liechtenstein,Europe,38332,17,16115
2022-03-29,liechtenstein,Europe,38332,61,16176
2022-03-30,liechtenstein,Europe,38332,110,16286
2022-03-31,liechtenstein,Europe,38332,92,16378
2022-04-01,liechtenstein,Europe,38332,51,16429
2022-04-02,liechtenstein,Europe,38332,36,16465
2022-04-03,liechtenstein,Europe,38332,57,16522
2022-04-04,liechtenstein,Europe,38332,37,16559
2022-04-05,liechtenstein,Europe,38332,11,16570
2022-04-06,liechtenstein,Europe,38332,54,16624
2022-04-07,liechtenstein,Europe,38332,78,16702
2022-04-08,liechtenstein,Europe,38332,12,16714
2022-04-09,liechtenstein,Europe,38332,21,16735
2022-04-10,liechtenstein,Europe,38332,22,16757
2022-04-11,liechtenstein,Europe,38332,27,16784
2022-04-12,liechtenstein,Europe,38332,50,16834
2022-04-13,liechtenstein,Europe,38332,31,16865
2022-04-14,liechtenstein,Europe,38332,41,16906
2022-04-15,liechtenstein,Europe,38332,40,16946
2022-04-16,liechtenstein,Europe,38332,29,16975
2022-04-17,liechtenstein,Europe,38332,6,16981
2022-04-18,liechtenstein,Europe,38332,22,17003
2022-04-19,liechtenstein,Europe,38332,2,17005
2022-04-20,liechtenstein,Europe,38332,22,17027
2022-04-21,liechtenstein,Europe,38332,22,17049
2022-04-22,liechtenstein,Europe,38332,15,17064
2022-04-23,liechtenstein,Europe,38332,27,17091
2022-04-24,liechtenstein,Europe,38332,12,17103
2022-04-25,liechtenstein,Europe,38332,2,17105
2022-04-26,liechtenstein,Europe,38332,21,17126
2022-04-27,liechtenstein,Europe,38332,7,17133
2022-04-28,liechtenstein,Europe,38332,30,17163
2022-04-29,liechtenstein,Europe,38332,8,17171
2022-04-30,liechtenstein,Europe,38332,14,17185
2022-05-01,liechtenstein,Europe,38332,14,17199
2022-05-02,liechtenstein,Europe,38332,2,17201
2022-05-03,liechtenstein,Europe,38332,11,17212
2022-05-04,liechtenstein,Europe,38332,13,17225
2022-05-05,liechtenstein,Europe,38332,5,17230
2022-05-06,liechtenstein,Europe,38332,30,17260
2020-03-01,luxembourg,Europe,644943,0,1
2020-03-02,luxembourg,Europe,644943,0,1
2020-03-03,luxembourg,Europe,644943,0,1
2020-03-04,luxembourg,Europe,644943,0,1
2020-03-05,luxembourg,Europe,644943,1,2
2020-03-06,luxembourg,Europe,644943,1,3
2020-03-07,luxembourg,Europe,644943,1,4
2020-03-08,luxembourg,Europe,644943,1,5
2020-03-09,luxembourg,Europe,644943,0,5
2020-03-10,luxembourg,Europe,644943,2,7
2020-03-11,luxembourg,Europe,644943,0,7
2020-03-12,luxembourg,Europe,644943,16,23
2020-03-13,luxembourg,Europe,644943,10,33
2020-03-14,luxembourg,Europe,644943,11,44
2020-03-15,luxembourg,Europe,644943,21,65
2020-03-16,luxembourg,Europe,644943,3,68
2020-03-17,luxembourg,Europe,644943,48,116
2020-03-18,luxembourg,Europe,644943,52,168
2020-03-19,luxembourg,Europe,644943,108,276
2020-03-20,luxembourg,Europe,644943,122,398
2020-03-21,luxembourg,Europe,644943,152,550
2020-03-22,luxembourg,Europe,644943,105,655
2020-03-23,luxembourg,Europe,644943,63,718
2020-03-24,luxembourg,Europe,644943,183,901
2020-03-25,luxembourg,Europe,644943,191,1092
2020-03-26,luxembourg,Europe,644943,98,1190
2020-03-27,luxembourg,Europe,644943,124,1314
2020-03-28,luxembourg,Europe,644943,185,1499
2020-03-29,luxembourg,Europe,644943,97,1596
2020-03-30,luxembourg,Europe,644943,31,1627
2020-03-31,luxembourg,Europe,644943,155,1782
2020-04-01,luxembourg,Europe,644943,115,1897
2020-04-02,luxembourg,Europe,644943,137,2034
2020-04-03,luxembourg,Europe,644943,102,2136
2020-04-04,luxembourg,Europe,644943,96,2232
2020-04-05,luxembourg,Europe,644943,61,2293
2020-04-06,luxembourg,Europe,644943,32,2325
2020-04-07,luxembourg,Europe,644943,104,2429
2020-04-08,luxembourg,Europe,644943,52,2481
2020-04-09,luxembourg,Europe,644943,66,2547
2020-04-10,luxembourg,Europe,644943,88,2635
2020-04-11,luxembourg,Europe,644943,38,2673
2020-04-12,luxembourg,Europe,644943,9,2682
2020-04-13,luxembourg,Europe,644943,9,2691
2020-04-14,luxembourg,Europe,644943,12,2703
2020-04-15,luxembourg,Europe,644943,54,2757
2020-04-16,luxembourg,Europe,644943,58,2815
2020-04-17,luxembourg,Europe,644943,29,2844
2020-04-18,luxembourg,Europe,644943,47,2891
2020-04-19,luxembourg,Europe,644943,11,2902
2020-04-20,luxembourg,Europe,644943,7,2909
2020-04-21,luxembourg,Europe,644943,49,2958
2020-04-22,luxembourg,Europe,644943,29,2987
2020-04-23,luxembourg,Europe,644943,9,2996
2020-04-24,luxembourg,Europe,644943,25,3021
2020-04-25,luxembourg,Europe,644943,13,3034
2020-04-26,luxembourg,Europe,644943,10,3044
2020-04-27,luxembourg,Europe,644943,5,3049
2020-04-28,luxembourg,Europe,644943,10,3059
2020-04-29,luxembourg,Europe,644943,23,3082
2020-04-30,luxembourg,Europe,644943,12,3094
2020-05-01,luxembourg,Europe,644943,15,3109
2020-05-02,luxembourg,Europe,644943,8,3117
2020-05-03,luxembourg,Europe,644943,10,3127
2020-05-04,luxembourg,Europe,644943,3,3130
2020-05-05,luxembourg,Europe,644943,10,3140
2020-05-06,luxembourg,Europe,644943,9,3149
2020-05-07,luxembourg,Europe,644943,7,3156
2020-05-08,luxembourg,Europe,644943,10,3166
2020-05-09,luxembourg,Europe,644943,5,3171
2020-05-10,luxembourg,Europe,644943,7,3178
2020-05-11,luxembourg,Europe,644943,2,3180
2020-05-12,luxembourg,Europe,644943,5,3185
2020-05-13,luxembourg,Europe,644943,8,3193
2020-05-14,luxembourg,Europe,644943,9,3202
2020-05-15,luxembourg,Europe,644943,7,3209
2020-05-16,luxembourg,Europe,644943,6,3215
2020-05-17,luxembourg,Europe,644943,12,3227
2020-05-18,luxembourg,Europe,644943,2,3229
2020-05-19,luxembourg,Europe,644943,9,3238
2020-05-20,luxembourg,Europe,644943,11,3249
2020-05-21,luxembourg,Europe,644943,7,3256
2020-05-22,luxembourg,Europe,644943,1,3257
2020-05-23,luxembourg,Europe,644943,7,3264
2020-05-24,luxembourg,Europe,644943,2,3266
2020-05-25,luxembourg,Europe,644943,1,3267
2020-05-26,luxembourg,Europe,644943,2,3269
2020-05-27,luxembourg,Europe,644943,5,3274
2020-05-28,luxembourg,Europe,644943,6,3280
2020-05-29,luxembourg,Europe,644943,3,3283
2020-05-30,luxembourg,Europe,644943,3,3286
2020-05-31,luxembourg,Europe,644943,2,3288
2020-06-01,luxembourg,Europe,644943,1,3289
2020-06-02,luxembourg,Europe,644943,1,3290
2020-06-03,luxembourg,Europe,644943,3,3293
2020-06-04,luxembourg,Europe,644943,2,3295
2020-06-05,luxembourg,Europe,644943,4,3299
2020-06-06,luxembourg,Europe,644943,2,3301
2020-06-07,luxembourg,Europe,644943,3,3304
2020-06-08,luxembourg,Europe,644943,1,3305
2020-06-09,luxembourg,Europe,644943,5,3310
2020-06-10,luxembourg,Europe,644943,2,3312
2020-06-11,luxembourg,Europe,644943,2,3314
2020-06-12,luxembourg,Europe,644943,2,3316
2020-06-13,luxembourg,Europe,644943,7,3323
2020-06-14,luxembourg,Europe,644943,6,3329
2020-06-15,luxembourg,Europe,644943,2,3331
2020-06-16,luxembourg,Europe,644943,2,3333
2020-06-17,luxembourg,Europe,644943,8,3341
2020-06-18,luxembourg,Europe,644943,5,3346
2020-06-19,luxembourg,Europe,644943,7,3353
2020-06-20,luxembourg,Europe,644943,5,3358
2020-06-21,luxembourg,Europe,644943,12,3370
2020-06-22,luxembourg,Europe,644943,1,3371
2020-06-23,luxembourg,Europe,644943,10,3381
2020-06-24,luxembourg,Europe,644943,6,3387
2020-06-25,luxembourg,Europe,644943,9,3396
2020-06-26,luxembourg,Europe,644943,18,3414
2020-06-27,luxembourg,Europe,644943,36,3450
2020-06-28,luxembourg,Europe,644943,20,3470
2020-06-29,luxembourg,Europe,644943,11,3481
2020-06-30,luxembourg,Europe,644943,35,3516
2020-07-01,luxembourg,Europe,644943,38,3554
2020-07-02,luxembourg,Europe,644943,41,3595
2020-07-03,luxembourg,Europe,644943,43,3638
2020-07-04,luxembourg,Europe,644943,24,3662
2020-07-05,luxembourg,Europe,644943,38,3700
2020-07-06,luxembourg,Europe,644943,16,3716
2020-07-07,luxembourg,Europe,644943,50,3766
2020-07-08,luxembourg,Europe,644943,38,3804
2020-07-09,luxembourg,Europe,644943,56,3860
2020-07-10,luxembourg,Europe,644943,47,3907
2020-07-11,luxembourg,Europe,644943,53,3960
2020-07-12,luxembourg,Europe,644943,68,4028
2020-07-13,luxembourg,Europe,644943,25,4053
2020-07-14,luxembourg,Europe,644943,82,4135
2020-07-15,luxembourg,Europe,644943,54,4189
2020-07-16,luxembourg,Europe,644943,133,4322
2020-07-17,luxembourg,Europe,644943,101,4423
2020-07-18,luxembourg,Europe,644943,61,4484
2020-07-19,luxembourg,Europe,644943,100,4584
2020-07-20,luxembourg,Europe,644943,28,4612
2020-07-21,luxembourg,Europe,644943,70,4682
2020-07-22,luxembourg,Europe,644943,106,4788
2020-07-23,luxembourg,Europe,644943,80,4868
2020-07-24,luxembourg,Europe,644943,85,4953
2020-07-25,luxembourg,Europe,644943,95,5048
2020-07-26,luxembourg,Europe,644943,74,5122
2020-07-27,luxembourg,Europe,644943,295,5417
2020-07-28,luxembourg,Europe,644943,0,5417
2020-07-29,luxembourg,Europe,644943,0,5417
2020-07-30,luxembourg,Europe,644943,0,5417
2020-07-31,luxembourg,Europe,644943,68,5485
2020-08-01,luxembourg,Europe,644943,77,5562
2020-08-02,luxembourg,Europe,644943,48,5610
2020-08-03,luxembourg,Europe,644943,7,5617
2020-08-04,luxembourg,Europe,644943,49,5666
2020-08-05,luxembourg,Europe,644943,79,5745
2020-08-06,luxembourg,Europe,644943,54,5799
2020-08-07,luxembourg,Europe,644943,33,5832
2020-08-08,luxembourg,Europe,644943,46,5878
2020-08-09,luxembourg,Europe,644943,29,5907
2020-08-10,luxembourg,Europe,644943,7,5914
2020-08-11,luxembourg,Europe,644943,25,5939
2020-08-12,luxembourg,Europe,644943,40,5979
2020-08-13,luxembourg,Europe,644943,59,6038
2020-08-14,luxembourg,Europe,644943,33,6071
2020-08-15,luxembourg,Europe,644943,26,6097
2020-08-16,luxembourg,Europe,644943,11,6108
2020-08-17,luxembourg,Europe,644943,10,6118
2020-08-18,luxembourg,Europe,644943,23,6141
2020-08-19,luxembourg,Europe,644943,58,6199
2020-08-20,luxembourg,Europe,644943,53,6252
2020-08-21,luxembourg,Europe,644943,59,6311
2020-08-22,luxembourg,Europe,644943,50,6361
2020-08-23,luxembourg,Europe,644943,6,6367
2020-08-24,luxembourg,Europe,644943,16,6383
2020-08-25,luxembourg,Europe,644943,34,6417
2020-08-26,luxembourg,Europe,644943,75,6492
2020-08-27,luxembourg,Europe,644943,51,6543
2020-08-28,luxembourg,Europe,644943,37,6580
2020-08-29,luxembourg,Europe,644943,45,6625
2020-08-30,luxembourg,Europe,644943,48,6673
2020-08-31,luxembourg,Europe,644943,4,6677
2020-09-01,luxembourg,Europe,644943,25,6702
2020-02-27,macedonia,Europe,2083215,0,1
2020-02-28,macedonia,Europe,2083215,0,1
2020-02-29,macedonia,Europe,2083215,0,1
2020-03-01,macedonia,Europe,2083215,0,1
2020-03-02,macedonia,Europe,2083215,0,1
2020-03-03,macedonia,Europe,2083215,0,1
2020-03-04,macedonia,Europe,2083215,0,1
2020-03-05,macedonia,Europe,2083215,0,1
2020-03-06,macedonia,Europe,2083215,2,3
2020-03-07,macedonia,Europe,2083215,0,3
2020-03-08,macedonia,Europe,2083215,0,3
2020-03-09,macedonia,Europe,2083215,2,5
2020-03-10,macedonia,Europe,2083215,2,7
2020-03-11,macedonia,Europe,2083215,2,9
2020-03-12,macedonia,Europe,2083215,0,9
2020-03-13,macedonia,Europe,2083215,5,14
2020-03-14,macedonia,Europe,2083215,5,19
2020-03-15,macedonia,Europe,2083215,0,19
2020-03-16,macedonia,Europe,2083215,5,24
2020-03-17,macedonia,Europe,2083215,7,31
2020-03-18,macedonia,Europe,2083215,12,43
2020-03-19,macedonia,Europe,2083215,7,50
2020-03-20,macedonia,Europe,2083215,26,76
2020-03-21,macedonia,Europe,2083215,9,85
2020-03-22,macedonia,Europe,2083215,30,115
2020-03-23,macedonia,Europe,2083215,21,136
2020-03-24,macedonia,Europe,2083215,12,148
2020-03-25,macedonia,Europe,2083215,29,177
2020-03-26,macedonia,Europe,2083215,24,201
2020-03-27,macedonia,Europe,2083215,18,219
2020-03-28,macedonia,Europe,2083215,22,241
2020-03-29,macedonia,Europe,2083215,18,259
2020-03-30,macedonia,Europe,2083215,26,285
2020-03-31,macedonia,Europe,2083215,44,329
2020-04-01,macedonia,Europe,2083215,25,354
2020-04-02,macedonia,Europe,2083215,30,384
2020-04-03,macedonia,Europe,2083215,46,430
2020-04-04,macedonia,Europe,2083215,53,483
2020-04-05,macedonia,Europe,2083215,72,555
2020-04-06,macedonia,Europe,2083215,15,570
2020-04-07,macedonia,Europe,2083215,29,599
2020-04-08,macedonia,Europe,2083215,18,617
2020-04-09,macedonia,Europe,2083215,46,663
2020-04-10,macedonia,Europe,2083215,48,711
2020-04-11,macedonia,Europe,2083215,49,760
2020-04-12,macedonia,Europe,2083215,68,828
2020-04-13,macedonia,Europe,2083215,26,854
2020-04-14,macedonia,Europe,2083215,54,908
2020-04-15,macedonia,Europe,2083215,66,974
2020-04-16,macedonia,Europe,2083215,107,1081
2020-04-17,macedonia,Europe,2083215,36,1117
2020-04-18,macedonia,Europe,2083215,53,1170
2020-04-19,macedonia,Europe,2083215,37,1207
2020-04-20,macedonia,Europe,2083215,18,1225
2020-04-21,macedonia,Europe,2083215,6,1231
2020-04-22,macedonia,Europe,2083215,28,1259
2020-04-23,macedonia,Europe,2083215,41,1300
2020-04-24,macedonia,Europe,2083215,26,1326
2020-04-25,macedonia,Europe,2083215,41,1367
2020-04-26,macedonia,Europe,2083215,19,1386
2020-04-27,macedonia,Europe,2083215,13,1399
2020-04-28,macedonia,Europe,2083215,22,1421
2020-04-29,macedonia,Europe,2083215,21,1442
2020-04-30,macedonia,Europe,2083215,23,1465
2020-05-01,macedonia,Europe,2083215,29,1494
2020-05-02,macedonia,Europe,2083215,12,1506
2020-05-03,macedonia,Europe,2083215,5,1511
2020-05-04,macedonia,Europe,2083215,7,1518
2020-05-05,macedonia,Europe,2083215,8,1526
2020-05-06,macedonia,Europe,2083215,13,1539
2020-05-07,macedonia,Europe,2083215,33,1572
2020-05-08,macedonia,Europe,2083215,14,1586
2020-05-09,macedonia,Europe,2083215,36,1622
2020-05-10,macedonia,Europe,2083215,20,1642
2020-05-11,macedonia,Europe,2083215,22,1664
2020-05-12,macedonia,Europe,2083215,10,1674
2020-05-13,macedonia,Europe,2083215,20,1694
2020-05-14,macedonia,Europe,2083215,29,1723
2020-05-15,macedonia,Europe,2083215,17,1740
2020-05-16,macedonia,Europe,2083215,22,1762
2020-05-17,macedonia,Europe,2083215,30,1792
2020-05-18,macedonia,Europe,2083215,25,1817
2020-05-19,macedonia,Europe,2083215,22,1839
2020-05-20,macedonia,Europe,2083215,19,1858
2020-05-21,macedonia,Europe,2083215,40,1898
2020-05-22,macedonia,Europe,2083215,23,1921
2020-05-23,macedonia,Europe,2083215,20,1941
2020-05-24,macedonia,Europe,2083215,37,1978
2020-05-25,macedonia,Europe,2083215,21,1999
2020-05-26,macedonia,Europe,2083215,15,2014
2020-05-27,macedonia,Europe,2083215,25,2039
2020-05-28,macedonia,Europe,2083215,38,2077
2020-05-29,macedonia,Europe,2083215,52,2129
2020-05-30,macedonia,Europe,2083215,35,2164
2020-05-31,macedonia,Europe,2083215,62,2226
2020-06-01,macedonia,Europe,2083215,89,2315
2020-06-02,macedonia,Europe,2083215,76,2391
2020-06-03,macedonia,Europe,2083215,101,2492
2020-06-04,macedonia,Europe,2083215,119,2611
2020-06-05,macedonia,Europe,2083215,179,2790
2020-06-06,macedonia,Europe,2083215,125,2915
2020-06-07,macedonia,Europe,2083215,110,3025
2020-06-08,macedonia,Europe,2083215,127,3152
2020-06-09,macedonia,Europe,2083215,87,3239
2020-06-10,macedonia,Europe,2083215,125,3364
2020-06-11,macedonia,Europe,2083215,174,3538
2020-06-12,macedonia,Europe,2083215,163,3701
2020-06-13,macedonia,Europe,2083215,194,3895
2020-06-14,macedonia,Europe,2083215,162,4057
2020-06-15,macedonia,Europe,2083215,100,4157
2020-06-16,macedonia,Europe,2083215,142,4299
2020-06-17,macedonia,Europe,2083215,183,4482
2020-06-18,macedonia,Europe,2083215,182,4664
2020-06-19,macedonia,Europe,2083215,156,4820
2020-06-20,macedonia,Europe,2083215,185,5005
2020-06-21,macedonia,Europe,2083215,101,5106
2020-06-22,macedonia,Europe,2083215,90,5196
2020-06-23,macedonia,Europe,2083215,115,5311
2020-06-24,macedonia,Europe,2083215,134,5445
2020-06-25,macedonia,Europe,2083215,150,5595
2020-06-26,macedonia,Europe,2083215,163,5758
2020-06-27,macedonia,Europe,2083215,148,5906
2020-06-28,macedonia,Europe,2083215,174,6080
2020-06-29,macedonia,Europe,2083215,129,6209
2020-06-30,macedonia,Europe,2083215,125,6334
2020-07-01,macedonia,Europe,2083215,120,6454
2020-07-02,macedonia,Europe,2083215,171,6625
2020-07-03,macedonia,Europe,2083215,162,6787
2020-07-04,macedonia,Europe,2083215,145,6932
2020-07-05,macedonia,Europe,2083215,114,7046
2020-07-06,macedonia,Europe,2083215,78,7124
2020-07-07,macedonia,Europe,2083215,120,7244
2020-07-08,macedonia,Europe,2083215,162,7406
2020-07-09,macedonia,Europe,2083215,166,7572
2020-07-10,macedonia,Europe,2083215,205,7777
2020-07-11,macedonia,Europe,2083215,198,7975
2020-07-12,macedonia,Europe,2083215,136,8111
2020-07-13,macedonia,Europe,2083215,86,8197
2020-07-14,macedonia,Europe,2083215,135,8332
2020-07-15,macedonia,Europe,2083215,198,8530
2020-07-16,macedonia,Europe,2083215,93,8623
2020-07-17,macedonia,Europe,2083215,163,8786
2020-07-18,macedonia,Europe,2083215,240,9026
2020-07-19,macedonia,Europe,2083215,127,9153
2020-07-20,macedonia,Europe,2083215,96,9249
2020-07-21,macedonia,Europe,2083215,163,9412
2020-07-22,macedonia,Europe,2083215,135,9547
2020-07-23,macedonia,Europe,2083215,122,9669
2020-07-24,macedonia,Europe,2083215,128,9797
2020-07-25,macedonia,Europe,2083215,137,9934
2020-07-26,macedonia,Europe,2083215,152,10086
2020-07-27,macedonia,Europe,2083215,127,10213
2020-07-28,macedonia,Europe,2083215,102,10315
2020-07-29,macedonia,Europe,2083215,188,10503
2020-07-30,macedonia,Europe,2083215,114,10617
2020-07-31,macedonia,Europe,2083215,137,10754
2020-08-01,macedonia,Europe,2083215,137,10891
2020-08-02,macedonia,Europe,2083215,163,11054
2020-08-03,macedonia,Europe,2083215,74,11128
2020-08-04,macedonia,Europe,2083215,74,11202
2020-08-05,macedonia,Europe,2083215,87,11289
2020-08-06,macedonia,Europe,2083215,110,11399
2020-08-07,macedonia,Europe,2083215,155,11554
2020-08-08,macedonia,Europe,2083215,200,11754
2020-08-09,macedonia,Europe,2083215,85,11839
2020-08-10,macedonia,Europe,2083215,103,11942
2020-08-11,macedonia,Europe,2083215,141,12083
2020-08-12,macedonia,Europe,2083215,134,12217
2020-08-13,macedonia,Europe,2083215,140,12357
2020-08-14,macedonia,Europe,2083215,158,12515
2020-08-15,macedonia,Europe,2083215,138,12653
2020-08-16,macedonia,Europe,2083215,86,12739
2020-08-17,macedonia,Europe,2083215,101,12840
2020-08-18,macedonia,Europe,2083215,130,12970
2020-08-19,macedonia,Europe,2083215,106,13076
2020-08-20,macedonia,Europe,2083215,118,13194
2020-08-21,macedonia,Europe,2083215,114,13308
2020-08-22,macedonia,Europe,2083215,150,13458
2020-08-23,macedonia,Europe,2083215,137,13595
2020-08-24,macedonia,Europe,2083215,78,13673
2020-08-25,macedonia,Europe,2083215,126,13799
2020-08-26,macedonia,Europe,2083215,115,13914
2020-08-27,macedonia,Europe,2083215,90,14004
2020-08-28,macedonia,Europe,2083215,159,14163
2020-08-29,macedonia,Europe,2083215,130,14293
2020-08-30,macedonia,Europe,2083215,37,14330
2020-08-31,macedonia,Europe,2083215,11,14341
2020-09-01,macedonia,Europe,2083215,114,14455
2020-09-02,macedonia,Europe,2083215,145,14600
2020-09-03,macedonia,Europe,2083215,162,14762
2020-09-04,macedonia,Europe,2083215,109,14871
2020-09-05,macedonia,Europe,2083215,127,14998
2020-09-06,macedonia,Europe,2083215,92,15090
2020-09-07,macedonia,Europe,2083215,37,15127
2020-09-08,macedonia,Europe,2083215,99,15226
2020-09-09,macedonia,Europe,2083215,67,15293
2020-09-10,macedonia,Europe,2083215,121,15414
2020-09-11,macedonia,Europe,2083215,140,15554
2020-09-12,macedonia,Europe,2083215,140,15694
2020-09-13,macedonia,Europe,2083215,97,15791
2020-09-14,macedonia,Europe,2083215,36,15827
2020-09-15,macedonia,Europe,2083215,98,15925
2020-09-16,macedonia,Europe,2083215,163,16088
2020-09-17,macedonia,Europe,2083215,186,16274
2020-09-18,macedonia,Europe,2083215,143,16417
2020-09-19,macedonia,Europe,2083215,140,16557
2020-09-20,macedonia,Europe,2083215,178,16735
2020-09-21,macedonia,Europe,2083215,45,16780
2020-09-22,macedonia,Europe,2083215,87,16867
2020-09-23,macedonia,Europe,2083215,182,17049
2020-09-24,macedonia,Europe,2083215,151,17200
2020-09-25,macedonia,Europe,2083215,143,17343
2020-09-26,macedonia,Europe,2083215,140,17483
2020-09-27,macedonia,Europe,2083215,146,17629
2020-09-28,macedonia,Europe,2083215,45,17674
2020-09-29,macedonia,Europe,2083215,112,17786
2020-09-30,macedonia,Europe,2083215,191,17977
2020-10-01,macedonia,Europe,2083215,161,18138
2020-10-02,macedonia,Europe,2083215,225,18363
2020-10-03,macedonia,Europe,2083215,239,18602
2020-10-04,macedonia,Europe,2083215,188,18790
2020-10-05,macedonia,Europe,2083215,83,18873
2020-10-06,macedonia,Europe,2083215,223,19096
2020-10-07,macedonia,Europe,2083215,317,19413
2020-10-08,macedonia,Europe,2083215,364,19777
2020-10-09,macedonia,Europe,2083215,386,20163
2020-10-10,macedonia,Europe,2083215,392,20555
2020-10-11,macedonia,Europe,2083215,382,20937
2020-10-12,macedonia,Europe,2083215,176,21113
2020-10-13,macedonia,Europe,2083215,80,21193
2020-10-14,macedonia,Europe,2083215,443,21636
2020-10-15,macedonia,Europe,2083215,534,22170
2020-10-16,macedonia,Europe,2083215,437,22607
2020-10-17,macedonia,Europe,2083215,594,23201
2020-10-18,macedonia,Europe,2083215,427,23628
2020-10-19,macedonia,Europe,2083215,160,23788
2020-10-20,macedonia,Europe,2083215,408,24196
2020-10-21,macedonia,Europe,2083215,640,24836
2020-10-22,macedonia,Europe,2083215,637,25473
2020-10-23,macedonia,Europe,2083215,518,25991
2020-10-24,macedonia,Europe,2083215,403,26394
2020-10-25,macedonia,Europe,2083215,560,26954
2020-10-26,macedonia,Europe,2083215,245,27199
2020-10-27,macedonia,Europe,2083215,628,27827
2020-10-28,macedonia,Europe,2083215,870,28697
2020-10-29,macedonia,Europe,2083215,861,29558
2020-10-30,macedonia,Europe,2083215,930,30488
2020-10-31,macedonia,Europe,2083215,1084,31572
2020-11-01,macedonia,Europe,2083215,864,32436
2020-11-02,macedonia,Europe,2083215,561,32997
2020-11-03,macedonia,Europe,2083215,911,33908
2020-11-04,macedonia,Europe,2083215,1189,35097
2020-11-05,macedonia,Europe,2083215,1275,36372
2020-11-06,macedonia,Europe,2083215,1127,37499
2020-11-07,macedonia,Europe,2083215,1283,38782
2020-11-08,macedonia,Europe,2083215,978,39760
2020-11-09,macedonia,Europe,2083215,515,40275
2020-11-10,macedonia,Europe,2083215,947,41222
2020-11-11,macedonia,Europe,2083215,1318,42540
2020-11-12,macedonia,Europe,2083215,1295,43835
2020-11-13,macedonia,Europe,2083215,1063,44898
2020-11-14,macedonia,Europe,2083215,1164,46062
2020-11-15,macedonia,Europe,2083215,988,47050
2020-11-16,macedonia,Europe,2083215,586,47636
2020-11-17,macedonia,Europe,2083215,977,48613
2020-11-18,macedonia,Europe,2083215,1402,50015
2020-11-19,macedonia,Europe,2083215,1198,51213
2020-11-20,macedonia,Europe,2083215,1236,52449
2020-11-21,macedonia,Europe,2083215,1182,53631
2020-11-22,macedonia,Europe,2083215,1112,54743
2020-11-23,macedonia,Europe,2083215,384,55127
2020-11-24,macedonia,Europe,2083215,1037,56164
2020-11-25,macedonia,Europe,2083215,1287,57451
2020-11-26,macedonia,Europe,2083215,1157,58608
2020-11-27,macedonia,Europe,2083215,1093,59701
2020-11-28,macedonia,Europe,2083215,1022,60723
2020-11-29,macedonia,Europe,2083215,820,61543
2020-11-30,macedonia,Europe,2083215,335,61878
2020-12-01,macedonia,Europe,2083215,1067,62945
2020-12-02,macedonia,Europe,2083215,945,63890
2020-12-03,macedonia,Europe,2083215,1341,65231
2020-12-04,macedonia,Europe,2083215,1099,66330
2020-12-05,macedonia,Europe,2083215,981,67311
2020-12-06,macedonia,Europe,2083215,657,67968
2020-12-07,macedonia,Europe,2083215,364,68332
2020-12-08,macedonia,Europe,2083215,1120,69452
2020-12-09,macedonia,Europe,2083215,502,69954
2020-12-10,macedonia,Europe,2083215,929,70883
2020-12-11,macedonia,Europe,2083215,1161,72044
2020-12-12,macedonia,Europe,2083215,981,73025
2020-12-13,macedonia,Europe,2083215,613,73638
2020-12-14,macedonia,Europe,2083215,213,73851
2020-12-15,macedonia,Europe,2083215,881,74732
2020-12-16,macedonia,Europe,2083215,865,75597
2020-12-17,macedonia,Europe,2083215,654,76251
2020-12-18,macedonia,Europe,2083215,883,77134
2020-12-19,macedonia,Europe,2083215,815,77949
2020-12-20,macedonia,Europe,2083215,356,78305
2020-12-21,macedonia,Europe,2083215,129,78434
2020-12-22,macedonia,Europe,2083215,756,79190
2020-12-23,macedonia,Europe,2083215,625,79815
2020-12-24,macedonia,Europe,2083215,592,80407
2020-12-25,macedonia,Europe,2083215,489,80896
2020-12-26,macedonia,Europe,2083215,529,81425
2020-12-27,macedonia,Europe,2083215,296,81721
2020-12-28,macedonia,Europe,2083215,83,81804
2020-12-29,macedonia,Europe,2083215,497,82301
2020-12-30,macedonia,Europe,2083215,493,82794
2020-12-31,macedonia,Europe,2083215,535,83329
2021-01-01,macedonia,Europe,2083215,414,83743
2021-01-02,macedonia,Europe,2083215,46,83789
2021-01-03,macedonia,Europe,2083215,235,84024
2021-01-04,macedonia,Europe,2083215,105,84129
2021-01-05,macedonia,Europe,2083215,580,84709
2021-01-06,macedonia,Europe,2083215,619,85328
2021-01-07,macedonia,Europe,2083215,166,85494
2021-01-08,macedonia,Europe,2083215,100,85594
2021-01-09,macedonia,Europe,2083215,556,86150
2021-01-10,macedonia,Europe,2083215,344,86494
2021-01-11,macedonia,Europe,2083215,103,86597
2021-01-12,macedonia,Europe,2083215,520,87117
2021-01-13,macedonia,Europe,2083215,473,87590
2021-01-14,macedonia,Europe,2083215,396,87986
2021-01-15,macedonia,Europe,2083215,403,88389
2021-01-16,macedonia,Europe,2083215,360,88749
2021-01-17,macedonia,Europe,2083215,189,88938
2021-01-18,macedonia,Europe,2083215,54,88992
2021-01-19,macedonia,Europe,2083215,400,89392
2021-01-20,macedonia,Europe,2083215,71,89463
2021-01-21,macedonia,Europe,2083215,354,89817
2021-01-22,macedonia,Europe,2083215,307,90124
2021-01-23,macedonia,Europe,2083215,347,90471
2021-01-24,macedonia,Europe,2083215,183,90654
2021-01-25,macedonia,Europe,2083215,63,90717
2021-01-26,macedonia,Europe,2083215,444,91161
2021-01-27,macedonia,Europe,2083215,394,91555
2021-01-28,macedonia,Europe,2083215,336,91891
2021-01-29,macedonia,Europe,2083215,302,92193
2021-01-30,macedonia,Europe,2083215,325,92518
2021-01-31,macedonia,Europe,2083215,175,92693
2021-02-01,macedonia,Europe,2083215,60,92753
2021-02-02,macedonia,Europe,2083215,407,93160
2021-02-03,macedonia,Europe,2083215,350,93510
2021-02-04,macedonia,Europe,2083215,372,93882
2021-02-05,macedonia,Europe,2083215,314,94196
2021-02-06,macedonia,Europe,2083215,403,94599
2021-02-07,macedonia,Europe,2083215,199,94798
2021-02-08,macedonia,Europe,2083215,73,94871
2021-02-09,macedonia,Europe,2083215,476,95347
2021-02-10,macedonia,Europe,2083215,389,95736
2021-02-11,macedonia,Europe,2083215,416,96152
2021-02-12,macedonia,Europe,2083215,366,96518
2021-02-13,macedonia,Europe,2083215,354,96872
2021-02-14,macedonia,Europe,2083215,180,97052
2021-02-15,macedonia,Europe,2083215,49,97101
2021-02-16,macedonia,Europe,2083215,355,97456
2021-02-17,macedonia,Europe,2083215,347,97803
2021-02-18,macedonia,Europe,2083215,371,98174
2021-02-19,macedonia,Europe,2083215,410,98584
2021-02-20,macedonia,Europe,2083215,447,99031
2021-02-21,macedonia,Europe,2083215,254,99285
2021-02-22,macedonia,Europe,2083215,123,99408
2021-02-23,macedonia,Europe,2083215,509,99917
2021-02-24,macedonia,Europe,2083215,715,100632
2021-02-25,macedonia,Europe,2083215,582,101214
2021-02-26,macedonia,Europe,2083215,548,101762
2021-02-27,macedonia,Europe,2083215,720,102482
2021-02-28,macedonia,Europe,2083215,305,102787
2021-03-01,macedonia,Europe,2083215,233,103020
2021-03-02,macedonia,Europe,2083215,726,103746
2021-03-03,macedonia,Europe,2083215,802,104548
2021-03-04,macedonia,Europe,2083215,721,105269
2021-03-05,macedonia,Europe,2083215,841,106110
2021-03-06,macedonia,Europe,2083215,722,106832
2021-03-07,macedonia,Europe,2083215,331,107163
2021-03-08,macedonia,Europe,2083215,316,107479
2021-03-09,macedonia,Europe,2083215,871,108350
2021-03-10,macedonia,Europe,2083215,912,109262
2021-03-11,macedonia,Europe,2083215,947,110209
2021-03-12,macedonia,Europe,2083215,868,111077
2020-05-18,madagascar,Africa,29016291,18,322
2020-05-19,madagascar,Africa,29016291,4,326
2020-05-20,madagascar,Africa,29016291,45,371
2020-05-21,madagascar,Africa,29016291,34,405
2020-05-22,madagascar,Africa,29016291,43,448
2020-05-23,madagascar,Africa,29016291,40,488
2020-05-24,madagascar,Africa,29016291,39,527
2020-05-25,madagascar,Africa,29016291,15,542
2020-05-26,madagascar,Africa,29016291,44,586
2020-05-27,madagascar,Africa,29016291,26,612
2020-05-28,madagascar,Africa,29016291,44,656
2020-05-29,madagascar,Africa,29016291,42,698
2020-05-30,madagascar,Africa,29016291,60,758
2020-05-31,madagascar,Africa,29016291,13,771
2020-06-01,madagascar,Africa,29016291,55,826
2020-06-02,madagascar,Africa,29016291,19,845
2020-06-03,madagascar,Africa,29016291,63,908
2020-06-04,madagascar,Africa,29016291,49,957
2020-06-05,madagascar,Africa,29016291,18,975
2020-06-06,madagascar,Africa,29016291,51,1026
2020-06-07,madagascar,Africa,29016291,26,1052
2020-06-08,madagascar,Africa,29016291,42,1094
2020-06-09,madagascar,Africa,29016291,44,1138
2020-06-10,madagascar,Africa,29016291,24,1162
2020-06-11,madagascar,Africa,29016291,41,1203
2020-06-12,madagascar,Africa,29016291,27,1230
2020-06-13,madagascar,Africa,29016291,22,1252
2020-06-14,madagascar,Africa,29016291,20,1272
2020-06-15,madagascar,Africa,29016291,18,1290
2020-06-16,madagascar,Africa,29016291,27,1317
2020-06-17,madagascar,Africa,29016291,61,1378
2020-06-18,madagascar,Africa,29016291,25,1403
2020-06-19,madagascar,Africa,29016291,40,1443
2020-06-20,madagascar,Africa,29016291,60,1503
2020-06-21,madagascar,Africa,29016291,93,1596
2020-06-22,madagascar,Africa,29016291,44,1640
2020-06-23,madagascar,Africa,29016291,84,1724
2020-06-24,madagascar,Africa,29016291,63,1787
2020-06-25,madagascar,Africa,29016291,42,1829
2020-06-26,madagascar,Africa,29016291,93,1922
2020-06-27,madagascar,Africa,29016291,83,2005
2020-06-28,madagascar,Africa,29016291,73,2078
2020-06-29,madagascar,Africa,29016291,60,2138
2020-06-30,madagascar,Africa,29016291,76,2214
2020-07-01,madagascar,Africa,29016291,89,2303
2020-07-02,madagascar,Africa,29016291,100,2403
2020-07-03,madagascar,Africa,29016291,109,2512
2020-07-04,madagascar,Africa,29016291,216,2728
2020-07-05,madagascar,Africa,29016291,213,2941
2020-07-06,madagascar,Africa,29016291,309,3250
2020-07-07,madagascar,Africa,29016291,222,3472
2020-07-08,madagascar,Africa,29016291,101,3573
2020-07-09,madagascar,Africa,29016291,209,3782
2020-07-10,madagascar,Africa,29016291,361,4143
2020-07-11,madagascar,Africa,29016291,435,4578
2020-07-12,madagascar,Africa,29016291,289,4867
2020-07-13,madagascar,Africa,29016291,213,5080
2020-07-14,madagascar,Africa,29016291,263,5343
2020-07-15,madagascar,Africa,29016291,262,5605
2020-07-16,madagascar,Africa,29016291,484,6089
2020-07-17,madagascar,Africa,29016291,378,6467
2020-07-18,madagascar,Africa,29016291,382,6849
2020-07-19,madagascar,Africa,29016291,200,7049
2020-07-20,madagascar,Africa,29016291,104,7153
2020-07-21,madagascar,Africa,29016291,395,7548
2020-07-22,madagascar,Africa,29016291,614,8162
2020-07-23,madagascar,Africa,29016291,219,8381
2020-07-24,madagascar,Africa,29016291,360,8741
2020-07-25,madagascar,Africa,29016291,125,8866
2020-07-26,madagascar,Africa,29016291,429,9295
2020-07-27,madagascar,Africa,29016291,395,9690
2020-07-28,madagascar,Africa,29016291,414,10104
2020-07-29,madagascar,Africa,29016291,213,10317
2020-07-30,madagascar,Africa,29016291,431,10748
2020-07-31,madagascar,Africa,29016291,120,10868
2020-08-01,madagascar,Africa,29016291,405,11273
2020-08-02,madagascar,Africa,29016291,255,11528
2020-08-03,madagascar,Africa,29016291,132,11660
2020-08-04,madagascar,Africa,29016291,235,11895
2020-08-05,madagascar,Africa,29016291,327,12222
2020-08-06,madagascar,Africa,29016291,304,12526
2020-08-07,madagascar,Africa,29016291,182,12708
2020-08-08,madagascar,Africa,29016291,214,12922
2020-08-09,madagascar,Africa,29016291,164,13086
2020-08-10,madagascar,Africa,29016291,116,13202
2020-08-11,madagascar,Africa,29016291,115,13317
2020-08-12,madagascar,Africa,29016291,80,13397
2020-08-13,madagascar,Africa,29016291,125,13522
2020-08-14,madagascar,Africa,29016291,121,13643
2020-08-15,madagascar,Africa,29016291,81,13724
2020-08-16,madagascar,Africa,29016291,103,13827
2020-08-17,madagascar,Africa,29016291,59,13886
2020-08-18,madagascar,Africa,29016291,123,14009
2020-08-19,madagascar,Africa,29016291,65,14074
2020-08-20,madagascar,Africa,29016291,80,14154
2020-08-21,madagascar,Africa,29016291,64,14218
2020-08-22,madagascar,Africa,29016291,59,14277
2020-08-23,madagascar,Africa,29016291,50,14327
2020-08-24,madagascar,Africa,29016291,75,14402
2020-08-25,madagascar,Africa,29016291,73,14475
2020-08-26,madagascar,Africa,29016291,79,14554
2020-08-27,madagascar,Africa,29016291,38,14592
2020-08-28,madagascar,Africa,29016291,104,14696
2020-08-29,madagascar,Africa,29016291,95,14791
2020-08-30,madagascar,Africa,29016291,52,14843
2020-08-31,madagascar,Africa,29016291,20,14863
2020-09-01,madagascar,Africa,29016291,94,14957
2020-09-02,madagascar,Africa,29016291,66,15023
2020-09-03,madagascar,Africa,29016291,83,15106
2020-09-04,madagascar,Africa,29016291,81,15187
2020-09-05,madagascar,Africa,29016291,82,15269
2020-09-06,madagascar,Africa,29016291,50,15319
2020-09-07,madagascar,Africa,29016291,33,15352
2020-09-08,madagascar,Africa,29016291,83,15435
2020-09-09,madagascar,Africa,29016291,85,15520
2020-09-10,madagascar,Africa,29016291,104,15624
2020-09-11,madagascar,Africa,29016291,45,15669
2020-09-12,madagascar,Africa,29016291,68,15737
2020-09-13,madagascar,Africa,29016291,20,15757
2020-09-14,madagascar,Africa,29016291,12,15769
2020-09-15,madagascar,Africa,29016291,34,15803
2020-09-16,madagascar,Africa,29016291,68,15871
2020-09-17,madagascar,Africa,29016291,54,15925
2020-09-18,madagascar,Africa,29016291,46,15971
2020-09-19,madagascar,Africa,29016291,49,16020
2020-09-20,madagascar,Africa,29016291,33,16053
2020-09-21,madagascar,Africa,29016291,20,16073
2020-09-22,madagascar,Africa,29016291,63,16136
2020-09-23,madagascar,Africa,29016291,31,16167
2020-09-24,madagascar,Africa,29016291,24,16191
2020-09-25,madagascar,Africa,29016291,30,16221
2020-09-26,madagascar,Africa,29016291,36,16257
2020-09-27,madagascar,Africa,29016291,28,16285
2020-09-28,madagascar,Africa,29016291,63,16348
2020-09-29,madagascar,Africa,29016291,29,16377
2020-09-30,madagascar,Africa,29016291,31,16408
2020-10-01,madagascar,Africa,29016291,46,16454
2020-10-02,madagascar,Africa,29016291,39,16493
2020-10-03,madagascar,Africa,29016291,36,16529
2020-10-04,madagascar,Africa,29016291,29,16558
2020-10-05,madagascar,Africa,29016291,12,16570
2020-10-06,madagascar,Africa,29016291,30,16600
2020-10-07,madagascar,Africa,29016291,33,16633
2020-10-08,madagascar,Africa,29016291,21,16654
2020-10-09,madagascar,Africa,29016291,22,16676
2020-10-10,madagascar,Africa,29016291,26,16702
2020-10-11,madagascar,Africa,29016291,16,16718
2020-10-12,madagascar,Africa,29016291,8,16726
2020-10-13,madagascar,Africa,29016291,28,16754
2020-10-14,madagascar,Africa,29016291,0,16754
2020-10-15,madagascar,Africa,29016291,0,16754
2020-10-16,madagascar,Africa,29016291,0,16754
2020-10-17,madagascar,Africa,29016291,56,16810
2020-10-18,madagascar,Africa,29016291,0,16810
2020-10-19,madagascar,Africa,29016291,0,16810
2020-10-20,madagascar,Africa,29016291,0,16810
2020-10-21,madagascar,Africa,29016291,0,16810
2020-10-22,madagascar,Africa,29016291,0,16810
2020-10-23,madagascar,Africa,29016291,0,16810
2020-10-24,madagascar,Africa,29016291,158,16968
2020-10-25,madagascar,Africa,29016291,0,16968
2020-10-26,madagascar,Africa,29016291,0,16968
2020-10-27,madagascar,Africa,29016291,0,16968
2020-10-28,madagascar,Africa,29016291,0,16968
2020-10-29,madagascar,Africa,29016291,0,16968
2020-10-30,madagascar,Africa,29016291,0,16968
2020-10-31,madagascar,Africa,29016291,143,17111
2020-11-01,madagascar,Africa,29016291,0,17111
2020-11-02,madagascar,Africa,29016291,0,17111
2020-11-03,madagascar,Africa,29016291,0,17111
2020-11-04,madagascar,Africa,29016291,0,17111
2020-11-05,madagascar,Africa,29016291,0,17111
2020-11-06,madagascar,Africa,29016291,0,17111
2020-11-07,madagascar,Africa,29016291,0,17111
2020-11-08,madagascar,Africa,29016291,112,17223
2020-11-09,madagascar,Africa,29016291,0,17223
2020-11-10,madagascar,Africa,29016291,0,17223
2020-11-11,madagascar,Africa,29016291,0,17223
2020-11-12,madagascar,Africa,29016291,0,17223
2020-11-13,madagascar,Africa,29016291,0,17223
2020-11-14,madagascar,Africa,29016291,0,17223
2020-11-15,madagascar,Africa,29016291,87,17310
2020-11-16,madagascar,Africa,29016291,0,17310
2020-11-17,madagascar,Africa,29016291,0,17310
2020-11-18,madagascar,Africa,29016291,0,17310
2020-11-19,madagascar,Africa,29016291,0,17310
2020-11-20,madagascar,Africa,29016291,0,17310
2020-11-21,madagascar,Africa,29016291,0,17310
2020-11-22,madagascar,Africa,29016291,31,17341
2020-11-23,madagascar,Africa,29016291,0,17341
2020-11-24,madagascar,Africa,29016291,0,17341
2020-11-25,madagascar,Africa,29016291,0,17341
2020-11-26,madagascar,Africa,29016291,0,17341
2020-11-27,madagascar,Africa,29016291,0,17341
2020-11-28,madagascar,Africa,29016291,0,17341
2020-11-29,madagascar,Africa,29016291,0,17341
2020-11-30,madagascar,Africa,29016291,0,17341
2020-12-01,madagascar,Africa,29016291,0,17341
2020-12-02,madagascar,Africa,29016291,0,17341
2020-12-03,madagascar,Africa,29016291,0,17341
2020-12-04,madagascar,Africa,29016291,0,17341
2020-12-05,madagascar,Africa,29016291,132,17473
2020-12-06,madagascar,Africa,29016291,0,17473
2020-12-07,madagascar,Africa,29016291,0,17473
2020-12-08,madagascar,Africa,29016291,0,17473
2020-12-09,madagascar,Africa,29016291,0,17473
2020-12-10,madagascar,Africa,29016291,0,17473
2020-12-11,madagascar,Africa,29016291,0,17473
2020-12-12,madagascar,Africa,29016291,114,17587
2020-12-13,madagascar,Africa,29016291,0,17587
2020-12-14,madagascar,Africa,29016291,0,17587
2020-12-15,madagascar,Africa,29016291,0,17587
2020-12-16,madagascar,Africa,29016291,0,17587
2020-12-17,madagascar,Africa,29016291,0,17587
2020-12-18,madagascar,Africa,29016291,0,17587
2020-12-19,madagascar,Africa,29016291,0,17587
2020-12-20,madagascar,Africa,29016291,46,17633
2020-12-21,madagascar,Africa,29016291,0,17633
2020-12-22,madagascar,Africa,29016291,0,17633
2020-12-23,madagascar,Africa,29016291,0,17633
2020-12-24,madagascar,Africa,29016291,0,17633
2020-12-25,madagascar,Africa,29016291,0,17633
2020-12-26,madagascar,Africa,29016291,0,17633
2020-12-27,madagascar,Africa,29016291,81,17714
2020-12-28,madagascar,Africa,29016291,0,17714
2020-12-29,madagascar,Africa,29016291,0,17714
2020-12-30,madagascar,Africa,29016291,0,17714
2020-12-31,madagascar,Africa,29016291,0,17714
2021-01-01,madagascar,Africa,29016291,0,17714
2021-01-02,madagascar,Africa,29016291,53,17767
2021-01-03,madagascar,Africa,29016291,0,17767
2021-01-04,madagascar,Africa,29016291,0,17767
2021-01-05,madagascar,Africa,29016291,0,17767
2021-01-06,madagascar,Africa,29016291,0,17767
2021-01-07,madagascar,Africa,29016291,0,17767
2021-01-08,madagascar,Africa,29016291,0,17767
2021-01-09,madagascar,Africa,29016291,0,17767
2021-01-10,madagascar,Africa,29016291,234,18001
2021-01-11,madagascar,Africa,29016291,0,18001
2021-01-12,madagascar,Africa,29016291,0,18001
2021-01-13,madagascar,Africa,29016291,0,18001
2021-01-14,madagascar,Africa,29016291,0,18001
2021-01-15,madagascar,Africa,29016291,0,18001
2021-01-16,madagascar,Africa,29016291,0,18001
2021-01-17,madagascar,Africa,29016291,300,18301
2021-01-18,madagascar,Africa,29016291,0,18301
2021-01-19,madagascar,Africa,29016291,0,18301
2021-01-20,madagascar,Africa,29016291,0,18301
2021-01-21,madagascar,Africa,29016291,0,18301
2021-01-22,madagascar,Africa,29016291,0,18301
2021-01-23,madagascar,Africa,29016291,0,18301
2021-01-24,madagascar,Africa,29016291,442,18743
2021-01-25,madagascar,Africa,29016291,0,18743
2021-01-26,madagascar,Africa,29016291,0,18743
2021-01-27,madagascar,Africa,29016291,0,18743
2021-01-28,madagascar,Africa,29016291,0,18743
2021-01-29,madagascar,Africa,29016291,0,18743
2021-01-30,madagascar,Africa,29016291,0,18743
2021-01-31,madagascar,Africa,29016291,322,19065
2021-02-01,madagascar,Africa,29016291,0,19065
2021-02-02,madagascar,Africa,29016291,0,19065
2021-02-03,madagascar,Africa,29016291,0,19065
2021-02-04,madagascar,Africa,29016291,0,19065
2021-02-05,madagascar,Africa,29016291,0,19065
2021-02-06,madagascar,Africa,29016291,0,19065
2021-02-07,madagascar,Africa,29016291,295,19360
2021-02-08,madagascar,Africa,29016291,0,19360
2021-02-09,madagascar,Africa,29016291,0,19360
2021-02-10,madagascar,Africa,29016291,0,19360
2021-02-11,madagascar,Africa,29016291,0,19360
2021-02-12,madagascar,Africa,29016291,0,19360
2021-02-13,madagascar,Africa,29016291,0,19360
2021-02-14,madagascar,Africa,29016291,238,19598
2021-02-15,madagascar,Africa,29016291,0,19598
2021-02-16,madagascar,Africa,29016291,0,19598
2021-02-17,madagascar,Africa,29016291,0,19598
2021-02-18,madagascar,Africa,29016291,0,19598
2021-02-19,madagascar,Africa,29016291,0,19598
2021-02-20,madagascar,Africa,29016291,0,19598
2021-02-21,madagascar,Africa,29016291,233,19831
2021-02-22,madagascar,Africa,29016291,0,19831
2021-02-23,madagascar,Africa,29016291,0,19831
2021-02-24,madagascar,Africa,29016291,0,19831
2021-02-25,madagascar,Africa,29016291,0,19831
2021-02-26,madagascar,Africa,29016291,0,19831
2021-02-27,madagascar,Africa,29016291,0,19831
2021-02-28,madagascar,Africa,29016291,0,19831
2021-03-01,madagascar,Africa,29016291,0,19831
2021-03-02,madagascar,Africa,29016291,0,19831
2021-03-03,madagascar,Africa,29016291,0,19831
2021-03-04,madagascar,Africa,29016291,0,19831
2021-03-05,madagascar,Africa,29016291,0,19831
2021-03-06,madagascar,Africa,29016291,324,20155
2021-03-07,madagascar,Africa,29016291,0,20155
2021-03-08,madagascar,Africa,29016291,0,20155
2021-03-09,madagascar,Africa,29016291,0,20155
2021-03-10,madagascar,Africa,29016291,0,20155
2021-03-11,madagascar,Africa,29016291,0,20155
2021-03-12,madagascar,Africa,29016291,0,20155
2021-03-13,madagascar,Africa,29016291,1201,21356
2021-03-14,madagascar,Africa,29016291,126,21482
2021-03-15,madagascar,Africa,29016291,105,21587
2021-03-16,madagascar,Africa,29016291,101,21688
2021-03-17,madagascar,Africa,29016291,138,21826
2021-03-18,madagascar,Africa,29016291,173,21999
2021-03-19,madagascar,Africa,29016291,114,22113
2021-03-20,madagascar,Africa,29016291,162,22275
2021-03-21,madagascar,Africa,29016291,209,22484
2021-03-22,madagascar,Africa,29016291,132,22616
2021-03-23,madagascar,Africa,29016291,66,22682
2021-03-24,madagascar,Africa,29016291,162,22844
2021-03-25,madagascar,Africa,29016291,196,23040
2021-03-26,madagascar,Africa,29016291,190,23230
2021-03-27,madagascar,Africa,29016291,194,23424
2021-03-28,madagascar,Africa,29016291,161,23585
2021-03-29,madagascar,Africa,29016291,384,23969
2021-03-30,madagascar,Africa,29016291,295,24264
2021-03-31,madagascar,Africa,29016291,162,24426
2021-04-01,madagascar,Africa,29016291,270,24696
2021-04-02,madagascar,Africa,29016291,272,24968
2021-04-03,madagascar,Africa,29016291,294,25262
2021-04-04,madagascar,Africa,29016291,310,25572
2021-04-05,madagascar,Africa,29016291,137,25709
2021-04-06,madagascar,Africa,29016291,165,25874
2021-04-07,madagascar,Africa,29016291,253,26127
2021-04-08,madagascar,Africa,29016291,348,26475
2021-04-09,madagascar,Africa,29016291,559,27034
2021-04-10,madagascar,Africa,29016291,514,27548
2021-04-11,madagascar,Africa,29016291,515,28063
2021-04-12,madagascar,Africa,29016291,478,28541
2021-04-13,madagascar,Africa,29016291,224,28765
2021-04-14,madagascar,Africa,29016291,583,29348
2021-04-15,madagascar,Africa,29016291,859,30207
2021-04-16,madagascar,Africa,29016291,832,31039
2021-04-17,madagascar,Africa,29016291,578,31617
2021-04-18,madagascar,Africa,29016291,588,32205
2021-04-19,madagascar,Africa,29016291,593,32798
2021-04-20,madagascar,Africa,29016291,404,33202
2021-04-21,madagascar,Africa,29016291,390,33592
2021-04-22,madagascar,Africa,29016291,477,34069
2021-04-23,madagascar,Africa,29016291,706,34775
2021-04-24,madagascar,Africa,29016291,487,35262
2021-04-25,madagascar,Africa,29016291,484,35746
2021-04-26,madagascar,Africa,29016291,299,36045
2021-04-27,madagascar,Africa,29016291,145,36190
2021-04-28,madagascar,Africa,29016291,320,36510
2021-04-29,madagascar,Africa,29016291,186,36696
2021-04-30,madagascar,Africa,29016291,318,37014
2021-05-01,madagascar,Africa,29016291,282,37296
2021-05-02,madagascar,Africa,29016291,334,37630
2021-05-03,madagascar,Africa,29016291,121,37751
2021-05-04,madagascar,Africa,29016291,238,37989
2021-05-05,madagascar,Africa,29016291,127,38116
2021-05-06,madagascar,Africa,29016291,221,38337
2021-05-07,madagascar,Africa,29016291,304,38641
2021-05-08,madagascar,Africa,29016291,233,38874
2021-05-09,madagascar,Africa,29016291,138,39012
2021-05-10,madagascar,Africa,29016291,150,39162
2021-05-11,madagascar,Africa,29016291,189,39351
2021-05-12,madagascar,Africa,29016291,159,39510
2021-05-13,madagascar,Africa,29016291,249,39759
2021-05-14,madagascar,Africa,29016291,129,39888
2021-05-15,madagascar,Africa,29016291,117,40005
2021-05-16,madagascar,Africa,29016291,136,40141
2021-05-17,madagascar,Africa,29016291,63,40204
2021-05-18,madagascar,Africa,29016291,122,40326
2021-05-19,madagascar,Africa,29016291,59,40385
2021-05-20,madagascar,Africa,29016291,134,40519
2021-05-21,madagascar,Africa,29016291,173,40692
2021-05-22,madagascar,Africa,29016291,88,40780
2021-05-23,madagascar,Africa,29016291,96,40876
2021-05-24,madagascar,Africa,29016291,78,40954
2021-05-25,madagascar,Africa,29016291,45,40999
2021-05-26,madagascar,Africa,29016291,62,41061
2021-05-27,madagascar,Africa,29016291,41,41102
2021-05-28,madagascar,Africa,29016291,82,41184
2021-05-29,madagascar,Africa,29016291,50,41234
2021-05-30,madagascar,Africa,29016291,32,41266
2021-05-31,madagascar,Africa,29016291,76,41342
2021-06-01,madagascar,Africa,29016291,24,41366
2021-06-02,madagascar,Africa,29016291,53,41419
2021-06-03,madagascar,Africa,29016291,69,41488
2021-06-04,madagascar,Africa,29016291,52,41540
2021-06-05,madagascar,Africa,29016291,91,41631
2021-06-06,madagascar,Africa,29016291,59,41690
2021-06-07,madagascar,Africa,29016291,52,41742
2021-06-08,madagascar,Africa,29016291,16,41758
2021-06-09,madagascar,Africa,29016291,28,41786
2021-06-10,madagascar,Africa,29016291,54,41840
2021-06-11,madagascar,Africa,29016291,29,41869
2021-06-12,madagascar,Africa,29016291,25,41894
2021-06-13,madagascar,Africa,29016291,39,41933
2021-06-14,madagascar,Africa,29016291,15,41948
2021-06-15,madagascar,Africa,29016291,18,41966
2021-06-16,madagascar,Africa,29016291,32,41998
2021-06-17,madagascar,Africa,29016291,36,42034
2021-06-18,madagascar,Africa,29016291,42,42076
2021-06-19,madagascar,Africa,29016291,11,42087
2021-06-20,madagascar,Africa,29016291,36,42123
2021-06-21,madagascar,Africa,29016291,14,42137
2021-06-22,madagascar,Africa,29016291,0,42137
2021-06-23,madagascar,Africa,29016291,24,42161
2021-06-24,madagascar,Africa,29016291,5,42166
2021-06-25,madagascar,Africa,29016291,28,42194
2021-06-26,madagascar,Africa,29016291,0,42194
2021-06-27,madagascar,Africa,29016291,0,42194
2021-06-28,madagascar,Africa,29016291,0,42194
2021-06-29,madagascar,Africa,29016291,13,42207
2021-06-30,madagascar,Africa,29016291,9,42216
2021-07-01,madagascar,Africa,29016291,31,42247
2021-07-02,madagascar,Africa,29016291,17,42264
2021-07-03,madagascar,Africa,29016291,24,42288
2021-07-04,madagascar,Africa,29016291,23,42311
2021-07-05,madagascar,Africa,29016291,18,42329
2021-07-06,madagascar,Africa,29016291,8,42337
2021-07-07,madagascar,Africa,29016291,21,42358
2021-07-08,madagascar,Africa,29016291,18,42376
2021-07-09,madagascar,Africa,29016291,16,42392
2021-07-10,madagascar,Africa,29016291,19,42411
2021-07-11,madagascar,Africa,29016291,16,42427
2021-07-12,madagascar,Africa,29016291,17,42444
2021-07-13,madagascar,Africa,29016291,18,42462
2021-07-14,madagascar,Africa,29016291,0,42462
2021-07-15,madagascar,Africa,29016291,17,42479
2021-07-16,madagascar,Africa,29016291,16,42495
2021-07-17,madagascar,Africa,29016291,25,42520
2021-07-18,madagascar,Africa,29016291,16,42536
2021-07-19,madagascar,Africa,29016291,2,42538
2021-07-20,madagascar,Africa,29016291,13,42551
2021-07-21,madagascar,Africa,29016291,7,42558
2021-07-22,madagascar,Africa,29016291,3,42561
2021-07-23,madagascar,Africa,29016291,20,42581
2021-07-24,madagascar,Africa,29016291,9,42590
2021-07-25,madagascar,Africa,29016291,9,42599
2021-07-26,madagascar,Africa,29016291,0,42599
2021-07-27,madagascar,Africa,29016291,8,42607
2021-07-28,madagascar,Africa,29016291,8,42615
2021-07-29,madagascar,Africa,29016291,30,42645
2021-07-30,madagascar,Africa,29016291,7,42652
2021-07-31,madagascar,Africa,29016291,11,42663
2021-08-01,madagascar,Africa,29016291,2,42665
2021-08-02,madagascar,Africa,29016291,7,42672
2021-08-03,madagascar,Africa,29016291,2,42674
2021-08-04,madagascar,Africa,29016291,11,42685
2021-08-05,madagascar,Africa,29016291,0,42685
2021-08-06,madagascar,Africa,29016291,0,42685
2021-08-07,madagascar,Africa,29016291,0,42685
2021-08-08,madagascar,Africa,29016291,91,42776
2021-08-09,madagascar,Africa,29016291,5,42781
2021-08-10,madagascar,Africa,29016291,6,42787
2021-08-11,madagascar,Africa,29016291,4,42791
2021-08-12,madagascar,Africa,29016291,4,42795
2021-08-13,madagascar,Africa,29016291,7,42802
2021-08-14,madagascar,Africa,29016291,9,42811
2021-08-15,madagascar,Africa,29016291,4,42815
2021-08-16,madagascar,Africa,29016291,4,42819
2021-08-17,madagascar,Africa,29016291,9,42828
2021-08-18,madagascar,Africa,29016291,4,42832
2021-08-19,madagascar,Africa,29016291,4,42836
2021-08-20,madagascar,Africa,29016291,2,42838
2021-08-21,madagascar,Africa,29016291,4,42842
2021-08-22,madagascar,Africa,29016291,3,42845
2021-08-23,madagascar,Africa,29016291,2,42847
2021-08-24,madagascar,Africa,29016291,0,42847
2021-08-25,madagascar,Africa,29016291,3,42850
2021-08-26,madagascar,Africa,29016291,4,42854
2021-08-27,madagascar,Africa,29016291,3,42857
2021-08-28,madagascar,Africa,29016291,5,42862
2021-08-29,madagascar,Africa,29016291,0,42862
2021-08-30,madagascar,Africa,29016291,3,42865
2021-08-31,madagascar,Africa,29016291,4,42869
2021-09-01,madagascar,Africa,29016291,4,42873
2021-09-02,madagascar,Africa,29016291,3,42876
2021-09-03,madagascar,Africa,29016291,2,42878
2021-09-04,madagascar,Africa,29016291,3,42881
2021-09-05,madagascar,Africa,29016291,3,42884
2021-09-06,madagascar,Africa,29016291,0,42884
2021-09-07,madagascar,Africa,29016291,0,42884
2021-09-08,madagascar,Africa,29016291,0,42884
2021-09-09,madagascar,Africa,29016291,6,42890
2021-09-10,madagascar,Africa,29016291,1,42891
2021-09-11,madagascar,Africa,29016291,3,42894
2021-09-12,madagascar,Africa,29016291,0,42894
2021-09-13,madagascar,Africa,29016291,4,42898
2021-09-14,madagascar,Africa,29016291,0,42898
2021-09-15,madagascar,Africa,29016291,0,42898
2021-09-16,madagascar,Africa,29016291,0,42898
2021-09-17,madagascar,Africa,29016291,0,42898
2021-09-18,madagascar,Africa,29016291,0,42898
2021-09-19,madagascar,Africa,29016291,0,42898
2021-09-20,madagascar,Africa,29016291,0,42898
2021-09-21,madagascar,Africa,29016291,672,43570
2021-09-22,madagascar,Africa,29016291,0,43570
2021-09-23,madagascar,Africa,29016291,0,43570
2021-09-24,madagascar,Africa,29016291,0,43570
2021-09-25,madagascar,Africa,29016291,0,43570
2021-09-26,madagascar,Africa,29016291,0,43570
2021-09-27,madagascar,Africa,29016291,0,43570
2021-09-28,madagascar,Africa,29016291,0,43570
2021-09-29,madagascar,Africa,29016291,27,43597
2021-09-30,madagascar,Africa,29016291,0,43597
2021-10-01,madagascar,Africa,29016291,0,43597
2021-10-02,madagascar,Africa,29016291,0,43597
2021-10-03,madagascar,Africa,29016291,0,43597
2021-10-04,madagascar,Africa,29016291,0,43597
2021-10-05,madagascar,Africa,29016291,13,43610
2021-10-06,madagascar,Africa,29016291,0,43610
2021-10-07,madagascar,Africa,29016291,0,43610
2021-10-08,madagascar,Africa,29016291,0,43610
2021-10-09,madagascar,Africa,29016291,0,43610
2021-10-10,madagascar,Africa,29016291,0,43610
2021-10-11,madagascar,Africa,29016291,0,43610
2021-10-12,madagascar,Africa,29016291,0,43610
2021-10-13,madagascar,Africa,29016291,0,43610
2021-10-14,madagascar,Africa,29016291,6,43616
2021-10-15,madagascar,Africa,29016291,0,43616
2021-10-16,madagascar,Africa,29016291,0,43616
2021-10-17,madagascar,Africa,29016291,0,43616
2021-10-18,madagascar,Africa,29016291,0,43616
2021-10-19,madagascar,Africa,29016291,0,43616
2021-10-20,madagascar,Africa,29016291,0,43616
2021-10-21,madagascar,Africa,29016291,0,43616
2021-10-22,madagascar,Africa,29016291,0,43616
2021-10-23,madagascar,Africa,29016291,6,43622
2021-10-24,madagascar,Africa,29016291,0,43622
2021-10-25,madagascar,Africa,29016291,0,43622
2021-10-26,madagascar,Africa,29016291,4,43626
2021-10-27,madagascar,Africa,29016291,0,43626
2021-10-28,madagascar,Africa,29016291,0,43626
2021-10-29,madagascar,Africa,29016291,0,43626
2021-10-30,madagascar,Africa,29016291,0,43626
2021-10-31,madagascar,Africa,29016291,0,43626
2021-11-01,madagascar,Africa,29016291,0,43626
2021-11-02,madagascar,Africa,29016291,0,43626
2021-11-03,madagascar,Africa,29016291,0,43626
2021-11-04,madagascar,Africa,29016291,6,43632
2021-11-05,madagascar,Africa,29016291,0,43632
2021-11-06,madagascar,Africa,29016291,0,43632
2021-11-07,madagascar,Africa,29016291,0,43632
2021-11-08,madagascar,Africa,29016291,0,43632
2021-11-09,madagascar,Africa,29016291,0,43632
2021-11-10,madagascar,Africa,29016291,40,43672
2021-11-11,madagascar,Africa,29016291,0,43672
2021-11-12,madagascar,Africa,29016291,0,43672
2021-11-13,madagascar,Africa,29016291,0,43672
2021-11-14,madagascar,Africa,29016291,0,43672
2021-11-15,madagascar,Africa,29016291,0,43672
2021-11-16,madagascar,Africa,29016291,0,43672
2021-11-17,madagascar,Africa,29016291,0,43672
2021-11-18,madagascar,Africa,29016291,0,43672
2021-11-19,madagascar,Africa,29016291,0,43672
2021-11-20,madagascar,Africa,29016291,0,43672
2021-11-21,madagascar,Africa,29016291,0,43672
2021-11-22,madagascar,Africa,29016291,0,43672
2021-11-23,madagascar,Africa,29016291,400,44072
2021-11-24,madagascar,Africa,29016291,0,44072
2021-11-25,madagascar,Africa,29016291,0,44072
2021-11-26,madagascar,Africa,29016291,0,44072
2021-11-27,madagascar,Africa,29016291,0,44072
2021-11-28,madagascar,Africa,29016291,0,44072
2021-11-29,madagascar,Africa,29016291,258,44330
2021-11-30,madagascar,Africa,29016291,0,44330
2021-12-01,madagascar,Africa,29016291,0,44330
2021-12-02,madagascar,Africa,29016291,0,44330
2021-12-03,madagascar,Africa,29016291,0,44330
2021-12-04,madagascar,Africa,29016291,470,44800
2021-12-05,madagascar,Africa,29016291,0,44800
2021-12-06,madagascar,Africa,29016291,0,44800
2021-12-07,madagascar,Africa,29016291,0,44800
2021-12-08,madagascar,Africa,29016291,0,44800
2021-12-09,madagascar,Africa,29016291,0,44800
2021-12-10,madagascar,Africa,29016291,0,44800
2020-02-20,malaysia,Asia,33138284,0,22
2020-02-21,malaysia,Asia,33138284,0,22
2020-02-22,malaysia,Asia,33138284,0,22
2020-02-23,malaysia,Asia,33138284,0,22
2020-02-24,malaysia,Asia,33138284,0,22
2020-02-25,malaysia,Asia,33138284,0,22
2020-02-26,malaysia,Asia,33138284,0,22
2020-02-27,malaysia,Asia,33138284,1,23
2020-02-28,malaysia,Asia,33138284,2,25
2020-02-29,malaysia,Asia,33138284,0,25
2020-03-01,malaysia,Asia,33138284,4,29
2020-03-02,malaysia,Asia,33138284,0,29
2020-03-03,malaysia,Asia,33138284,7,36
2020-03-04,malaysia,Asia,33138284,14,50
2020-03-05,malaysia,Asia,33138284,5,55
2020-03-06,malaysia,Asia,33138284,28,83
2020-03-07,malaysia,Asia,33138284,10,93
2020-03-08,malaysia,Asia,33138284,6,99
2020-03-09,malaysia,Asia,33138284,18,117
2020-03-10,malaysia,Asia,33138284,12,129
2020-03-11,malaysia,Asia,33138284,20,149
2020-03-12,malaysia,Asia,33138284,9,158
2020-03-13,malaysia,Asia,33138284,39,197
2020-03-14,malaysia,Asia,33138284,41,238
2020-03-15,malaysia,Asia,33138284,190,428
2020-03-16,malaysia,Asia,33138284,125,553
2020-03-17,malaysia,Asia,33138284,120,673
2020-03-18,malaysia,Asia,33138284,117,790
2020-03-19,malaysia,Asia,33138284,110,900
2020-03-20,malaysia,Asia,33138284,130,1030
2020-03-21,malaysia,Asia,33138284,153,1183
2020-03-22,malaysia,Asia,33138284,123,1306
2020-03-23,malaysia,Asia,33138284,212,1518
2020-03-24,malaysia,Asia,33138284,106,1624
2020-03-25,malaysia,Asia,33138284,172,1796
2020-03-26,malaysia,Asia,33138284,235,2031
2020-03-27,malaysia,Asia,33138284,130,2161
2020-03-28,malaysia,Asia,33138284,159,2320
2020-03-29,malaysia,Asia,33138284,150,2470
2020-03-30,malaysia,Asia,33138284,156,2626
2020-03-31,malaysia,Asia,33138284,140,2766
2020-04-01,malaysia,Asia,33138284,142,2908
2020-04-02,malaysia,Asia,33138284,208,3116
2020-04-03,malaysia,Asia,33138284,217,3333
2020-04-04,malaysia,Asia,33138284,150,3483
2020-04-05,malaysia,Asia,33138284,179,3662
2020-04-06,malaysia,Asia,33138284,131,3793
2020-04-07,malaysia,Asia,33138284,170,3963
2020-04-08,malaysia,Asia,33138284,156,4119
2020-04-09,malaysia,Asia,33138284,109,4228
2020-04-10,malaysia,Asia,33138284,118,4346
2020-04-11,malaysia,Asia,33138284,184,4530
2020-04-12,malaysia,Asia,33138284,153,4683
2020-04-13,malaysia,Asia,33138284,134,4817
2020-04-14,malaysia,Asia,33138284,170,4987
2020-04-15,malaysia,Asia,33138284,85,5072
2020-04-16,malaysia,Asia,33138284,110,5182
2020-04-17,malaysia,Asia,33138284,69,5251
2020-04-18,malaysia,Asia,33138284,54,5305
2020-04-19,malaysia,Asia,33138284,84,5389
2020-04-20,malaysia,Asia,33138284,36,5425
2020-04-21,malaysia,Asia,33138284,57,5482
2020-04-22,malaysia,Asia,33138284,50,5532
2020-04-23,malaysia,Asia,33138284,71,5603
2020-04-24,malaysia,Asia,33138284,88,5691
2020-04-25,malaysia,Asia,33138284,51,5742
2020-04-26,malaysia,Asia,33138284,38,5780
2020-04-27,malaysia,Asia,33138284,40,5820
2020-04-28,malaysia,Asia,33138284,31,5851
2020-04-29,malaysia,Asia,33138284,94,5945
2020-04-30,malaysia,Asia,33138284,57,6002
2020-05-01,malaysia,Asia,33138284,69,6071
2020-05-02,malaysia,Asia,33138284,105,6176
2020-05-03,malaysia,Asia,33138284,122,6298
2020-05-04,malaysia,Asia,33138284,55,6353
2020-05-05,malaysia,Asia,33138284,30,6383
2020-05-06,malaysia,Asia,33138284,45,6428
2020-05-07,malaysia,Asia,33138284,39,6467
2020-04-30,maldives,Asia,558272,190,468
2020-05-01,maldives,Asia,558272,23,491
2020-05-02,maldives,Asia,558272,28,519
2020-05-03,maldives,Asia,558272,8,527
2020-05-04,maldives,Asia,558272,14,541
2020-05-05,maldives,Asia,558272,32,573
2020-05-06,maldives,Asia,558272,44,617
2020-05-07,maldives,Asia,558272,31,648
2020-05-08,maldives,Asia,558272,96,744
2020-05-09,maldives,Asia,558272,46,790
2020-05-10,maldives,Asia,558272,45,835
2020-05-11,maldives,Asia,558272,62,897
2020-05-12,maldives,Asia,558272,7,904
2020-05-13,maldives,Asia,558272,51,955
2020-05-14,maldives,Asia,558272,27,982
2020-05-15,maldives,Asia,558272,49,1031
2020-05-16,maldives,Asia,558272,47,1078
2020-05-17,maldives,Asia,558272,16,1094
2020-05-18,maldives,Asia,558272,12,1106
2020-05-19,maldives,Asia,558272,37,1143
2020-05-20,maldives,Asia,558272,43,1186
2020-05-21,maldives,Asia,558272,30,1216
2020-05-22,maldives,Asia,558272,58,1274
2020-05-23,maldives,Asia,558272,39,1313
2020-05-24,maldives,Asia,558272,58,1371
2020-05-25,maldives,Asia,558272,24,1395
2020-05-26,maldives,Asia,558272,43,1438
2020-05-27,maldives,Asia,558272,19,1457
2020-05-28,maldives,Asia,558272,56,1513
2020-05-29,maldives,Asia,558272,78,1591
2020-05-30,maldives,Asia,558272,81,1672
2020-05-31,maldives,Asia,558272,101,1773
2020-06-01,maldives,Asia,558272,56,1829
2020-06-02,maldives,Asia,558272,12,1841
2020-06-03,maldives,Asia,558272,9,1850
2020-06-04,maldives,Asia,558272,22,1872
2020-06-05,maldives,Asia,558272,11,1883
2020-06-06,maldives,Asia,558272,18,1901
2020-06-07,maldives,Asia,558272,2,1903
2020-06-08,maldives,Asia,558272,13,1916
2020-06-09,maldives,Asia,558272,26,1942
2020-06-10,maldives,Asia,558272,20,1962
2020-06-11,maldives,Asia,558272,14,1976
2020-06-12,maldives,Asia,558272,27,2003
2020-06-13,maldives,Asia,558272,10,2013
2020-06-14,maldives,Asia,558272,22,2035
2020-06-15,maldives,Asia,558272,30,2065
2020-06-16,maldives,Asia,558272,29,2094
2020-06-17,maldives,Asia,558272,26,2120
2020-06-18,maldives,Asia,558272,17,2137
2020-06-19,maldives,Asia,558272,13,2150
2020-06-20,maldives,Asia,558272,37,2187
2020-06-21,maldives,Asia,558272,16,2203
2020-06-22,maldives,Asia,558272,14,2217
2020-06-23,maldives,Asia,558272,21,2238
2020-06-24,maldives,Asia,558272,23,2261
2020-06-25,maldives,Asia,558272,16,2277
2020-06-26,maldives,Asia,558272,6,2283
2020-06-27,maldives,Asia,558272,22,2305
2020-06-28,maldives,Asia,558272,19,2324
2020-06-29,maldives,Asia,558272,13,2337
2020-06-30,maldives,Asia,558272,24,2361
2020-07-01,maldives,Asia,558272,21,2382
2020-07-02,maldives,Asia,558272,18,2400
2020-07-03,maldives,Asia,558272,10,2410
2020-07-04,maldives,Asia,558272,25,2435
2020-07-05,maldives,Asia,558272,33,2468
2020-07-06,maldives,Asia,558272,23,2491
2020-07-07,maldives,Asia,558272,10,2501
2020-07-08,maldives,Asia,558272,16,2517
2020-07-09,maldives,Asia,558272,36,2553
2020-07-10,maldives,Asia,558272,64,2617
2020-07-11,maldives,Asia,558272,47,2664
2020-07-12,maldives,Asia,558272,67,2731
2020-07-13,maldives,Asia,558272,31,2762
2020-07-14,maldives,Asia,558272,39,2801
2020-07-15,maldives,Asia,558272,30,2831
2020-07-16,maldives,Asia,558272,68,2899
2020-07-17,maldives,Asia,558272,14,2913
2020-07-18,maldives,Asia,558272,17,2930
2020-07-19,maldives,Asia,558272,36,2966
2020-07-20,maldives,Asia,558272,33,2999
2020-07-21,maldives,Asia,558272,45,3044
2020-07-22,maldives,Asia,558272,59,3103
2020-07-23,maldives,Asia,558272,17,3120
2020-07-24,maldives,Asia,558272,55,3175
2020-07-25,maldives,Asia,558272,77,3252
2020-07-26,maldives,Asia,558272,50,3302
2020-07-27,maldives,Asia,558272,67,3369
2020-07-28,maldives,Asia,558272,137,3506
2020-07-29,maldives,Asia,558272,61,3567
2020-07-30,maldives,Asia,558272,152,3719
2020-07-31,maldives,Asia,558272,74,3793
2020-08-01,maldives,Asia,558272,156,3949
2020-08-02,maldives,Asia,558272,215,4164
2020-08-03,maldives,Asia,558272,129,4293
2020-08-04,maldives,Asia,558272,153,4446
2020-08-05,maldives,Asia,558272,148,4594
2020-08-06,maldives,Asia,558272,86,4680
2020-08-07,maldives,Asia,558272,89,4769
2020-08-08,maldives,Asia,558272,129,4898
2020-08-09,maldives,Asia,558272,143,5041
2020-08-10,maldives,Asia,558272,116,5157
2020-08-11,maldives,Asia,558272,66,5223
2020-08-12,maldives,Asia,558272,143,5366
2020-08-13,maldives,Asia,558272,128,5494
2020-08-14,maldives,Asia,558272,78,5572
2020-08-15,maldives,Asia,558272,107,5679
2020-08-16,maldives,Asia,558272,106,5785
2020-08-17,maldives,Asia,558272,124,5909
2020-08-18,maldives,Asia,558272,170,6079
2020-08-19,maldives,Asia,558272,146,6225
2020-08-20,maldives,Asia,558272,145,6370
2020-08-21,maldives,Asia,558272,194,6564
2020-08-22,maldives,Asia,558272,96,6660
2020-08-23,maldives,Asia,558272,119,6779
2020-08-24,maldives,Asia,558272,133,6912
2020-08-25,maldives,Asia,558272,135,7047
2020-08-26,maldives,Asia,558272,178,7225
2020-08-27,maldives,Asia,558272,104,7329
2020-08-28,maldives,Asia,558272,140,7469
2020-08-29,maldives,Asia,558272,109,7578
2020-08-30,maldives,Asia,558272,89,7667
2020-08-31,maldives,Asia,558272,137,7804
2020-09-01,maldives,Asia,558272,199,8003
2020-09-02,maldives,Asia,558272,137,8140
2020-09-03,maldives,Asia,558272,141,8281
2020-09-04,maldives,Asia,558272,80,8361
2020-09-05,maldives,Asia,558272,125,8486
2020-09-06,maldives,Asia,558272,98,8584
2020-09-07,maldives,Asia,558272,83,8667
2020-09-08,maldives,Asia,558272,74,8741
2020-09-09,maldives,Asia,558272,93,8834
2020-09-10,maldives,Asia,558272,66,8900
2020-09-11,maldives,Asia,558272,90,8990
2020-09-12,maldives,Asia,558272,62,9052
2020-09-13,maldives,Asia,558272,121,9173
2020-09-14,maldives,Asia,558272,70,9243
2020-09-15,maldives,Asia,558272,85,9328
2020-09-16,maldives,Asia,558272,99,9427
2020-09-17,maldives,Asia,558272,67,9494
2020-09-18,maldives,Asia,558272,74,9568
2020-09-19,maldives,Asia,558272,81,9649
2020-09-20,maldives,Asia,558272,75,9724
2020-09-21,maldives,Asia,558272,46,9770
2020-09-22,maldives,Asia,558272,48,9818
2020-09-23,maldives,Asia,558272,67,9885
2020-09-24,maldives,Asia,558272,54,9939
2020-09-25,maldives,Asia,558272,75,10014
2020-09-26,maldives,Asia,558272,31,10045
2020-09-27,maldives,Asia,558272,53,10098
2020-09-28,maldives,Asia,558272,59,10157
2020-09-29,maldives,Asia,558272,37,10194
2020-09-30,maldives,Asia,558272,97,10291
2020-10-01,maldives,Asia,558272,63,10354
2020-10-02,maldives,Asia,558272,44,10398
2020-10-03,maldives,Asia,558272,67,10465
2020-10-04,maldives,Asia,558272,65,10530
2020-10-05,maldives,Asia,558272,37,10567
2020-10-06,maldives,Asia,558272,54,10621
2020-10-07,maldives,Asia,558272,35,10656
2020-10-08,maldives,Asia,558272,86,10742
2020-10-09,maldives,Asia,558272,66,10808
2020-10-10,maldives,Asia,558272,51,10859
2020-10-11,maldives,Asia,558272,35,10894
2020-10-12,maldives,Asia,558272,49,10943
2020-10-13,maldives,Asia,558272,50,10993
2020-10-14,maldives,Asia,558272,69,11062
2020-10-15,maldives,Asia,558272,51,11113
2020-10-16,maldives,Asia,558272,41,11154
2020-10-17,maldives,Asia,558272,24,11178
2020-10-18,maldives,Asia,558272,32,11210
2020-10-19,maldives,Asia,558272,22,11232
2020-10-20,maldives,Asia,558272,39,11271
2020-10-21,maldives,Asia,558272,45,11316
2020-10-22,maldives,Asia,558272,42,11358
2020-10-23,maldives,Asia,558272,33,11391
2020-10-24,maldives,Asia,558272,30,11421
2020-10-25,maldives,Asia,558272,84,11505
2020-10-26,maldives,Asia,558272,27,11532
2020-10-27,maldives,Asia,558272,35,11567
2020-10-28,maldives,Asia,558272,24,11591
2020-10-29,maldives,Asia,558272,25,11616
2020-10-30,maldives,Asia,558272,27,11643
2020-10-31,maldives,Asia,558272,16,11659
2020-11-01,maldives,Asia,558272,42,11701
2020-11-02,maldives,Asia,558272,36,11737
2020-11-03,maldives,Asia,558272,59,11796
2020-11-04,maldives,Asia,558272,26,11822
2020-11-05,maldives,Asia,558272,71,11893
2020-11-06,maldives,Asia,558272,39,11932
2020-11-07,maldives,Asia,558272,30,11962
2020-11-08,maldives,Asia,558272,24,11986
2020-11-09,maldives,Asia,558272,23,12009
2020-11-10,maldives,Asia,558272,21,12030
2020-11-11,maldives,Asia,558272,29,12059
2020-11-12,maldives,Asia,558272,26,12085
2020-11-13,maldives,Asia,558272,27,12112
2020-11-14,maldives,Asia,558272,42,12154
2020-11-15,maldives,Asia,558272,50,12204
2020-11-16,maldives,Asia,558272,110,12314
2020-11-17,maldives,Asia,558272,41,12355
2020-11-18,maldives,Asia,558272,29,12384
2020-11-19,maldives,Asia,558272,68,12452
2020-11-20,maldives,Asia,558272,94,12546
2020-11-21,maldives,Asia,558272,32,12578
2020-11-22,maldives,Asia,558272,30,12608
2020-11-23,maldives,Asia,558272,150,12758
2020-11-24,maldives,Asia,558272,52,12810
2020-11-25,maldives,Asia,558272,44,12854
2020-11-26,maldives,Asia,558272,35,12889
2020-11-27,maldives,Asia,558272,44,12933
2020-11-28,maldives,Asia,558272,14,12947
2020-11-29,maldives,Asia,558272,47,12994
2020-11-30,maldives,Asia,558272,17,13011
2020-12-01,maldives,Asia,558272,38,13049
2020-12-02,maldives,Asia,558272,21,13070
2020-12-03,maldives,Asia,558272,36,13106
2020-12-04,maldives,Asia,558272,37,13143
2020-12-05,maldives,Asia,558272,16,13159
2020-12-06,maldives,Asia,558272,39,13198
2020-12-07,maldives,Asia,558272,15,13213
2020-12-08,maldives,Asia,558272,35,13248
2020-12-09,maldives,Asia,558272,26,13274
2020-12-10,maldives,Asia,558272,34,13308
2020-12-11,maldives,Asia,558272,18,13326
2020-12-12,maldives,Asia,558272,22,13348
2020-12-13,maldives,Asia,558272,20,13368
2020-12-14,maldives,Asia,558272,11,13379
2020-12-15,maldives,Asia,558272,13,13392
2020-12-16,maldives,Asia,558272,10,13402
2020-12-17,maldives,Asia,558272,16,13418
2020-12-18,maldives,Asia,558272,26,13444
2020-12-19,maldives,Asia,558272,30,13474
2020-12-20,maldives,Asia,558272,19,13493
2020-12-21,maldives,Asia,558272,8,13501
2020-12-22,maldives,Asia,558272,23,13524
2020-12-23,maldives,Asia,558272,13,13537
2020-12-24,maldives,Asia,558272,21,13558
2020-12-25,maldives,Asia,558272,25,13583
2020-12-26,maldives,Asia,558272,35,13618
2020-12-27,maldives,Asia,558272,26,13644
2020-12-28,maldives,Asia,558272,16,13660
2020-12-29,maldives,Asia,558272,31,13691
2020-12-30,maldives,Asia,558272,47,13738
2020-12-31,maldives,Asia,558272,19,13757
2021-01-01,maldives,Asia,558272,47,13804
2021-01-02,maldives,Asia,558272,30,13834
2021-01-03,maldives,Asia,558272,33,13867
2021-01-04,maldives,Asia,558272,26,13893
2021-01-05,maldives,Asia,558272,37,13930
2021-01-06,maldives,Asia,558272,37,13967
2021-01-07,maldives,Asia,558272,21,13988
2021-01-08,maldives,Asia,558272,52,14040
2021-01-09,maldives,Asia,558272,25,14065
2021-01-10,maldives,Asia,558272,44,14109
2021-01-11,maldives,Asia,558272,50,14159
2021-01-12,maldives,Asia,558272,59,14218
2021-01-13,maldives,Asia,558272,59,14277
2021-01-14,maldives,Asia,558272,48,14325
2021-01-15,maldives,Asia,558272,50,14375
2021-01-16,maldives,Asia,558272,87,14462
2021-01-17,maldives,Asia,558272,51,14513
2020-03-29,mali,Africa,21336613,0,18
2020-03-30,mali,Africa,21336613,7,25
2020-03-31,mali,Africa,21336613,3,28
2020-04-01,mali,Africa,21336613,3,31
2020-04-02,mali,Africa,21336613,5,36
2020-04-03,mali,Africa,21336613,3,39
2020-04-04,mali,Africa,21336613,2,41
2020-04-05,mali,Africa,21336613,4,45
2020-04-06,mali,Africa,21336613,2,47
2020-04-07,mali,Africa,21336613,9,56
2020-04-08,mali,Africa,21336613,3,59
2020-04-09,mali,Africa,21336613,15,74
2020-04-10,mali,Africa,21336613,13,87
2020-04-11,mali,Africa,21336613,0,87
2020-04-12,mali,Africa,21336613,18,105
2020-04-13,mali,Africa,21336613,18,123
2020-04-14,mali,Africa,21336613,21,144
2020-04-15,mali,Africa,21336613,4,148
2020-04-16,mali,Africa,21336613,23,171
2020-04-17,mali,Africa,21336613,0,171
2020-04-18,mali,Africa,21336613,45,216
2020-04-19,mali,Africa,21336613,8,224
2020-04-20,mali,Africa,21336613,22,246
2020-04-21,mali,Africa,21336613,12,258
2020-04-22,mali,Africa,21336613,35,293
2020-04-23,mali,Africa,21336613,16,309
2020-04-24,mali,Africa,21336613,16,325
2020-04-25,mali,Africa,21336613,45,370
2020-04-26,mali,Africa,21336613,19,389
2020-04-27,mali,Africa,21336613,19,408
2020-04-28,mali,Africa,21336613,16,424
2020-04-29,mali,Africa,21336613,58,482
2020-04-30,mali,Africa,21336613,8,490
2020-05-01,mali,Africa,21336613,18,508
2020-05-02,mali,Africa,21336613,36,544
2020-05-03,mali,Africa,21336613,19,563
2020-05-04,mali,Africa,21336613,17,580
2020-05-05,mali,Africa,21336613,32,612
2020-05-06,mali,Africa,21336613,19,631
2020-05-07,mali,Africa,21336613,19,650
2020-05-08,mali,Africa,21336613,18,668
2020-05-09,mali,Africa,21336613,24,692
2020-05-10,mali,Africa,21336613,12,704
2020-05-11,mali,Africa,21336613,8,712
2020-05-12,mali,Africa,21336613,18,730
2020-05-13,mali,Africa,21336613,28,758
2020-05-14,mali,Africa,21336613,21,779
2020-05-15,mali,Africa,21336613,27,806
2020-05-16,mali,Africa,21336613,29,835
2020-05-17,mali,Africa,21336613,25,860
2020-05-18,mali,Africa,21336613,14,874
2020-05-19,mali,Africa,21336613,27,901
2020-05-20,mali,Africa,21336613,30,931
2020-05-21,mali,Africa,21336613,16,947
2020-05-22,mali,Africa,21336613,22,969
2020-05-23,mali,Africa,21336613,46,1015
2020-05-24,mali,Africa,21336613,15,1030
2020-05-25,mali,Africa,21336613,29,1059
2020-05-26,mali,Africa,21336613,18,1077
2020-05-27,mali,Africa,21336613,39,1116
2020-05-28,mali,Africa,21336613,78,1194
2020-05-29,mali,Africa,21336613,32,1226
2020-05-30,mali,Africa,21336613,24,1250
2020-05-31,mali,Africa,21336613,15,1265
2020-06-01,mali,Africa,21336613,50,1315
2020-06-02,mali,Africa,21336613,36,1351
2020-06-03,mali,Africa,21336613,35,1386
2020-06-04,mali,Africa,21336613,75,1461
2020-06-05,mali,Africa,21336613,24,1485
2020-06-06,mali,Africa,21336613,38,1523
2020-06-07,mali,Africa,21336613,10,1533
2020-06-08,mali,Africa,21336613,14,1547
2020-06-09,mali,Africa,21336613,39,1586
2020-06-10,mali,Africa,21336613,81,1667
2020-06-11,mali,Africa,21336613,55,1722
2020-06-12,mali,Africa,21336613,30,1752
2020-06-13,mali,Africa,21336613,24,1776
2020-06-14,mali,Africa,21336613,33,1809
2020-06-15,mali,Africa,21336613,51,1860
2020-06-16,mali,Africa,21336613,25,1885
2020-06-17,mali,Africa,21336613,5,1890
2020-06-18,mali,Africa,21336613,16,1906
2020-06-19,mali,Africa,21336613,17,1923
2020-06-20,mali,Africa,21336613,0,1923
2020-06-21,mali,Africa,21336613,10,1933
2020-06-22,mali,Africa,21336613,28,1961
2020-06-23,mali,Africa,21336613,17,1978
2020-06-24,mali,Africa,21336613,27,2005
2020-06-25,mali,Africa,21336613,34,2039
2020-06-26,mali,Africa,21336613,21,2060
2020-06-27,mali,Africa,21336613,58,2118
2020-06-28,mali,Africa,21336613,29,2147
2020-06-29,mali,Africa,21336613,26,2173
2020-06-30,mali,Africa,21336613,8,2181
2020-07-01,mali,Africa,21336613,21,2202
2020-07-02,mali,Africa,21336613,58,2260
2020-07-03,mali,Africa,21336613,25,2285
2020-07-04,mali,Africa,21336613,18,2303
2020-07-05,mali,Africa,21336613,27,2330
2020-07-06,mali,Africa,21336613,1,2331
2020-07-07,mali,Africa,21336613,17,2348
2020-07-08,mali,Africa,21336613,10,2358
2020-07-09,mali,Africa,21336613,12,2370
2020-07-10,mali,Africa,21336613,34,2404
2020-07-11,mali,Africa,21336613,2,2406
2020-07-12,mali,Africa,21336613,5,2411
2020-07-13,mali,Africa,21336613,1,2412
2020-07-14,mali,Africa,21336613,11,2423
2020-07-15,mali,Africa,21336613,10,2433
2020-07-16,mali,Africa,21336613,7,2440
2020-07-17,mali,Africa,21336613,27,2467
2020-07-18,mali,Africa,21336613,5,2472
2020-07-19,mali,Africa,21336613,3,2475
2020-07-20,mali,Africa,21336613,0,2475
2020-07-21,mali,Africa,21336613,2,2477
2020-07-22,mali,Africa,21336613,17,2494
2020-07-23,mali,Africa,21336613,0,2494
2020-07-24,mali,Africa,21336613,9,2503
2020-07-25,mali,Africa,21336613,0,2503
2020-07-26,mali,Africa,21336613,7,2510
2020-07-27,mali,Africa,21336613,3,2513
2020-07-28,mali,Africa,21336613,7,2520
2020-07-29,mali,Africa,21336613,1,2521
2020-07-30,mali,Africa,21336613,1,2522
2020-07-31,mali,Africa,21336613,13,2535
2020-08-01,mali,Africa,21336613,0,2535
2020-08-02,mali,Africa,21336613,6,2541
2020-08-03,mali,Africa,21336613,2,2543
2020-08-04,mali,Africa,21336613,0,2543
2020-08-05,mali,Africa,21336613,3,2546
2020-08-06,mali,Africa,21336613,6,2552
2020-08-07,mali,Africa,21336613,9,2561
2020-08-08,mali,Africa,21336613,4,2565
2020-08-09,mali,Africa,21336613,2,2567
2020-08-10,mali,Africa,21336613,6,2573
2020-08-11,mali,Africa,21336613,4,2577
2020-08-12,mali,Africa,21336613,5,2582
2020-08-13,mali,Africa,21336613,15,2597
2020-08-14,mali,Africa,21336613,0,2597
2020-08-15,mali,Africa,21336613,17,2614
2020-08-16,mali,Africa,21336613,26,2640
2020-08-17,mali,Africa,21336613,0,2640
2020-08-18,mali,Africa,21336613,26,2666
2020-08-19,mali,Africa,21336613,1,2667
2020-08-20,mali,Africa,21336613,0,2667
2020-08-21,mali,Africa,21336613,21,2688
2020-08-22,mali,Africa,21336613,11,2699
2020-08-23,mali,Africa,21336613,6,2705
2020-08-24,mali,Africa,21336613,3,2708
2020-08-25,mali,Africa,21336613,5,2713
2020-08-26,mali,Africa,21336613,4,2717
2020-08-27,mali,Africa,21336613,13,2730
2020-08-28,mali,Africa,21336613,6,2736
2020-08-29,mali,Africa,21336613,21,2757
2020-08-30,mali,Africa,21336613,16,2773
2020-08-31,mali,Africa,21336613,3,2776
2020-09-01,mali,Africa,21336613,1,2777
2020-09-02,mali,Africa,21336613,25,2802
2020-09-03,mali,Africa,21336613,5,2807
2020-09-04,mali,Africa,21336613,7,2814
2020-09-05,mali,Africa,21336613,19,2833
2020-09-06,mali,Africa,21336613,9,2842
2020-09-07,mali,Africa,21336613,28,2870
2020-09-08,mali,Africa,21336613,12,2882
2020-09-09,mali,Africa,21336613,16,2898
2020-09-10,mali,Africa,21336613,11,2909
2020-09-11,mali,Africa,21336613,3,2912
2020-09-12,mali,Africa,21336613,4,2916
2020-09-13,mali,Africa,21336613,8,2924
2020-09-14,mali,Africa,21336613,11,2935
2020-09-15,mali,Africa,21336613,5,2940
2020-09-16,mali,Africa,21336613,26,2966
2020-09-17,mali,Africa,21336613,0,2966
2020-09-18,mali,Africa,21336613,25,2991
2020-09-19,mali,Africa,21336613,15,3006
2020-09-20,mali,Africa,21336613,7,3013
2020-09-21,mali,Africa,21336613,11,3024
2020-09-22,mali,Africa,21336613,6,3030
2020-09-23,mali,Africa,21336613,4,3034
2020-09-24,mali,Africa,21336613,7,3041
2020-09-25,mali,Africa,21336613,23,3064
2020-09-26,mali,Africa,21336613,16,3080
2020-09-27,mali,Africa,21336613,6,3086
2020-09-28,mali,Africa,21336613,4,3090
2020-09-29,mali,Africa,21336613,11,3101
2020-09-30,mali,Africa,21336613,17,3118
2020-10-01,mali,Africa,21336613,13,3131
2020-10-02,mali,Africa,21336613,25,3156
2020-10-03,mali,Africa,21336613,14,3170
2020-10-04,mali,Africa,21336613,14,3184
2020-10-05,mali,Africa,21336613,5,3189
2020-10-06,mali,Africa,21336613,6,3195
2020-10-07,mali,Africa,21336613,15,3210
2020-10-08,mali,Africa,21336613,25,3235
2020-10-09,mali,Africa,21336613,13,3248
2020-10-10,mali,Africa,21336613,25,3273
2020-10-11,mali,Africa,21336613,13,3286
2020-10-12,mali,Africa,21336613,10,3296
2020-10-13,mali,Africa,21336613,1,3297
2020-10-14,mali,Africa,21336613,55,3352
2020-10-15,mali,Africa,21336613,16,3368
2020-10-16,mali,Africa,21336613,10,3378
2020-10-17,mali,Africa,21336613,1,3379
2020-10-18,mali,Africa,21336613,9,3388
2020-10-19,mali,Africa,21336613,19,3407
2020-10-20,mali,Africa,21336613,4,3411
2020-10-21,mali,Africa,21336613,17,3428
2020-10-22,mali,Africa,21336613,12,3440
2020-10-23,mali,Africa,21336613,4,3444
2020-10-24,mali,Africa,21336613,28,3472
2020-10-25,mali,Africa,21336613,18,3490
2020-10-26,mali,Africa,21336613,9,3499
2020-10-27,mali,Africa,21336613,16,3515
2020-10-28,mali,Africa,21336613,15,3530
2020-10-29,mali,Africa,21336613,7,3537
2020-10-30,mali,Africa,21336613,8,3545
2020-10-31,mali,Africa,21336613,9,3554
2020-11-01,mali,Africa,21336613,11,3565
2020-11-02,mali,Africa,21336613,8,3573
2020-11-03,mali,Africa,21336613,11,3584
2020-11-04,mali,Africa,21336613,25,3609
2020-11-05,mali,Africa,21336613,24,3633
2020-11-06,mali,Africa,21336613,24,3657
2020-11-07,mali,Africa,21336613,19,3676
2020-11-08,mali,Africa,21336613,30,3706
2020-11-09,mali,Africa,21336613,6,3712
2020-11-10,mali,Africa,21336613,33,3745
2020-11-11,mali,Africa,21336613,8,3753
2020-11-12,mali,Africa,21336613,39,3792
2020-11-13,mali,Africa,21336613,14,3806
2020-11-14,mali,Africa,21336613,62,3868
2020-11-15,mali,Africa,21336613,32,3900
2020-11-16,mali,Africa,21336613,48,3948
2020-11-17,mali,Africa,21336613,32,3980
2020-11-18,mali,Africa,21336613,53,4033
2020-11-19,mali,Africa,21336613,60,4093
2020-11-20,mali,Africa,21336613,76,4169
2020-11-21,mali,Africa,21336613,37,4206
2020-11-22,mali,Africa,21336613,49,4255
2020-11-23,mali,Africa,21336613,71,4326
2020-11-24,mali,Africa,21336613,91,4417
2020-11-25,mali,Africa,21336613,44,4461
2020-11-26,mali,Africa,21336613,44,4505
2020-11-27,mali,Africa,21336613,62,4567
2020-11-28,mali,Africa,21336613,92,4659
2020-11-29,mali,Africa,21336613,29,4688
2020-11-30,mali,Africa,21336613,22,4710
2020-12-01,mali,Africa,21336613,52,4762
2020-12-02,mali,Africa,21336613,75,4837
2020-12-03,mali,Africa,21336613,43,4880
2020-12-04,mali,Africa,21336613,58,4938
2020-12-05,mali,Africa,21336613,124,5062
2020-12-06,mali,Africa,21336613,73,5135
2020-12-07,mali,Africa,21336613,155,5290
2020-12-08,mali,Africa,21336613,152,5442
2020-12-09,mali,Africa,21336613,27,5469
2020-12-10,mali,Africa,21336613,107,5576
2020-12-11,mali,Africa,21336613,73,5649
2020-12-12,mali,Africa,21336613,72,5721
2020-12-13,mali,Africa,21336613,93,5814
2020-12-14,mali,Africa,21336613,22,5836
2020-12-15,mali,Africa,21336613,42,5878
2020-12-16,mali,Africa,21336613,91,5969
2020-12-17,mali,Africa,21336613,80,6049
2020-12-18,mali,Africa,21336613,71,6120
2020-12-19,mali,Africa,21336613,44,6164
2020-12-20,mali,Africa,21336613,27,6191
2020-12-21,mali,Africa,21336613,41,6232
2020-12-22,mali,Africa,21336613,59,6291
2020-12-23,mali,Africa,21336613,56,6347
2020-12-24,mali,Africa,21336613,94,6441
2020-12-25,mali,Africa,21336613,47,6488
2020-12-26,mali,Africa,21336613,86,6574
2020-12-27,mali,Africa,21336613,55,6629
2020-12-28,mali,Africa,21336613,74,6703
2020-12-29,mali,Africa,21336613,93,6796
2020-12-30,mali,Africa,21336613,233,7029
2020-12-31,mali,Africa,21336613,61,7090
2021-01-01,mali,Africa,21336613,113,7203
2021-01-02,mali,Africa,21336613,23,7226
2021-01-03,mali,Africa,21336613,27,7253
2021-01-04,mali,Africa,21336613,7,7260
2021-01-05,mali,Africa,21336613,89,7349
2021-01-06,mali,Africa,21336613,46,7395
2021-01-07,mali,Africa,21336613,32,7427
2021-01-08,mali,Africa,21336613,85,7512
2021-01-09,mali,Africa,21336613,53,7565
2021-01-10,mali,Africa,21336613,35,7600
2021-01-11,mali,Africa,21336613,64,7664
2021-01-12,mali,Africa,21336613,23,7687
2021-01-13,mali,Africa,21336613,51,7738
2021-01-14,mali,Africa,21336613,21,7759
2021-01-15,mali,Africa,21336613,41,7800
2021-01-16,mali,Africa,21336613,23,7823
2021-01-17,mali,Africa,21336613,16,7839
2021-01-18,mali,Africa,21336613,16,7855
2021-01-19,mali,Africa,21336613,25,7880
2021-01-20,mali,Africa,21336613,17,7897
2021-01-21,mali,Africa,21336613,14,7911
2021-01-22,mali,Africa,21336613,26,7937
2021-01-23,mali,Africa,21336613,28,7965
2021-01-24,mali,Africa,21336613,18,7983
2021-01-25,mali,Africa,21336613,12,7995
2021-01-26,mali,Africa,21336613,11,8006
2021-01-27,mali,Africa,21336613,31,8037
2021-01-28,mali,Africa,21336613,19,8056
2021-01-29,mali,Africa,21336613,7,8063
2021-01-30,mali,Africa,21336613,6,8069
2021-01-31,mali,Africa,21336613,22,8091
2021-02-01,mali,Africa,21336613,9,8100
2021-02-02,mali,Africa,21336613,11,8111
2021-02-03,mali,Africa,21336613,8,8119
2021-02-04,mali,Africa,21336613,11,8130
2021-02-05,mali,Africa,21336613,15,8145
2021-02-06,mali,Africa,21336613,15,8160
2021-02-07,mali,Africa,21336613,16,8176
2021-02-08,mali,Africa,21336613,5,8181
2021-02-09,mali,Africa,21336613,11,8192
2021-02-10,mali,Africa,21336613,11,8203
2021-02-11,mali,Africa,21336613,15,8218
2021-02-12,mali,Africa,21336613,4,8222
2021-02-13,mali,Africa,21336613,4,8226
2021-02-14,mali,Africa,21336613,3,8229
2021-02-15,mali,Africa,21336613,6,8235
2021-02-16,mali,Africa,21336613,6,8241
2021-02-17,mali,Africa,21336613,15,8256
2021-02-18,mali,Africa,21336613,0,8256
2021-02-19,mali,Africa,21336613,4,8260
2021-02-20,mali,Africa,21336613,32,8292
2021-02-21,mali,Africa,21336613,7,8299
2021-02-22,mali,Africa,21336613,7,8306
2021-02-23,mali,Africa,21336613,18,8324
2021-02-24,mali,Africa,21336613,8,8332
2021-02-25,mali,Africa,21336613,17,8349
2021-02-26,mali,Africa,21336613,9,8358
2021-02-27,mali,Africa,21336613,7,8365
2021-02-28,mali,Africa,21336613,11,8376
2021-03-01,mali,Africa,21336613,14,8390
2021-03-02,mali,Africa,21336613,30,8420
2021-03-03,mali,Africa,21336613,26,8446
2021-03-04,mali,Africa,21336613,24,8470
2021-03-05,mali,Africa,21336613,39,8509
2021-03-06,mali,Africa,21336613,51,8560
2021-03-07,mali,Africa,21336613,20,8580
2021-03-08,mali,Africa,21336613,33,8613
2021-03-09,mali,Africa,21336613,0,8613
2021-03-10,mali,Africa,21336613,97,8710
2021-03-11,mali,Africa,21336613,72,8782
2021-03-12,mali,Africa,21336613,31,8813
2021-03-13,mali,Africa,21336613,49,8862
2021-03-14,mali,Africa,21336613,51,8913
2021-03-15,mali,Africa,21336613,20,8933
2021-03-16,mali,Africa,21336613,85,9018
2021-03-17,mali,Africa,21336613,48,9066
2021-03-18,mali,Africa,21336613,52,9118
2021-03-19,mali,Africa,21336613,73,9191
2021-03-20,mali,Africa,21336613,79,9270
2021-03-21,mali,Africa,21336613,60,9330
2021-03-22,mali,Africa,21336613,50,9380
2021-03-23,mali,Africa,21336613,94,9474
2021-03-24,mali,Africa,21336613,103,9577
2021-03-25,mali,Africa,21336613,70,9647
2021-03-26,mali,Africa,21336613,72,9719
2021-03-27,mali,Africa,21336613,54,9773
2021-03-28,mali,Africa,21336613,98,9871
2021-03-29,mali,Africa,21336613,50,9921
2021-03-30,mali,Africa,21336613,77,9998
2021-03-31,mali,Africa,21336613,44,10042
2021-04-01,mali,Africa,21336613,157,10199
2021-04-02,mali,Africa,21336613,86,10285
2021-04-03,mali,Africa,21336613,147,10432
2021-04-04,mali,Africa,21336613,148,10580
2021-04-05,mali,Africa,21336613,40,10620
2021-04-06,mali,Africa,21336613,138,10758
2021-04-07,mali,Africa,21336613,83,10841
2021-04-08,mali,Africa,21336613,413,11254
2021-04-09,mali,Africa,21336613,139,11393
2021-04-10,mali,Africa,21336613,312,11705
2021-04-11,mali,Africa,21336613,139,11844
2021-04-12,mali,Africa,21336613,158,12002
2021-04-13,mali,Africa,21336613,177,12179
2021-04-14,mali,Africa,21336613,288,12467
2021-04-15,mali,Africa,21336613,239,12706
2021-04-16,mali,Africa,21336613,129,12835
2021-04-17,mali,Africa,21336613,145,12980
2021-04-18,mali,Africa,21336613,90,13070
2021-04-19,mali,Africa,21336613,75,13145
2021-04-20,mali,Africa,21336613,101,13246
2021-04-21,mali,Africa,21336613,90,13336
2021-04-22,mali,Africa,21336613,84,13420
2021-04-23,mali,Africa,21336613,84,13504
2021-04-24,mali,Africa,21336613,56,13560
2021-04-25,mali,Africa,21336613,67,13627
2021-04-26,mali,Africa,21336613,31,13658
2021-04-27,mali,Africa,21336613,64,13722
2021-04-28,mali,Africa,21336613,58,13780
2021-04-29,mali,Africa,21336613,35,13815
2021-04-30,mali,Africa,21336613,43,13858
2021-05-01,mali,Africa,21336613,38,13896
2021-05-02,mali,Africa,21336613,19,13915
2021-05-03,mali,Africa,21336613,22,13937
2021-05-04,mali,Africa,21336613,32,13969
2021-05-05,mali,Africa,21336613,29,13998
2021-05-06,mali,Africa,21336613,31,14029
2021-05-07,mali,Africa,21336613,30,14059
2021-05-08,mali,Africa,21336613,23,14082
2021-05-09,mali,Africa,21336613,26,14108
2021-05-10,mali,Africa,21336613,7,14115
2021-05-11,mali,Africa,21336613,18,14133
2021-05-12,mali,Africa,21336613,16,14149
2021-05-13,mali,Africa,21336613,0,14149
2021-05-14,mali,Africa,21336613,14,14163
2021-05-15,mali,Africa,21336613,13,14176
2021-05-16,mali,Africa,21336613,14,14190
2021-05-17,mali,Africa,21336613,4,14194
2021-05-18,mali,Africa,21336613,13,14207
2021-05-19,mali,Africa,21336613,14,14221
2021-05-20,mali,Africa,21336613,5,14226
2021-05-21,mali,Africa,21336613,10,14236
2021-05-22,mali,Africa,21336613,4,14240
2021-05-23,mali,Africa,21336613,1,14241
2021-05-24,mali,Africa,21336613,3,14244
2021-05-25,mali,Africa,21336613,8,14252
2021-05-26,mali,Africa,21336613,4,14256
2021-05-27,mali,Africa,21336613,3,14259
2021-05-28,mali,Africa,21336613,3,14262
2021-05-29,mali,Africa,21336613,3,14265
2021-05-30,mali,Africa,21336613,0,14265
2021-05-31,mali,Africa,21336613,2,14267
2021-06-01,mali,Africa,21336613,4,14271
2021-06-02,mali,Africa,21336613,10,14281
2021-06-03,mali,Africa,21336613,0,14281
2021-06-04,mali,Africa,21336613,6,14287
2021-06-05,mali,Africa,21336613,9,14296
2021-06-06,mali,Africa,21336613,2,14298
2021-06-07,mali,Africa,21336613,4,14302
2021-06-08,mali,Africa,21336613,22,14324
2021-06-09,mali,Africa,21336613,4,14328
2021-06-10,mali,Africa,21336613,1,14329
2021-06-11,mali,Africa,21336613,7,14336
2021-06-12,mali,Africa,21336613,13,14349
2021-06-13,mali,Africa,21336613,1,14350
2021-06-14,mali,Africa,21336613,2,14352
2021-06-15,mali,Africa,21336613,4,14356
2021-06-16,mali,Africa,21336613,3,14359
2021-06-17,mali,Africa,21336613,5,14364
2021-06-18,mali,Africa,21336613,11,14375
2021-06-19,mali,Africa,21336613,5,14380
2021-06-20,mali,Africa,21336613,1,14381
2021-06-21,mali,Africa,21336613,4,14385
2021-06-22,mali,Africa,21336613,0,14385
2021-06-23,mali,Africa,21336613,6,14391
2021-06-24,mali,Africa,21336613,5,14396
2021-06-25,mali,Africa,21336613,8,14404
2021-06-26,mali,Africa,21336613,10,14414
2021-06-27,mali,Africa,21336613,3,14417
2021-06-28,mali,Africa,21336613,2,14419
2021-06-29,mali,Africa,21336613,3,14422
2021-06-30,mali,Africa,21336613,4,14426
2021-07-01,mali,Africa,21336613,2,14428
2021-07-02,mali,Africa,21336613,7,14435
2021-07-03,mali,Africa,21336613,3,14438
2021-07-04,mali,Africa,21336613,11,14449
2021-07-05,mali,Africa,21336613,2,14451
2021-07-06,mali,Africa,21336613,3,14454
2021-07-07,mali,Africa,21336613,0,14454
2021-07-08,mali,Africa,21336613,1,14455
2021-07-09,mali,Africa,21336613,2,14457
2021-07-10,mali,Africa,21336613,4,14461
2021-07-11,mali,Africa,21336613,2,14463
2021-07-12,mali,Africa,21336613,13,14476
2021-07-13,mali,Africa,21336613,10,14486
2021-07-14,mali,Africa,21336613,6,14492
2021-07-15,mali,Africa,21336613,4,14496
2021-07-16,mali,Africa,21336613,6,14502
2021-07-17,mali,Africa,21336613,7,14509
2021-07-18,mali,Africa,21336613,4,14513
2021-07-19,mali,Africa,21336613,0,14513
2021-07-20,mali,Africa,21336613,9,14522
2021-07-21,mali,Africa,21336613,2,14524
2021-07-22,mali,Africa,21336613,3,14527
2021-07-23,mali,Africa,21336613,5,14532
2021-07-24,mali,Africa,21336613,8,14540
2021-07-25,mali,Africa,21336613,2,14542
2021-07-26,mali,Africa,21336613,4,14546
2021-07-27,mali,Africa,21336613,5,14551
2021-07-28,mali,Africa,21336613,12,14563
2021-07-29,mali,Africa,21336613,3,14566
2021-07-30,mali,Africa,21336613,8,14574
2021-07-31,mali,Africa,21336613,10,14584
2021-08-01,mali,Africa,21336613,3,14587
2021-08-02,mali,Africa,21336613,2,14589
2021-08-03,mali,Africa,21336613,6,14595
2021-08-04,mali,Africa,21336613,10,14605
2021-08-05,mali,Africa,21336613,10,14615
2021-08-06,mali,Africa,21336613,18,14633
2021-08-07,mali,Africa,21336613,4,14637
2021-08-08,mali,Africa,21336613,5,14642
2021-08-09,mali,Africa,21336613,5,14647
2021-08-10,mali,Africa,21336613,5,14652
2021-08-11,mali,Africa,21336613,10,14662
2021-08-12,mali,Africa,21336613,7,14669
2021-08-13,mali,Africa,21336613,16,14685
2021-08-14,mali,Africa,21336613,7,14692
2021-08-15,mali,Africa,21336613,3,14695
2021-08-16,mali,Africa,21336613,2,14697
2021-08-17,mali,Africa,21336613,4,14701
2021-08-18,mali,Africa,21336613,13,14714
2021-08-19,mali,Africa,21336613,21,14735
2021-08-20,mali,Africa,21336613,5,14740
2021-08-21,mali,Africa,21336613,9,14749
2021-08-22,mali,Africa,21336613,8,14757
2021-08-23,mali,Africa,21336613,6,14763
2021-08-24,mali,Africa,21336613,15,14778
2021-08-25,mali,Africa,21336613,17,14795
2021-08-26,mali,Africa,21336613,8,14803
2021-08-27,mali,Africa,21336613,11,14814
2021-08-28,mali,Africa,21336613,32,14846
2020-04-09,malta,Europe,443733,38,337
2020-04-10,malta,Europe,443733,13,350
2020-04-11,malta,Europe,443733,20,370
2020-04-12,malta,Europe,443733,8,378
2020-04-13,malta,Europe,443733,6,384
2020-04-14,malta,Europe,443733,9,393
2020-04-15,malta,Europe,443733,6,399
2020-04-16,malta,Europe,443733,13,412
2020-04-17,malta,Europe,443733,10,422
2020-04-18,malta,Europe,443733,4,426
2020-04-19,malta,Europe,443733,1,427
2020-04-20,malta,Europe,443733,4,431
2020-04-21,malta,Europe,443733,12,443
2020-04-22,malta,Europe,443733,1,444
2020-04-23,malta,Europe,443733,1,445
2020-04-24,malta,Europe,443733,2,447
2020-04-25,malta,Europe,443733,1,448
2020-04-26,malta,Europe,443733,0,448
2020-04-27,malta,Europe,443733,2,450
2020-04-28,malta,Europe,443733,8,458
2020-04-29,malta,Europe,443733,5,463
2020-04-30,malta,Europe,443733,2,465
2020-05-01,malta,Europe,443733,2,467
2020-05-02,malta,Europe,443733,1,468
2020-05-03,malta,Europe,443733,9,477
2020-05-04,malta,Europe,443733,3,480
2020-05-05,malta,Europe,443733,2,482
2020-05-06,malta,Europe,443733,2,484
2020-05-07,malta,Europe,443733,2,486
2020-05-08,malta,Europe,443733,3,489
2020-05-09,malta,Europe,443733,1,490
2020-05-10,malta,Europe,443733,6,496
2020-05-11,malta,Europe,443733,7,503
2020-05-12,malta,Europe,443733,3,506
2020-05-13,malta,Europe,443733,2,508
2020-05-14,malta,Europe,443733,14,522
2020-05-15,malta,Europe,443733,10,532
2020-05-16,malta,Europe,443733,14,546
2020-05-17,malta,Europe,443733,7,553
2020-05-18,malta,Europe,443733,5,558
2020-05-19,malta,Europe,443733,11,569
2020-05-20,malta,Europe,443733,15,584
2020-05-21,malta,Europe,443733,15,599
2020-05-22,malta,Europe,443733,1,600
2020-05-23,malta,Europe,443733,9,609
2020-05-24,malta,Europe,443733,1,610
2020-05-25,malta,Europe,443733,1,611
2020-05-26,malta,Europe,443733,0,611
2020-05-27,malta,Europe,443733,1,612
2020-05-28,malta,Europe,443733,4,616
2020-05-29,malta,Europe,443733,0,616
2020-05-30,malta,Europe,443733,2,618
2020-05-31,malta,Europe,443733,0,618
2020-06-01,malta,Europe,443733,1,619
2020-06-02,malta,Europe,443733,1,620
2020-06-03,malta,Europe,443733,2,622
2020-06-04,malta,Europe,443733,0,622
2020-06-05,malta,Europe,443733,3,625
2020-06-06,malta,Europe,443733,2,627
2020-06-07,malta,Europe,443733,2,629
2020-06-08,malta,Europe,443733,1,630
2020-06-09,malta,Europe,443733,2,632
2020-06-10,malta,Europe,443733,3,635
2020-06-11,malta,Europe,443733,5,640
2020-06-12,malta,Europe,443733,5,645
2020-06-13,malta,Europe,443733,1,646
2020-06-14,malta,Europe,443733,3,649
2020-06-15,malta,Europe,443733,1,650
2020-06-16,malta,Europe,443733,6,656
2020-06-17,malta,Europe,443733,6,662
2020-06-18,malta,Europe,443733,1,663
2020-06-19,malta,Europe,443733,0,663
2020-06-20,malta,Europe,443733,1,664
2020-06-21,malta,Europe,443733,1,665
2020-06-22,malta,Europe,443733,0,665
2020-06-23,malta,Europe,443733,0,665
2020-06-24,malta,Europe,443733,0,665
2020-06-25,malta,Europe,443733,3,668
2020-06-26,malta,Europe,443733,2,670
2020-06-27,malta,Europe,443733,0,670
2020-06-28,malta,Europe,443733,0,670
2020-06-29,malta,Europe,443733,0,670
2020-06-30,malta,Europe,443733,0,670
2020-07-01,malta,Europe,443733,1,671
2020-07-02,malta,Europe,443733,0,671
2020-07-03,malta,Europe,443733,1,672
2020-07-04,malta,Europe,443733,0,672
2020-07-05,malta,Europe,443733,0,672
2020-07-06,malta,Europe,443733,0,672
2020-07-07,malta,Europe,443733,1,673
2020-07-08,malta,Europe,443733,0,673
2020-07-09,malta,Europe,443733,1,674
2020-07-10,malta,Europe,443733,0,674
2020-07-11,malta,Europe,443733,0,674
2020-07-12,malta,Europe,443733,0,674
2020-07-13,malta,Europe,443733,0,674
2020-07-14,malta,Europe,443733,0,674
2020-07-15,malta,Europe,443733,0,674
2020-07-16,malta,Europe,443733,0,674
2020-07-17,malta,Europe,443733,0,674
2020-07-18,malta,Europe,443733,2,676
2020-07-19,malta,Europe,443733,1,677
2020-07-20,malta,Europe,443733,0,677
2020-07-21,malta,Europe,443733,0,677
2020-07-22,malta,Europe,443733,2,679
2020-07-23,malta,Europe,443733,1,680
2020-07-24,malta,Europe,443733,6,686
2020-07-25,malta,Europe,443733,0,686
2020-07-26,malta,Europe,443733,14,700
2020-07-27,malta,Europe,443733,1,701
2020-07-28,malta,Europe,443733,7,708
2020-07-29,malta,Europe,443733,12,720
2020-07-30,malta,Europe,443733,9,729
2020-07-31,malta,Europe,443733,10,739
2020-08-01,malta,Europe,443733,21,760
2020-08-02,malta,Europe,443733,15,775
2020-08-03,malta,Europe,443733,14,789
2020-08-04,malta,Europe,443733,16,805
2020-08-05,malta,Europe,443733,36,841
2020-08-06,malta,Europe,443733,4,845
2020-08-07,malta,Europe,443733,49,894
2020-08-08,malta,Europe,443733,40,934
2020-08-09,malta,Europe,443733,54,988
2020-08-10,malta,Europe,443733,23,1011
2020-08-11,malta,Europe,443733,0,1011
2020-08-12,malta,Europe,443733,78,1089
2020-08-13,malta,Europe,443733,55,1144
2020-08-14,malta,Europe,443733,32,1176
2020-08-15,malta,Europe,443733,67,1243
2020-08-16,malta,Europe,443733,63,1306
2020-08-17,malta,Europe,443733,69,1375
2020-08-18,malta,Europe,443733,48,1423
2020-08-19,malta,Europe,443733,47,1470
2020-08-20,malta,Europe,443733,40,1510
2020-08-21,malta,Europe,443733,36,1546
2020-08-22,malta,Europe,443733,31,1577
2020-08-23,malta,Europe,443733,35,1612
2020-08-24,malta,Europe,443733,55,1667
2020-08-25,malta,Europe,443733,38,1705
2020-08-26,malta,Europe,443733,46,1751
2020-08-27,malta,Europe,443733,37,1788
2020-08-28,malta,Europe,443733,32,1820
2020-08-29,malta,Europe,443733,27,1847
2020-08-30,malta,Europe,443733,15,1862
2020-08-31,malta,Europe,443733,21,1883
2020-09-01,malta,Europe,443733,26,1909
2020-09-02,malta,Europe,443733,22,1931
2020-09-03,malta,Europe,443733,34,1965
2020-09-04,malta,Europe,443733,19,1984
2020-09-05,malta,Europe,443733,30,2014
2020-09-06,malta,Europe,443733,25,2039
2020-09-07,malta,Europe,443733,37,2076
2020-09-08,malta,Europe,443733,23,2099
2020-09-09,malta,Europe,443733,63,2162
2020-09-10,malta,Europe,443733,42,2204
2020-09-11,malta,Europe,443733,43,2247
2020-09-12,malta,Europe,443733,27,2274
2020-09-13,malta,Europe,443733,78,2352
2020-09-14,malta,Europe,443733,53,2405
2020-09-15,malta,Europe,443733,49,2454
2020-09-16,malta,Europe,443733,106,2560
2020-09-17,malta,Europe,443733,35,2595
2020-09-18,malta,Europe,443733,39,2634
2020-09-19,malta,Europe,443733,65,2699
2020-09-20,malta,Europe,443733,32,2731
2020-09-21,malta,Europe,443733,45,2776
2020-09-22,malta,Europe,443733,38,2814
2020-09-23,malta,Europe,443733,42,2856
2020-09-24,malta,Europe,443733,42,2898
2020-09-25,malta,Europe,443733,31,2929
2020-09-26,malta,Europe,443733,29,2958
2020-09-27,malta,Europe,443733,21,2979
2020-09-28,malta,Europe,443733,27,3006
2020-09-29,malta,Europe,443733,29,3035
2020-09-30,malta,Europe,443733,23,3058
2020-10-01,malta,Europe,443733,37,3095
2020-10-02,malta,Europe,443733,44,3139
2020-10-03,malta,Europe,443733,65,3204
2020-10-04,malta,Europe,443733,66,3270
2020-10-05,malta,Europe,443733,57,3327
2020-10-06,malta,Europe,443733,47,3374
2020-10-07,malta,Europe,443733,68,3442
2020-10-08,malta,Europe,443733,64,3506
2020-10-09,malta,Europe,443733,75,3581
2020-10-10,malta,Europe,443733,100,3681
2020-10-11,malta,Europe,443733,95,3776
2020-10-12,malta,Europe,443733,68,3844
2020-10-13,malta,Europe,443733,93,3937
2020-10-14,malta,Europe,443733,111,4048
2020-10-15,malta,Europe,443733,112,4160
2020-10-16,malta,Europe,443733,122,4282
2020-10-17,malta,Europe,443733,204,4486
2020-10-18,malta,Europe,443733,142,4628
2020-10-19,malta,Europe,443733,109,4737
2020-10-20,malta,Europe,443733,134,4871
2020-10-21,malta,Europe,443733,155,5026
2020-10-22,malta,Europe,443733,111,5137
2020-10-23,malta,Europe,443733,121,5258
2020-10-24,malta,Europe,443733,115,5373
2020-10-25,malta,Europe,443733,125,5498
2020-10-26,malta,Europe,443733,80,5578
2020-10-27,malta,Europe,443733,107,5685
2020-10-28,malta,Europe,443733,75,5760
2020-10-29,malta,Europe,443733,106,5866
2020-10-30,malta,Europe,443733,76,5942
2020-10-31,malta,Europe,443733,100,6042
2020-11-01,malta,Europe,443733,140,6182
2020-11-02,malta,Europe,443733,218,6400
2020-11-03,malta,Europe,443733,106,6506
2020-11-04,malta,Europe,443733,84,6590
2020-11-05,malta,Europe,443733,174,6764
2020-11-06,malta,Europe,443733,129,6893
2020-11-07,malta,Europe,443733,146,7039
2020-11-08,malta,Europe,443733,102,7141
2020-11-09,malta,Europe,443733,102,7243
2020-11-10,malta,Europe,443733,153,7396
2020-11-11,malta,Europe,443733,141,7537
2020-11-12,malta,Europe,443733,109,7646
2020-11-13,malta,Europe,443733,150,7796
2020-11-14,malta,Europe,443733,121,7917
2020-11-15,malta,Europe,443733,117,8034
2020-11-16,malta,Europe,443733,103,8137
2020-11-17,malta,Europe,443733,110,8247
2020-11-18,malta,Europe,443733,173,8420
2020-11-19,malta,Europe,443733,140,8560
2020-11-20,malta,Europe,443733,121,8681
2020-11-21,malta,Europe,443733,141,8822
2020-11-22,malta,Europe,443733,102,8924
2020-11-23,malta,Europe,443733,80,9004
2020-11-24,malta,Europe,443733,133,9137
2020-11-25,malta,Europe,443733,116,9253
2020-11-26,malta,Europe,443733,152,9405
2020-11-27,malta,Europe,443733,96,9501
2020-11-28,malta,Europe,443733,108,9609
2020-11-29,malta,Europe,443733,143,9752
2020-11-30,malta,Europe,443733,121,9873
2020-12-01,malta,Europe,443733,102,9975
2020-12-02,malta,Europe,443733,126,10101
2020-12-03,malta,Europe,443733,96,10197
2020-12-04,malta,Europe,443733,123,10320
2020-12-05,malta,Europe,443733,103,10423
2020-12-06,malta,Europe,443733,97,10520
2020-12-07,malta,Europe,443733,139,10659
2020-12-08,malta,Europe,443733,40,10699
2020-12-09,malta,Europe,443733,79,10778
2020-12-10,malta,Europe,443733,106,10884
2020-12-11,malta,Europe,443733,96,10980
2020-12-12,malta,Europe,443733,121,11101
2020-12-13,malta,Europe,443733,52,11153
2020-12-14,malta,Europe,443733,101,11254
2020-12-15,malta,Europe,443733,49,11303
2020-12-16,malta,Europe,443733,112,11415
2020-12-17,malta,Europe,443733,60,11475
2020-12-18,malta,Europe,443733,94,11569
2020-12-19,malta,Europe,443733,52,11621
2020-12-20,malta,Europe,443733,93,11714
2020-12-21,malta,Europe,443733,88,11802
2020-12-22,malta,Europe,443733,108,11910
2020-12-23,malta,Europe,443733,82,11992
2020-12-24,malta,Europe,443733,70,12062
2020-12-25,malta,Europe,443733,50,12112
2020-12-26,malta,Europe,443733,129,12241
2020-12-27,malta,Europe,443733,84,12325
2020-12-28,malta,Europe,443733,101,12426
2020-12-29,malta,Europe,443733,115,12541
2020-12-30,malta,Europe,443733,124,12665
2020-12-31,malta,Europe,443733,109,12774
2021-01-01,malta,Europe,443733,135,12909
2021-01-02,malta,Europe,443733,88,12997
2021-01-03,malta,Europe,443733,85,13082
2021-01-04,malta,Europe,443733,148,13230
2021-01-05,malta,Europe,443733,158,13388
2021-01-06,malta,Europe,443733,224,13612
2021-01-07,malta,Europe,443733,164,13776
2021-01-08,malta,Europe,443733,191,13967
2021-01-09,malta,Europe,443733,245,14212
2021-01-10,malta,Europe,443733,184,14396
2021-01-11,malta,Europe,443733,133,14529
2021-01-12,malta,Europe,443733,240,14769
2021-01-13,malta,Europe,443733,189,14958
2021-01-14,malta,Europe,443733,121,15079
2021-01-15,malta,Europe,443733,193,15272
2021-01-16,malta,Europe,443733,175,15447
2021-01-17,malta,Europe,443733,141,15588
2021-01-18,malta,Europe,443733,154,15742
2021-01-19,malta,Europe,443733,200,15942
2021-01-20,malta,Europe,443733,187,16129
2021-01-21,malta,Europe,443733,151,16280
2021-01-22,malta,Europe,443733,143,16423
2021-01-23,malta,Europe,443733,119,16542
2021-01-24,malta,Europe,443733,116,16658
2021-01-25,malta,Europe,443733,203,16861
2021-01-26,malta,Europe,443733,138,16999
2021-01-27,malta,Europe,443733,193,17192
2021-01-28,malta,Europe,443733,208,17400
2021-01-29,malta,Europe,443733,185,17585
2021-01-30,malta,Europe,443733,136,17721
2021-01-31,malta,Europe,443733,182,17903
2021-02-01,malta,Europe,443733,124,18027
2021-02-02,malta,Europe,443733,141,18168
2021-02-03,malta,Europe,443733,138,18306
2021-02-04,malta,Europe,443733,79,18385
2021-02-05,malta,Europe,443733,57,18442
2021-02-06,malta,Europe,443733,134,18576
2021-02-07,malta,Europe,443733,100,18676
2021-02-08,malta,Europe,443733,137,18813
2021-02-09,malta,Europe,443733,202,19015
2021-02-10,malta,Europe,443733,167,19182
2021-02-11,malta,Europe,443733,151,19333
2021-02-12,malta,Europe,443733,164,19497
2021-02-13,malta,Europe,443733,154,19651
2021-02-14,malta,Europe,443733,138,19789
2021-02-15,malta,Europe,443733,156,19945
2021-02-16,malta,Europe,443733,102,20047
2021-02-17,malta,Europe,443733,199,20246
2021-02-18,malta,Europe,443733,163,20409
2021-02-19,malta,Europe,443733,154,20563
2021-02-20,malta,Europe,443733,199,20762
2021-02-21,malta,Europe,443733,130,20892
2021-02-22,malta,Europe,443733,193,21085
2021-02-23,malta,Europe,443733,221,21306
2021-02-24,malta,Europe,443733,226,21532
2021-02-25,malta,Europe,443733,192,21724
2021-02-26,malta,Europe,443733,258,21982
2021-02-27,malta,Europe,443733,237,22219
2021-02-28,malta,Europe,443733,263,22482
2021-03-01,malta,Europe,443733,175,22657
2021-03-02,malta,Europe,443733,336,22993
2021-03-03,malta,Europe,443733,233,23226
2021-03-04,malta,Europe,443733,362,23588
2021-03-05,malta,Europe,443733,283,23871
2021-03-06,malta,Europe,443733,345,24216
2021-03-07,malta,Europe,443733,182,24398
2021-03-08,malta,Europe,443733,201,24599
2021-03-09,malta,Europe,443733,248,24847
2021-03-10,malta,Europe,443733,510,25357
2021-03-11,malta,Europe,443733,283,25640
2021-03-12,malta,Europe,443733,329,25969
2021-03-13,malta,Europe,443733,298,26267
2021-03-14,malta,Europe,443733,268,26535
2021-03-15,malta,Europe,443733,213,26748
2021-03-16,malta,Europe,443733,313,27061
2021-03-17,malta,Europe,443733,211,27272
2021-03-18,malta,Europe,443733,243,27515
2021-03-19,malta,Europe,443733,179,27694
2021-03-20,malta,Europe,443733,210,27904
2021-03-21,malta,Europe,443733,224,28128
2021-03-22,malta,Europe,443733,191,28319
2021-03-23,malta,Europe,443733,90,28409
2021-03-24,malta,Europe,443733,101,28510
2021-03-25,malta,Europe,443733,102,28612
2021-03-26,malta,Europe,443733,103,28715
2021-03-27,malta,Europe,443733,93,28808
2021-03-28,malta,Europe,443733,67,28875
2021-03-29,malta,Europe,443733,63,28938
2021-03-30,malta,Europe,443733,55,28993
2021-03-31,malta,Europe,443733,40,29033
2021-04-01,malta,Europe,443733,52,29085
2021-04-02,malta,Europe,443733,42,29127
2021-04-03,malta,Europe,443733,62,29189
2021-04-04,malta,Europe,443733,34,29223
2021-04-05,malta,Europe,443733,56,29279
2021-04-06,malta,Europe,443733,64,29343
2021-04-07,malta,Europe,443733,65,29408
2021-04-08,malta,Europe,443733,55,29463
2021-04-09,malta,Europe,443733,48,29511
2021-04-10,malta,Europe,443733,37,29548
2021-04-11,malta,Europe,443733,66,29614
2021-04-12,malta,Europe,443733,47,29661
2021-04-13,malta,Europe,443733,59,29720
2021-04-14,malta,Europe,443733,58,29778
2021-04-15,malta,Europe,443733,55,29833
2021-04-16,malta,Europe,443733,27,29860
2021-04-17,malta,Europe,443733,67,29927
2021-04-18,malta,Europe,443733,39,29966
2021-04-19,malta,Europe,443733,60,30026
2021-04-20,malta,Europe,443733,13,30039
2021-04-21,malta,Europe,443733,24,30063
2021-04-22,malta,Europe,443733,33,30096
2021-04-23,malta,Europe,443733,33,30129
2021-04-24,malta,Europe,443733,20,30149
2021-04-25,malta,Europe,443733,25,30174
2021-04-26,malta,Europe,443733,15,30189
2021-04-27,malta,Europe,443733,45,30234
2021-04-28,malta,Europe,443733,15,30249
2021-04-29,malta,Europe,443733,27,30276
2021-04-30,malta,Europe,443733,16,30292
2021-05-01,malta,Europe,443733,15,30307
2021-05-02,malta,Europe,443733,12,30319
2021-05-03,malta,Europe,443733,35,30354
2021-05-04,malta,Europe,443733,27,30381
2021-05-05,malta,Europe,443733,30,30411
2021-05-06,malta,Europe,443733,9,30420
2021-05-07,malta,Europe,443733,12,30432
2021-05-08,malta,Europe,443733,6,30438
2021-05-09,malta,Europe,443733,9,30447
2021-05-10,malta,Europe,443733,11,30458
2021-05-11,malta,Europe,443733,6,30464
2021-05-12,malta,Europe,443733,5,30469
2021-05-13,malta,Europe,443733,4,30473
2021-05-14,malta,Europe,443733,1,30474
2021-05-15,malta,Europe,443733,4,30478
2021-05-16,malta,Europe,443733,2,30480
2021-05-17,malta,Europe,443733,4,30484
2021-05-18,malta,Europe,443733,2,30486
2021-05-19,malta,Europe,443733,3,30489
2021-05-20,malta,Europe,443733,2,30491
2021-05-21,malta,Europe,443733,6,30497
2021-05-22,malta,Europe,443733,2,30499
2021-05-23,malta,Europe,443733,5,30504
2021-05-24,malta,Europe,443733,2,30506
2021-05-25,malta,Europe,443733,3,30509
2021-05-26,malta,Europe,443733,7,30516
2021-05-27,malta,Europe,443733,4,30520
2021-05-28,malta,Europe,443733,6,30526
2021-05-29,malta,Europe,443733,3,30529
2021-05-30,malta,Europe,443733,4,30533
2021-05-31,malta,Europe,443733,2,30535
2021-06-01,malta,Europe,443733,8,30543
2021-06-02,malta,Europe,443733,10,30553
2021-06-03,malta,Europe,443733,4,30557
2021-06-04,malta,Europe,443733,2,30559
2021-06-05,malta,Europe,443733,9,30568
2021-06-06,malta,Europe,443733,3,30571
2021-06-07,malta,Europe,443733,0,30571
2021-06-08,malta,Europe,443733,1,30572
2021-06-09,malta,Europe,443733,1,30573
2021-06-10,malta,Europe,443733,4,30577
2021-06-11,malta,Europe,443733,2,30579
2021-06-12,malta,Europe,443733,2,30581
2021-06-13,malta,Europe,443733,0,30581
2021-06-14,malta,Europe,443733,1,30582
2021-06-15,malta,Europe,443733,0,30582
2021-06-16,malta,Europe,443733,3,30585
2021-06-17,malta,Europe,443733,0,30585
2021-06-18,malta,Europe,443733,3,30588
2021-06-19,malta,Europe,443733,0,30588
2021-06-20,malta,Europe,443733,1,30589
2021-06-21,malta,Europe,443733,1,30590
2021-06-22,malta,Europe,443733,5,30595
2021-06-23,malta,Europe,443733,0,30595
2021-06-24,malta,Europe,443733,3,30598
2021-06-25,malta,Europe,443733,5,30603
2021-06-26,malta,Europe,443733,3,30606
2021-06-27,malta,Europe,443733,0,30606
2021-06-28,malta,Europe,443733,6,30612
2021-06-29,malta,Europe,443733,6,30618
2021-06-30,malta,Europe,443733,5,30623
2021-07-01,malta,Europe,443733,4,30627
2021-07-02,malta,Europe,443733,6,30633
2021-07-03,malta,Europe,443733,7,30640
2021-07-04,malta,Europe,443733,12,30652
2021-07-05,malta,Europe,443733,12,30664
2021-07-06,malta,Europe,443733,11,30675
2021-07-07,malta,Europe,443733,25,30700
2021-07-08,malta,Europe,443733,55,30755
2021-07-09,malta,Europe,443733,96,30851
2021-07-10,malta,Europe,443733,109,30960
2021-07-11,malta,Europe,443733,101,31061
2021-07-12,malta,Europe,443733,179,31240
2021-07-13,malta,Europe,443733,154,31394
2021-07-14,malta,Europe,443733,218,31612
2021-07-15,malta,Europe,443733,222,31834
2021-07-16,malta,Europe,443733,235,32069
2021-07-17,malta,Europe,443733,206,32275
2021-07-18,malta,Europe,443733,195,32470
2021-07-19,malta,Europe,443733,146,32616
2021-07-20,malta,Europe,443733,217,32833
2021-07-21,malta,Europe,443733,199,33032
2021-07-22,malta,Europe,443733,166,33198
2021-07-23,malta,Europe,443733,172,33370
2021-07-24,malta,Europe,443733,171,33541
2021-07-25,malta,Europe,443733,127,33668
2021-07-26,malta,Europe,443733,94,33762
2021-07-27,malta,Europe,443733,142,33904
2021-07-28,malta,Europe,443733,91,33995
2021-07-29,malta,Europe,443733,95,34090
2021-07-30,malta,Europe,443733,111,34201
2021-07-31,malta,Europe,443733,94,34295
2021-08-01,malta,Europe,443733,80,34375
2021-08-02,malta,Europe,443733,64,34439
2021-08-03,malta,Europe,443733,69,34508
2021-08-04,malta,Europe,443733,82,34590
2021-08-05,malta,Europe,443733,78,34668
2021-08-06,malta,Europe,443733,48,34716
2021-08-07,malta,Europe,443733,71,34787
2021-08-08,malta,Europe,443733,59,34846
2021-08-09,malta,Europe,443733,56,34902
2021-08-10,malta,Europe,443733,51,34953
2021-08-11,malta,Europe,443733,87,35040
2021-08-12,malta,Europe,443733,51,35091
2021-08-13,malta,Europe,443733,101,35192
2021-08-14,malta,Europe,443733,94,35286
2021-08-15,malta,Europe,443733,51,35337
2021-08-16,malta,Europe,443733,43,35380
2021-08-17,malta,Europe,443733,54,35434
2021-08-18,malta,Europe,443733,82,35516
2021-08-19,malta,Europe,443733,86,35602
2021-08-20,malta,Europe,443733,51,35653
2021-08-21,malta,Europe,443733,68,35721
2021-08-22,malta,Europe,443733,53,35774
2021-08-23,malta,Europe,443733,57,35831
2021-08-24,malta,Europe,443733,35,35866
2021-08-25,malta,Europe,443733,42,35908
2021-08-26,malta,Europe,443733,42,35950
2021-08-27,malta,Europe,443733,40,35990
2021-08-28,malta,Europe,443733,49,36039
2021-08-29,malta,Europe,443733,50,36089
2021-08-30,malta,Europe,443733,34,36123
2021-08-31,malta,Europe,443733,48,36171
2021-09-01,malta,Europe,443733,76,36247
2021-09-02,malta,Europe,443733,75,36322
2021-09-03,malta,Europe,443733,42,36364
2021-09-04,malta,Europe,443733,62,36426
2021-09-05,malta,Europe,443733,49,36475
2021-09-06,malta,Europe,443733,37,36512
2021-09-07,malta,Europe,443733,41,36553
2021-09-08,malta,Europe,443733,53,36606
2021-09-09,malta,Europe,443733,30,36636
2021-09-10,malta,Europe,443733,38,36674
2021-09-11,malta,Europe,443733,34,36708
2021-09-12,malta,Europe,443733,50,36758
2021-09-13,malta,Europe,443733,35,36793
2021-09-14,malta,Europe,443733,50,36843
2021-09-15,malta,Europe,443733,32,36875
2021-09-16,malta,Europe,443733,25,36900
2021-09-17,malta,Europe,443733,27,36927
2021-09-18,malta,Europe,443733,25,36952
2021-09-19,malta,Europe,443733,20,36972
2021-09-20,malta,Europe,443733,22,36994
2021-09-21,malta,Europe,443733,24,37018
2021-09-22,malta,Europe,443733,18,37036
2021-09-23,malta,Europe,443733,12,37048
2021-09-24,malta,Europe,443733,13,37061
2021-09-25,malta,Europe,443733,16,37077
2021-09-26,malta,Europe,443733,13,37090
2021-09-27,malta,Europe,443733,13,37103
2021-09-28,malta,Europe,443733,16,37119
2021-09-29,malta,Europe,443733,8,37127
2021-09-30,malta,Europe,443733,22,37149
2021-10-01,malta,Europe,443733,14,37163
2021-10-02,malta,Europe,443733,24,37187
2021-10-03,malta,Europe,443733,10,37197
2021-10-04,malta,Europe,443733,24,37221
2021-10-05,malta,Europe,443733,25,37246
2021-10-06,malta,Europe,443733,18,37264
2021-10-07,malta,Europe,443733,19,37283
2021-10-08,malta,Europe,443733,24,37307
2021-10-09,malta,Europe,443733,16,37323
2021-10-10,malta,Europe,443733,24,37347
2021-10-11,malta,Europe,443733,11,37358
2021-10-12,malta,Europe,443733,17,37375
2021-10-13,malta,Europe,443733,18,37393
2021-10-14,malta,Europe,443733,19,37412
2021-10-15,malta,Europe,443733,25,37437
2021-10-16,malta,Europe,443733,8,37445
2021-10-17,malta,Europe,443733,8,37453
2021-10-18,malta,Europe,443733,11,37464
2021-10-19,malta,Europe,443733,22,37486
2021-10-20,malta,Europe,443733,20,37506
2021-10-21,malta,Europe,443733,17,37523
2021-10-22,malta,Europe,443733,10,37533
2021-10-23,malta,Europe,443733,6,37539
2021-10-24,malta,Europe,443733,12,37551
2021-10-25,malta,Europe,443733,13,37564
2021-10-26,malta,Europe,443733,16,37580
2021-10-27,malta,Europe,443733,15,37595
2021-10-28,malta,Europe,443733,15,37610
2021-10-29,malta,Europe,443733,8,37618
2021-10-30,malta,Europe,443733,19,37637
2021-10-31,malta,Europe,443733,16,37653
2021-11-01,malta,Europe,443733,20,37673
2021-11-02,malta,Europe,443733,29,37702
2021-11-03,malta,Europe,443733,34,37736
2021-11-04,malta,Europe,443733,37,37773
2021-11-05,malta,Europe,443733,40,37813
2021-11-06,malta,Europe,443733,41,37854
2021-11-07,malta,Europe,443733,50,37904
2021-11-08,malta,Europe,443733,27,37931
2021-11-09,malta,Europe,443733,35,37966
2021-11-10,malta,Europe,443733,38,38004
2021-11-11,malta,Europe,443733,63,38067
2021-11-12,malta,Europe,443733,50,38117
2021-11-13,malta,Europe,443733,51,38168
2021-11-14,malta,Europe,443733,32,38200
2021-11-15,malta,Europe,443733,55,38255
2021-11-16,malta,Europe,443733,64,38319
2021-11-17,malta,Europe,443733,64,38383
2021-11-18,malta,Europe,443733,66,38449
2021-11-19,malta,Europe,443733,79,38528
2021-11-20,malta,Europe,443733,59,38587
2021-11-21,malta,Europe,443733,122,38709
2021-11-22,malta,Europe,443733,62,38771
2021-11-23,malta,Europe,443733,71,38842
2021-11-24,malta,Europe,443733,86,38928
2021-11-25,malta,Europe,443733,83,39011
2021-11-26,malta,Europe,443733,56,39067
2021-11-27,malta,Europe,443733,95,39162
2021-11-28,malta,Europe,443733,72,39234
2021-11-29,malta,Europe,443733,95,39329
2021-11-30,malta,Europe,443733,106,39435
2021-12-01,malta,Europe,443733,95,39530
2021-12-02,malta,Europe,443733,138,39668
2021-12-03,malta,Europe,443733,138,39806
2021-12-04,malta,Europe,443733,59,39865
2021-12-05,malta,Europe,443733,69,39934
2021-12-06,malta,Europe,443733,81,40015
2021-12-07,malta,Europe,443733,86,40101
2021-12-08,malta,Europe,443733,87,40188
2021-12-09,malta,Europe,443733,81,40269
2021-12-10,malta,Europe,443733,88,40357
2021-12-11,malta,Europe,443733,111,40468
2021-12-12,malta,Europe,443733,78,40546
2021-12-13,malta,Europe,443733,78,40624
2021-12-14,malta,Europe,443733,100,40724
2021-12-15,malta,Europe,443733,168,40892
2021-12-16,malta,Europe,443733,167,41059
2021-12-17,malta,Europe,443733,221,41280
2021-12-18,malta,Europe,443733,291,41571
2021-12-19,malta,Europe,443733,282,41853
2021-12-20,malta,Europe,443733,252,42105
2021-12-21,malta,Europe,443733,386,42491
2021-12-22,malta,Europe,443733,582,43073
2021-12-23,malta,Europe,443733,733,43806
2021-12-24,malta,Europe,443733,955,44761
2021-12-25,malta,Europe,443733,917,45678
2021-12-26,malta,Europe,443733,572,46250
2021-12-27,malta,Europe,443733,832,47082
2021-12-28,malta,Europe,443733,1298,48380
2021-12-29,malta,Europe,443733,1337,49717
2021-12-30,malta,Europe,443733,1353,51070
2021-12-31,malta,Europe,443733,1403,52473
2022-01-01,malta,Europe,443733,1030,53503
2022-01-02,malta,Europe,443733,747,54250
2022-01-03,malta,Europe,443733,812,55062
2022-01-04,malta,Europe,443733,1147,56209
2022-01-05,malta,Europe,443733,922,57131
2022-01-06,malta,Europe,443733,1144,58275
2022-01-07,malta,Europe,443733,786,59061
2022-01-08,malta,Europe,443733,762,59823
2022-01-09,malta,Europe,443733,563,60386
2022-01-10,malta,Europe,443733,437,60823
2022-01-11,malta,Europe,443733,432,61255
2022-01-12,malta,Europe,443733,673,61928
2022-01-13,malta,Europe,443733,462,62390
2022-01-14,malta,Europe,443733,516,62906
2022-01-15,malta,Europe,443733,503,63409
2022-01-16,malta,Europe,443733,301,63710
2022-01-17,malta,Europe,443733,288,63998
2022-01-18,malta,Europe,443733,379,64377
2022-01-19,malta,Europe,443733,342,64719
2022-01-20,malta,Europe,443733,286,65005
2022-01-21,malta,Europe,443733,306,65311
2022-01-22,malta,Europe,443733,285,65596
2022-01-23,malta,Europe,443733,273,65869
2022-01-24,malta,Europe,443733,202,66071
2022-01-25,malta,Europe,443733,323,66394
2022-01-26,malta,Europe,443733,314,66708
2022-01-27,malta,Europe,443733,230,66938
2022-01-28,malta,Europe,443733,229,67167
2022-01-29,malta,Europe,443733,190,67357
2022-01-30,malta,Europe,443733,191,67548
2022-01-31,malta,Europe,443733,169,67717
2022-02-01,malta,Europe,443733,249,67966
2022-02-02,malta,Europe,443733,227,68193
2022-02-03,malta,Europe,443733,240,68433
2022-02-04,malta,Europe,443733,214,68647
2022-02-05,malta,Europe,443733,195,68842
2022-02-06,malta,Europe,443733,158,69000
2022-02-07,malta,Europe,443733,175,69175
2022-02-08,malta,Europe,443733,186,69361
2022-02-09,malta,Europe,443733,172,69533
2022-02-10,malta,Europe,443733,118,69651
2022-02-11,malta,Europe,443733,143,69794
2022-02-12,malta,Europe,443733,107,69901
2022-02-13,malta,Europe,443733,116,70017
2022-02-14,malta,Europe,443733,72,70089
2022-02-15,malta,Europe,443733,122,70211
2022-02-16,malta,Europe,443733,117,70328
2022-02-17,malta,Europe,443733,109,70437
2022-02-18,malta,Europe,443733,79,70516
2022-02-19,malta,Europe,443733,72,70588
2022-02-20,malta,Europe,443733,77,70665
2022-02-21,malta,Europe,443733,74,70739
2022-02-22,malta,Europe,443733,90,70829
2022-02-23,malta,Europe,443733,79,70908
2022-02-24,malta,Europe,443733,95,71003
2022-02-25,malta,Europe,443733,80,71083
2022-02-26,malta,Europe,443733,96,71179
2022-02-27,malta,Europe,443733,56,71235
2022-02-28,malta,Europe,443733,40,71275
2022-03-01,malta,Europe,443733,86,71361
2022-03-02,malta,Europe,443733,94,71455
2022-03-03,malta,Europe,443733,126,71581
2022-03-04,malta,Europe,443733,98,71679
2022-03-05,malta,Europe,443733,121,71800
2022-03-06,malta,Europe,443733,99,71899
2022-03-07,malta,Europe,443733,72,71971
2022-03-08,malta,Europe,443733,159,72130
2022-03-09,malta,Europe,443733,138,72268
2022-03-10,malta,Europe,443733,153,72421
2022-03-11,malta,Europe,443733,139,72560
2022-03-12,malta,Europe,443733,127,72687
2022-03-13,malta,Europe,443733,171,72858
2022-03-14,malta,Europe,443733,143,73001
2022-03-15,malta,Europe,443733,194,73195
2022-03-16,malta,Europe,443733,229,73424
2022-03-17,malta,Europe,443733,304,73728
2022-03-18,malta,Europe,443733,301,74029
2022-03-19,malta,Europe,443733,286,74315
2022-03-20,malta,Europe,443733,203,74518
2022-03-21,malta,Europe,443733,251,74769
2022-03-22,malta,Europe,443733,333,75102
2022-03-23,malta,Europe,443733,375,75477
2022-03-24,malta,Europe,443733,415,75892
2022-03-25,malta,Europe,443733,465,76357
2022-03-26,malta,Europe,443733,392,76749
2022-03-27,malta,Europe,443733,350,77099
2022-03-28,malta,Europe,443733,360,77459
2022-03-29,malta,Europe,443733,603,78062
2022-03-30,malta,Europe,443733,717,78779
2022-03-31,malta,Europe,443733,760,79539
2022-04-01,malta,Europe,443733,659,80198
2022-04-02,malta,Europe,443733,791,80989
2022-04-03,malta,Europe,443733,607,81596
2022-04-04,malta,Europe,443733,530,82126
2022-04-05,malta,Europe,443733,719,82845
2022-04-06,malta,Europe,443733,822,83667
2022-04-07,malta,Europe,443733,731,84398
2022-04-08,malta,Europe,443733,659,85057
2022-04-09,malta,Europe,443733,563,85620
2022-04-10,malta,Europe,443733,542,86162
2022-04-11,malta,Europe,443733,433,86595
2022-04-12,malta,Europe,443733,438,87033
2022-04-13,malta,Europe,443733,408,87441
2022-04-14,malta,Europe,443733,431,87872
2022-04-15,malta,Europe,443733,372,88244
2022-04-16,malta,Europe,443733,314,88558
2022-04-17,malta,Europe,443733,271,88829
2022-04-18,malta,Europe,443733,199,89028
2022-04-19,malta,Europe,443733,282,89310
2020-03-31,mauritania,Africa,4877181,0,6
2020-04-01,mauritania,Africa,4877181,0,6
2020-04-02,mauritania,Africa,4877181,0,6
2020-04-03,mauritania,Africa,4877181,0,6
2020-04-04,mauritania,Africa,4877181,0,6
2020-04-05,mauritania,Africa,4877181,0,6
2020-04-06,mauritania,Africa,4877181,0,6
2020-04-07,mauritania,Africa,4877181,0,6
2020-04-08,mauritania,Africa,4877181,0,6
2020-04-09,mauritania,Africa,4877181,1,7
2020-04-10,mauritania,Africa,4877181,0,7
2020-04-11,mauritania,Africa,4877181,0,7
2020-04-12,mauritania,Africa,4877181,0,7
2020-04-13,mauritania,Africa,4877181,0,7
2020-04-14,mauritania,Africa,4877181,0,7
2020-04-15,mauritania,Africa,4877181,0,7
2020-04-16,mauritania,Africa,4877181,0,7
2020-04-17,mauritania,Africa,4877181,0,7
2020-04-18,mauritania,Africa,4877181,0,7
2020-04-19,mauritania,Africa,4877181,0,7
2020-04-20,mauritania,Africa,4877181,0,7
2020-04-21,mauritania,Africa,4877181,0,7
2020-04-22,mauritania,Africa,4877181,0,7
2020-04-23,mauritania,Africa,4877181,0,7
2020-04-24,mauritania,Africa,4877181,0,7
2020-04-25,mauritania,Africa,4877181,0,7
2020-04-26,mauritania,Africa,4877181,0,7
2020-04-27,mauritania,Africa,4877181,0,7
2020-04-28,mauritania,Africa,4877181,0,7
2020-04-29,mauritania,Africa,4877181,1,8
2020-04-30,mauritania,Africa,4877181,0,8
2020-05-01,mauritania,Africa,4877181,0,8
2020-05-02,mauritania,Africa,4877181,0,8
2020-05-03,mauritania,Africa,4877181,0,8
2020-05-04,mauritania,Africa,4877181,0,8
2020-05-05,mauritania,Africa,4877181,0,8
2020-05-06,mauritania,Africa,4877181,0,8
2020-05-07,mauritania,Africa,4877181,0,8
2020-05-08,mauritania,Africa,4877181,0,8
2020-05-09,mauritania,Africa,4877181,0,8
2020-05-10,mauritania,Africa,4877181,0,8
2020-05-11,mauritania,Africa,4877181,0,8
2020-05-12,mauritania,Africa,4877181,1,9
2020-05-13,mauritania,Africa,4877181,6,15
2020-05-14,mauritania,Africa,4877181,5,20
2020-05-15,mauritania,Africa,4877181,9,29
2020-05-16,mauritania,Africa,4877181,11,40
2020-05-17,mauritania,Africa,4877181,22,62
2020-05-18,mauritania,Africa,4877181,19,81
2020-05-19,mauritania,Africa,4877181,50,131
2020-05-20,mauritania,Africa,4877181,10,141
2020-05-21,mauritania,Africa,4877181,32,173
2020-05-22,mauritania,Africa,4877181,27,200
2020-05-23,mauritania,Africa,4877181,27,227
2020-05-24,mauritania,Africa,4877181,10,237
2020-05-25,mauritania,Africa,4877181,25,262
2020-05-26,mauritania,Africa,4877181,6,268
2020-05-27,mauritania,Africa,4877181,24,292
2020-05-28,mauritania,Africa,4877181,54,346
2020-05-29,mauritania,Africa,4877181,77,423
2020-05-30,mauritania,Africa,4877181,60,483
2020-05-31,mauritania,Africa,4877181,47,530
2020-06-01,mauritania,Africa,4877181,58,588
2020-06-02,mauritania,Africa,4877181,80,668
2020-06-03,mauritania,Africa,4877181,77,745
2020-06-04,mauritania,Africa,4877181,39,784
2020-06-05,mauritania,Africa,4877181,99,883
2020-06-06,mauritania,Africa,4877181,64,947
2020-06-07,mauritania,Africa,4877181,102,1049
2020-06-08,mauritania,Africa,4877181,55,1104
2020-06-09,mauritania,Africa,4877181,58,1162
2020-06-10,mauritania,Africa,4877181,121,1283
2020-06-11,mauritania,Africa,4877181,156,1439
2020-06-12,mauritania,Africa,4877181,133,1572
2020-06-13,mauritania,Africa,4877181,110,1682
2020-06-14,mauritania,Africa,4877181,101,1783
2020-06-15,mauritania,Africa,4877181,104,1887
2020-06-16,mauritania,Africa,4877181,170,2057
2020-06-17,mauritania,Africa,4877181,166,2223
2020-06-18,mauritania,Africa,4877181,201,2424
2020-06-19,mauritania,Africa,4877181,197,2621
2020-06-20,mauritania,Africa,4877181,192,2813
2020-06-21,mauritania,Africa,4877181,171,2984
2020-06-22,mauritania,Africa,4877181,137,3121
2020-06-23,mauritania,Africa,4877181,171,3292
2020-06-24,mauritania,Africa,4877181,227,3519
2020-06-25,mauritania,Africa,4877181,220,3739
2020-06-26,mauritania,Africa,4877181,168,3907
2020-06-27,mauritania,Africa,4877181,118,4025
2020-06-28,mauritania,Africa,4877181,124,4149
2020-06-29,mauritania,Africa,4877181,88,4237
2020-06-30,mauritania,Africa,4877181,126,4363
2020-07-01,mauritania,Africa,4877181,109,4472
2020-07-02,mauritania,Africa,4877181,134,4606
2020-07-03,mauritania,Africa,4877181,99,4705
2020-07-04,mauritania,Africa,4877181,122,4827
2020-07-05,mauritania,Africa,4877181,52,4879
2020-07-06,mauritania,Africa,4877181,69,4948
2020-07-07,mauritania,Africa,4877181,76,5024
2020-07-08,mauritania,Africa,4877181,63,5087
2020-07-09,mauritania,Africa,4877181,39,5126
2020-07-10,mauritania,Africa,4877181,77,5203
2020-07-11,mauritania,Africa,4877181,72,5275
2020-07-12,mauritania,Africa,4877181,80,5355
2020-07-13,mauritania,Africa,4877181,91,5446
2020-07-14,mauritania,Africa,4877181,72,5518
2020-07-15,mauritania,Africa,4877181,46,5564
2020-07-16,mauritania,Africa,4877181,95,5659
2020-07-17,mauritania,Africa,4877181,51,5710
2020-07-18,mauritania,Africa,4877181,103,5813
2020-07-19,mauritania,Africa,4877181,60,5873
2020-07-20,mauritania,Africa,4877181,50,5923
2020-07-21,mauritania,Africa,4877181,62,5985
2020-07-22,mauritania,Africa,4877181,42,6027
2020-07-23,mauritania,Africa,4877181,40,6067
2020-07-24,mauritania,Africa,4877181,49,6116
2020-07-25,mauritania,Africa,4877181,35,6151
2020-07-26,mauritania,Africa,4877181,20,6171
2020-07-27,mauritania,Africa,4877181,37,6208
2020-07-28,mauritania,Africa,4877181,41,6249
2020-07-29,mauritania,Africa,4877181,24,6273
2020-07-30,mauritania,Africa,4877181,22,6295
2020-07-31,mauritania,Africa,4877181,15,6310
2020-08-01,mauritania,Africa,4877181,9,6319
2020-08-02,mauritania,Africa,4877181,4,6323
2020-08-03,mauritania,Africa,4877181,59,6382
2020-08-04,mauritania,Africa,4877181,36,6418
2020-08-05,mauritania,Africa,4877181,26,6444
2020-08-06,mauritania,Africa,4877181,29,6473
2020-08-07,mauritania,Africa,4877181,25,6498
2020-08-08,mauritania,Africa,4877181,12,6510
2020-08-09,mauritania,Africa,4877181,13,6523
2020-08-10,mauritania,Africa,4877181,32,6555
2020-08-11,mauritania,Africa,4877181,43,6598
2020-08-12,mauritania,Africa,4877181,24,6622
2020-08-13,mauritania,Africa,4877181,31,6653
2020-08-14,mauritania,Africa,4877181,23,6676
2020-08-15,mauritania,Africa,4877181,17,6693
2020-08-16,mauritania,Africa,4877181,8,6701
2020-08-17,mauritania,Africa,4877181,61,6762
2020-08-18,mauritania,Africa,4877181,27,6789
2020-08-19,mauritania,Africa,4877181,40,6829
2020-08-20,mauritania,Africa,4877181,19,6848
2020-08-21,mauritania,Africa,4877181,37,6885
2020-08-22,mauritania,Africa,4877181,9,6894
2020-08-23,mauritania,Africa,4877181,11,6905
2020-08-24,mauritania,Africa,4877181,23,6928
2020-08-25,mauritania,Africa,4877181,32,6960
2020-08-26,mauritania,Africa,4877181,17,6977
2020-08-27,mauritania,Africa,4877181,16,6993
2020-08-28,mauritania,Africa,4877181,19,7012
2020-08-29,mauritania,Africa,4877181,0,7012
2020-08-30,mauritania,Africa,4877181,4,7016
2020-08-31,mauritania,Africa,4877181,32,7048
2020-09-01,mauritania,Africa,4877181,27,7075
2020-09-02,mauritania,Africa,4877181,14,7089
2020-09-03,mauritania,Africa,4877181,17,7106
2020-09-04,mauritania,Africa,4877181,20,7126
2020-09-05,mauritania,Africa,4877181,8,7134
2020-09-06,mauritania,Africa,4877181,8,7142
2020-09-07,mauritania,Africa,4877181,23,7165
2020-09-08,mauritania,Africa,4877181,0,7165
2020-09-09,mauritania,Africa,4877181,26,7191
2020-09-10,mauritania,Africa,4877181,31,7222
2020-09-11,mauritania,Africa,4877181,44,7266
2020-09-12,mauritania,Africa,4877181,8,7274
2020-09-13,mauritania,Africa,4877181,2,7276
2020-09-14,mauritania,Africa,4877181,19,7295
2020-09-15,mauritania,Africa,4877181,24,7319
2020-09-16,mauritania,Africa,4877181,13,7332
2020-09-17,mauritania,Africa,4877181,14,7346
2020-09-18,mauritania,Africa,4877181,15,7361
2020-09-19,mauritania,Africa,4877181,4,7365
2020-09-20,mauritania,Africa,4877181,3,7368
2020-09-21,mauritania,Africa,4877181,16,7384
2020-09-22,mauritania,Africa,4877181,19,7403
2020-09-23,mauritania,Africa,4877181,22,7425
2020-09-24,mauritania,Africa,4877181,8,7433
2020-09-25,mauritania,Africa,4877181,24,7457
2020-09-26,mauritania,Africa,4877181,5,7462
2020-09-27,mauritania,Africa,4877181,2,7464
2020-09-28,mauritania,Africa,4877181,10,7474
2020-09-29,mauritania,Africa,4877181,14,7488
2020-09-30,mauritania,Africa,4877181,14,7502
2020-10-01,mauritania,Africa,4877181,3,7505
2020-10-02,mauritania,Africa,4877181,6,7511
2020-03-22,mauritius,Africa,1275698,15,29
2020-03-23,mauritius,Africa,1275698,9,38
2020-03-24,mauritius,Africa,1275698,6,44
2020-03-25,mauritius,Africa,1275698,6,50
2020-03-26,mauritius,Africa,1275698,35,85
2020-03-27,mauritius,Africa,1275698,14,99
2020-03-28,mauritius,Africa,1275698,9,108
2020-03-29,mauritius,Africa,1275698,5,113
2020-03-30,mauritius,Africa,1275698,22,135
2020-03-31,mauritius,Africa,1275698,16,151
2020-04-01,mauritius,Africa,1275698,19,170
2020-04-02,mauritius,Africa,1275698,9,179
2020-04-03,mauritius,Africa,1275698,18,197
2020-04-04,mauritius,Africa,1275698,11,208
2020-04-05,mauritius,Africa,1275698,33,241
2020-04-06,mauritius,Africa,1275698,18,259
2020-04-07,mauritius,Africa,1275698,26,285
2020-04-08,mauritius,Africa,1275698,5,290
2020-04-09,mauritius,Africa,1275698,44,334
2020-04-10,mauritius,Africa,1275698,4,338
2020-04-11,mauritius,Africa,1275698,1,339
2020-04-12,mauritius,Africa,1275698,5,344
2020-04-13,mauritius,Africa,1275698,0,344
2020-04-14,mauritius,Africa,1275698,0,344
2020-04-15,mauritius,Africa,1275698,0,344
2020-04-16,mauritius,Africa,1275698,0,344
2020-04-17,mauritius,Africa,1275698,0,344
2020-04-18,mauritius,Africa,1275698,1,345
2020-04-19,mauritius,Africa,1275698,3,348
2020-04-20,mauritius,Africa,1275698,0,348
2020-04-21,mauritius,Africa,1275698,0,348
2020-04-22,mauritius,Africa,1275698,1,349
2020-04-23,mauritius,Africa,1275698,2,351
2020-04-24,mauritius,Africa,1275698,0,351
2020-04-25,mauritius,Africa,1275698,0,351
2020-04-26,mauritius,Africa,1275698,1,352
2020-04-27,mauritius,Africa,1275698,0,352
2020-04-28,mauritius,Africa,1275698,0,352
2020-04-29,mauritius,Africa,1275698,0,352
2020-04-30,mauritius,Africa,1275698,0,352
2020-05-01,mauritius,Africa,1275698,0,352
2020-05-02,mauritius,Africa,1275698,0,352
2020-05-03,mauritius,Africa,1275698,0,352
2020-05-04,mauritius,Africa,1275698,0,352
2020-05-05,mauritius,Africa,1275698,0,352
2020-05-06,mauritius,Africa,1275698,0,352
2020-05-07,mauritius,Africa,1275698,0,352
2020-05-08,mauritius,Africa,1275698,0,352
2020-05-09,mauritius,Africa,1275698,0,352
2020-05-10,mauritius,Africa,1275698,0,352
2020-05-11,mauritius,Africa,1275698,0,352
2020-05-12,mauritius,Africa,1275698,0,352
2020-05-13,mauritius,Africa,1275698,0,352
2020-05-14,mauritius,Africa,1275698,0,352
2020-05-15,mauritius,Africa,1275698,0,352
2020-05-16,mauritius,Africa,1275698,0,352
2020-05-17,mauritius,Africa,1275698,0,352
2020-05-18,mauritius,Africa,1275698,0,352
2020-05-19,mauritius,Africa,1275698,0,352
2020-05-20,mauritius,Africa,1275698,0,352
2020-05-21,mauritius,Africa,1275698,0,352
2020-05-22,mauritius,Africa,1275698,0,352
2020-05-23,mauritius,Africa,1275698,0,352
2020-05-24,mauritius,Africa,1275698,2,354
2020-05-25,mauritius,Africa,1275698,0,354
2020-05-26,mauritius,Africa,1275698,0,354
2020-05-27,mauritius,Africa,1275698,0,354
2020-05-28,mauritius,Africa,1275698,0,354
2020-05-29,mauritius,Africa,1275698,1,355
2020-05-30,mauritius,Africa,1275698,0,355
2020-05-31,mauritius,Africa,1275698,0,355
2020-06-01,mauritius,Africa,1275698,0,355
2020-06-02,mauritius,Africa,1275698,0,355
2020-06-03,mauritius,Africa,1275698,0,355
2020-06-04,mauritius,Africa,1275698,0,355
2020-06-05,mauritius,Africa,1275698,2,357
2020-06-06,mauritius,Africa,1275698,0,357
2020-06-07,mauritius,Africa,1275698,0,357
2020-06-08,mauritius,Africa,1275698,0,357
2020-06-09,mauritius,Africa,1275698,0,357
2020-06-10,mauritius,Africa,1275698,0,357
2020-06-11,mauritius,Africa,1275698,0,357
2020-06-12,mauritius,Africa,1275698,0,357
2020-06-13,mauritius,Africa,1275698,0,357
2020-06-14,mauritius,Africa,1275698,0,357
2020-06-15,mauritius,Africa,1275698,0,357
2020-06-16,mauritius,Africa,1275698,0,357
2020-06-17,mauritius,Africa,1275698,0,357
2020-06-18,mauritius,Africa,1275698,0,357
2020-06-19,mauritius,Africa,1275698,0,357
2020-06-20,mauritius,Africa,1275698,0,357
2020-06-21,mauritius,Africa,1275698,0,357
2020-06-22,mauritius,Africa,1275698,3,360
2020-06-23,mauritius,Africa,1275698,0,360
2020-06-24,mauritius,Africa,1275698,1,361
2020-06-25,mauritius,Africa,1275698,0,361
2020-06-26,mauritius,Africa,1275698,0,361
2020-06-27,mauritius,Africa,1275698,0,361
2020-06-28,mauritius,Africa,1275698,0,361
2020-06-29,mauritius,Africa,1275698,0,361
2020-06-30,mauritius,Africa,1275698,0,361
2020-07-01,mauritius,Africa,1275698,0,361
2020-07-02,mauritius,Africa,1275698,0,361
2020-07-03,mauritius,Africa,1275698,0,361
2020-07-04,mauritius,Africa,1275698,0,361
2020-07-05,mauritius,Africa,1275698,0,361
2020-07-06,mauritius,Africa,1275698,1,362
2020-07-07,mauritius,Africa,1275698,0,362
2020-07-08,mauritius,Africa,1275698,0,362
2020-07-09,mauritius,Africa,1275698,0,362
2020-07-10,mauritius,Africa,1275698,0,362
2020-07-11,mauritius,Africa,1275698,0,362
2020-07-12,mauritius,Africa,1275698,0,362
2020-07-13,mauritius,Africa,1275698,0,362
2020-07-14,mauritius,Africa,1275698,0,362
2020-07-15,mauritius,Africa,1275698,1,363
2020-07-16,mauritius,Africa,1275698,0,363
2020-07-17,mauritius,Africa,1275698,0,363
2020-07-18,mauritius,Africa,1275698,0,363
2020-07-19,mauritius,Africa,1275698,0,363
2020-07-20,mauritius,Africa,1275698,0,363
2020-07-21,mauritius,Africa,1275698,0,363
2020-07-22,mauritius,Africa,1275698,0,363
2020-07-23,mauritius,Africa,1275698,0,363
2020-07-24,mauritius,Africa,1275698,1,364
2020-07-25,mauritius,Africa,1275698,0,364
2020-07-26,mauritius,Africa,1275698,0,364
2020-07-27,mauritius,Africa,1275698,0,364
2020-07-28,mauritius,Africa,1275698,0,364
2020-07-29,mauritius,Africa,1275698,0,364
2020-07-30,mauritius,Africa,1275698,0,364
2020-07-31,mauritius,Africa,1275698,0,364
2020-08-01,mauritius,Africa,1275698,0,364
2020-08-02,mauritius,Africa,1275698,0,364
2020-08-03,mauritius,Africa,1275698,0,364
2020-08-04,mauritius,Africa,1275698,0,364
2020-08-05,mauritius,Africa,1275698,0,364
2020-08-06,mauritius,Africa,1275698,0,364
2020-08-07,mauritius,Africa,1275698,0,364
2020-08-08,mauritius,Africa,1275698,0,364
2020-08-09,mauritius,Africa,1275698,0,364
2020-08-10,mauritius,Africa,1275698,0,364
2020-08-11,mauritius,Africa,1275698,0,364
2020-08-12,mauritius,Africa,1275698,0,364
2020-08-13,mauritius,Africa,1275698,0,364
2020-08-14,mauritius,Africa,1275698,1,365
2020-08-15,mauritius,Africa,1275698,1,366
2020-08-16,mauritius,Africa,1275698,0,366
2020-08-17,mauritius,Africa,1275698,0,366
2020-08-18,mauritius,Africa,1275698,0,366
2020-08-19,mauritius,Africa,1275698,0,366
2020-08-20,mauritius,Africa,1275698,0,366
2020-08-21,mauritius,Africa,1275698,0,366
2020-08-22,mauritius,Africa,1275698,0,366
2020-08-23,mauritius,Africa,1275698,0,366
2020-08-24,mauritius,Africa,1275698,1,367
2020-08-25,mauritius,Africa,1275698,1,368
2020-08-26,mauritius,Africa,1275698,6,374
2020-08-27,mauritius,Africa,1275698,1,375
2020-08-28,mauritius,Africa,1275698,0,375
2020-08-29,mauritius,Africa,1275698,0,375
2020-08-30,mauritius,Africa,1275698,0,375
2020-08-31,mauritius,Africa,1275698,1,376
2020-09-01,mauritius,Africa,1275698,0,376
2020-09-02,mauritius,Africa,1275698,0,376
2020-09-03,mauritius,Africa,1275698,0,376
2020-09-04,mauritius,Africa,1275698,0,376
2020-09-05,mauritius,Africa,1275698,0,376
2020-09-06,mauritius,Africa,1275698,0,376
2020-09-07,mauritius,Africa,1275698,0,376
2020-09-08,mauritius,Africa,1275698,5,381
2020-09-09,mauritius,Africa,1275698,0,381
2020-09-10,mauritius,Africa,1275698,0,381
2020-09-11,mauritius,Africa,1275698,0,381
2020-09-12,mauritius,Africa,1275698,0,381
2020-09-13,mauritius,Africa,1275698,0,381
2020-09-14,mauritius,Africa,1275698,0,381
2020-09-15,mauritius,Africa,1275698,4,385
2020-09-16,mauritius,Africa,1275698,0,385
2020-09-17,mauritius,Africa,1275698,1,386
2020-09-18,mauritius,Africa,1275698,0,386
2020-09-19,mauritius,Africa,1275698,0,386
2020-09-20,mauritius,Africa,1275698,0,386
2020-09-21,mauritius,Africa,1275698,0,386
2020-09-22,mauritius,Africa,1275698,1,387
2020-09-23,mauritius,Africa,1275698,0,387
2020-09-24,mauritius,Africa,1275698,0,387
2020-09-25,mauritius,Africa,1275698,0,387
2020-09-26,mauritius,Africa,1275698,0,387
2020-09-27,mauritius,Africa,1275698,0,387
2020-09-28,mauritius,Africa,1275698,0,387
2020-09-29,mauritius,Africa,1275698,15,402
2020-09-30,mauritius,Africa,1275698,0,402
2020-10-01,mauritius,Africa,1275698,0,402
2020-10-02,mauritius,Africa,1275698,4,406
2020-10-03,mauritius,Africa,1275698,0,406
2020-10-04,mauritius,Africa,1275698,0,406
2020-10-05,mauritius,Africa,1275698,2,408
2020-10-06,mauritius,Africa,1275698,9,417
2020-10-07,mauritius,Africa,1275698,0,417
2020-10-08,mauritius,Africa,1275698,0,417
2020-10-09,mauritius,Africa,1275698,0,417
2020-10-10,mauritius,Africa,1275698,0,417
2020-10-11,mauritius,Africa,1275698,0,417
2020-10-12,mauritius,Africa,1275698,10,427
2020-10-13,mauritius,Africa,1275698,3,430
2020-10-14,mauritius,Africa,1275698,0,430
2020-10-15,mauritius,Africa,1275698,9,439
2020-10-16,mauritius,Africa,1275698,2,441
2020-10-17,mauritius,Africa,1275698,0,441
2020-10-18,mauritius,Africa,1275698,0,441
2020-10-19,mauritius,Africa,1275698,2,443
2020-10-20,mauritius,Africa,1275698,0,443
2020-10-21,mauritius,Africa,1275698,0,443
2020-10-22,mauritius,Africa,1275698,6,449
2020-10-23,mauritius,Africa,1275698,11,460
2020-10-24,mauritius,Africa,1275698,0,460
2020-10-25,mauritius,Africa,1275698,0,460
2020-10-26,mauritius,Africa,1275698,4,464
2020-10-27,mauritius,Africa,1275698,0,464
2020-10-28,mauritius,Africa,1275698,2,466
2020-10-29,mauritius,Africa,1275698,0,466
2020-10-30,mauritius,Africa,1275698,0,466
2020-10-31,mauritius,Africa,1275698,0,466
2020-11-01,mauritius,Africa,1275698,5,471
2020-11-02,mauritius,Africa,1275698,5,476
2020-11-03,mauritius,Africa,1275698,0,476
2020-11-04,mauritius,Africa,1275698,1,477
2020-11-05,mauritius,Africa,1275698,1,478
2020-11-06,mauritius,Africa,1275698,0,478
2020-11-07,mauritius,Africa,1275698,0,478
2020-11-08,mauritius,Africa,1275698,0,478
2020-11-09,mauritius,Africa,1275698,0,478
2020-11-10,mauritius,Africa,1275698,0,478
2020-11-11,mauritius,Africa,1275698,0,478
2020-11-12,mauritius,Africa,1275698,16,494
2020-11-13,mauritius,Africa,1275698,2,496
2020-11-14,mauritius,Africa,1275698,0,496
2020-11-15,mauritius,Africa,1275698,9,505
2020-11-16,mauritius,Africa,1275698,14,519
2020-11-17,mauritius,Africa,1275698,0,519
2020-11-18,mauritius,Africa,1275698,3,522
2020-11-19,mauritius,Africa,1275698,0,522
2020-11-20,mauritius,Africa,1275698,0,522
2020-11-21,mauritius,Africa,1275698,0,522
2020-11-22,mauritius,Africa,1275698,0,522
2020-11-23,mauritius,Africa,1275698,0,522
2020-11-24,mauritius,Africa,1275698,0,522
2020-11-25,mauritius,Africa,1275698,3,525
2020-11-26,mauritius,Africa,1275698,1,526
2020-11-27,mauritius,Africa,1275698,3,529
2020-11-28,mauritius,Africa,1275698,0,529
2020-11-29,mauritius,Africa,1275698,0,529
2020-11-30,mauritius,Africa,1275698,3,532
2020-12-01,mauritius,Africa,1275698,1,533
2020-12-02,mauritius,Africa,1275698,3,536
2020-12-03,mauritius,Africa,1275698,0,536
2020-12-04,mauritius,Africa,1275698,0,536
2020-12-05,mauritius,Africa,1275698,0,536
2020-12-06,mauritius,Africa,1275698,0,536
2020-12-07,mauritius,Africa,1275698,3,539
2020-12-08,mauritius,Africa,1275698,4,543
2020-12-09,mauritius,Africa,1275698,0,543
2020-12-10,mauritius,Africa,1275698,0,543
2020-12-11,mauritius,Africa,1275698,0,543
2020-12-12,mauritius,Africa,1275698,0,543
2020-12-13,mauritius,Africa,1275698,0,543
2020-12-14,mauritius,Africa,1275698,9,552
2020-12-15,mauritius,Africa,1275698,1,553
2020-12-16,mauritius,Africa,1275698,0,553
2020-12-17,mauritius,Africa,1275698,0,553
2020-12-18,mauritius,Africa,1275698,0,553
2020-12-19,mauritius,Africa,1275698,0,553
2020-12-20,mauritius,Africa,1275698,0,553
2020-12-21,mauritius,Africa,1275698,0,553
2020-12-22,mauritius,Africa,1275698,2,555
2020-12-23,mauritius,Africa,1275698,1,556
2020-12-24,mauritius,Africa,1275698,0,556
2020-12-25,mauritius,Africa,1275698,0,556
2020-12-26,mauritius,Africa,1275698,0,556
2020-12-27,mauritius,Africa,1275698,0,556
2020-12-28,mauritius,Africa,1275698,0,556
2020-12-29,mauritius,Africa,1275698,0,556
2020-12-30,mauritius,Africa,1275698,0,556
2020-12-31,mauritius,Africa,1275698,0,556
2021-01-01,mauritius,Africa,1275698,0,556
2021-01-02,mauritius,Africa,1275698,0,556
2021-01-03,mauritius,Africa,1275698,0,556
2021-01-04,mauritius,Africa,1275698,4,560
2021-01-05,mauritius,Africa,1275698,0,560
2021-01-06,mauritius,Africa,1275698,9,569
2021-01-07,mauritius,Africa,1275698,0,569
2021-01-08,mauritius,Africa,1275698,0,569
2021-01-09,mauritius,Africa,1275698,0,569
2021-01-10,mauritius,Africa,1275698,0,569
2021-01-11,mauritius,Africa,1275698,6,575
2021-01-12,mauritius,Africa,1275698,1,576
2021-01-13,mauritius,Africa,1275698,1,577
2021-01-14,mauritius,Africa,1275698,0,577
2021-01-15,mauritius,Africa,1275698,0,577
2021-01-16,mauritius,Africa,1275698,0,577
2021-01-17,mauritius,Africa,1275698,0,577
2021-01-18,mauritius,Africa,1275698,10,587
2021-01-19,mauritius,Africa,1275698,0,587
2021-01-20,mauritius,Africa,1275698,0,587
2021-01-21,mauritius,Africa,1275698,0,587
2021-01-22,mauritius,Africa,1275698,0,587
2021-01-23,mauritius,Africa,1275698,0,587
2021-01-24,mauritius,Africa,1275698,0,587
2021-01-25,mauritius,Africa,1275698,13,600
2021-01-26,mauritius,Africa,1275698,0,600
2021-01-27,mauritius,Africa,1275698,1,601
2021-01-28,mauritius,Africa,1275698,0,601
2021-01-29,mauritius,Africa,1275698,0,601
2021-01-30,mauritius,Africa,1275698,0,601
2021-01-31,mauritius,Africa,1275698,0,601
2021-02-01,mauritius,Africa,1275698,14,615
2021-02-02,mauritius,Africa,1275698,1,616
2021-02-03,mauritius,Africa,1275698,1,617
2021-02-04,mauritius,Africa,1275698,0,617
2021-02-05,mauritius,Africa,1275698,0,617
2021-02-06,mauritius,Africa,1275698,0,617
2021-02-07,mauritius,Africa,1275698,0,617
2021-02-08,mauritius,Africa,1275698,10,627
2021-02-09,mauritius,Africa,1275698,1,628
2021-02-10,mauritius,Africa,1275698,1,629
2021-02-11,mauritius,Africa,1275698,0,629
2021-02-12,mauritius,Africa,1275698,0,629
2021-02-13,mauritius,Africa,1275698,0,629
2021-02-14,mauritius,Africa,1275698,0,629
2021-02-15,mauritius,Africa,1275698,6,635
2021-02-16,mauritius,Africa,1275698,2,637
2021-02-17,mauritius,Africa,1275698,0,637
2021-02-18,mauritius,Africa,1275698,0,637
2021-02-19,mauritius,Africa,1275698,0,637
2021-02-20,mauritius,Africa,1275698,0,637
2021-02-21,mauritius,Africa,1275698,0,637
2021-02-22,mauritius,Africa,1275698,0,637
2021-02-23,mauritius,Africa,1275698,7,644
2021-02-24,mauritius,Africa,1275698,0,644
2021-02-25,mauritius,Africa,1275698,0,644
2021-02-26,mauritius,Africa,1275698,0,644
2021-02-27,mauritius,Africa,1275698,0,644
2021-02-28,mauritius,Africa,1275698,0,644
2021-03-01,mauritius,Africa,1275698,3,647
2021-03-02,mauritius,Africa,1275698,0,647
2021-03-03,mauritius,Africa,1275698,0,647
2021-03-04,mauritius,Africa,1275698,1,648
2021-03-05,mauritius,Africa,1275698,3,651
2021-03-06,mauritius,Africa,1275698,0,651
2021-03-07,mauritius,Africa,1275698,5,656
2021-03-08,mauritius,Africa,1275698,0,656
2021-03-09,mauritius,Africa,1275698,5,661
2021-03-10,mauritius,Africa,1275698,17,678
2021-03-11,mauritius,Africa,1275698,27,705
2021-03-12,mauritius,Africa,1275698,46,751
2021-03-13,mauritius,Africa,1275698,30,781
2021-03-14,mauritius,Africa,1275698,3,784
2021-03-15,mauritius,Africa,1275698,5,789
2021-03-16,mauritius,Africa,1275698,12,801
2021-03-17,mauritius,Africa,1275698,4,805
2021-03-18,mauritius,Africa,1275698,6,811
2021-03-19,mauritius,Africa,1275698,27,838
2021-03-20,mauritius,Africa,1275698,3,841
2021-03-21,mauritius,Africa,1275698,10,851
2021-03-22,mauritius,Africa,1275698,45,896
2021-03-23,mauritius,Africa,1275698,3,899
2021-03-24,mauritius,Africa,1275698,0,899
2021-03-25,mauritius,Africa,1275698,3,902
2021-03-26,mauritius,Africa,1275698,19,921
2021-03-27,mauritius,Africa,1275698,31,952
2021-03-28,mauritius,Africa,1275698,35,987
2021-03-29,mauritius,Africa,1275698,27,1014
2021-03-30,mauritius,Africa,1275698,40,1054
2021-03-31,mauritius,Africa,1275698,34,1088
2021-04-01,mauritius,Africa,1275698,12,1100
2021-04-02,mauritius,Africa,1275698,60,1160
2021-04-03,mauritius,Africa,1275698,10,1170
2021-04-04,mauritius,Africa,1275698,9,1179
2021-04-05,mauritius,Africa,1275698,11,1190
2021-04-06,mauritius,Africa,1275698,36,1226
2021-04-07,mauritius,Africa,1275698,12,1238
2021-04-08,mauritius,Africa,1275698,4,1242
2021-04-09,mauritius,Africa,1275698,15,1257
2021-04-10,mauritius,Africa,1275698,5,1262
2021-04-11,mauritius,Africa,1275698,2,1264
2021-04-12,mauritius,Africa,1275698,1,1265
2021-04-13,mauritius,Africa,1275698,5,1270
2021-04-14,mauritius,Africa,1275698,3,1273
2021-04-15,mauritius,Africa,1275698,1,1274
2021-04-16,mauritius,Africa,1275698,0,1274
2021-04-17,mauritius,Africa,1275698,1,1275
2021-04-18,mauritius,Africa,1275698,0,1275
2021-04-19,mauritius,Africa,1275698,0,1275
2021-04-20,mauritius,Africa,1275698,0,1275
2021-04-21,mauritius,Africa,1275698,1,1276
2021-04-22,mauritius,Africa,1275698,1,1277
2021-04-23,mauritius,Africa,1275698,0,1277
2021-04-24,mauritius,Africa,1275698,1,1278
2021-04-25,mauritius,Africa,1275698,0,1278
2021-04-26,mauritius,Africa,1275698,0,1278
2021-04-27,mauritius,Africa,1275698,0,1278
2021-04-28,mauritius,Africa,1275698,1,1279
2021-04-29,mauritius,Africa,1275698,1,1280
2021-04-30,mauritius,Africa,1275698,1,1281
2021-05-01,mauritius,Africa,1275698,2,1283
2021-05-02,mauritius,Africa,1275698,0,1283
2021-05-03,mauritius,Africa,1275698,0,1283
2021-05-04,mauritius,Africa,1275698,3,1286
2021-05-05,mauritius,Africa,1275698,2,1288
2021-05-06,mauritius,Africa,1275698,0,1288
2020-04-01,mayotte,Africa,285070,7,101
2020-04-02,mayotte,Africa,285070,15,116
2020-04-03,mayotte,Africa,285070,12,128
2020-04-04,mayotte,Africa,285070,6,134
2020-04-05,mayotte,Africa,285070,13,147
2020-04-06,mayotte,Africa,285070,17,164
2020-04-07,mayotte,Africa,285070,7,171
2020-04-08,mayotte,Africa,285070,13,184
2020-04-09,mayotte,Africa,285070,0,184
2020-04-10,mayotte,Africa,285070,7,191
2020-04-11,mayotte,Africa,285070,5,196
2020-04-12,mayotte,Africa,285070,0,196
2020-04-13,mayotte,Africa,285070,11,207
2020-04-14,mayotte,Africa,285070,10,217
2020-04-15,mayotte,Africa,285070,0,217
2020-04-16,mayotte,Africa,285070,16,233
2020-04-17,mayotte,Africa,285070,12,245
2020-04-18,mayotte,Africa,285070,9,254
2020-04-19,mayotte,Africa,285070,17,271
2020-04-20,mayotte,Africa,285070,0,271
2020-04-21,mayotte,Africa,285070,40,311
2020-04-22,mayotte,Africa,285070,15,326
2020-04-23,mayotte,Africa,285070,0,326
2020-04-24,mayotte,Africa,285070,28,354
2020-04-25,mayotte,Africa,285070,26,380
2020-04-26,mayotte,Africa,285070,21,401
2020-04-27,mayotte,Africa,285070,0,401
2020-04-28,mayotte,Africa,285070,59,460
2020-04-29,mayotte,Africa,285070,0,460
2020-04-30,mayotte,Africa,285070,79,539
2020-05-01,mayotte,Africa,285070,0,539
2020-05-02,mayotte,Africa,285070,57,596
2020-05-03,mayotte,Africa,285070,54,650
2020-05-04,mayotte,Africa,285070,36,686
2020-05-05,mayotte,Africa,285070,53,739
2020-05-06,mayotte,Africa,285070,0,739
2020-05-07,mayotte,Africa,285070,115,854
2020-05-08,mayotte,Africa,285070,0,854
2020-05-09,mayotte,Africa,285070,134,988
2020-05-10,mayotte,Africa,285070,35,1023
2020-05-11,mayotte,Africa,285070,0,1023
2020-05-12,mayotte,Africa,285070,72,1095
2020-05-13,mayotte,Africa,285070,48,1143
2020-05-14,mayotte,Africa,285070,67,1210
2020-05-15,mayotte,Africa,285070,0,1210
2020-05-16,mayotte,Africa,285070,102,1312
2020-05-17,mayotte,Africa,285070,30,1342
2020-05-18,mayotte,Africa,285070,28,1370
2020-05-19,mayotte,Africa,285070,0,1370
2020-05-20,mayotte,Africa,285070,105,1475
2020-05-21,mayotte,Africa,285070,0,1475
2020-05-22,mayotte,Africa,285070,46,1521
2020-05-23,mayotte,Africa,285070,0,1521
2020-05-24,mayotte,Africa,285070,66,1587
2020-05-25,mayotte,Africa,285070,22,1609
2020-05-26,mayotte,Africa,285070,25,1634
2020-05-27,mayotte,Africa,285070,11,1645
2020-05-28,mayotte,Africa,285070,25,1670
2020-05-29,mayotte,Africa,285070,29,1699
2020-05-30,mayotte,Africa,285070,0,1699
2020-05-31,mayotte,Africa,285070,0,1699
2020-06-01,mayotte,Africa,285070,235,1934
2020-06-02,mayotte,Africa,285070,52,1986
2020-06-03,mayotte,Africa,285070,7,1993
2020-06-04,mayotte,Africa,285070,65,2058
2020-06-05,mayotte,Africa,285070,21,2079
2020-06-06,mayotte,Africa,285070,0,2079
2020-06-07,mayotte,Africa,285070,0,2079
2020-06-08,mayotte,Africa,285070,72,2151
2020-06-09,mayotte,Africa,285070,24,2175
2020-06-10,mayotte,Africa,285070,51,2226
2020-06-11,mayotte,Africa,285070,14,2240
2020-06-12,mayotte,Africa,285070,28,2268
2020-06-13,mayotte,Africa,285070,14,2282
2020-06-14,mayotte,Africa,285070,16,2298
2020-06-15,mayotte,Africa,285070,12,2310
2020-06-16,mayotte,Africa,285070,23,2333
2020-06-17,mayotte,Africa,285070,12,2345
2020-06-18,mayotte,Africa,285070,38,2383
2020-06-19,mayotte,Africa,285070,11,2394
2020-06-20,mayotte,Africa,285070,10,2404
2020-06-21,mayotte,Africa,285070,0,2404
2020-06-22,mayotte,Africa,285070,30,2434
2020-06-23,mayotte,Africa,285070,0,2434
2020-06-24,mayotte,Africa,285070,33,2467
2020-06-25,mayotte,Africa,285070,41,2508
2020-06-26,mayotte,Africa,285070,0,2508
2020-06-27,mayotte,Africa,285070,0,2508
2020-06-28,mayotte,Africa,285070,0,2508
2020-06-29,mayotte,Africa,285070,52,2560
2020-06-30,mayotte,Africa,285070,43,2603
2020-07-01,mayotte,Africa,285070,40,2643
2020-07-02,mayotte,Africa,285070,7,2650
2020-07-03,mayotte,Africa,285070,11,2661
2020-07-04,mayotte,Africa,285070,0,2661
2020-07-05,mayotte,Africa,285070,0,2661
2020-07-06,mayotte,Africa,285070,18,2679
2020-07-07,mayotte,Africa,285070,9,2688
2020-07-08,mayotte,Africa,285070,0,2688
2020-07-09,mayotte,Africa,285070,14,2702
2020-07-10,mayotte,Africa,285070,9,2711
2020-07-11,mayotte,Africa,285070,0,2711
2020-07-12,mayotte,Africa,285070,0,2711
2020-07-13,mayotte,Africa,285070,13,2724
2020-07-14,mayotte,Africa,285070,13,2737
2020-07-15,mayotte,Africa,285070,6,2743
2020-07-16,mayotte,Africa,285070,35,2778
2020-07-17,mayotte,Africa,285070,4,2782
2020-07-18,mayotte,Africa,285070,0,2782
2020-07-19,mayotte,Africa,285070,0,2782
2020-07-20,mayotte,Africa,285070,26,2808
2020-07-21,mayotte,Africa,285070,16,2824
2020-07-22,mayotte,Africa,285070,15,2839
2020-07-23,mayotte,Africa,285070,23,2862
2020-07-24,mayotte,Africa,285070,0,2862
2020-07-25,mayotte,Africa,285070,0,2862
2020-07-26,mayotte,Africa,285070,0,2862
2020-07-27,mayotte,Africa,285070,38,2900
2020-07-28,mayotte,Africa,285070,0,2900
2020-07-29,mayotte,Africa,285070,5,2905
2020-07-30,mayotte,Africa,285070,57,2962
2020-07-31,mayotte,Africa,285070,0,2962
2020-08-01,mayotte,Africa,285070,0,2962
2020-08-02,mayotte,Africa,285070,0,2962
2020-08-03,mayotte,Africa,285070,46,3008
2020-08-04,mayotte,Africa,285070,15,3023
2020-08-05,mayotte,Africa,285070,8,3031
2020-08-06,mayotte,Africa,285070,11,3042
2020-08-07,mayotte,Africa,285070,26,3068
2020-08-08,mayotte,Africa,285070,0,3068
2020-08-09,mayotte,Africa,285070,0,3068
2020-08-10,mayotte,Africa,285070,0,3068
2020-08-11,mayotte,Africa,285070,23,3091
2020-08-12,mayotte,Africa,285070,0,3091
2020-08-13,mayotte,Africa,285070,28,3119
2020-08-14,mayotte,Africa,285070,0,3119
2020-08-15,mayotte,Africa,285070,0,3119
2020-08-16,mayotte,Africa,285070,0,3119
2020-08-17,mayotte,Africa,285070,41,3160
2020-08-18,mayotte,Africa,285070,20,3180
2020-08-19,mayotte,Africa,285070,20,3200
2020-08-20,mayotte,Africa,285070,21,3221
2020-08-21,mayotte,Africa,285070,16,3237
2020-08-22,mayotte,Africa,285070,0,3237
2020-08-23,mayotte,Africa,285070,0,3237
2020-08-24,mayotte,Africa,285070,0,3237
2020-08-25,mayotte,Africa,285070,0,3237
2020-08-26,mayotte,Africa,285070,0,3237
2020-08-27,mayotte,Africa,285070,64,3301
2020-08-28,mayotte,Africa,285070,0,3301
2020-08-29,mayotte,Africa,285070,0,3301
2020-08-30,mayotte,Africa,285070,0,3301
2020-08-31,mayotte,Africa,285070,0,3301
2020-09-01,mayotte,Africa,285070,0,3301
2020-09-02,mayotte,Africa,285070,0,3301
2020-09-03,mayotte,Africa,285070,73,3374
2020-09-04,mayotte,Africa,285070,0,3374
2020-09-05,mayotte,Africa,285070,0,3374
2020-09-06,mayotte,Africa,285070,0,3374
2020-09-07,mayotte,Africa,285070,0,3374
2020-09-08,mayotte,Africa,285070,0,3374
2020-09-09,mayotte,Africa,285070,0,3374
2020-09-10,mayotte,Africa,285070,0,3374
2020-09-11,mayotte,Africa,285070,0,3374
2020-09-12,mayotte,Africa,285070,0,3374
2020-09-13,mayotte,Africa,285070,0,3374
2020-09-14,mayotte,Africa,285070,167,3541
2020-09-15,mayotte,Africa,285070,0,3541
2020-09-16,mayotte,Africa,285070,0,3541
2020-09-17,mayotte,Africa,285070,0,3541
2020-09-18,mayotte,Africa,285070,0,3541
2020-09-19,mayotte,Africa,285070,0,3541
2020-09-20,mayotte,Africa,285070,0,3541
2020-09-21,mayotte,Africa,285070,0,3541
2020-09-22,mayotte,Africa,285070,0,3541
2020-09-23,mayotte,Africa,285070,0,3541
2020-09-24,mayotte,Africa,285070,0,3541
2020-09-25,mayotte,Africa,285070,0,3541
2020-09-26,mayotte,Africa,285070,0,3541
2020-09-27,mayotte,Africa,285070,0,3541
2020-09-28,mayotte,Africa,285070,0,3541
2020-09-29,mayotte,Africa,285070,0,3541
2020-09-30,mayotte,Africa,285070,238,3779
2020-10-01,mayotte,Africa,285070,0,3779
2020-10-02,mayotte,Africa,285070,0,3779
2020-10-03,mayotte,Africa,285070,0,3779
2020-10-04,mayotte,Africa,285070,0,3779
2020-10-05,mayotte,Africa,285070,113,3892
2020-10-06,mayotte,Africa,285070,0,3892
2020-10-07,mayotte,Africa,285070,0,3892
2020-10-08,mayotte,Africa,285070,0,3892
2020-10-09,mayotte,Africa,285070,97,3989
2020-10-10,mayotte,Africa,285070,0,3989
2020-10-11,mayotte,Africa,285070,0,3989
2020-10-12,mayotte,Africa,285070,41,4030
2020-10-13,mayotte,Africa,285070,0,4030
2020-10-14,mayotte,Africa,285070,0,4030
2020-10-15,mayotte,Africa,285070,0,4030
2020-10-16,mayotte,Africa,285070,0,4030
2020-10-17,mayotte,Africa,285070,0,4030
2020-10-18,mayotte,Africa,285070,0,4030
2020-10-19,mayotte,Africa,285070,129,4159
2020-10-20,mayotte,Africa,285070,0,4159
2020-10-21,mayotte,Africa,285070,44,4203
2020-10-22,mayotte,Africa,285070,0,4203
2020-10-23,mayotte,Africa,285070,73,4276
2020-10-24,mayotte,Africa,285070,0,4276
2020-10-25,mayotte,Africa,285070,0,4276
2020-10-26,mayotte,Africa,285070,45,4321
2020-10-27,mayotte,Africa,285070,0,4321
2020-10-28,mayotte,Africa,285070,45,4366
2020-10-29,mayotte,Africa,285070,0,4366
2020-10-30,mayotte,Africa,285070,0,4366
2020-10-31,mayotte,Africa,285070,0,4366
2020-11-01,mayotte,Africa,285070,0,4366
2020-11-02,mayotte,Africa,285070,123,4489
2020-11-03,mayotte,Africa,285070,35,4524
2020-11-04,mayotte,Africa,285070,26,4550
2020-11-05,mayotte,Africa,285070,0,4550
2020-11-06,mayotte,Africa,285070,0,4550
2020-11-07,mayotte,Africa,285070,0,4550
2020-11-08,mayotte,Africa,285070,0,4550
2020-11-09,mayotte,Africa,285070,265,4815
2020-11-10,mayotte,Africa,285070,0,4815
2020-11-11,mayotte,Africa,285070,0,4815
2020-11-12,mayotte,Africa,285070,106,4921
2020-11-13,mayotte,Africa,285070,0,4921
2020-11-14,mayotte,Africa,285070,0,4921
2020-11-15,mayotte,Africa,285070,0,4921
2020-11-16,mayotte,Africa,285070,22,4943
2020-11-17,mayotte,Africa,285070,0,4943
2020-11-18,mayotte,Africa,285070,93,5036
2020-11-19,mayotte,Africa,285070,0,5036
2020-11-20,mayotte,Africa,285070,0,5036
2020-11-21,mayotte,Africa,285070,0,5036
2020-11-22,mayotte,Africa,285070,0,5036
2020-11-23,mayotte,Africa,285070,86,5122
2020-11-24,mayotte,Africa,285070,0,5122
2020-11-25,mayotte,Africa,285070,59,5181
2020-11-26,mayotte,Africa,285070,0,5181
2020-11-27,mayotte,Africa,285070,0,5181
2020-11-28,mayotte,Africa,285070,0,5181
2020-11-29,mayotte,Africa,285070,0,5181
2020-11-30,mayotte,Africa,285070,0,5181
2020-12-01,mayotte,Africa,285070,0,5181
2020-12-02,mayotte,Africa,285070,0,5181
2020-12-03,mayotte,Africa,285070,0,5181
2020-12-04,mayotte,Africa,285070,0,5181
2020-12-05,mayotte,Africa,285070,0,5181
2020-12-06,mayotte,Africa,285070,0,5181
2020-12-07,mayotte,Africa,285070,0,5181
2020-12-08,mayotte,Africa,285070,0,5181
2020-12-09,mayotte,Africa,285070,318,5499
2020-12-10,mayotte,Africa,285070,0,5499
2020-12-11,mayotte,Africa,285070,52,5551
2020-12-12,mayotte,Africa,285070,0,5551
2020-12-13,mayotte,Africa,285070,0,5551
2020-12-14,mayotte,Africa,285070,0,5551
2020-12-15,mayotte,Africa,285070,65,5616
2020-12-16,mayotte,Africa,285070,0,5616
2020-12-17,mayotte,Africa,285070,0,5616
2020-12-18,mayotte,Africa,285070,92,5708
2020-12-19,mayotte,Africa,285070,0,5708
2020-12-20,mayotte,Africa,285070,0,5708
2020-12-21,mayotte,Africa,285070,0,5708
2020-12-22,mayotte,Africa,285070,0,5708
2020-12-23,mayotte,Africa,285070,59,5767
2020-12-24,mayotte,Africa,285070,0,5767
2020-12-25,mayotte,Africa,285070,0,5767
2020-12-26,mayotte,Africa,285070,0,5767
2020-12-27,mayotte,Africa,285070,0,5767
2020-12-28,mayotte,Africa,285070,123,5890
2020-12-29,mayotte,Africa,285070,0,5890
2020-12-30,mayotte,Africa,285070,0,5890
2020-12-31,mayotte,Africa,285070,0,5890
2021-01-01,mayotte,Africa,285070,0,5890
2021-01-02,mayotte,Africa,285070,0,5890
2021-01-03,mayotte,Africa,285070,13,5903
2021-01-04,mayotte,Africa,285070,142,6045
2021-01-05,mayotte,Africa,285070,0,6045
2021-01-06,mayotte,Africa,285070,0,6045
2021-01-07,mayotte,Africa,285070,0,6045
2021-01-08,mayotte,Africa,285070,187,6232
2021-01-09,mayotte,Africa,285070,0,6232
2021-01-10,mayotte,Africa,285070,0,6232
2021-01-11,mayotte,Africa,285070,0,6232
2021-01-12,mayotte,Africa,285070,0,6232
2021-01-13,mayotte,Africa,285070,23,6255
2021-01-14,mayotte,Africa,285070,0,6255
2021-01-15,mayotte,Africa,285070,356,6611
2021-01-16,mayotte,Africa,285070,0,6611
2021-01-17,mayotte,Africa,285070,0,6611
2021-01-18,mayotte,Africa,285070,178,6789
2021-01-19,mayotte,Africa,285070,129,6918
2021-01-20,mayotte,Africa,285070,63,6981
2021-01-21,mayotte,Africa,285070,177,7158
2021-01-22,mayotte,Africa,285070,92,7250
2021-01-23,mayotte,Africa,285070,0,7250
2021-01-24,mayotte,Africa,285070,0,7250
2021-01-25,mayotte,Africa,285070,340,7590
2021-01-26,mayotte,Africa,285070,0,7590
2021-01-27,mayotte,Africa,285070,294,7884
2021-01-28,mayotte,Africa,285070,148,8032
2021-01-29,mayotte,Africa,285070,199,8231
2021-01-30,mayotte,Africa,285070,0,8231
2021-01-31,mayotte,Africa,285070,0,8231
2021-02-01,mayotte,Africa,285070,357,8588
2021-02-02,mayotte,Africa,285070,415,9003
2021-02-03,mayotte,Africa,285070,289,9292
2021-02-04,mayotte,Africa,285070,254,9546
2021-02-05,mayotte,Africa,285070,0,9546
2021-02-06,mayotte,Africa,285070,0,9546
2021-02-07,mayotte,Africa,285070,0,9546
2021-02-08,mayotte,Africa,285070,1601,11147
2021-02-09,mayotte,Africa,285070,300,11447
2021-02-10,mayotte,Africa,285070,336,11783
2021-02-11,mayotte,Africa,285070,657,12440
2021-02-12,mayotte,Africa,285070,262,12702
2021-02-13,mayotte,Africa,285070,513,13215
2021-02-14,mayotte,Africa,285070,320,13535
2021-02-15,mayotte,Africa,285070,135,13670
2021-02-16,mayotte,Africa,285070,367,14037
2021-02-17,mayotte,Africa,285070,444,14481
2021-02-18,mayotte,Africa,285070,11,14492
2021-02-19,mayotte,Africa,285070,0,14492
2021-02-20,mayotte,Africa,285070,1300,15792
2021-02-21,mayotte,Africa,285070,0,15792
2021-02-22,mayotte,Africa,285070,268,16060
2021-02-23,mayotte,Africa,285070,289,16349
2021-02-24,mayotte,Africa,285070,289,16638
2021-02-25,mayotte,Africa,285070,223,16861
2021-02-26,mayotte,Africa,285070,0,16861
2021-02-27,mayotte,Africa,285070,0,16861
2021-02-28,mayotte,Africa,285070,0,16861
2021-03-01,mayotte,Africa,285070,739,17600
2021-03-02,mayotte,Africa,285070,0,17600
2021-03-03,mayotte,Africa,285070,0,17600
2021-03-04,mayotte,Africa,285070,454,18054
2021-03-05,mayotte,Africa,285070,86,18140
2021-03-06,mayotte,Africa,285070,0,18140
2021-03-07,mayotte,Africa,285070,0,18140
2021-03-08,mayotte,Africa,285070,175,18315
2021-03-09,mayotte,Africa,285070,98,18413
2021-03-10,mayotte,Africa,285070,0,18413
2021-03-11,mayotte,Africa,285070,191,18604
2021-03-12,mayotte,Africa,285070,38,18642
2021-03-13,mayotte,Africa,285070,0,18642
2021-03-14,mayotte,Africa,285070,0,18642
2021-03-15,mayotte,Africa,285070,203,18845
2021-03-16,mayotte,Africa,285070,0,18845
2021-03-17,mayotte,Africa,285070,77,18922
2021-03-18,mayotte,Africa,285070,62,18984
2021-03-19,mayotte,Africa,285070,22,19006
2021-03-20,mayotte,Africa,285070,0,19006
2021-03-21,mayotte,Africa,285070,0,19006
2021-03-22,mayotte,Africa,285070,0,19006
2021-03-23,mayotte,Africa,285070,218,19224
2021-03-24,mayotte,Africa,285070,0,19224
2021-03-25,mayotte,Africa,285070,77,19301
2021-03-26,mayotte,Africa,285070,0,19301
2021-03-27,mayotte,Africa,285070,0,19301
2021-03-28,mayotte,Africa,285070,0,19301
2021-03-29,mayotte,Africa,285070,0,19301
2021-03-30,mayotte,Africa,285070,0,19301
2021-03-31,mayotte,Africa,285070,0,19301
2021-04-01,mayotte,Africa,285070,0,19301
2021-04-02,mayotte,Africa,285070,0,19301
2021-04-03,mayotte,Africa,285070,0,19301
2021-04-04,mayotte,Africa,285070,0,19301
2021-04-05,mayotte,Africa,285070,0,19301
2021-04-06,mayotte,Africa,285070,0,19301
2021-04-07,mayotte,Africa,285070,0,19301
2021-04-08,mayotte,Africa,285070,0,19301
2021-04-09,mayotte,Africa,285070,0,19301
2021-04-10,mayotte,Africa,285070,0,19301
2021-04-11,mayotte,Africa,285070,0,19301
2021-04-12,mayotte,Africa,285070,0,19301
2021-04-13,mayotte,Africa,285070,0,19301
2021-04-14,mayotte,Africa,285070,0,19301
2021-04-15,mayotte,Africa,285070,0,19301
2021-04-16,mayotte,Africa,285070,0,19301
2021-04-17,mayotte,Africa,285070,0,19301
2021-04-18,mayotte,Africa,285070,0,19301
2021-04-19,mayotte,Africa,285070,0,19301
2021-04-20,mayotte,Africa,285070,0,19301
2021-04-21,mayotte,Africa,285070,0,19301
2021-04-22,mayotte,Africa,285070,0,19301
2021-04-23,mayotte,Africa,285070,0,19301
2021-04-24,mayotte,Africa,285070,0,19301
2021-04-25,mayotte,Africa,285070,0,19301
2021-04-26,mayotte,Africa,285070,0,19301
2021-04-27,mayotte,Africa,285070,0,19301
2021-04-28,mayotte,Africa,285070,0,19301
2021-04-29,mayotte,Africa,285070,0,19301
2021-04-30,mayotte,Africa,285070,0,19301
2021-05-01,mayotte,Africa,285070,0,19301
2021-05-02,mayotte,Africa,285070,0,19301
2021-05-03,mayotte,Africa,285070,0,19301
2021-05-04,mayotte,Africa,285070,0,19301
2021-05-05,mayotte,Africa,285070,0,19301
2021-05-06,mayotte,Africa,285070,0,19301
2021-05-07,mayotte,Africa,285070,0,19301
2021-05-08,mayotte,Africa,285070,0,19301
2021-05-09,mayotte,Africa,285070,0,19301
2021-05-10,mayotte,Africa,285070,0,19301
2021-05-11,mayotte,Africa,285070,0,19301
2021-05-12,mayotte,Africa,285070,0,19301
2021-05-13,mayotte,Africa,285070,0,19301
2021-05-14,mayotte,Africa,285070,0,19301
2021-05-15,mayotte,Africa,285070,0,19301
2021-05-16,mayotte,Africa,285070,0,19301
2021-05-17,mayotte,Africa,285070,0,19301
2021-05-18,mayotte,Africa,285070,0,19301
2021-05-19,mayotte,Africa,285070,0,19301
2021-05-20,mayotte,Africa,285070,0,19301
2021-05-21,mayotte,Africa,285070,0,19301
2021-05-22,mayotte,Africa,285070,0,19301
2021-05-23,mayotte,Africa,285070,0,19301
2021-05-24,mayotte,Africa,285070,0,19301
2021-05-25,mayotte,Africa,285070,0,19301
2021-05-26,mayotte,Africa,285070,0,19301
2021-05-27,mayotte,Africa,285070,0,19301
2021-05-28,mayotte,Africa,285070,0,19301
2021-05-29,mayotte,Africa,285070,0,19301
2021-05-30,mayotte,Africa,285070,0,19301
2021-05-31,mayotte,Africa,285070,0,19301
2021-06-01,mayotte,Africa,285070,0,19301
2021-06-02,mayotte,Africa,285070,32,19333
2021-06-03,mayotte,Africa,285070,0,19333
2021-06-04,mayotte,Africa,285070,14,19347
2021-06-05,mayotte,Africa,285070,0,19347
2021-06-06,mayotte,Africa,285070,0,19347
2021-06-07,mayotte,Africa,285070,0,19347
2021-06-08,mayotte,Africa,285070,0,19347
2021-06-09,mayotte,Africa,285070,0,19347
2021-06-10,mayotte,Africa,285070,0,19347
2021-06-11,mayotte,Africa,285070,26,19373
2021-06-12,mayotte,Africa,285070,0,19373
2021-06-13,mayotte,Africa,285070,0,19373
2021-06-14,mayotte,Africa,285070,5,19378
2021-06-15,mayotte,Africa,285070,0,19378
2021-06-16,mayotte,Africa,285070,0,19378
2021-06-17,mayotte,Africa,285070,0,19378
2021-06-18,mayotte,Africa,285070,0,19378
2021-06-19,mayotte,Africa,285070,11,19389
2021-06-20,mayotte,Africa,285070,0,19389
2021-06-21,mayotte,Africa,285070,0,19389
2021-06-22,mayotte,Africa,285070,0,19389
2021-06-23,mayotte,Africa,285070,0,19389
2021-06-24,mayotte,Africa,285070,0,19389
2021-06-25,mayotte,Africa,285070,16,19405
2021-06-26,mayotte,Africa,285070,0,19405
2021-06-27,mayotte,Africa,285070,0,19405
2021-06-28,mayotte,Africa,285070,0,19405
2021-06-29,mayotte,Africa,285070,0,19405
2021-06-30,mayotte,Africa,285070,0,19405
2021-07-01,mayotte,Africa,285070,0,19405
2021-07-02,mayotte,Africa,285070,0,19405
2021-07-03,mayotte,Africa,285070,0,19405
2021-07-04,mayotte,Africa,285070,0,19405
2021-07-05,mayotte,Africa,285070,20,19425
2021-07-06,mayotte,Africa,285070,0,19425
2021-07-07,mayotte,Africa,285070,0,19425
2021-07-08,mayotte,Africa,285070,0,19425
2021-07-09,mayotte,Africa,285070,0,19425
2021-07-10,mayotte,Africa,285070,0,19425
2021-07-11,mayotte,Africa,285070,0,19425
2021-07-12,mayotte,Africa,285070,25,19450
2021-07-13,mayotte,Africa,285070,0,19450
2021-07-14,mayotte,Africa,285070,0,19450
2021-07-15,mayotte,Africa,285070,0,19450
2021-07-16,mayotte,Africa,285070,0,19450
2021-07-17,mayotte,Africa,285070,0,19450
2021-07-18,mayotte,Africa,285070,0,19450
2021-07-19,mayotte,Africa,285070,10,19460
2021-07-20,mayotte,Africa,285070,0,19460
2021-07-21,mayotte,Africa,285070,0,19460
2021-07-22,mayotte,Africa,285070,0,19460
2021-07-23,mayotte,Africa,285070,5,19465
2021-07-24,mayotte,Africa,285070,0,19465
2021-07-25,mayotte,Africa,285070,0,19465
2021-07-26,mayotte,Africa,285070,9,19474
2021-07-27,mayotte,Africa,285070,0,19474
2021-07-28,mayotte,Africa,285070,0,19474
2021-07-29,mayotte,Africa,285070,0,19474
2021-07-30,mayotte,Africa,285070,20,19494
2021-07-31,mayotte,Africa,285070,0,19494
2021-08-01,mayotte,Africa,285070,0,19494
2021-08-02,mayotte,Africa,285070,0,19494
2021-08-03,mayotte,Africa,285070,9,19503
2021-08-04,mayotte,Africa,285070,0,19503
2021-08-05,mayotte,Africa,285070,15,19518
2021-08-06,mayotte,Africa,285070,13,19531
2021-08-07,mayotte,Africa,285070,0,19531
2021-08-08,mayotte,Africa,285070,0,19531
2021-08-09,mayotte,Africa,285070,15,19546
2021-08-10,mayotte,Africa,285070,0,19546
2021-08-11,mayotte,Africa,285070,0,19546
2021-08-12,mayotte,Africa,285070,0,19546
2021-08-13,mayotte,Africa,285070,21,19567
2021-08-14,mayotte,Africa,285070,0,19567
2021-08-15,mayotte,Africa,285070,0,19567
2021-08-16,mayotte,Africa,285070,47,19614
2021-08-17,mayotte,Africa,285070,0,19614
2021-08-18,mayotte,Africa,285070,0,19614
2021-08-19,mayotte,Africa,285070,11,19625
2021-08-20,mayotte,Africa,285070,39,19664
2021-08-21,mayotte,Africa,285070,0,19664
2021-08-22,mayotte,Africa,285070,0,19664
2021-08-23,mayotte,Africa,285070,18,19682
2021-08-24,mayotte,Africa,285070,16,19698
2021-08-25,mayotte,Africa,285070,19,19717
2021-08-26,mayotte,Africa,285070,9,19726
2021-08-27,mayotte,Africa,285070,13,19739
2021-08-28,mayotte,Africa,285070,0,19739
2021-08-29,mayotte,Africa,285070,0,19739
2021-08-30,mayotte,Africa,285070,41,19780
2021-08-31,mayotte,Africa,285070,0,19780
2021-09-01,mayotte,Africa,285070,47,19827
2021-09-02,mayotte,Africa,285070,25,19852
2021-09-03,mayotte,Africa,285070,23,19875
2021-09-04,mayotte,Africa,285070,0,19875
2021-09-05,mayotte,Africa,285070,0,19875
2021-09-06,mayotte,Africa,285070,50,19925
2021-09-07,mayotte,Africa,285070,22,19947
2021-09-08,mayotte,Africa,285070,0,19947
2021-09-09,mayotte,Africa,285070,0,19947
2021-09-10,mayotte,Africa,285070,68,20015
2021-09-11,mayotte,Africa,285070,0,20015
2021-09-12,mayotte,Africa,285070,0,20015
2021-09-13,mayotte,Africa,285070,29,20044
2021-09-14,mayotte,Africa,285070,23,20067
2021-09-15,mayotte,Africa,285070,0,20067
2021-09-16,mayotte,Africa,285070,40,20107
2021-09-17,mayotte,Africa,285070,18,20125
2021-09-18,mayotte,Africa,285070,0,20125
2021-09-19,mayotte,Africa,285070,0,20125
2021-09-20,mayotte,Africa,285070,29,20154
2021-09-21,mayotte,Africa,285070,25,20179
2021-09-22,mayotte,Africa,285070,19,20198
2021-09-23,mayotte,Africa,285070,7,20205
2021-09-24,mayotte,Africa,285070,14,20219
2021-09-25,mayotte,Africa,285070,0,20219
2021-09-26,mayotte,Africa,285070,0,20219
2021-09-27,mayotte,Africa,285070,23,20242
2021-09-28,mayotte,Africa,285070,15,20257
2021-09-29,mayotte,Africa,285070,17,20274
2021-09-30,mayotte,Africa,285070,0,20274
2021-10-01,mayotte,Africa,285070,49,20323
2021-10-02,mayotte,Africa,285070,0,20323
2021-10-03,mayotte,Africa,285070,0,20323
2021-10-04,mayotte,Africa,285070,14,20337
2021-10-05,mayotte,Africa,285070,0,20337
2021-10-06,mayotte,Africa,285070,36,20373
2021-10-07,mayotte,Africa,285070,0,20373
2021-10-08,mayotte,Africa,285070,12,20385
2021-10-09,mayotte,Africa,285070,0,20385
2021-10-10,mayotte,Africa,285070,0,20385
2021-10-11,mayotte,Africa,285070,12,20397
2021-10-12,mayotte,Africa,285070,0,20397
2021-10-13,mayotte,Africa,285070,25,20422
2021-10-14,mayotte,Africa,285070,0,20422
2021-10-15,mayotte,Africa,285070,17,20439
2021-10-16,mayotte,Africa,285070,0,20439
2021-10-17,mayotte,Africa,285070,0,20439
2021-10-18,mayotte,Africa,285070,0,20439
2021-10-19,mayotte,Africa,285070,0,20439
2021-10-20,mayotte,Africa,285070,25,20464
2021-10-21,mayotte,Africa,285070,0,20464
2021-10-22,mayotte,Africa,285070,21,20485
2021-10-23,mayotte,Africa,285070,0,20485
2021-10-24,mayotte,Africa,285070,0,20485
2021-10-25,mayotte,Africa,285070,12,20497
2021-10-26,mayotte,Africa,285070,0,20497
2021-10-27,mayotte,Africa,285070,0,20497
2021-10-28,mayotte,Africa,285070,0,20497
2021-10-29,mayotte,Africa,285070,58,20555
2021-10-30,mayotte,Africa,285070,0,20555
2021-10-31,mayotte,Africa,285070,0,20555
2021-11-01,mayotte,Africa,285070,0,20555
2021-11-02,mayotte,Africa,285070,32,20587
2021-11-03,mayotte,Africa,285070,25,20612
2021-11-04,mayotte,Africa,285070,0,20612
2021-11-05,mayotte,Africa,285070,39,20651
2021-11-06,mayotte,Africa,285070,0,20651
2021-11-07,mayotte,Africa,285070,0,20651
2021-11-08,mayotte,Africa,285070,58,20709
2021-11-09,mayotte,Africa,285070,0,20709
2021-11-10,mayotte,Africa,285070,42,20751
2021-11-11,mayotte,Africa,285070,0,20751
2021-11-12,mayotte,Africa,285070,18,20769
2021-11-13,mayotte,Africa,285070,0,20769
2021-11-14,mayotte,Africa,285070,0,20769
2021-11-15,mayotte,Africa,285070,21,20790
2021-11-16,mayotte,Africa,285070,0,20790
2021-11-17,mayotte,Africa,285070,47,20837
2021-11-18,mayotte,Africa,285070,0,20837
2021-11-19,mayotte,Africa,285070,23,20860
2021-11-20,mayotte,Africa,285070,0,20860
2021-11-21,mayotte,Africa,285070,0,20860
2021-11-22,mayotte,Africa,285070,0,20860
2021-11-23,mayotte,Africa,285070,45,20905
2021-11-24,mayotte,Africa,285070,9,20914
2021-11-25,mayotte,Africa,285070,0,20914
2021-11-26,mayotte,Africa,285070,24,20938
2021-11-27,mayotte,Africa,285070,0,20938
2021-11-28,mayotte,Africa,285070,0,20938
2021-11-29,mayotte,Africa,285070,22,20960
2021-11-30,mayotte,Africa,285070,13,20973
2021-12-01,mayotte,Africa,285070,0,20973
2021-12-02,mayotte,Africa,285070,0,20973
2021-12-03,mayotte,Africa,285070,30,21003
2021-12-04,mayotte,Africa,285070,0,21003
2021-12-05,mayotte,Africa,285070,0,21003
2021-12-06,mayotte,Africa,285070,0,21003
2021-12-07,mayotte,Africa,285070,40,21043
2021-12-08,mayotte,Africa,285070,0,21043
2021-12-09,mayotte,Africa,285070,0,21043
2021-12-10,mayotte,Africa,285070,45,21088
2021-12-11,mayotte,Africa,285070,0,21088
2021-12-12,mayotte,Africa,285070,0,21088
2021-12-13,mayotte,Africa,285070,0,21088
2021-12-14,mayotte,Africa,285070,41,21129
2021-12-15,mayotte,Africa,285070,10,21139
2021-12-16,mayotte,Africa,285070,0,21139
2021-12-17,mayotte,Africa,285070,41,21180
2021-12-18,mayotte,Africa,285070,0,21180
2020-03-19,moldova,Europe,4016504,13,49
2020-03-20,moldova,Europe,4016504,17,66
2020-03-21,moldova,Europe,4016504,14,80
2020-03-22,moldova,Europe,4016504,14,94
2020-03-23,moldova,Europe,4016504,15,109
2020-03-24,moldova,Europe,4016504,16,125
2020-03-25,moldova,Europe,4016504,24,149
2020-03-26,moldova,Europe,4016504,28,177
2020-03-27,moldova,Europe,4016504,22,199
2020-03-28,moldova,Europe,4016504,32,231
2020-03-29,moldova,Europe,4016504,32,263
2020-03-30,moldova,Europe,4016504,35,298
2020-03-31,moldova,Europe,4016504,55,353
2020-04-01,moldova,Europe,4016504,70,423
2020-04-02,moldova,Europe,4016504,82,505
2020-04-03,moldova,Europe,4016504,86,591
2020-04-04,moldova,Europe,4016504,161,752
2020-04-05,moldova,Europe,4016504,112,864
2020-04-06,moldova,Europe,4016504,101,965
2020-04-07,moldova,Europe,4016504,91,1056
2020-04-08,moldova,Europe,4016504,118,1174
2020-04-09,moldova,Europe,4016504,115,1289
2020-04-10,moldova,Europe,4016504,149,1438
2020-04-11,moldova,Europe,4016504,122,1560
2020-04-12,moldova,Europe,4016504,102,1662
2020-04-13,moldova,Europe,4016504,50,1712
2020-04-14,moldova,Europe,4016504,222,1934
2020-04-15,moldova,Europe,4016504,115,2049
2020-04-16,moldova,Europe,4016504,105,2154
2020-04-17,moldova,Europe,4016504,110,2264
2020-04-18,moldova,Europe,4016504,87,2351
2020-04-19,moldova,Europe,4016504,121,2472
2020-04-20,moldova,Europe,4016504,76,2548
2020-04-21,moldova,Europe,4016504,66,2614
2020-04-22,moldova,Europe,4016504,164,2778
2020-04-23,moldova,Europe,4016504,148,2926
2020-04-24,moldova,Europe,4016504,184,3110
2020-04-25,moldova,Europe,4016504,194,3304
2020-04-26,moldova,Europe,4016504,104,3408
2020-04-27,moldova,Europe,4016504,73,3481
2020-04-28,moldova,Europe,4016504,157,3638
2020-04-29,moldova,Europe,4016504,133,3771
2020-04-30,moldova,Europe,4016504,126,3897
2020-05-01,moldova,Europe,4016504,83,3980
2020-05-02,moldova,Europe,4016504,72,4052
2020-05-03,moldova,Europe,4016504,69,4121
2020-05-04,moldova,Europe,4016504,127,4248
2020-02-29,monaco,Europe,39760,0,1
2020-03-01,monaco,Europe,39760,0,1
2020-03-02,monaco,Europe,39760,0,1
2020-03-03,monaco,Europe,39760,0,1
2020-03-04,monaco,Europe,39760,0,1
2020-03-05,monaco,Europe,39760,0,1
2020-03-06,monaco,Europe,39760,0,1
2020-03-07,monaco,Europe,39760,0,1
2020-03-08,monaco,Europe,39760,0,1
2020-03-09,monaco,Europe,39760,0,1
2020-03-10,monaco,Europe,39760,1,2
2020-03-11,monaco,Europe,39760,0,2
2020-03-12,monaco,Europe,39760,1,3
2020-03-13,monaco,Europe,39760,4,7
2020-03-14,monaco,Europe,39760,2,9
2020-03-15,monaco,Europe,39760,0,9
2020-03-16,monaco,Europe,39760,0,9
2020-03-17,monaco,Europe,39760,0,9
2020-03-18,monaco,Europe,39760,3,12
2020-03-19,monaco,Europe,39760,6,18
2020-03-20,monaco,Europe,39760,0,18
2020-03-21,monaco,Europe,39760,2,20
2020-03-22,monaco,Europe,39760,2,22
2020-03-23,monaco,Europe,39760,1,23
2020-03-24,monaco,Europe,39760,0,23
2020-03-25,monaco,Europe,39760,3,26
2020-03-26,monaco,Europe,39760,6,32
2020-03-27,monaco,Europe,39760,1,33
2020-03-28,monaco,Europe,39760,2,35
2020-03-29,monaco,Europe,39760,1,36
2020-03-30,monaco,Europe,39760,1,37
2020-03-31,monaco,Europe,39760,3,40
2020-04-01,monaco,Europe,39760,2,42
2020-04-02,monaco,Europe,39760,4,46
2020-04-03,monaco,Europe,39760,1,47
2020-04-04,monaco,Europe,39760,3,50
2020-04-05,monaco,Europe,39760,1,51
2020-04-06,monaco,Europe,39760,2,53
2020-04-07,monaco,Europe,39760,0,53
2020-04-08,monaco,Europe,39760,3,56
2020-04-09,monaco,Europe,39760,6,62
2020-04-10,monaco,Europe,39760,0,62
2020-04-11,monaco,Europe,39760,1,63
2020-04-12,monaco,Europe,39760,0,63
2020-04-13,monaco,Europe,39760,0,63
2020-04-14,monaco,Europe,39760,0,63
2020-04-15,monaco,Europe,39760,0,63
2020-04-16,monaco,Europe,39760,1,64
2020-04-17,monaco,Europe,39760,0,64
2020-04-18,monaco,Europe,39760,0,64
2020-04-19,monaco,Europe,39760,0,64
2020-04-20,monaco,Europe,39760,0,64
2020-04-21,monaco,Europe,39760,0,64
2020-04-22,monaco,Europe,39760,0,64
2020-04-23,monaco,Europe,39760,0,64
2020-04-24,monaco,Europe,39760,0,64
2020-04-25,monaco,Europe,39760,0,64
2020-04-26,monaco,Europe,39760,1,65
2020-04-27,monaco,Europe,39760,0,65
2020-04-28,monaco,Europe,39760,0,65
2020-04-29,monaco,Europe,39760,0,65
2020-04-30,monaco,Europe,39760,0,65
2020-05-01,monaco,Europe,39760,0,65
2020-05-02,monaco,Europe,39760,0,65
2020-05-03,monaco,Europe,39760,0,65
2020-05-04,monaco,Europe,39760,0,65
2020-05-05,monaco,Europe,39760,0,65
2020-05-06,monaco,Europe,39760,0,65
2020-05-07,monaco,Europe,39760,0,65
2020-05-08,monaco,Europe,39760,0,65
2020-05-09,monaco,Europe,39760,0,65
2020-05-10,monaco,Europe,39760,1,66
2020-05-11,monaco,Europe,39760,0,66
2020-05-12,monaco,Europe,39760,0,66
2020-05-13,monaco,Europe,39760,0,66
2020-05-14,monaco,Europe,39760,0,66
2020-05-15,monaco,Europe,39760,0,66
2020-05-16,monaco,Europe,39760,0,66
2020-05-17,monaco,Europe,39760,1,67
2020-05-18,monaco,Europe,39760,0,67
2020-05-19,monaco,Europe,39760,0,67
2020-05-20,monaco,Europe,39760,0,67
2020-05-21,monaco,Europe,39760,0,67
2020-05-22,monaco,Europe,39760,0,67
2020-05-23,monaco,Europe,39760,2,69
2020-05-24,monaco,Europe,39760,0,69
2020-05-25,monaco,Europe,39760,0,69
2020-05-26,monaco,Europe,39760,0,69
2020-05-27,monaco,Europe,39760,0,69
2020-05-28,monaco,Europe,39760,0,69
2020-05-29,monaco,Europe,39760,0,69
2020-05-30,monaco,Europe,39760,0,69
2020-05-31,monaco,Europe,39760,0,69
2020-06-01,monaco,Europe,39760,0,69
2020-06-02,monaco,Europe,39760,0,69
2020-06-03,monaco,Europe,39760,0,69
2020-06-04,monaco,Europe,39760,0,69
2020-06-05,monaco,Europe,39760,0,69
2020-06-06,monaco,Europe,39760,0,69
2020-06-07,monaco,Europe,39760,0,69
2020-06-08,monaco,Europe,39760,0,69
2020-06-09,monaco,Europe,39760,0,69
2020-06-10,monaco,Europe,39760,0,69
2020-06-11,monaco,Europe,39760,0,69
2020-06-12,monaco,Europe,39760,0,69
2020-06-13,monaco,Europe,39760,0,69
2020-06-14,monaco,Europe,39760,0,69
2020-06-15,monaco,Europe,39760,0,69
2020-06-16,monaco,Europe,39760,0,69
2020-06-17,monaco,Europe,39760,0,69
2020-06-18,monaco,Europe,39760,0,69
2020-06-19,monaco,Europe,39760,0,69
2020-06-20,monaco,Europe,39760,1,70
2020-06-21,monaco,Europe,39760,0,70
2020-06-22,monaco,Europe,39760,0,70
2020-06-23,monaco,Europe,39760,1,71
2020-06-24,monaco,Europe,39760,0,71
2020-06-25,monaco,Europe,39760,0,71
2020-06-26,monaco,Europe,39760,1,72
2020-06-27,monaco,Europe,39760,0,72
2020-06-28,monaco,Europe,39760,0,72
2020-06-29,monaco,Europe,39760,0,72
2020-06-30,monaco,Europe,39760,0,72
2020-07-01,monaco,Europe,39760,3,75
2020-07-02,monaco,Europe,39760,0,75
2020-07-03,monaco,Europe,39760,0,75
2020-07-04,monaco,Europe,39760,2,77
2020-07-05,monaco,Europe,39760,0,77
2020-07-06,monaco,Europe,39760,0,77
2020-07-07,monaco,Europe,39760,0,77
2020-07-08,monaco,Europe,39760,0,77
2020-07-09,monaco,Europe,39760,0,77
2020-07-10,monaco,Europe,39760,1,78
2020-07-11,monaco,Europe,39760,0,78
2020-07-12,monaco,Europe,39760,0,78
2020-07-13,monaco,Europe,39760,0,78
2020-07-14,monaco,Europe,39760,0,78
2020-07-15,monaco,Europe,39760,0,78
2020-07-16,monaco,Europe,39760,0,78
2020-07-17,monaco,Europe,39760,0,78
2020-07-18,monaco,Europe,39760,0,78
2020-07-19,monaco,Europe,39760,0,78
2020-07-20,monaco,Europe,39760,2,80
2020-07-21,monaco,Europe,39760,1,81
2020-07-22,monaco,Europe,39760,1,82
2020-07-23,monaco,Europe,39760,1,83
2020-07-24,monaco,Europe,39760,0,83
2020-07-25,monaco,Europe,39760,0,83
2020-07-26,monaco,Europe,39760,0,83
2020-07-27,monaco,Europe,39760,1,84
2020-07-28,monaco,Europe,39760,2,86
2020-07-29,monaco,Europe,39760,0,86
2020-07-30,monaco,Europe,39760,0,86
2020-07-31,monaco,Europe,39760,0,86
2020-08-01,monaco,Europe,39760,0,86
2020-08-02,monaco,Europe,39760,1,87
2020-08-03,monaco,Europe,39760,2,89
2020-08-04,monaco,Europe,39760,3,92
2020-08-05,monaco,Europe,39760,1,93
2020-08-06,monaco,Europe,39760,2,95
2020-08-07,monaco,Europe,39760,1,96
2020-08-08,monaco,Europe,39760,0,96
2020-08-09,monaco,Europe,39760,0,96
2020-08-10,monaco,Europe,39760,1,97
2020-08-11,monaco,Europe,39760,2,99
2020-08-12,monaco,Europe,39760,2,101
2020-08-13,monaco,Europe,39760,0,101
2020-08-14,monaco,Europe,39760,0,101
2020-08-15,monaco,Europe,39760,0,101
2020-08-16,monaco,Europe,39760,1,102
2020-08-17,monaco,Europe,39760,0,102
2020-08-18,monaco,Europe,39760,0,102
2020-08-19,monaco,Europe,39760,0,102
2020-08-20,monaco,Europe,39760,0,102
2020-08-21,monaco,Europe,39760,4,106
2020-08-22,monaco,Europe,39760,2,108
2020-08-23,monaco,Europe,39760,4,112
2020-08-24,monaco,Europe,39760,3,115
2020-08-25,monaco,Europe,39760,6,121
2020-08-26,monaco,Europe,39760,1,122
2020-08-27,monaco,Europe,39760,3,125
2020-08-28,monaco,Europe,39760,0,125
2020-08-29,monaco,Europe,39760,5,130
2020-08-30,monaco,Europe,39760,1,131
2020-08-31,monaco,Europe,39760,7,138
2020-09-01,monaco,Europe,39760,2,140
2020-09-02,monaco,Europe,39760,2,142
2020-09-03,monaco,Europe,39760,1,143
2020-09-04,monaco,Europe,39760,4,147
2020-09-05,monaco,Europe,39760,0,147
2020-09-06,monaco,Europe,39760,0,147
2020-09-07,monaco,Europe,39760,6,153
2020-09-08,monaco,Europe,39760,3,156
2020-09-09,monaco,Europe,39760,5,161
2020-09-10,monaco,Europe,39760,4,165
2020-09-11,monaco,Europe,39760,3,168
2020-09-12,monaco,Europe,39760,1,169
2020-09-13,monaco,Europe,39760,2,171
2020-09-14,monaco,Europe,39760,6,177
2020-09-15,monaco,Europe,39760,1,178
2020-09-16,monaco,Europe,39760,3,181
2020-09-17,monaco,Europe,39760,5,186
2020-09-18,monaco,Europe,39760,5,191
2020-09-19,monaco,Europe,39760,1,192
2020-09-20,monaco,Europe,39760,1,193
2020-09-21,monaco,Europe,39760,2,195
2020-09-22,monaco,Europe,39760,2,197
2020-09-23,monaco,Europe,39760,2,199
2020-09-24,monaco,Europe,39760,6,205
2020-09-25,monaco,Europe,39760,3,208
2020-09-26,monaco,Europe,39760,2,210
2020-09-27,monaco,Europe,39760,0,210
2020-09-28,monaco,Europe,39760,2,212
2020-09-29,monaco,Europe,39760,2,214
2020-09-30,monaco,Europe,39760,4,218
2020-10-01,monaco,Europe,39760,1,219
2020-10-02,monaco,Europe,39760,2,221
2020-10-03,monaco,Europe,39760,1,222
2020-10-04,monaco,Europe,39760,0,222
2020-10-05,monaco,Europe,39760,1,223
2020-10-06,monaco,Europe,39760,1,224
2020-10-07,monaco,Europe,39760,3,227
2020-10-08,monaco,Europe,39760,2,229
2020-10-09,monaco,Europe,39760,4,233
2020-10-10,monaco,Europe,39760,0,233
2020-10-11,monaco,Europe,39760,1,234
2020-10-12,monaco,Europe,39760,2,236
2020-10-13,monaco,Europe,39760,5,241
2020-10-14,monaco,Europe,39760,7,248
2020-10-15,monaco,Europe,39760,5,253
2020-10-16,monaco,Europe,39760,2,255
2020-10-17,monaco,Europe,39760,5,260
2020-10-18,monaco,Europe,39760,5,265
2020-10-19,monaco,Europe,39760,3,268
2020-10-20,monaco,Europe,39760,3,271
2020-10-21,monaco,Europe,39760,2,273
2020-10-22,monaco,Europe,39760,8,281
2020-10-23,monaco,Europe,39760,14,295
2020-10-24,monaco,Europe,39760,1,296
2020-10-25,monaco,Europe,39760,10,306
2020-10-26,monaco,Europe,39760,4,310
2020-10-27,monaco,Europe,39760,10,320
2020-10-28,monaco,Europe,39760,17,337
2020-10-29,monaco,Europe,39760,10,347
2020-10-30,monaco,Europe,39760,8,355
2020-10-31,monaco,Europe,39760,4,359
2020-11-01,monaco,Europe,39760,7,366
2020-11-02,monaco,Europe,39760,9,375
2020-11-03,monaco,Europe,39760,22,397
2020-11-04,monaco,Europe,39760,15,412
2020-11-05,monaco,Europe,39760,18,430
2020-11-06,monaco,Europe,39760,24,454
2020-11-07,monaco,Europe,39760,29,483
2020-11-08,monaco,Europe,39760,3,486
2020-11-09,monaco,Europe,39760,4,490
2020-11-10,monaco,Europe,39760,22,512
2020-11-11,monaco,Europe,39760,12,524
2020-11-12,monaco,Europe,39760,8,532
2020-11-13,monaco,Europe,39760,8,540
2020-11-14,monaco,Europe,39760,5,545
2020-12-30,mongolia,Asia,3376601,20,1195
2020-12-31,mongolia,Asia,3376601,20,1215
2021-01-01,mongolia,Asia,3376601,5,1220
2021-01-02,mongolia,Asia,3376601,22,1242
2021-01-03,mongolia,Asia,3376601,21,1263
2021-01-04,mongolia,Asia,3376601,23,1286
2021-01-05,mongolia,Asia,3376601,22,1308
2021-01-06,mongolia,Asia,3376601,41,1349
2021-01-07,mongolia,Asia,3376601,13,1362
2021-01-08,mongolia,Asia,3376601,33,1395
2021-01-09,mongolia,Asia,3376601,13,1408
2021-01-10,mongolia,Asia,3376601,21,1429
2021-01-11,mongolia,Asia,3376601,13,1442
2021-01-12,mongolia,Asia,3376601,14,1456
2021-01-13,mongolia,Asia,3376601,13,1469
2021-01-14,mongolia,Asia,3376601,10,1479
2021-01-15,mongolia,Asia,3376601,12,1491
2021-01-16,mongolia,Asia,3376601,21,1512
2021-01-17,mongolia,Asia,3376601,5,1517
2021-01-18,mongolia,Asia,3376601,9,1526
2021-01-19,mongolia,Asia,3376601,10,1536
2021-01-20,mongolia,Asia,3376601,32,1568
2021-01-21,mongolia,Asia,3376601,16,1584
2021-01-22,mongolia,Asia,3376601,8,1592
2021-01-23,mongolia,Asia,3376601,19,1611
2021-01-24,mongolia,Asia,3376601,16,1627
2021-01-25,mongolia,Asia,3376601,16,1643
2021-01-26,mongolia,Asia,3376601,13,1656
2021-01-27,mongolia,Asia,3376601,11,1667
2021-01-28,mongolia,Asia,3376601,25,1692
2021-01-29,mongolia,Asia,3376601,18,1710
2021-01-30,mongolia,Asia,3376601,32,1742
2021-01-31,mongolia,Asia,3376601,37,1779
2021-02-01,mongolia,Asia,3376601,35,1814
2021-02-02,mongolia,Asia,3376601,18,1832
2021-02-03,mongolia,Asia,3376601,27,1859
2021-02-04,mongolia,Asia,3376601,31,1890
2021-02-05,mongolia,Asia,3376601,38,1928
2021-02-06,mongolia,Asia,3376601,61,1989
2021-02-07,mongolia,Asia,3376601,34,2023
2021-02-08,mongolia,Asia,3376601,50,2073
2021-02-09,mongolia,Asia,3376601,47,2120
2021-02-10,mongolia,Asia,3376601,54,2174
2021-02-11,mongolia,Asia,3376601,33,2207
2021-02-12,mongolia,Asia,3376601,40,2247
2021-02-13,mongolia,Asia,3376601,46,2293
2021-02-14,mongolia,Asia,3376601,58,2351
2021-02-15,mongolia,Asia,3376601,32,2383
2021-02-16,mongolia,Asia,3376601,33,2416
2021-02-17,mongolia,Asia,3376601,28,2444
2021-02-18,mongolia,Asia,3376601,49,2493
2021-02-19,mongolia,Asia,3376601,58,2551
2021-02-20,mongolia,Asia,3376601,35,2586
2021-02-21,mongolia,Asia,3376601,52,2638
2021-02-22,mongolia,Asia,3376601,55,2693
2021-02-23,mongolia,Asia,3376601,30,2723
2021-02-24,mongolia,Asia,3376601,32,2755
2021-02-25,mongolia,Asia,3376601,46,2801
2021-02-26,mongolia,Asia,3376601,30,2831
2021-02-27,mongolia,Asia,3376601,35,2866
2021-02-28,mongolia,Asia,3376601,41,2907
2021-03-01,mongolia,Asia,3376601,45,2952
2021-03-02,mongolia,Asia,3376601,48,3000
2021-03-03,mongolia,Asia,3376601,32,3032
2021-03-04,mongolia,Asia,3376601,44,3076
2021-03-05,mongolia,Asia,3376601,77,3153
2021-03-06,mongolia,Asia,3376601,8,3161
2021-03-07,mongolia,Asia,3376601,67,3228
2021-03-08,mongolia,Asia,3376601,108,3336
2021-03-09,mongolia,Asia,3376601,36,3372
2021-03-10,mongolia,Asia,3376601,109,3481
2021-03-11,mongolia,Asia,3376601,80,3561
2021-03-12,mongolia,Asia,3376601,103,3664
2021-03-13,mongolia,Asia,3376601,169,3833
2021-03-14,mongolia,Asia,3376601,128,3961
2021-03-15,mongolia,Asia,3376601,122,4083
2021-03-16,mongolia,Asia,3376601,127,4210
2021-03-17,mongolia,Asia,3376601,130,4340
2021-03-18,mongolia,Asia,3376601,158,4498
2021-03-19,mongolia,Asia,3376601,160,4658
2021-03-20,mongolia,Asia,3376601,148,4806
2021-03-21,mongolia,Asia,3376601,170,4976
2021-03-22,mongolia,Asia,3376601,210,5186
2021-03-23,mongolia,Asia,3376601,206,5392
2021-03-24,mongolia,Asia,3376601,218,5610
2021-03-25,mongolia,Asia,3376601,285,5895
2021-03-26,mongolia,Asia,3376601,437,6332
2021-03-27,mongolia,Asia,3376601,361,6693
2021-03-28,mongolia,Asia,3376601,321,7014
2021-03-29,mongolia,Asia,3376601,575,7589
2021-03-30,mongolia,Asia,3376601,481,8070
2021-03-31,mongolia,Asia,3376601,377,8447
2021-04-01,mongolia,Asia,3376601,394,8841
2021-04-02,mongolia,Asia,3376601,486,9327
2021-04-03,mongolia,Asia,3376601,271,9598
2021-04-04,mongolia,Asia,3376601,620,10218
2021-04-05,mongolia,Asia,3376601,602,10820
2021-04-06,mongolia,Asia,3376601,831,11651
2021-04-07,mongolia,Asia,3376601,575,12226
2021-04-08,mongolia,Asia,3376601,554,12780
2021-04-09,mongolia,Asia,3376601,714,13494
2021-04-10,mongolia,Asia,3376601,689,14183
2021-04-11,mongolia,Asia,3376601,831,15014
2021-04-12,mongolia,Asia,3376601,704,15718
2021-04-13,mongolia,Asia,3376601,885,16603
2021-04-14,mongolia,Asia,3376601,1220,17823
2021-04-15,mongolia,Asia,3376601,742,18565
2021-04-16,mongolia,Asia,3376601,1107,19672
2021-04-17,mongolia,Asia,3376601,983,20655
2021-04-18,mongolia,Asia,3376601,1340,21995
2021-04-19,mongolia,Asia,3376601,889,22884
2021-04-20,mongolia,Asia,3376601,1311,24195
2021-04-21,mongolia,Asia,3376601,1169,25364
2021-04-22,mongolia,Asia,3376601,1328,26692
2021-04-23,mongolia,Asia,3376601,1264,27956
2021-04-24,mongolia,Asia,3376601,1263,29219
2021-04-25,mongolia,Asia,3376601,1264,30483
2021-04-26,mongolia,Asia,3376601,856,31339
2021-04-27,mongolia,Asia,3376601,1098,32437
2021-04-28,mongolia,Asia,3376601,1171,33608
2021-04-29,mongolia,Asia,3376601,1015,34623
2021-04-30,mongolia,Asia,3376601,1356,35979
2021-05-01,mongolia,Asia,3376601,1306,37285
2021-05-02,mongolia,Asia,3376601,1185,38470
2021-05-03,mongolia,Asia,3376601,911,39381
2021-05-04,mongolia,Asia,3376601,1015,40396
2021-05-05,mongolia,Asia,3376601,1128,41524
2021-05-06,mongolia,Asia,3376601,940,42464
2021-05-07,mongolia,Asia,3376601,737,43201
2021-05-08,mongolia,Asia,3376601,815,44016
2021-05-09,mongolia,Asia,3376601,804,44820
2021-05-10,mongolia,Asia,3376601,639,45459
2021-05-11,mongolia,Asia,3376601,477,45936
2021-05-12,mongolia,Asia,3376601,512,46448
2021-05-13,mongolia,Asia,3376601,585,47033
2021-05-14,mongolia,Asia,3376601,515,47548
2021-05-15,mongolia,Asia,3376601,553,48101
2021-05-16,mongolia,Asia,3376601,541,48642
2021-05-17,mongolia,Asia,3376601,533,49175
2021-05-18,mongolia,Asia,3376601,349,49524
2021-05-19,mongolia,Asia,3376601,575,50099
2021-05-20,mongolia,Asia,3376601,519,50618
2021-05-21,mongolia,Asia,3376601,629,51247
2021-05-22,mongolia,Asia,3376601,684,51931
2021-05-23,mongolia,Asia,3376601,539,52470
2021-05-24,mongolia,Asia,3376601,630,53100
2021-05-25,mongolia,Asia,3376601,634,53734
2021-05-26,mongolia,Asia,3376601,680,54414
2021-05-27,mongolia,Asia,3376601,653,55067
2021-05-28,mongolia,Asia,3376601,785,55852
2021-05-29,mongolia,Asia,3376601,769,56621
2021-05-30,mongolia,Asia,3376601,891,57512
2021-05-31,mongolia,Asia,3376601,927,58439
2021-06-01,mongolia,Asia,3376601,790,59229
2021-06-02,mongolia,Asia,3376601,1143,60372
2021-06-03,mongolia,Asia,3376601,1024,61396
2021-06-04,mongolia,Asia,3376601,1189,62585
2021-06-05,mongolia,Asia,3376601,1393,63978
2021-06-06,mongolia,Asia,3376601,1288,65266
2021-06-07,mongolia,Asia,3376601,1177,66443
2021-06-08,mongolia,Asia,3376601,1267,67710
2021-06-09,mongolia,Asia,3376601,1312,69022
2021-06-10,mongolia,Asia,3376601,1460,70482
2021-06-11,mongolia,Asia,3376601,1622,72104
2021-06-12,mongolia,Asia,3376601,1792,73896
2021-06-13,mongolia,Asia,3376601,2188,76084
2021-06-14,mongolia,Asia,3376601,2263,78347
2021-06-15,mongolia,Asia,3376601,2386,80733
2021-06-16,mongolia,Asia,3376601,2395,83128
2021-06-17,mongolia,Asia,3376601,2642,85770
2021-06-18,mongolia,Asia,3376601,2746,88516
2021-06-19,mongolia,Asia,3376601,2635,91151
2021-06-20,mongolia,Asia,3376601,2400,93551
2021-06-21,mongolia,Asia,3376601,2268,95819
2021-06-22,mongolia,Asia,3376601,2231,98050
2021-06-23,mongolia,Asia,3376601,2213,100263
2021-06-24,mongolia,Asia,3376601,2366,102629
2021-06-25,mongolia,Asia,3376601,2271,104900
2021-06-26,mongolia,Asia,3376601,2362,107262
2021-06-27,mongolia,Asia,3376601,2432,109694
2021-06-28,mongolia,Asia,3376601,1811,111505
2021-06-29,mongolia,Asia,3376601,1727,113232
2021-06-30,mongolia,Asia,3376601,2246,115478
2021-07-01,mongolia,Asia,3376601,2485,117963
2021-07-02,mongolia,Asia,3376601,2376,120339
2021-07-03,mongolia,Asia,3376601,2401,122740
2021-07-04,mongolia,Asia,3376601,2520,125260
2021-07-05,mongolia,Asia,3376601,1551,126811
2021-07-06,mongolia,Asia,3376601,1643,128454
2021-07-07,mongolia,Asia,3376601,1998,130452
2021-07-08,mongolia,Asia,3376601,1510,131962
2021-07-09,mongolia,Asia,3376601,2308,134270
2021-07-10,mongolia,Asia,3376601,1783,136053
2021-07-11,mongolia,Asia,3376601,1735,137788
2021-07-12,mongolia,Asia,3376601,1496,139284
2021-07-13,mongolia,Asia,3376601,1246,140530
2021-07-14,mongolia,Asia,3376601,1159,141689
2021-07-15,mongolia,Asia,3376601,1439,143128
2021-07-16,mongolia,Asia,3376601,1364,144492
2021-07-17,mongolia,Asia,3376601,1295,145787
2021-07-18,mongolia,Asia,3376601,1466,147253
2021-07-19,mongolia,Asia,3376601,1171,148424
2021-07-20,mongolia,Asia,3376601,1309,149733
2021-07-21,mongolia,Asia,3376601,1497,151230
2021-07-22,mongolia,Asia,3376601,1309,152539
2021-07-23,mongolia,Asia,3376601,1243,153782
2021-07-24,mongolia,Asia,3376601,1442,155224
2021-07-25,mongolia,Asia,3376601,1513,156737
2021-07-26,mongolia,Asia,3376601,1237,157974
2021-07-27,mongolia,Asia,3376601,1127,159101
2021-07-28,mongolia,Asia,3376601,1243,160344
2021-07-29,mongolia,Asia,3376601,1231,161575
2021-07-30,mongolia,Asia,3376601,1294,162869
2021-07-31,mongolia,Asia,3376601,1286,164155
2021-08-01,mongolia,Asia,3376601,992,165147
2021-08-02,mongolia,Asia,3376601,1063,166210
2021-08-03,mongolia,Asia,3376601,1019,167229
2021-08-04,mongolia,Asia,3376601,1444,168673
2021-08-05,mongolia,Asia,3376601,1178,169851
2021-08-06,mongolia,Asia,3376601,1246,171097
2021-08-07,mongolia,Asia,3376601,972,172069
2021-08-08,mongolia,Asia,3376601,1463,173532
2021-08-09,mongolia,Asia,3376601,1071,174603
2021-08-10,mongolia,Asia,3376601,957,175560
2021-08-11,mongolia,Asia,3376601,1433,176993
2021-08-12,mongolia,Asia,3376601,1443,178436
2021-08-13,mongolia,Asia,3376601,1453,179889
2021-08-14,mongolia,Asia,3376601,1402,181291
2021-08-15,mongolia,Asia,3376601,1300,182591
2021-08-16,mongolia,Asia,3376601,1061,183652
2021-08-17,mongolia,Asia,3376601,1303,184955
2021-08-18,mongolia,Asia,3376601,1582,186537
2021-08-19,mongolia,Asia,3376601,1875,188412
2021-08-20,mongolia,Asia,3376601,1841,190253
2021-08-21,mongolia,Asia,3376601,1651,191904
2021-08-22,mongolia,Asia,3376601,1780,193684
2021-08-23,mongolia,Asia,3376601,1566,195250
2021-08-24,mongolia,Asia,3376601,1596,196846
2021-08-25,mongolia,Asia,3376601,2433,199279
2021-08-26,mongolia,Asia,3376601,2467,201746
2021-08-27,mongolia,Asia,3376601,2289,204035
2021-08-28,mongolia,Asia,3376601,2422,206457
2021-08-29,mongolia,Asia,3376601,2414,208871
2021-08-30,mongolia,Asia,3376601,2209,211080
2021-08-31,mongolia,Asia,3376601,2740,213820
2021-09-01,mongolia,Asia,3376601,3726,217546
2021-09-02,mongolia,Asia,3376601,3805,221351
2021-09-03,mongolia,Asia,3376601,3638,224989
2021-09-04,mongolia,Asia,3376601,3696,228685
2021-09-05,mongolia,Asia,3376601,3628,232313
2021-09-06,mongolia,Asia,3376601,3766,236079
2021-09-07,mongolia,Asia,3376601,3963,240042
2021-09-08,mongolia,Asia,3376601,3677,243719
2021-09-09,mongolia,Asia,3376601,3680,247399
2021-09-10,mongolia,Asia,3376601,2009,249408
2021-09-11,mongolia,Asia,3376601,3240,252648
2021-09-12,mongolia,Asia,3376601,2771,255419
2021-09-13,mongolia,Asia,3376601,2351,257770
2021-09-14,mongolia,Asia,3376601,2939,260709
2021-09-15,mongolia,Asia,3376601,2737,263446
2021-09-16,mongolia,Asia,3376601,3234,266680
2021-09-17,mongolia,Asia,3376601,2796,269476
2021-09-18,mongolia,Asia,3376601,2893,272369
2021-09-19,mongolia,Asia,3376601,2777,275146
2021-09-20,mongolia,Asia,3376601,2851,277997
2021-09-21,mongolia,Asia,3376601,2543,280540
2021-09-22,mongolia,Asia,3376601,3416,283956
2021-09-23,mongolia,Asia,3376601,3361,287317
2021-09-24,mongolia,Asia,3376601,2612,289929
2021-09-25,mongolia,Asia,3376601,2662,292591
2021-09-26,mongolia,Asia,3376601,2184,294775
2021-09-27,mongolia,Asia,3376601,1991,296766
2021-09-28,mongolia,Asia,3376601,2153,298919
2021-09-29,mongolia,Asia,3376601,2515,301434
2021-09-30,mongolia,Asia,3376601,2650,304084
2021-10-01,mongolia,Asia,3376601,2519,306603
2021-10-02,mongolia,Asia,3376601,2461,309064
2021-10-03,mongolia,Asia,3376601,1811,310875
2021-10-04,mongolia,Asia,3376601,1501,312376
2021-10-05,mongolia,Asia,3376601,2225,314601
2021-10-06,mongolia,Asia,3376601,2409,317010
2021-10-07,mongolia,Asia,3376601,2237,319247
2021-10-08,mongolia,Asia,3376601,2410,321657
2021-10-09,mongolia,Asia,3376601,1665,323322
2021-10-10,mongolia,Asia,3376601,2068,325390
2021-10-11,mongolia,Asia,3376601,1348,326738
2021-10-12,mongolia,Asia,3376601,1566,328304
2021-10-13,mongolia,Asia,3376601,2565,330869
2021-10-14,mongolia,Asia,3376601,1920,332789
2021-10-15,mongolia,Asia,3376601,2076,334865
2021-10-16,mongolia,Asia,3376601,1643,336508
2021-10-17,mongolia,Asia,3376601,1897,338405
2021-10-18,mongolia,Asia,3376601,1131,339536
2021-10-19,mongolia,Asia,3376601,1303,340839
2021-10-20,mongolia,Asia,3376601,2153,342992
2021-10-21,mongolia,Asia,3376601,1744,344736
2021-10-22,mongolia,Asia,3376601,1719,346455
2021-10-23,mongolia,Asia,3376601,1733,348188
2021-10-24,mongolia,Asia,3376601,1321,349509
2021-10-25,mongolia,Asia,3376601,1095,350604
2021-10-26,mongolia,Asia,3376601,1231,351835
2021-10-27,mongolia,Asia,3376601,1669,353504
2021-10-28,mongolia,Asia,3376601,1625,355129
2021-10-29,mongolia,Asia,3376601,1636,356765
2021-10-30,mongolia,Asia,3376601,1443,358208
2021-10-31,mongolia,Asia,3376601,1188,359396
2021-11-01,mongolia,Asia,3376601,921,360317
2021-11-02,mongolia,Asia,3376601,1021,361338
2021-11-03,mongolia,Asia,3376601,1434,362772
2021-11-04,mongolia,Asia,3376601,1279,364051
2021-11-05,mongolia,Asia,3376601,1182,365233
2021-11-06,mongolia,Asia,3376601,940,366173
2021-11-07,mongolia,Asia,3376601,789,366962
2021-11-08,mongolia,Asia,3376601,450,367412
2021-11-09,mongolia,Asia,3376601,941,368353
2021-11-10,mongolia,Asia,3376601,950,369303
2021-11-11,mongolia,Asia,3376601,1021,370324
2021-11-12,mongolia,Asia,3376601,875,371199
2021-11-13,mongolia,Asia,3376601,988,372187
2021-11-14,mongolia,Asia,3376601,666,372853
2021-11-15,mongolia,Asia,3376601,491,373344
2021-11-16,mongolia,Asia,3376601,753,374097
2021-11-17,mongolia,Asia,3376601,873,374970
2021-11-18,mongolia,Asia,3376601,777,375747
2021-11-19,mongolia,Asia,3376601,595,376342
2021-11-20,mongolia,Asia,3376601,536,376878
2021-11-21,mongolia,Asia,3376601,509,377387
2021-11-22,mongolia,Asia,3376601,287,377674
2021-11-23,mongolia,Asia,3376601,525,378199
2021-11-24,mongolia,Asia,3376601,634,378833
2021-11-25,mongolia,Asia,3376601,711,379544
2021-11-26,mongolia,Asia,3376601,586,380130
2021-11-27,mongolia,Asia,3376601,486,380616
2021-11-28,mongolia,Asia,3376601,329,380945
2021-11-29,mongolia,Asia,3376601,190,381135
2021-11-30,mongolia,Asia,3376601,393,381528
2021-12-01,mongolia,Asia,3376601,554,382082
2021-12-02,mongolia,Asia,3376601,441,382523
2021-12-03,mongolia,Asia,3376601,375,382898
2021-12-04,mongolia,Asia,3376601,318,383216
2021-12-05,mongolia,Asia,3376601,327,383543
2021-12-06,mongolia,Asia,3376601,139,383682
2021-12-07,mongolia,Asia,3376601,296,383978
2021-12-08,mongolia,Asia,3376601,310,384288
2021-12-09,mongolia,Asia,3376601,338,384626
2021-12-10,mongolia,Asia,3376601,286,384912
2021-12-11,mongolia,Asia,3376601,284,385196
2021-12-12,mongolia,Asia,3376601,157,385353
2021-12-13,mongolia,Asia,3376601,94,385447
2021-12-14,mongolia,Asia,3376601,191,385638
2021-12-15,mongolia,Asia,3376601,335,385973
2021-12-16,mongolia,Asia,3376601,285,386258
2021-12-17,mongolia,Asia,3376601,262,386520
2021-12-18,mongolia,Asia,3376601,267,386787
2021-12-19,mongolia,Asia,3376601,204,386991
2021-12-20,mongolia,Asia,3376601,125,387116
2021-12-21,mongolia,Asia,3376601,240,387356
2021-12-22,mongolia,Asia,3376601,328,387684
2021-12-23,mongolia,Asia,3376601,191,387875
2021-12-24,mongolia,Asia,3376601,188,388063
2021-12-25,mongolia,Asia,3376601,248,388311
2021-12-26,mongolia,Asia,3376601,204,388515
2021-12-27,mongolia,Asia,3376601,83,388598
2021-12-28,mongolia,Asia,3376601,157,388755
2021-12-29,mongolia,Asia,3376601,218,388973
2021-12-30,mongolia,Asia,3376601,116,389089
2021-12-31,mongolia,Asia,3376601,272,389361
2022-01-01,mongolia,Asia,3376601,289,389650
2022-01-02,mongolia,Asia,3376601,226,389876
2022-01-03,mongolia,Asia,3376601,138,390014
2022-01-04,mongolia,Asia,3376601,488,390502
2022-01-05,mongolia,Asia,3376601,585,391087
2022-01-06,mongolia,Asia,3376601,570,391657
2022-01-07,mongolia,Asia,3376601,773,392430
2022-01-08,mongolia,Asia,3376601,1040,393470
2022-01-09,mongolia,Asia,3376601,1010,394480
2022-01-10,mongolia,Asia,3376601,649,395129
2022-01-11,mongolia,Asia,3376601,1208,396337
2022-01-12,mongolia,Asia,3376601,1818,398155
2022-01-13,mongolia,Asia,3376601,2279,400434
2022-01-14,mongolia,Asia,3376601,2010,402444
2022-01-15,mongolia,Asia,3376601,2347,404791
2022-01-16,mongolia,Asia,3376601,2751,407542
2022-01-17,mongolia,Asia,3376601,1673,409215
2022-01-18,mongolia,Asia,3376601,2135,411350
2022-01-19,mongolia,Asia,3376601,3088,414438
2022-01-20,mongolia,Asia,3376601,3119,417557
2022-01-21,mongolia,Asia,3376601,3282,420839
2022-01-22,mongolia,Asia,3376601,2656,423495
2022-01-23,mongolia,Asia,3376601,2766,426261
2022-01-24,mongolia,Asia,3376601,2089,428350
2022-01-25,mongolia,Asia,3376601,1978,430328
2022-01-26,mongolia,Asia,3376601,3080,433408
2022-01-27,mongolia,Asia,3376601,2273,435681
2022-01-28,mongolia,Asia,3376601,2614,438295
2022-01-29,mongolia,Asia,3376601,2057,440352
2022-01-30,mongolia,Asia,3376601,1834,442186
2022-01-31,mongolia,Asia,3376601,1206,443392
2022-02-01,mongolia,Asia,3376601,1196,444588
2022-02-02,mongolia,Asia,3376601,1488,446076
2022-02-03,mongolia,Asia,3376601,694,446770
2022-02-04,mongolia,Asia,3376601,694,447464
2022-02-05,mongolia,Asia,3376601,570,448034
2022-02-06,mongolia,Asia,3376601,637,448671
2022-02-07,mongolia,Asia,3376601,860,449531
2022-02-08,mongolia,Asia,3376601,1100,450631
2022-02-09,mongolia,Asia,3376601,1192,451823
2022-02-10,mongolia,Asia,3376601,1230,453053
2022-02-11,mongolia,Asia,3376601,1297,454350
2022-02-12,mongolia,Asia,3376601,1070,455420
2022-02-13,mongolia,Asia,3376601,893,456313
2022-02-14,mongolia,Asia,3376601,553,456866
2022-02-15,mongolia,Asia,3376601,609,457475
2022-02-16,mongolia,Asia,3376601,834,458309
2022-02-17,mongolia,Asia,3376601,874,459183
2022-02-18,mongolia,Asia,3376601,761,459944
2022-02-19,mongolia,Asia,3376601,606,460550
2022-02-20,mongolia,Asia,3376601,488,461038
2022-02-21,mongolia,Asia,3376601,309,461347
2022-02-22,mongolia,Asia,3376601,449,461796
2022-02-23,mongolia,Asia,3376601,525,462321
2022-02-24,mongolia,Asia,3376601,497,462818
2022-02-25,mongolia,Asia,3376601,517,463335
2022-02-26,mongolia,Asia,3376601,390,463725
2022-02-27,mongolia,Asia,3376601,320,464045
2022-02-28,mongolia,Asia,3376601,166,464211
2022-03-01,mongolia,Asia,3376601,305,464516
2022-03-02,mongolia,Asia,3376601,255,464771
2022-03-03,mongolia,Asia,3376601,323,465094
2022-03-04,mongolia,Asia,3376601,232,465326
2022-03-05,mongolia,Asia,3376601,264,465590
2022-03-06,mongolia,Asia,3376601,173,465763
2022-03-07,mongolia,Asia,3376601,190,465953
2022-03-08,mongolia,Asia,3376601,189,466142
2022-03-09,mongolia,Asia,3376601,161,466303
2022-03-10,mongolia,Asia,3376601,120,466423
2022-03-11,mongolia,Asia,3376601,219,466642
2022-03-12,mongolia,Asia,3376601,175,466817
2022-03-13,mongolia,Asia,3376601,94,466911
2022-03-14,mongolia,Asia,3376601,92,467003
2022-03-15,mongolia,Asia,3376601,97,467100
2022-03-16,mongolia,Asia,3376601,164,467264
2022-03-17,mongolia,Asia,3376601,95,467359
2022-03-18,mongolia,Asia,3376601,77,467436
2022-03-19,mongolia,Asia,3376601,85,467521
2022-03-20,mongolia,Asia,3376601,39,467560
2022-03-21,mongolia,Asia,3376601,35,467595
2022-03-22,mongolia,Asia,3376601,46,467641
2022-03-23,mongolia,Asia,3376601,85,467726
2022-03-24,mongolia,Asia,3376601,55,467781
2022-03-25,mongolia,Asia,3376601,103,467884
2022-03-26,mongolia,Asia,3376601,73,467957
2022-03-27,mongolia,Asia,3376601,25,467982
2022-03-28,mongolia,Asia,3376601,69,468051
2020-04-26,montserrat,North America,4998,0,11
2020-04-27,montserrat,North America,4998,0,11
2020-04-28,montserrat,North America,4998,0,11
2020-04-29,montserrat,North America,4998,0,11
2020-04-30,montserrat,North America,4998,0,11
2020-05-01,montserrat,North America,4998,0,11
2020-05-02,montserrat,North America,4998,0,11
2020-05-03,montserrat,North America,4998,0,11
2020-05-04,montserrat,North America,4998,0,11
2020-05-05,montserrat,North America,4998,0,11
2020-05-06,montserrat,North America,4998,0,11
2020-05-07,montserrat,North America,4998,0,11
2020-05-08,montserrat,North America,4998,0,11
2020-05-09,montserrat,North America,4998,0,11
2020-05-10,montserrat,North America,4998,0,11
2020-05-11,montserrat,North America,4998,0,11
2020-05-12,montserrat,North America,4998,0,11
2020-05-13,montserrat,North America,4998,0,11
2020-05-14,montserrat,North America,4998,0,11
2020-05-15,montserrat,North America,4998,0,11
2020-05-16,montserrat,North America,4998,0,11
2020-05-17,montserrat,North America,4998,0,11
2020-05-18,montserrat,North America,4998,0,11
2020-05-19,montserrat,North America,4998,0,11
2020-05-20,montserrat,North America,4998,0,11
2020-05-21,montserrat,North America,4998,0,11
2020-05-22,montserrat,North America,4998,0,11
2020-05-23,montserrat,North America,4998,0,11
2020-05-24,montserrat,North America,4998,0,11
2020-05-25,montserrat,North America,4998,0,11
2020-05-26,montserrat,North America,4998,0,11
2020-05-27,montserrat,North America,4998,0,11
2020-05-28,montserrat,North America,4998,0,11
2020-05-29,montserrat,North America,4998,0,11
2020-05-30,montserrat,North America,4998,0,11
2020-05-31,montserrat,North America,4998,0,11
2020-06-01,montserrat,North America,4998,0,11
2020-06-02,montserrat,North America,4998,0,11
2020-06-03,montserrat,North America,4998,0,11
2020-06-04,montserrat,North America,4998,0,11
2020-06-05,montserrat,North America,4998,0,11
2020-06-06,montserrat,North America,4998,0,11
2020-06-07,montserrat,North America,4998,0,11
2020-06-08,montserrat,North America,4998,0,11
2020-06-09,montserrat,North America,4998,0,11
2020-06-10,montserrat,North America,4998,0,11
2020-06-11,montserrat,North America,4998,0,11
2020-06-12,montserrat,North America,4998,0,11
2020-06-13,montserrat,North America,4998,0,11
2020-06-14,montserrat,North America,4998,0,11
2020-06-15,montserrat,North America,4998,0,11
2020-06-16,montserrat,North America,4998,0,11
2020-06-17,montserrat,North America,4998,0,11
2020-06-18,montserrat,North America,4998,0,11
2020-06-19,montserrat,North America,4998,0,11
2020-06-20,montserrat,North America,4998,0,11
2020-06-21,montserrat,North America,4998,0,11
2020-06-22,montserrat,North America,4998,0,11
2020-06-23,montserrat,North America,4998,0,11
2020-06-24,montserrat,North America,4998,0,11
2020-06-25,montserrat,North America,4998,0,11
2020-06-26,montserrat,North America,4998,0,11
2020-06-27,montserrat,North America,4998,0,11
2020-06-28,montserrat,North America,4998,0,11
2020-06-29,montserrat,North America,4998,0,11
2020-06-30,montserrat,North America,4998,0,11
2020-07-01,montserrat,North America,4998,0,11
2020-07-02,montserrat,North America,4998,0,11
2020-07-03,montserrat,North America,4998,0,11
2020-07-04,montserrat,North America,4998,0,11
2020-07-05,montserrat,North America,4998,0,11
2020-07-06,montserrat,North America,4998,0,11
2020-07-07,montserrat,North America,4998,0,11
2020-07-08,montserrat,North America,4998,0,11
2020-07-09,montserrat,North America,4998,0,11
2020-07-10,montserrat,North America,4998,0,11
2020-07-11,montserrat,North America,4998,1,12
2020-07-12,montserrat,North America,4998,0,12
2020-07-13,montserrat,North America,4998,0,12
2020-07-14,montserrat,North America,4998,0,12
2020-07-15,montserrat,North America,4998,0,12
2020-07-16,montserrat,North America,4998,0,12
2020-07-17,montserrat,North America,4998,0,12
2020-07-18,montserrat,North America,4998,0,12
2020-07-19,montserrat,North America,4998,0,12
2020-07-20,montserrat,North America,4998,0,12
2020-07-21,montserrat,North America,4998,0,12
2020-07-22,montserrat,North America,4998,0,12
2020-07-23,montserrat,North America,4998,0,12
2020-07-24,montserrat,North America,4998,0,12
2020-07-25,montserrat,North America,4998,0,12
2020-07-26,montserrat,North America,4998,0,12
2020-07-27,montserrat,North America,4998,0,12
2020-07-28,montserrat,North America,4998,0,12
2020-07-29,montserrat,North America,4998,1,13
2020-07-30,montserrat,North America,4998,0,13
2020-07-31,montserrat,North America,4998,0,13
2020-08-01,montserrat,North America,4998,0,13
2020-08-02,montserrat,North America,4998,0,13
2020-08-03,montserrat,North America,4998,0,13
2020-08-04,montserrat,North America,4998,0,13
2020-08-05,montserrat,North America,4998,0,13
2020-08-06,montserrat,North America,4998,0,13
2020-08-07,montserrat,North America,4998,0,13
2020-08-08,montserrat,North America,4998,0,13
2020-08-09,montserrat,North America,4998,0,13
2020-08-10,montserrat,North America,4998,0,13
2020-08-11,montserrat,North America,4998,0,13
2020-08-12,montserrat,North America,4998,0,13
2020-08-13,montserrat,North America,4998,0,13
2020-08-14,montserrat,North America,4998,0,13
2020-08-15,montserrat,North America,4998,0,13
2020-08-16,montserrat,North America,4998,0,13
2020-08-17,montserrat,North America,4998,0,13
2020-08-18,montserrat,North America,4998,0,13
2020-08-19,montserrat,North America,4998,0,13
2020-08-20,montserrat,North America,4998,0,13
2020-08-21,montserrat,North America,4998,0,13
2020-08-22,montserrat,North America,4998,0,13
2020-08-23,montserrat,North America,4998,0,13
2020-08-24,montserrat,North America,4998,0,13
2020-08-25,montserrat,North America,4998,0,13
2020-08-26,montserrat,North America,4998,0,13
2020-08-27,montserrat,North America,4998,0,13
2020-08-28,montserrat,North America,4998,0,13
2020-08-29,montserrat,North America,4998,0,13
2020-08-30,montserrat,North America,4998,0,13
2020-08-31,montserrat,North America,4998,0,13
2020-09-01,montserrat,North America,4998,0,13
2020-09-02,montserrat,North America,4998,0,13
2020-09-03,montserrat,North America,4998,0,13
2020-09-04,montserrat,North America,4998,0,13
2020-09-05,montserrat,North America,4998,0,13
2020-09-06,montserrat,North America,4998,0,13
2020-09-07,montserrat,North America,4998,0,13
2020-09-08,montserrat,North America,4998,0,13
2020-09-09,montserrat,North America,4998,0,13
2020-09-10,montserrat,North America,4998,0,13
2020-09-11,montserrat,North America,4998,0,13
2020-09-12,montserrat,North America,4998,0,13
2020-09-13,montserrat,North America,4998,0,13
2020-09-14,montserrat,North America,4998,0,13
2020-09-15,montserrat,North America,4998,0,13
2020-09-16,montserrat,North America,4998,0,13
2020-09-17,montserrat,North America,4998,0,13
2020-09-18,montserrat,North America,4998,0,13
2020-09-19,montserrat,North America,4998,0,13
2020-09-20,montserrat,North America,4998,0,13
2020-09-21,montserrat,North America,4998,0,13
2020-09-22,montserrat,North America,4998,0,13
2020-09-23,montserrat,North America,4998,0,13
2020-09-24,montserrat,North America,4998,0,13
2020-09-25,montserrat,North America,4998,0,13
2020-09-26,montserrat,North America,4998,0,13
2020-09-27,montserrat,North America,4998,0,13
2020-09-28,montserrat,North America,4998,0,13
2020-09-29,montserrat,North America,4998,0,13
2020-09-30,montserrat,North America,4998,0,13
2020-10-01,montserrat,North America,4998,0,13
2020-10-02,montserrat,North America,4998,0,13
2020-10-03,montserrat,North America,4998,0,13
2020-10-04,montserrat,North America,4998,0,13
2020-10-05,montserrat,North America,4998,0,13
2020-10-06,montserrat,North America,4998,0,13
2020-10-07,montserrat,North America,4998,0,13
2020-10-08,montserrat,North America,4998,0,13
2020-10-09,montserrat,North America,4998,0,13
2020-10-10,montserrat,North America,4998,0,13
2020-10-11,montserrat,North America,4998,0,13
2020-10-12,montserrat,North America,4998,0,13
2020-10-13,montserrat,North America,4998,0,13
2020-03-03,morocco,Africa,37725337,0,1
2020-03-04,morocco,Africa,37725337,0,1
2020-03-05,morocco,Africa,37725337,1,2
2020-03-06,morocco,Africa,37725337,0,2
2020-03-07,morocco,Africa,37725337,0,2
2020-03-08,morocco,Africa,37725337,0,2
2020-03-09,morocco,Africa,37725337,0,2
2020-03-10,morocco,Africa,37725337,1,3
2020-03-11,morocco,Africa,37725337,3,6
2020-03-12,morocco,Africa,37725337,0,6
2020-03-13,morocco,Africa,37725337,1,7
2020-03-14,morocco,Africa,37725337,11,18
2020-03-15,morocco,Africa,37725337,10,28
2020-03-16,morocco,Africa,37725337,9,37
2020-03-17,morocco,Africa,37725337,7,44
2020-03-18,morocco,Africa,37725337,10,54
2020-03-19,morocco,Africa,37725337,9,63
2020-03-20,morocco,Africa,37725337,23,86
2020-03-21,morocco,Africa,37725337,10,96
2020-03-22,morocco,Africa,37725337,19,115
2020-03-23,morocco,Africa,37725337,28,143
2020-03-24,morocco,Africa,37725337,27,170
2020-03-25,morocco,Africa,37725337,55,225
2020-03-26,morocco,Africa,37725337,50,275
2020-03-27,morocco,Africa,37725337,70,345
2020-03-28,morocco,Africa,37725337,57,402
2020-03-29,morocco,Africa,37725337,77,479
2020-03-30,morocco,Africa,37725337,77,556
2020-03-31,morocco,Africa,37725337,61,617
2020-04-01,morocco,Africa,37725337,37,654
2020-04-02,morocco,Africa,37725337,54,708
2020-04-03,morocco,Africa,37725337,83,791
2020-04-04,morocco,Africa,37725337,128,919
2020-04-05,morocco,Africa,37725337,102,1021
2020-04-06,morocco,Africa,37725337,99,1120
2020-04-07,morocco,Africa,37725337,64,1184
2020-04-08,morocco,Africa,37725337,91,1275
2020-04-09,morocco,Africa,37725337,99,1374
2020-04-10,morocco,Africa,37725337,74,1448
2020-04-11,morocco,Africa,37725337,97,1545
2020-04-12,morocco,Africa,37725337,116,1661
2020-04-13,morocco,Africa,37725337,102,1763
2020-04-14,morocco,Africa,37725337,125,1888
2020-04-15,morocco,Africa,37725337,136,2024
2020-04-16,morocco,Africa,37725337,259,2283
2020-04-17,morocco,Africa,37725337,281,2564
2020-04-18,morocco,Africa,37725337,121,2685
2020-04-19,morocco,Africa,37725337,170,2855
2020-04-20,morocco,Africa,37725337,191,3046
2020-04-21,morocco,Africa,37725337,163,3209
2020-04-22,morocco,Africa,37725337,237,3446
2020-04-23,morocco,Africa,37725337,122,3568
2020-04-24,morocco,Africa,37725337,190,3758
2020-04-25,morocco,Africa,37725337,139,3897
2020-04-26,morocco,Africa,37725337,168,4065
2020-04-27,morocco,Africa,37725337,55,4120
2020-04-28,morocco,Africa,37725337,132,4252
2020-04-29,morocco,Africa,37725337,69,4321
2020-04-30,morocco,Africa,37725337,102,4423
2020-05-01,morocco,Africa,37725337,146,4569
2020-05-02,morocco,Africa,37725337,160,4729
2020-05-03,morocco,Africa,37725337,174,4903
2020-05-04,morocco,Africa,37725337,150,5053
2020-05-05,morocco,Africa,37725337,166,5219
2020-05-06,morocco,Africa,37725337,189,5408
2020-05-07,morocco,Africa,37725337,140,5548
2020-05-08,morocco,Africa,37725337,163,5711
2020-05-09,morocco,Africa,37725337,199,5910
2020-05-10,morocco,Africa,37725337,153,6063
2020-05-11,morocco,Africa,37725337,218,6281
2020-05-12,morocco,Africa,37725337,137,6418
2020-05-13,morocco,Africa,37725337,94,6512
2020-05-14,morocco,Africa,37725337,95,6607
2020-05-15,morocco,Africa,37725337,45,6652
2020-05-16,morocco,Africa,37725337,89,6741
2020-05-17,morocco,Africa,37725337,129,6870
2020-05-18,morocco,Africa,37725337,82,6952
2020-05-19,morocco,Africa,37725337,71,7023
2020-05-20,morocco,Africa,37725337,110,7133
2020-05-21,morocco,Africa,37725337,78,7211
2020-05-22,morocco,Africa,37725337,121,7332
2020-05-23,morocco,Africa,37725337,74,7406
2020-05-24,morocco,Africa,37725337,27,7433
2020-05-25,morocco,Africa,37725337,99,7532
2020-05-26,morocco,Africa,37725337,45,7577
2020-05-27,morocco,Africa,37725337,24,7601
2020-05-28,morocco,Africa,37725337,42,7643
2020-05-29,morocco,Africa,37725337,71,7714
2020-05-30,morocco,Africa,37725337,66,7780
2020-05-31,morocco,Africa,37725337,27,7807
2020-06-01,morocco,Africa,37725337,26,7833
2020-06-02,morocco,Africa,37725337,33,7866
2020-06-03,morocco,Africa,37725337,56,7922
2020-06-04,morocco,Africa,37725337,81,8003
2020-06-05,morocco,Africa,37725337,68,8071
2020-06-06,morocco,Africa,37725337,80,8151
2020-06-07,morocco,Africa,37725337,73,8224
2020-06-08,morocco,Africa,37725337,78,8302
2020-06-09,morocco,Africa,37725337,135,8437
2020-06-10,morocco,Africa,37725337,71,8508
2020-06-11,morocco,Africa,37725337,29,8537
2020-06-12,morocco,Africa,37725337,73,8610
2020-06-13,morocco,Africa,37725337,82,8692
2020-06-14,morocco,Africa,37725337,101,8793
2020-06-15,morocco,Africa,37725337,92,8885
2020-06-16,morocco,Africa,37725337,46,8931
2020-06-17,morocco,Africa,37725337,66,8997
2020-06-18,morocco,Africa,37725337,77,9074
2020-06-19,morocco,Africa,37725337,539,9613
2020-06-20,morocco,Africa,37725337,226,9839
2020-06-21,morocco,Africa,37725337,138,9977
2020-06-22,morocco,Africa,37725337,195,10172
2020-06-23,morocco,Africa,37725337,172,10344
2020-06-24,morocco,Africa,37725337,563,10907
2020-06-25,morocco,Africa,37725337,431,11338
2020-06-26,morocco,Africa,37725337,295,11633
2020-06-27,morocco,Africa,37725337,244,11877
2020-06-28,morocco,Africa,37725337,175,12052
2020-06-29,morocco,Africa,37725337,238,12290
2020-06-30,morocco,Africa,37725337,243,12533
2020-07-01,morocco,Africa,37725337,103,12636
2020-07-02,morocco,Africa,37725337,333,12969
2020-07-03,morocco,Africa,37725337,319,13288
2020-07-04,morocco,Africa,37725337,534,13822
2020-07-05,morocco,Africa,37725337,393,14215
2020-07-06,morocco,Africa,37725337,164,14379
2020-07-07,morocco,Africa,37725337,228,14607
2020-07-08,morocco,Africa,37725337,164,14771
2020-07-09,morocco,Africa,37725337,308,15079
2020-07-10,morocco,Africa,37725337,249,15328
2020-07-11,morocco,Africa,37725337,214,15542
2020-07-12,morocco,Africa,37725337,203,15745
2020-07-13,morocco,Africa,37725337,191,15936
2020-07-14,morocco,Africa,37725337,161,16097
2020-07-15,morocco,Africa,37725337,165,16262
2020-07-16,morocco,Africa,37725337,283,16545
2020-07-17,morocco,Africa,37725337,181,16726
2020-07-18,morocco,Africa,37725337,289,17015
2020-07-19,morocco,Africa,37725337,221,17236
2020-07-20,morocco,Africa,37725337,326,17562
2020-07-21,morocco,Africa,37725337,180,17742
2020-07-22,morocco,Africa,37725337,220,17962
2020-07-23,morocco,Africa,37725337,302,18264
2020-07-24,morocco,Africa,37725337,570,18834
2020-07-25,morocco,Africa,37725337,811,19645
2020-07-26,morocco,Africa,37725337,633,20278
2020-07-27,morocco,Africa,37725337,609,20887
2020-07-28,morocco,Africa,37725337,500,21387
2020-07-29,morocco,Africa,37725337,826,22213
2020-07-30,morocco,Africa,37725337,1046,23259
2020-07-31,morocco,Africa,37725337,1063,24322
2020-08-01,morocco,Africa,37725337,693,25015
2020-08-02,morocco,Africa,37725337,522,25537
2020-08-03,morocco,Africa,37725337,659,26196
2020-08-04,morocco,Africa,37725337,1021,27217
2020-08-05,morocco,Africa,37725337,1283,28500
2020-08-06,morocco,Africa,37725337,1144,29644
2020-08-07,morocco,Africa,37725337,1018,30662
2020-08-08,morocco,Africa,37725337,1345,32007
2020-08-09,morocco,Africa,37725337,1230,33237
2020-08-10,morocco,Africa,37725337,826,34063
2020-08-11,morocco,Africa,37725337,1132,35195
2020-08-12,morocco,Africa,37725337,1499,36694
2020-08-13,morocco,Africa,37725337,1241,37935
2020-08-14,morocco,Africa,37725337,1306,39241
2020-08-15,morocco,Africa,37725337,1776,41017
2020-08-16,morocco,Africa,37725337,1472,42489
2020-08-17,morocco,Africa,37725337,1069,43558
2020-08-18,morocco,Africa,37725337,1245,44803
2020-08-19,morocco,Africa,37725337,1510,46313
2020-08-20,morocco,Africa,37725337,1325,47638
2020-08-21,morocco,Africa,37725337,1609,49247
2020-08-22,morocco,Africa,37725337,1565,50812
2020-08-23,morocco,Africa,37725337,1537,52349
2020-08-24,morocco,Africa,37725337,903,53252
2020-08-25,morocco,Africa,37725337,1276,54528
2020-08-26,morocco,Africa,37725337,1336,55864
2020-08-27,morocco,Africa,37725337,1221,57085
2020-08-28,morocco,Africa,37725337,1404,58489
2020-08-29,morocco,Africa,37725337,1567,60056
2020-08-30,morocco,Africa,37725337,1343,61399
2020-08-31,morocco,Africa,37725337,1191,62590
2020-09-01,morocco,Africa,37725337,1191,63781
2020-09-02,morocco,Africa,37725337,1672,65453
2020-09-03,morocco,Africa,37725337,1402,66855
2020-09-04,morocco,Africa,37725337,1750,68605
2020-09-05,morocco,Africa,37725337,1555,70160
2020-09-06,morocco,Africa,37725337,2234,72394
2020-09-07,morocco,Africa,37725337,1386,73780
2020-09-08,morocco,Africa,37725337,1941,75721
2020-09-09,morocco,Africa,37725337,2157,77878
2020-09-10,morocco,Africa,37725337,1889,79767
2020-09-11,morocco,Africa,37725337,2430,82197
2020-09-12,morocco,Africa,37725337,2238,84435
2020-09-13,morocco,Africa,37725337,2251,86686
2020-09-14,morocco,Africa,37725337,1517,88203
2020-09-15,morocco,Africa,37725337,2121,90324
2020-09-16,morocco,Africa,37725337,1692,92016
2020-09-17,morocco,Africa,37725337,2488,94504
2020-09-18,morocco,Africa,37725337,2760,97264
2020-09-19,morocco,Africa,37725337,2552,99816
2020-09-20,morocco,Africa,37725337,1927,101743
2020-09-21,morocco,Africa,37725337,1376,103119
2020-09-22,morocco,Africa,37725337,2227,105346
2020-09-23,morocco,Africa,37725337,2397,107743
2020-09-24,morocco,Africa,37725337,2356,110099
2020-09-25,morocco,Africa,37725337,2423,112522
2020-09-26,morocco,Africa,37725337,2719,115241
2020-09-27,morocco,Africa,37725337,2444,117685
2020-09-28,morocco,Africa,37725337,1422,119107
2020-09-29,morocco,Africa,37725337,2076,121183
2020-09-30,morocco,Africa,37725337,2470,123653
2020-10-01,morocco,Africa,37725337,2391,126044
2020-10-02,morocco,Africa,37725337,2521,128565
2020-10-03,morocco,Africa,37725337,2663,131228
2020-10-04,morocco,Africa,37725337,2044,133272
2020-10-05,morocco,Africa,37725337,1423,134695
2020-10-06,morocco,Africa,37725337,2553,137248
2020-10-07,morocco,Africa,37725337,2776,140024
2020-10-08,morocco,Africa,37725337,2929,142953
2020-10-09,morocco,Africa,37725337,3445,146398
2020-10-10,morocco,Africa,37725337,3443,149841
2020-10-11,morocco,Africa,37725337,2563,152404
2020-10-12,morocco,Africa,37725337,1357,153761
2020-10-13,morocco,Africa,37725337,3185,156946
2020-10-14,morocco,Africa,37725337,3387,160333
2020-10-15,morocco,Africa,37725337,3317,163650
2020-10-16,morocco,Africa,37725337,3498,167148
2020-10-17,morocco,Africa,37725337,3763,170911
2020-10-18,morocco,Africa,37725337,2721,173632
2020-10-19,morocco,Africa,37725337,2117,175749
2020-10-20,morocco,Africa,37725337,3254,179003
2020-10-21,morocco,Africa,37725337,3577,182580
2020-10-22,morocco,Africa,37725337,4151,186731
2020-10-23,morocco,Africa,37725337,3685,190416
2020-10-24,morocco,Africa,37725337,4045,194461
2020-10-25,morocco,Africa,37725337,3020,197481
2020-10-26,morocco,Africa,37725337,2264,199745
2020-10-27,morocco,Africa,37725337,3988,203733
2020-10-28,morocco,Africa,37725337,3985,207718
2020-10-29,morocco,Africa,37725337,4320,212038
2020-10-30,morocco,Africa,37725337,3256,215294
2020-10-31,morocco,Africa,37725337,3790,219084
2020-11-01,morocco,Africa,37725337,3460,222544
2020-11-02,morocco,Africa,37725337,2526,225070
2020-11-03,morocco,Africa,37725337,4495,229565
2020-11-04,morocco,Africa,37725337,5745,235310
2020-11-05,morocco,Africa,37725337,5641,240951
2020-11-06,morocco,Africa,37725337,5398,246349
2020-11-07,morocco,Africa,37725337,5836,252185
2020-11-08,morocco,Africa,37725337,4596,256781
2020-11-09,morocco,Africa,37725337,3170,259951
2020-11-10,morocco,Africa,37725337,5214,265165
2020-11-11,morocco,Africa,37725337,5461,270626
2020-11-12,morocco,Africa,37725337,6195,276821
2020-11-13,morocco,Africa,37725337,5515,282336
2020-11-14,morocco,Africa,37725337,5875,288211
2020-11-15,morocco,Africa,37725337,4966,293177
2020-11-16,morocco,Africa,37725337,3012,296189
2020-11-17,morocco,Africa,37725337,5415,301604
2020-11-18,morocco,Africa,37725337,5391,306995
2020-11-19,morocco,Africa,37725337,4559,311554
2020-11-20,morocco,Africa,37725337,4706,316260
2020-11-21,morocco,Africa,37725337,4702,320962
2020-11-22,morocco,Africa,37725337,3979,324941
2020-11-23,morocco,Africa,37725337,2587,327528
2020-11-24,morocco,Africa,37725337,3999,331527
2020-11-25,morocco,Africa,37725337,4979,336506
2020-11-26,morocco,Africa,37725337,4178,340684
2020-11-27,morocco,Africa,37725337,4592,345276
2020-11-28,morocco,Africa,37725337,4412,349688
2020-11-29,morocco,Africa,37725337,4115,353803
2020-11-30,morocco,Africa,37725337,2533,356336
2020-12-01,morocco,Africa,37725337,3508,359844
2020-12-02,morocco,Africa,37725337,4346,364190
2020-12-03,morocco,Africa,37725337,4434,368624
2020-12-04,morocco,Africa,37725337,3996,372620
2020-12-05,morocco,Africa,37725337,4118,376738
2020-12-06,morocco,Africa,37725337,2919,379657
2020-12-07,morocco,Africa,37725337,1531,381188
2020-12-08,morocco,Africa,37725337,2900,384088
2020-12-09,morocco,Africa,37725337,4096,388184
2020-12-10,morocco,Africa,37725337,3345,391529
2020-12-11,morocco,Africa,37725337,3035,394564
2020-12-12,morocco,Africa,37725337,3033,397597
2020-12-13,morocco,Africa,37725337,2012,399609
2020-12-14,morocco,Africa,37725337,1217,400826
2020-12-15,morocco,Africa,37725337,2793,403619
2020-12-16,morocco,Africa,37725337,3351,406970
2020-12-17,morocco,Africa,37725337,2776,409746
2020-12-18,morocco,Africa,37725337,2647,412393
2020-12-19,morocco,Africa,37725337,2833,415226
2020-12-20,morocco,Africa,37725337,1899,417125
2020-12-21,morocco,Africa,37725337,877,418002
2020-12-22,morocco,Africa,37725337,2646,420648
2020-12-23,morocco,Africa,37725337,2566,423214
2020-12-24,morocco,Africa,37725337,2650,425864
2020-12-25,morocco,Africa,37725337,2329,428193
2020-12-26,morocco,Africa,37725337,2369,430562
2020-12-27,morocco,Africa,37725337,1517,432079
2020-12-28,morocco,Africa,37725337,950,433029
2020-12-29,morocco,Africa,37725337,2160,435189
2020-12-30,morocco,Africa,37725337,2143,437332
2020-12-31,morocco,Africa,37725337,1861,439193
2021-01-01,morocco,Africa,37725337,1777,440970
2021-01-02,morocco,Africa,37725337,1171,442141
2021-01-03,morocco,Africa,37725337,1005,443146
2021-01-04,morocco,Africa,37725337,656,443802
2021-01-05,morocco,Africa,37725337,1637,445439
2021-01-06,morocco,Africa,37725337,1642,447081
2021-01-07,morocco,Africa,37725337,1597,448678
2021-01-08,morocco,Africa,37725337,1543,450221
2021-01-09,morocco,Africa,37725337,1416,451637
2021-01-10,morocco,Africa,37725337,895,452532
2021-01-11,morocco,Africa,37725337,456,452988
2021-01-12,morocco,Africa,37725337,801,453789
2021-01-13,morocco,Africa,37725337,1266,455055
2021-01-14,morocco,Africa,37725337,1279,456334
2021-01-15,morocco,Africa,37725337,1291,457625
2021-01-16,morocco,Africa,37725337,1240,458865
2021-01-17,morocco,Africa,37725337,806,459671
2021-01-18,morocco,Africa,37725337,473,460144
2021-01-19,morocco,Africa,37725337,1246,461390
2021-01-20,morocco,Africa,37725337,1152,462542
2021-01-21,morocco,Africa,37725337,1164,463706
2021-01-22,morocco,Africa,37725337,1138,464844
2021-01-23,morocco,Africa,37725337,925,465769
2021-01-24,morocco,Africa,37725337,520,466289
2021-01-25,morocco,Africa,37725337,337,466626
2021-01-26,morocco,Africa,37725337,867,467493
2021-01-27,morocco,Africa,37725337,890,468383
2021-01-28,morocco,Africa,37725337,756,469139
2021-01-29,morocco,Africa,37725337,851,469990
2021-01-30,morocco,Africa,37725337,701,470691
2021-01-31,morocco,Africa,37725337,466,471157
2021-02-01,morocco,Africa,37725337,281,471438
2021-02-02,morocco,Africa,37725337,835,472273
2021-02-03,morocco,Africa,37725337,774,473047
2021-02-04,morocco,Africa,37725337,620,473667
2021-02-05,morocco,Africa,37725337,712,474379
2021-02-06,morocco,Africa,37725337,587,474966
2021-02-07,morocco,Africa,37725337,389,475355
2021-02-08,morocco,Africa,37725337,234,475589
2021-02-09,morocco,Africa,37725337,536,476125
2021-02-10,morocco,Africa,37725337,564,476689
2021-02-11,morocco,Africa,37725337,471,477160
2021-02-12,morocco,Africa,37725337,496,477656
2021-02-13,morocco,Africa,37725337,479,478135
2021-02-14,morocco,Africa,37725337,339,478474
2021-02-15,morocco,Africa,37725337,121,478595
2021-02-16,morocco,Africa,37725337,476,479071
2021-02-17,morocco,Africa,37725337,508,479579
2021-02-18,morocco,Africa,37725337,477,480056
2021-02-19,morocco,Africa,37725337,448,480504
2021-02-20,morocco,Africa,37725337,444,480948
2021-02-21,morocco,Africa,37725337,207,481155
2021-02-22,morocco,Africa,37725337,108,481263
2021-02-23,morocco,Africa,37725337,446,481709
2021-02-24,morocco,Africa,37725337,419,482128
2021-02-25,morocco,Africa,37725337,386,482514
2021-02-26,morocco,Africa,37725337,480,482994
2021-02-27,morocco,Africa,37725337,416,483410
2021-02-28,morocco,Africa,37725337,244,483654
2021-03-01,morocco,Africa,37725337,112,483766
2021-03-02,morocco,Africa,37725337,393,484159
2021-03-03,morocco,Africa,37725337,594,484753
2021-03-04,morocco,Africa,37725337,394,485147
2021-03-05,morocco,Africa,37725337,420,485567
2021-03-06,morocco,Africa,37725337,407,485974
2021-03-07,morocco,Africa,37725337,249,486223
2021-03-08,morocco,Africa,37725337,102,486325
2021-03-09,morocco,Africa,37725337,508,486833
2021-03-10,morocco,Africa,37725337,453,487286
2021-03-11,morocco,Africa,37725337,464,487750
2021-03-12,morocco,Africa,37725337,431,488181
2021-03-13,morocco,Africa,37725337,451,488632
2021-03-14,morocco,Africa,37725337,305,488937
2021-03-15,morocco,Africa,37725337,159,489096
2021-03-16,morocco,Africa,37725337,526,489622
2021-03-17,morocco,Africa,37725337,466,490088
2021-03-18,morocco,Africa,37725337,487,490575
2021-03-19,morocco,Africa,37725337,444,491019
2021-03-20,morocco,Africa,37725337,444,491463
2021-03-21,morocco,Africa,37725337,246,491709
2021-03-22,morocco,Africa,37725337,125,491834
2021-03-23,morocco,Africa,37725337,569,492403
2021-03-24,morocco,Africa,37725337,439,492842
2021-03-25,morocco,Africa,37725337,511,493353
2021-03-26,morocco,Africa,37725337,514,493867
2021-03-27,morocco,Africa,37725337,491,494358
2021-03-28,morocco,Africa,37725337,301,494659
2021-03-29,morocco,Africa,37725337,97,494756
2021-03-30,morocco,Africa,37725337,665,495421
2021-03-31,morocco,Africa,37725337,676,496097
2021-04-01,morocco,Africa,37725337,579,496676
2021-04-02,morocco,Africa,37725337,581,497257
2021-04-03,morocco,Africa,37725337,575,497832
2021-04-04,morocco,Africa,37725337,365,498197
2021-04-05,morocco,Africa,37725337,132,498329
2021-04-06,morocco,Africa,37725337,696,499025
2021-04-07,morocco,Africa,37725337,663,499688
2021-04-08,morocco,Africa,37725337,635,500323
2021-04-09,morocco,Africa,37725337,625,500948
2021-04-10,morocco,Africa,37725337,740,501688
2021-04-11,morocco,Africa,37725337,414,502102
2021-04-12,morocco,Africa,37725337,175,502277
2021-04-13,morocco,Africa,37725337,684,502961
2021-04-14,morocco,Africa,37725337,703,503664
2021-04-15,morocco,Africa,37725337,596,504260
2021-04-16,morocco,Africa,37725337,587,504847
2021-04-17,morocco,Africa,37725337,600,505447
2021-04-18,morocco,Africa,37725337,364,505811
2021-04-19,morocco,Africa,37725337,138,505949
2021-04-20,morocco,Africa,37725337,720,506669
2021-04-21,morocco,Africa,37725337,669,507338
2021-04-22,morocco,Africa,37725337,600,507938
2021-04-23,morocco,Africa,37725337,592,508530
2021-04-24,morocco,Africa,37725337,507,509037
2021-04-25,morocco,Africa,37725337,326,509363
2021-04-26,morocco,Africa,37725337,102,509465
2021-04-27,morocco,Africa,37725337,507,509972
2021-04-28,morocco,Africa,37725337,493,510465
2020-05-26,mozambique,Africa,32885526,4,213
2020-05-27,mozambique,Africa,32885526,14,227
2020-05-28,mozambique,Africa,32885526,6,233
2020-05-29,mozambique,Africa,32885526,1,234
2020-05-30,mozambique,Africa,32885526,10,244
2020-05-31,mozambique,Africa,32885526,10,254
2020-06-01,mozambique,Africa,32885526,0,254
2020-06-02,mozambique,Africa,32885526,53,307
2020-06-03,mozambique,Africa,32885526,9,316
2020-06-04,mozambique,Africa,32885526,36,352
2020-06-05,mozambique,Africa,32885526,2,354
2020-06-06,mozambique,Africa,32885526,55,409
2020-06-07,mozambique,Africa,32885526,15,424
2020-06-08,mozambique,Africa,32885526,9,433
2020-06-09,mozambique,Africa,32885526,20,453
2020-06-10,mozambique,Africa,32885526,19,472
2020-06-11,mozambique,Africa,32885526,17,489
2020-06-12,mozambique,Africa,32885526,20,509
2020-06-13,mozambique,Africa,32885526,44,553
2020-06-14,mozambique,Africa,32885526,30,583
2020-06-15,mozambique,Africa,32885526,26,609
2020-06-16,mozambique,Africa,32885526,29,638
2020-06-17,mozambique,Africa,32885526,13,651
2020-06-18,mozambique,Africa,32885526,11,662
2020-06-19,mozambique,Africa,32885526,6,668
2020-06-20,mozambique,Africa,32885526,20,688
2020-06-21,mozambique,Africa,32885526,45,733
2020-06-22,mozambique,Africa,32885526,4,737
2020-06-23,mozambique,Africa,32885526,20,757
2020-06-24,mozambique,Africa,32885526,5,762
2020-06-25,mozambique,Africa,32885526,26,788
2020-06-26,mozambique,Africa,32885526,28,816
2020-06-27,mozambique,Africa,32885526,0,816
2020-06-28,mozambique,Africa,32885526,43,859
2020-06-29,mozambique,Africa,32885526,24,883
2020-06-30,mozambique,Africa,32885526,6,889
2020-07-01,mozambique,Africa,32885526,14,903
2020-07-02,mozambique,Africa,32885526,15,918
2020-07-03,mozambique,Africa,32885526,21,939
2020-07-04,mozambique,Africa,32885526,30,969
2020-07-05,mozambique,Africa,32885526,18,987
2020-07-06,mozambique,Africa,32885526,25,1012
2020-07-07,mozambique,Africa,32885526,28,1040
2020-07-08,mozambique,Africa,32885526,31,1071
2020-07-09,mozambique,Africa,32885526,21,1092
2020-07-10,mozambique,Africa,32885526,19,1111
2020-07-11,mozambique,Africa,32885526,24,1135
2020-07-12,mozambique,Africa,32885526,22,1157
2020-07-13,mozambique,Africa,32885526,62,1219
2020-07-14,mozambique,Africa,32885526,49,1268
2020-07-15,mozambique,Africa,32885526,62,1330
2020-07-16,mozambique,Africa,32885526,53,1383
2020-07-17,mozambique,Africa,32885526,19,1402
2020-07-18,mozambique,Africa,32885526,33,1435
2020-07-19,mozambique,Africa,32885526,56,1491
2020-07-20,mozambique,Africa,32885526,16,1507
2020-07-21,mozambique,Africa,32885526,29,1536
2020-07-22,mozambique,Africa,32885526,21,1557
2020-07-23,mozambique,Africa,32885526,25,1582
2020-07-24,mozambique,Africa,32885526,8,1590
2020-07-25,mozambique,Africa,32885526,26,1616
2020-07-26,mozambique,Africa,32885526,53,1669
2020-07-27,mozambique,Africa,32885526,32,1701
2020-07-28,mozambique,Africa,32885526,19,1720
2020-07-29,mozambique,Africa,32885526,28,1748
2020-07-30,mozambique,Africa,32885526,60,1808
2020-07-31,mozambique,Africa,32885526,56,1864
2020-08-01,mozambique,Africa,32885526,43,1907
2020-08-02,mozambique,Africa,32885526,39,1946
2020-08-03,mozambique,Africa,32885526,27,1973
2020-08-04,mozambique,Africa,32885526,56,2029
2020-08-05,mozambique,Africa,32885526,50,2079
2020-08-06,mozambique,Africa,32885526,41,2120
2020-08-07,mozambique,Africa,32885526,93,2213
2020-08-08,mozambique,Africa,32885526,28,2241
2020-08-09,mozambique,Africa,32885526,28,2269
2020-08-10,mozambique,Africa,32885526,142,2411
2020-08-11,mozambique,Africa,32885526,70,2481
2020-08-12,mozambique,Africa,32885526,78,2559
2020-08-13,mozambique,Africa,32885526,79,2638
2020-08-14,mozambique,Africa,32885526,70,2708
2020-08-15,mozambique,Africa,32885526,83,2791
2020-08-16,mozambique,Africa,32885526,64,2855
2020-08-17,mozambique,Africa,32885526,59,2914
2020-08-18,mozambique,Africa,32885526,77,2991
2020-08-19,mozambique,Africa,32885526,54,3045
2020-08-20,mozambique,Africa,32885526,70,3115
2020-08-21,mozambique,Africa,32885526,80,3195
2020-08-22,mozambique,Africa,32885526,109,3304
2020-08-23,mozambique,Africa,32885526,91,3395
2020-08-24,mozambique,Africa,32885526,45,3440
2020-08-25,mozambique,Africa,32885526,68,3508
2020-08-26,mozambique,Africa,32885526,82,3590
2020-08-27,mozambique,Africa,32885526,61,3651
2020-08-28,mozambique,Africa,32885526,46,3697
2020-08-29,mozambique,Africa,32885526,63,3760
2020-08-30,mozambique,Africa,32885526,61,3821
2020-08-31,mozambique,Africa,32885526,95,3916
2020-09-01,mozambique,Africa,32885526,123,4039
2020-09-02,mozambique,Africa,32885526,78,4117
2020-09-03,mozambique,Africa,32885526,90,4207
2020-09-04,mozambique,Africa,32885526,58,4265
2020-09-05,mozambique,Africa,32885526,76,4341
2020-09-06,mozambique,Africa,32885526,103,4444
2020-09-07,mozambique,Africa,32885526,113,4557
2020-09-08,mozambique,Africa,32885526,90,4647
2020-09-09,mozambique,Africa,32885526,117,4764
2020-09-10,mozambique,Africa,32885526,68,4832
2020-09-11,mozambique,Africa,32885526,86,4918
2020-09-12,mozambique,Africa,32885526,122,5040
2020-09-13,mozambique,Africa,32885526,229,5269
2020-09-14,mozambique,Africa,32885526,213,5482
2020-09-15,mozambique,Africa,32885526,231,5713
2020-09-16,mozambique,Africa,32885526,281,5994
2020-09-17,mozambique,Africa,32885526,167,6161
2020-09-18,mozambique,Africa,32885526,103,6264
2020-09-19,mozambique,Africa,32885526,273,6537
2020-09-20,mozambique,Africa,32885526,234,6771
2020-09-21,mozambique,Africa,32885526,141,6912
2020-09-22,mozambique,Africa,32885526,202,7114
2020-09-23,mozambique,Africa,32885526,148,7262
2020-09-24,mozambique,Africa,32885526,137,7399
2020-09-25,mozambique,Africa,32885526,190,7589
2020-09-26,mozambique,Africa,32885526,168,7757
2020-09-27,mozambique,Africa,32885526,226,7983
2020-09-28,mozambique,Africa,32885526,305,8288
2020-09-29,mozambique,Africa,32885526,268,8556
2020-09-30,mozambique,Africa,32885526,172,8728
2020-10-01,mozambique,Africa,32885526,160,8888
2020-10-02,mozambique,Africa,32885526,91,8979
2020-10-03,mozambique,Africa,32885526,70,9049
2020-10-04,mozambique,Africa,32885526,147,9196
2020-10-05,mozambique,Africa,32885526,100,9296
2020-10-06,mozambique,Africa,32885526,102,9398
2020-10-07,mozambique,Africa,32885526,96,9494
2020-10-08,mozambique,Africa,32885526,145,9639
2020-10-09,mozambique,Africa,32885526,103,9742
2020-10-10,mozambique,Africa,32885526,102,9844
2020-10-11,mozambique,Africa,32885526,157,10001
2020-10-12,mozambique,Africa,32885526,87,10088
2020-10-13,mozambique,Africa,32885526,170,10258
2020-10-14,mozambique,Africa,32885526,134,10392
2020-10-15,mozambique,Africa,32885526,145,10537
2020-10-16,mozambique,Africa,32885526,75,10612
2020-10-17,mozambique,Africa,32885526,95,10707
2020-10-18,mozambique,Africa,32885526,159,10866
2020-10-19,mozambique,Africa,32885526,214,11080
2020-10-20,mozambique,Africa,32885526,110,11190
2020-10-21,mozambique,Africa,32885526,141,11331
2020-10-22,mozambique,Africa,32885526,228,11559
2020-10-23,mozambique,Africa,32885526,189,11748
2020-10-24,mozambique,Africa,32885526,147,11895
2020-10-25,mozambique,Africa,32885526,91,11986
2020-10-26,mozambique,Africa,32885526,175,12161
2020-10-27,mozambique,Africa,32885526,112,12273
2020-10-28,mozambique,Africa,32885526,142,12415
2020-10-29,mozambique,Africa,32885526,110,12525
2020-10-30,mozambique,Africa,32885526,252,12777
2020-10-31,mozambique,Africa,32885526,92,12869
2020-11-01,mozambique,Africa,32885526,119,12988
2020-11-02,mozambique,Africa,32885526,142,13130
2020-11-03,mozambique,Africa,32885526,72,13202
2020-11-04,mozambique,Africa,32885526,81,13283
2020-11-05,mozambique,Africa,32885526,108,13391
2020-11-06,mozambique,Africa,32885526,94,13485
2020-11-07,mozambique,Africa,32885526,92,13577
2020-11-08,mozambique,Africa,32885526,191,13768
2020-11-09,mozambique,Africa,32885526,55,13823
2020-11-10,mozambique,Africa,32885526,69,13892
2020-11-11,mozambique,Africa,32885526,99,13991
2020-11-12,mozambique,Africa,32885526,103,14094
2020-11-13,mozambique,Africa,32885526,133,14227
2020-11-14,mozambique,Africa,32885526,113,14340
2020-11-15,mozambique,Africa,32885526,108,14448
2020-11-16,mozambique,Africa,32885526,66,14514
2020-11-17,mozambique,Africa,32885526,52,14566
2020-11-18,mozambique,Africa,32885526,63,14629
2020-11-19,mozambique,Africa,32885526,94,14723
2020-11-20,mozambique,Africa,32885526,154,14877
2020-11-21,mozambique,Africa,32885526,104,14981
2020-11-22,mozambique,Africa,32885526,56,15037
2020-11-23,mozambique,Africa,32885526,72,15109
2020-11-24,mozambique,Africa,32885526,122,15231
2020-11-25,mozambique,Africa,32885526,71,15302
2020-11-26,mozambique,Africa,32885526,165,15467
2020-11-27,mozambique,Africa,32885526,39,15506
2020-11-28,mozambique,Africa,32885526,80,15586
2020-11-29,mozambique,Africa,32885526,27,15613
2020-11-30,mozambique,Africa,32885526,88,15701
2020-12-01,mozambique,Africa,32885526,69,15770
2020-12-02,mozambique,Africa,32885526,96,15866
2020-12-03,mozambique,Africa,32885526,52,15918
2020-12-04,mozambique,Africa,32885526,120,16038
2020-12-05,mozambique,Africa,32885526,95,16133
2020-12-06,mozambique,Africa,32885526,111,16244
2020-12-07,mozambique,Africa,32885526,82,16326
2020-12-08,mozambique,Africa,32885526,47,16373
2020-12-09,mozambique,Africa,32885526,67,16440
2020-12-10,mozambique,Africa,32885526,81,16521
2020-12-11,mozambique,Africa,32885526,159,16680
2020-12-12,mozambique,Africa,32885526,132,16812
2020-12-13,mozambique,Africa,32885526,142,16954
2020-12-14,mozambique,Africa,32885526,48,17002
2020-12-15,mozambique,Africa,32885526,40,17042
2020-12-16,mozambique,Africa,32885526,101,17143
2020-12-17,mozambique,Africa,32885526,113,17256
2020-12-18,mozambique,Africa,32885526,82,17338
2020-12-19,mozambique,Africa,32885526,139,17477
2020-12-20,mozambique,Africa,32885526,91,17568
2020-12-21,mozambique,Africa,32885526,127,17695
2020-12-22,mozambique,Africa,32885526,72,17767
2020-12-23,mozambique,Africa,32885526,0,17767
2020-12-24,mozambique,Africa,32885526,264,18031
2020-12-25,mozambique,Africa,32885526,77,18108
2020-12-26,mozambique,Africa,32885526,54,18162
2020-12-27,mozambique,Africa,32885526,103,18265
2020-12-28,mozambique,Africa,32885526,45,18310
2020-12-29,mozambique,Africa,32885526,62,18372
2020-12-30,mozambique,Africa,32885526,113,18485
2020-12-31,mozambique,Africa,32885526,157,18642
2021-01-01,mozambique,Africa,32885526,152,18794
2021-01-02,mozambique,Africa,32885526,174,18968
2021-01-03,mozambique,Africa,32885526,341,19309
2021-01-04,mozambique,Africa,32885526,154,19463
2021-01-05,mozambique,Africa,32885526,79,19542
2021-01-06,mozambique,Africa,32885526,125,19667
2021-01-07,mozambique,Africa,32885526,294,19961
2021-01-08,mozambique,Africa,32885526,521,20482
2021-01-09,mozambique,Africa,32885526,879,21361
2021-01-10,mozambique,Africa,32885526,578,21939
2021-01-11,mozambique,Africa,32885526,395,22334
2021-01-12,mozambique,Africa,32885526,662,22996
2021-01-13,mozambique,Africa,32885526,730,23726
2021-01-14,mozambique,Africa,32885526,543,24269
2021-01-15,mozambique,Africa,32885526,735,25004
2021-01-16,mozambique,Africa,32885526,858,25862
2021-01-17,mozambique,Africa,32885526,689,26551
2021-01-18,mozambique,Africa,32885526,895,27446
2021-01-19,mozambique,Africa,32885526,824,28270
2021-01-20,mozambique,Africa,32885526,1126,29396
2021-01-21,mozambique,Africa,32885526,829,30225
2021-01-22,mozambique,Africa,32885526,623,30848
2021-01-23,mozambique,Africa,32885526,780,31628
2021-01-24,mozambique,Africa,32885526,790,32418
2021-01-25,mozambique,Africa,32885526,363,32781
2021-01-26,mozambique,Africa,32885526,1274,34055
2021-01-27,mozambique,Africa,32885526,871,34926
2021-01-28,mozambique,Africa,32885526,907,35833
2021-01-29,mozambique,Africa,32885526,1275,37108
2021-01-30,mozambique,Africa,32885526,597,37705
2021-01-31,mozambique,Africa,32885526,949,38654
2021-02-01,mozambique,Africa,32885526,806,39460
2021-02-02,mozambique,Africa,32885526,800,40260
2021-02-03,mozambique,Africa,32885526,1173,41433
2021-02-04,mozambique,Africa,32885526,1055,42488
2021-02-05,mozambique,Africa,32885526,696,43184
2021-02-06,mozambique,Africa,32885526,928,44112
2021-02-07,mozambique,Africa,32885526,488,44600
2021-02-08,mozambique,Africa,32885526,312,44912
2021-02-09,mozambique,Africa,32885526,873,45785
2021-02-10,mozambique,Africa,32885526,951,46736
2021-02-11,mozambique,Africa,32885526,1054,47790
2021-02-12,mozambique,Africa,32885526,798,48588
2021-02-13,mozambique,Africa,32885526,547,49135
2021-02-14,mozambique,Africa,32885526,1130,50265
2021-02-15,mozambique,Africa,32885526,426,50691
2021-02-16,mozambique,Africa,32885526,1109,51800
2021-02-17,mozambique,Africa,32885526,829,52629
2021-02-18,mozambique,Africa,32885526,898,53527
2021-02-19,mozambique,Africa,32885526,677,54204
2021-02-20,mozambique,Africa,32885526,764,54968
2021-02-21,mozambique,Africa,32885526,675,55643
2021-02-22,mozambique,Africa,32885526,517,56160
2021-02-23,mozambique,Africa,32885526,435,56595
2021-02-24,mozambique,Africa,32885526,325,56920
2021-02-25,mozambique,Africa,32885526,677,57597
2021-02-26,mozambique,Africa,32885526,621,58218
2021-02-27,mozambique,Africa,32885526,554,58772
2021-02-28,mozambique,Africa,32885526,578,59350
2021-03-01,mozambique,Africa,32885526,257,59607
2021-03-02,mozambique,Africa,32885526,307,59914
2021-03-03,mozambique,Africa,32885526,481,60395
2021-03-04,mozambique,Africa,32885526,775,61170
2021-03-05,mozambique,Africa,32885526,359,61529
2021-03-06,mozambique,Africa,32885526,602,62131
2021-03-07,mozambique,Africa,32885526,389,62520
2021-03-08,mozambique,Africa,32885526,183,62703
2021-03-09,mozambique,Africa,32885526,179,62882
2021-03-10,mozambique,Africa,32885526,292,63174
2021-03-11,mozambique,Africa,32885526,471,63645
2021-03-12,mozambique,Africa,32885526,359,64004
2021-03-13,mozambique,Africa,32885526,292,64296
2021-03-14,mozambique,Africa,32885526,220,64516
2021-03-15,mozambique,Africa,32885526,0,64516
2021-03-16,mozambique,Africa,32885526,413,64929
2021-03-17,mozambique,Africa,32885526,268,65197
2021-03-18,mozambique,Africa,32885526,255,65452
2021-03-19,mozambique,Africa,32885526,347,65799
2021-03-20,mozambique,Africa,32885526,265,66064
2021-03-21,mozambique,Africa,32885526,148,66212
2021-03-22,mozambique,Africa,32885526,94,66306
2021-03-23,mozambique,Africa,32885526,190,66496
2021-03-24,mozambique,Africa,32885526,153,66649
2021-03-25,mozambique,Africa,32885526,113,66762
2021-03-26,mozambique,Africa,32885526,117,66879
2021-03-27,mozambique,Africa,32885526,132,67011
2021-03-28,mozambique,Africa,32885526,186,67197
2021-03-29,mozambique,Africa,32885526,95,67292
2021-03-30,mozambique,Africa,32885526,0,67292
2021-03-31,mozambique,Africa,32885526,287,67579
2021-04-01,mozambique,Africa,32885526,150,67729
2021-04-02,mozambique,Africa,32885526,194,67923
2021-04-03,mozambique,Africa,32885526,82,68005
2021-04-04,mozambique,Africa,32885526,114,68119
2021-04-05,mozambique,Africa,32885526,108,68227
2021-04-06,mozambique,Africa,32885526,65,68292
2021-04-07,mozambique,Africa,32885526,139,68431
2021-04-08,mozambique,Africa,32885526,35,68466
2021-04-09,mozambique,Africa,32885526,40,68506
2021-04-10,mozambique,Africa,32885526,72,68578
2021-04-11,mozambique,Africa,32885526,180,68758
2021-04-12,mozambique,Africa,32885526,34,68792
2021-04-13,mozambique,Africa,32885526,79,68871
2021-04-14,mozambique,Africa,32885526,56,68927
2021-04-15,mozambique,Africa,32885526,75,69002
2021-04-16,mozambique,Africa,32885526,65,69067
2021-04-17,mozambique,Africa,32885526,67,69134
2021-04-18,mozambique,Africa,32885526,69,69203
2021-04-19,mozambique,Africa,32885526,25,69228
2021-04-20,mozambique,Africa,32885526,81,69309
2021-04-21,mozambique,Africa,32885526,128,69437
2021-04-22,mozambique,Africa,32885526,86,69523
2021-04-23,mozambique,Africa,32885526,74,69597
2021-04-24,mozambique,Africa,32885526,46,69643
2021-04-25,mozambique,Africa,32885526,22,69665
2021-04-26,mozambique,Africa,32885526,50,69715
2021-04-27,mozambique,Africa,32885526,47,69762
2021-04-28,mozambique,Africa,32885526,42,69804
2021-04-29,mozambique,Africa,32885526,60,69864
2021-04-30,mozambique,Africa,32885526,53,69917
2021-05-01,mozambique,Africa,32885526,48,69965
2021-05-02,mozambique,Africa,32885526,19,69984
2021-05-03,mozambique,Africa,32885526,16,70000
2021-05-04,mozambique,Africa,32885526,31,70031
2021-05-05,mozambique,Africa,32885526,21,70052
2021-05-06,mozambique,Africa,32885526,56,70108
2021-05-07,mozambique,Africa,32885526,30,70138
2021-05-08,mozambique,Africa,32885526,28,70166
2021-05-09,mozambique,Africa,32885526,46,70212
2021-05-10,mozambique,Africa,32885526,26,70238
2021-05-11,mozambique,Africa,32885526,29,70267
2021-05-12,mozambique,Africa,32885526,20,70287
2021-05-13,mozambique,Africa,32885526,28,70315
2021-05-14,mozambique,Africa,32885526,46,70361
2021-05-15,mozambique,Africa,32885526,49,70410
2021-05-16,mozambique,Africa,32885526,32,70442
2021-05-17,mozambique,Africa,32885526,21,70463
2021-05-18,mozambique,Africa,32885526,22,70485
2021-05-19,mozambique,Africa,32885526,24,70509
2021-05-20,mozambique,Africa,32885526,18,70527
2021-05-21,mozambique,Africa,32885526,24,70551
2021-05-22,mozambique,Africa,32885526,17,70568
2021-05-23,mozambique,Africa,32885526,22,70590
2021-05-24,mozambique,Africa,32885526,16,70606
2021-05-25,mozambique,Africa,32885526,30,70636
2021-05-26,mozambique,Africa,32885526,15,70651
2021-05-27,mozambique,Africa,32885526,22,70673
2021-05-28,mozambique,Africa,32885526,24,70697
2021-05-29,mozambique,Africa,32885526,27,70724
2021-05-30,mozambique,Africa,32885526,56,70780
2021-05-31,mozambique,Africa,32885526,15,70795
2021-06-01,mozambique,Africa,32885526,55,70850
2021-06-02,mozambique,Africa,32885526,73,70923
2021-06-03,mozambique,Africa,32885526,42,70965
2021-06-04,mozambique,Africa,32885526,54,71019
2021-06-05,mozambique,Africa,32885526,63,71082
2021-06-06,mozambique,Africa,32885526,32,71114
2021-06-07,mozambique,Africa,32885526,31,71145
2021-06-08,mozambique,Africa,32885526,20,71165
2021-06-09,mozambique,Africa,32885526,74,71239
2021-06-10,mozambique,Africa,32885526,40,71279
2021-06-11,mozambique,Africa,32885526,76,71355
2021-06-12,mozambique,Africa,32885526,106,71461
2021-06-13,mozambique,Africa,32885526,77,71538
2021-06-14,mozambique,Africa,32885526,30,71568
2021-06-15,mozambique,Africa,32885526,83,71651
2021-06-16,mozambique,Africa,32885526,113,71764
2021-06-17,mozambique,Africa,32885526,165,71929
2021-06-18,mozambique,Africa,32885526,194,72123
2021-06-19,mozambique,Africa,32885526,244,72367
2021-06-20,mozambique,Africa,32885526,140,72507
2021-06-21,mozambique,Africa,32885526,70,72577
2021-06-22,mozambique,Africa,32885526,198,72775
2021-06-23,mozambique,Africa,32885526,436,73211
2021-06-24,mozambique,Africa,32885526,441,73652
2021-06-25,mozambique,Africa,32885526,534,74186
2021-06-26,mozambique,Africa,32885526,518,74704
2021-06-27,mozambique,Africa,32885526,434,75138
2021-06-28,mozambique,Africa,32885526,284,75422
2021-06-29,mozambique,Africa,32885526,406,75828
2021-06-30,mozambique,Africa,32885526,576,76404
2021-07-01,mozambique,Africa,32885526,801,77205
2021-07-02,mozambique,Africa,32885526,869,78074
2021-07-03,mozambique,Africa,32885526,1139,79213
2021-07-04,mozambique,Africa,32885526,938,80151
2021-07-05,mozambique,Africa,32885526,737,80888
2021-07-06,mozambique,Africa,32885526,1458,82346
2021-07-07,mozambique,Africa,32885526,770,83116
2021-07-08,mozambique,Africa,32885526,1806,84922
2021-07-09,mozambique,Africa,32885526,1327,86249
2021-07-10,mozambique,Africa,32885526,1686,87935
2021-07-11,mozambique,Africa,32885526,933,88868
2021-07-12,mozambique,Africa,32885526,1687,90555
2021-07-13,mozambique,Africa,32885526,1331,91886
2021-07-14,mozambique,Africa,32885526,1543,93429
2021-07-15,mozambique,Africa,32885526,1304,94733
2021-07-16,mozambique,Africa,32885526,1394,96127
2021-07-17,mozambique,Africa,32885526,2025,98152
2021-07-18,mozambique,Africa,32885526,1260,99412
2021-07-19,mozambique,Africa,32885526,1373,100785
2021-07-20,mozambique,Africa,32885526,1224,102009
2021-07-21,mozambique,Africa,32885526,1704,103713
2021-07-22,mozambique,Africa,32885526,2153,105866
2021-07-23,mozambique,Africa,32885526,1443,107309
2021-07-24,mozambique,Africa,32885526,1451,108760
2021-07-25,mozambique,Africa,32885526,1528,110288
2021-07-26,mozambique,Africa,32885526,1435,111723
2021-07-27,mozambique,Africa,32885526,1703,113426
2021-07-28,mozambique,Africa,32885526,2460,115886
2021-07-29,mozambique,Africa,32885526,1774,117660
2021-07-30,mozambique,Africa,32885526,2290,119950
2021-07-31,mozambique,Africa,32885526,2078,122028
2021-08-01,mozambique,Africa,32885526,1513,123541
2021-08-02,mozambique,Africa,32885526,1421,124962
2021-08-03,mozambique,Africa,32885526,1429,126391
2021-08-04,mozambique,Africa,32885526,1034,127425
2021-08-05,mozambique,Africa,32885526,1611,129036
2021-08-06,mozambique,Africa,32885526,1490,130526
2021-08-07,mozambique,Africa,32885526,1273,131799
2021-08-08,mozambique,Africa,32885526,653,132452
2021-08-09,mozambique,Africa,32885526,725,133177
2021-08-10,mozambique,Africa,32885526,1166,134343
2021-08-11,mozambique,Africa,32885526,1185,135528
2021-08-12,mozambique,Africa,32885526,1038,136566
2021-08-13,mozambique,Africa,32885526,847,137413
2021-08-14,mozambique,Africa,32885526,931,138344
2021-08-15,mozambique,Africa,32885526,405,138749
2021-08-16,mozambique,Africa,32885526,289,139038
2021-08-17,mozambique,Africa,32885526,1033,140071
2021-08-18,mozambique,Africa,32885526,694,140765
2021-08-19,mozambique,Africa,32885526,618,141383
2021-08-20,mozambique,Africa,32885526,630,142013
2021-08-21,mozambique,Africa,32885526,510,142523
2021-08-22,mozambique,Africa,32885526,261,142784
2021-08-23,mozambique,Africa,32885526,343,143127
2021-08-24,mozambique,Africa,32885526,528,143655
2021-08-25,mozambique,Africa,32885526,377,144032
2021-08-26,mozambique,Africa,32885526,436,144468
2021-08-27,mozambique,Africa,32885526,731,145199
2021-08-28,mozambique,Africa,32885526,525,145724
2021-08-29,mozambique,Africa,32885526,139,145863
2021-08-30,mozambique,Africa,32885526,190,146053
2021-08-31,mozambique,Africa,32885526,263,146316
2021-09-01,mozambique,Africa,32885526,438,146754
2021-09-02,mozambique,Africa,32885526,312,147066
2021-09-03,mozambique,Africa,32885526,365,147431
2021-09-04,mozambique,Africa,32885526,354,147785
2021-09-05,mozambique,Africa,32885526,138,147923
2021-09-06,mozambique,Africa,32885526,131,148054
2021-09-07,mozambique,Africa,32885526,390,148444
2021-09-08,mozambique,Africa,32885526,108,148552
2021-09-09,mozambique,Africa,32885526,175,148727
2021-09-10,mozambique,Africa,32885526,174,148901
2021-09-11,mozambique,Africa,32885526,187,149088
2021-09-12,mozambique,Africa,32885526,119,149207
2021-09-13,mozambique,Africa,32885526,52,149259
2021-09-14,mozambique,Africa,32885526,221,149480
2021-09-15,mozambique,Africa,32885526,191,149671
2021-09-16,mozambique,Africa,32885526,133,149804
2021-09-17,mozambique,Africa,32885526,102,149906
2021-09-18,mozambique,Africa,32885526,75,149981
2021-09-19,mozambique,Africa,32885526,37,150018
2021-09-20,mozambique,Africa,32885526,49,150067
2021-09-21,mozambique,Africa,32885526,134,150201
2021-09-22,mozambique,Africa,32885526,79,150280
2021-09-23,mozambique,Africa,32885526,90,150370
2021-09-24,mozambique,Africa,32885526,69,150439
2021-09-25,mozambique,Africa,32885526,55,150494
2021-09-26,mozambique,Africa,32885526,36,150530
2021-09-27,mozambique,Africa,32885526,10,150540
2021-09-28,mozambique,Africa,32885526,32,150572
2021-09-29,mozambique,Africa,32885526,90,150662
2021-09-30,mozambique,Africa,32885526,61,150723
2021-10-01,mozambique,Africa,32885526,36,150759
2021-10-02,mozambique,Africa,32885526,31,150790
2021-10-03,mozambique,Africa,32885526,14,150804
2021-10-04,mozambique,Africa,32885526,3,150807
2021-10-05,mozambique,Africa,32885526,19,150826
2021-10-06,mozambique,Africa,32885526,48,150874
2021-10-07,mozambique,Africa,32885526,25,150899
2021-10-08,mozambique,Africa,32885526,36,150935
2021-10-09,mozambique,Africa,32885526,28,150963
2021-10-10,mozambique,Africa,32885526,22,150985
2021-10-11,mozambique,Africa,32885526,6,150991
2021-10-12,mozambique,Africa,32885526,27,151018
2021-10-13,mozambique,Africa,32885526,28,151046
2021-10-14,mozambique,Africa,32885526,15,151061
2021-10-15,mozambique,Africa,32885526,19,151080
2021-10-16,mozambique,Africa,32885526,17,151097
2021-10-17,mozambique,Africa,32885526,5,151102
2021-10-18,mozambique,Africa,32885526,10,151112
2021-10-19,mozambique,Africa,32885526,24,151136
2021-10-20,mozambique,Africa,32885526,21,151157
2021-10-21,mozambique,Africa,32885526,17,151174
2021-10-22,mozambique,Africa,32885526,21,151195
2021-10-23,mozambique,Africa,32885526,25,151220
2021-10-24,mozambique,Africa,32885526,5,151225
2021-10-25,mozambique,Africa,32885526,1,151226
2021-10-26,mozambique,Africa,32885526,17,151243
2021-10-27,mozambique,Africa,32885526,10,151253
2021-10-28,mozambique,Africa,32885526,7,151260
2021-10-29,mozambique,Africa,32885526,10,151270
2021-10-30,mozambique,Africa,32885526,18,151288
2021-10-31,mozambique,Africa,32885526,4,151292
2021-11-01,mozambique,Africa,32885526,10,151302
2021-11-02,mozambique,Africa,32885526,14,151316
2021-11-03,mozambique,Africa,32885526,9,151325
2021-11-04,mozambique,Africa,32885526,14,151339
2021-11-05,mozambique,Africa,32885526,13,151352
2021-11-06,mozambique,Africa,32885526,15,151367
2021-11-07,mozambique,Africa,32885526,1,151368
2021-11-08,mozambique,Africa,32885526,3,151371
2021-11-09,mozambique,Africa,32885526,11,151382
2021-11-10,mozambique,Africa,32885526,8,151390
2021-11-11,mozambique,Africa,32885526,20,151410
2021-11-12,mozambique,Africa,32885526,4,151414
2021-11-13,mozambique,Africa,32885526,8,151422
2021-11-14,mozambique,Africa,32885526,5,151427
2021-11-15,mozambique,Africa,32885526,5,151432
2021-11-16,mozambique,Africa,32885526,25,151457
2021-11-17,mozambique,Africa,32885526,9,151466
2021-11-18,mozambique,Africa,32885526,6,151472
2021-11-19,mozambique,Africa,32885526,5,151477
2021-11-20,mozambique,Africa,32885526,11,151488
2021-11-21,mozambique,Africa,32885526,0,151488
2021-11-22,mozambique,Africa,32885526,4,151492
2021-11-23,mozambique,Africa,32885526,3,151495
2021-11-24,mozambique,Africa,32885526,8,151503
2021-11-25,mozambique,Africa,32885526,9,151512
2021-11-26,mozambique,Africa,32885526,3,151515
2021-11-27,mozambique,Africa,32885526,0,151515
2021-11-28,mozambique,Africa,32885526,9,151524
2021-11-29,mozambique,Africa,32885526,4,151528
2021-11-30,mozambique,Africa,32885526,20,151548
2021-12-01,mozambique,Africa,32885526,46,151594
2021-12-02,mozambique,Africa,32885526,58,151652
2021-12-03,mozambique,Africa,32885526,111,151763
2021-12-04,mozambique,Africa,32885526,105,151868
2021-12-05,mozambique,Africa,32885526,56,151924
2021-12-06,mozambique,Africa,32885526,76,152000
2021-12-07,mozambique,Africa,32885526,120,152120
2021-12-08,mozambique,Africa,32885526,206,152326
2021-12-09,mozambique,Africa,32885526,260,152586
2021-12-10,mozambique,Africa,32885526,379,152965
2021-12-11,mozambique,Africa,32885526,443,153408
2021-12-12,mozambique,Africa,32885526,266,153674
2021-12-13,mozambique,Africa,32885526,113,153787
2021-12-14,mozambique,Africa,32885526,733,154520
2021-12-15,mozambique,Africa,32885526,975,155495
2021-12-16,mozambique,Africa,32885526,1234,156729
2021-12-17,mozambique,Africa,32885526,1382,158111
2021-12-18,mozambique,Africa,32885526,1252,159363
2021-12-19,mozambique,Africa,32885526,541,159904
2021-12-20,mozambique,Africa,32885526,553,160457
2021-12-21,mozambique,Africa,32885526,2068,162525
2021-12-22,mozambique,Africa,32885526,2337,164862
2021-12-23,mozambique,Africa,32885526,2445,167307
2021-12-24,mozambique,Africa,32885526,2770,170077
2021-12-25,mozambique,Africa,32885526,898,170975
2021-12-26,mozambique,Africa,32885526,527,171502
2021-12-27,mozambique,Africa,32885526,673,172175
2021-12-28,mozambique,Africa,32885526,3473,175648
2021-12-29,mozambique,Africa,32885526,3624,179272
2021-12-30,mozambique,Africa,32885526,4947,184219
2021-12-31,mozambique,Africa,32885526,4861,189080
2022-01-01,mozambique,Africa,32885526,2642,191722
2022-01-02,mozambique,Africa,32885526,731,192453
2022-01-03,mozambique,Africa,32885526,918,193371
2022-01-04,mozambique,Africa,32885526,2975,196346
2022-01-05,mozambique,Africa,32885526,3594,199940
2022-01-06,mozambique,Africa,32885526,3301,203241
2022-01-07,mozambique,Africa,32885526,3031,206272
2022-01-08,mozambique,Africa,32885526,3117,209389
2022-01-09,mozambique,Africa,32885526,1010,210399
2022-01-10,mozambique,Africa,32885526,592,210991
2022-01-11,mozambique,Africa,32885526,1868,212859
2022-01-12,mozambique,Africa,32885526,1948,214807
2022-01-13,mozambique,Africa,32885526,1752,216559
2022-01-14,mozambique,Africa,32885526,1262,217821
2022-01-15,mozambique,Africa,32885526,976,218797
2022-01-16,mozambique,Africa,32885526,284,219081
2022-01-17,mozambique,Africa,32885526,309,219390
2022-01-18,mozambique,Africa,32885526,851,220241
2022-01-19,mozambique,Africa,32885526,667,220908
2022-01-20,mozambique,Africa,32885526,524,221432
2022-01-21,mozambique,Africa,32885526,543,221975
2022-01-22,mozambique,Africa,32885526,440,222415
2022-01-23,mozambique,Africa,32885526,181,222596
2022-01-24,mozambique,Africa,32885526,56,222652
2022-01-25,mozambique,Africa,32885526,240,222892
2022-01-26,mozambique,Africa,32885526,220,223112
2022-01-27,mozambique,Africa,32885526,301,223413
2022-01-28,mozambique,Africa,32885526,199,223612
2022-01-29,mozambique,Africa,32885526,126,223738
2022-01-30,mozambique,Africa,32885526,73,223811
2022-01-31,mozambique,Africa,32885526,16,223827
2022-02-01,mozambique,Africa,32885526,122,223949
2022-02-02,mozambique,Africa,32885526,94,224043
2022-02-03,mozambique,Africa,32885526,100,224143
2020-07-11,namibia,Africa,2626590,45,713
2020-07-12,namibia,Africa,2626590,72,785
2020-07-13,namibia,Africa,2626590,76,861
2020-07-14,namibia,Africa,2626590,3,864
2020-07-15,namibia,Africa,2626590,96,960
2020-07-16,namibia,Africa,2626590,72,1032
2020-07-17,namibia,Africa,2626590,46,1078
2020-07-18,namibia,Africa,2626590,125,1203
2020-07-19,namibia,Africa,2626590,44,1247
2020-07-20,namibia,Africa,2626590,97,1344
2020-07-21,namibia,Africa,2626590,22,1366
2020-07-22,namibia,Africa,2626590,36,1402
2020-07-23,namibia,Africa,2626590,120,1522
2020-07-24,namibia,Africa,2626590,96,1618
2020-07-25,namibia,Africa,2626590,69,1687
2020-07-26,namibia,Africa,2626590,88,1775
2020-07-27,namibia,Africa,2626590,68,1843
2020-07-28,namibia,Africa,2626590,74,1917
2020-07-29,namibia,Africa,2626590,69,1986
2020-07-30,namibia,Africa,2626590,66,2052
2020-07-31,namibia,Africa,2626590,77,2129
2020-08-01,namibia,Africa,2626590,95,2224
2020-08-02,namibia,Africa,2626590,70,2294
2020-08-03,namibia,Africa,2626590,112,2406
2020-08-04,namibia,Africa,2626590,64,2470
2020-08-05,namibia,Africa,2626590,70,2540
2020-08-06,namibia,Africa,2626590,112,2652
2020-08-07,namibia,Africa,2626590,150,2802
2020-08-08,namibia,Africa,2626590,0,2802
2020-08-09,namibia,Africa,2626590,147,2949
2020-08-10,namibia,Africa,2626590,152,3101
2020-08-11,namibia,Africa,2626590,128,3229
2020-08-12,namibia,Africa,2626590,177,3406
2020-08-13,namibia,Africa,2626590,138,3544
2020-08-14,namibia,Africa,2626590,182,3726
2020-08-15,namibia,Africa,2626590,181,3907
2020-08-16,namibia,Africa,2626590,247,4154
2020-08-17,namibia,Africa,2626590,190,4344
2020-08-18,namibia,Africa,2626590,120,4464
2020-08-19,namibia,Africa,2626590,201,4665
2020-08-20,namibia,Africa,2626590,247,4912
2020-08-21,namibia,Africa,2626590,315,5227
2020-08-22,namibia,Africa,2626590,311,5538
2020-08-23,namibia,Africa,2626590,316,5854
2020-08-24,namibia,Africa,2626590,176,6030
2020-08-25,namibia,Africa,2626590,130,6160
2020-08-26,namibia,Africa,2626590,271,6431
2020-08-27,namibia,Africa,2626590,281,6712
2020-08-28,namibia,Africa,2626590,194,6906
2020-08-29,namibia,Africa,2626590,210,7116
2020-08-30,namibia,Africa,2626590,249,7365
2020-08-31,namibia,Africa,2626590,185,7550
2020-09-01,namibia,Africa,2626590,142,7692
2020-09-02,namibia,Africa,2626590,152,7844
2020-09-03,namibia,Africa,2626590,238,8082
2020-09-04,namibia,Africa,2626590,241,8323
2020-09-05,namibia,Africa,2626590,191,8514
2020-09-06,namibia,Africa,2626590,171,8685
2020-09-07,namibia,Africa,2626590,125,8810
2020-09-08,namibia,Africa,2626590,118,8928
2020-09-09,namibia,Africa,2626590,180,9108
2020-09-10,namibia,Africa,2626590,148,9256
2020-09-11,namibia,Africa,2626590,181,9437
2020-09-12,namibia,Africa,2626590,167,9604
2020-09-13,namibia,Africa,2626590,115,9719
2020-09-14,namibia,Africa,2626590,99,9818
2020-09-15,namibia,Africa,2626590,83,9901
2020-09-16,namibia,Africa,2626590,63,9964
2020-09-17,namibia,Africa,2626590,114,10078
2020-09-18,namibia,Africa,2626590,129,10207
2020-09-19,namibia,Africa,2626590,85,10292
2020-09-20,namibia,Africa,2626590,85,10377
2020-09-21,namibia,Africa,2626590,149,10526
2020-09-22,namibia,Africa,2626590,81,10607
2020-09-23,namibia,Africa,2626590,56,10663
2020-09-24,namibia,Africa,2626590,77,10740
2020-09-25,namibia,Africa,2626590,95,10835
2020-09-26,namibia,Africa,2626590,83,10918
2020-09-27,namibia,Africa,2626590,115,11033
2020-09-28,namibia,Africa,2626590,88,11121
2020-09-29,namibia,Africa,2626590,19,11140
2020-09-30,namibia,Africa,2626590,125,11265
2020-10-01,namibia,Africa,2626590,108,11373
2020-10-02,namibia,Africa,2626590,107,11480
2020-10-03,namibia,Africa,2626590,92,11572
2020-10-04,namibia,Africa,2626590,54,11626
2020-10-05,namibia,Africa,2626590,28,11654
2020-10-06,namibia,Africa,2626590,19,11673
2020-10-07,namibia,Africa,2626590,41,11714
2020-10-08,namibia,Africa,2626590,67,11781
2020-10-09,namibia,Africa,2626590,48,11829
2020-10-10,namibia,Africa,2626590,62,11891
2020-10-11,namibia,Africa,2626590,45,11936
2020-10-12,namibia,Africa,2626590,53,11989
2020-10-13,namibia,Africa,2626590,11,12000
2020-10-14,namibia,Africa,2626590,69,12069
2020-10-15,namibia,Africa,2626590,34,12103
2020-10-16,namibia,Africa,2626590,112,12215
2020-10-17,namibia,Africa,2626590,48,12263
2020-10-18,namibia,Africa,2626590,30,12293
2020-10-19,namibia,Africa,2626590,33,12326
2020-10-20,namibia,Africa,2626590,41,12367
2020-10-21,namibia,Africa,2626590,39,12406
2020-10-22,namibia,Africa,2626590,54,12460
2020-10-23,namibia,Africa,2626590,41,12501
2020-10-24,namibia,Africa,2626590,78,12579
2020-10-25,namibia,Africa,2626590,81,12660
2020-10-26,namibia,Africa,2626590,15,12675
2020-10-27,namibia,Africa,2626590,54,12729
2020-10-28,namibia,Africa,2626590,77,12806
2020-10-29,namibia,Africa,2626590,52,12858
2020-10-30,namibia,Africa,2626590,49,12907
2020-10-31,namibia,Africa,2626590,28,12935
2020-11-01,namibia,Africa,2626590,53,12988
2020-11-02,namibia,Africa,2626590,24,13012
2020-11-03,namibia,Africa,2626590,18,13030
2020-11-04,namibia,Africa,2626590,16,13046
2020-11-05,namibia,Africa,2626590,44,13090
2020-11-06,namibia,Africa,2626590,53,13143
2020-11-07,namibia,Africa,2626590,27,13170
2020-11-08,namibia,Africa,2626590,41,13211
2020-11-09,namibia,Africa,2626590,29,13240
2020-11-10,namibia,Africa,2626590,13,13253
2020-11-11,namibia,Africa,2626590,39,13292
2020-11-12,namibia,Africa,2626590,53,13345
2020-11-13,namibia,Africa,2626590,27,13372
2020-02-20,nepal,Asia,30112649,0,1
2020-02-21,nepal,Asia,30112649,0,1
2020-02-22,nepal,Asia,30112649,0,1
2020-02-23,nepal,Asia,30112649,0,1
2020-02-24,nepal,Asia,30112649,0,1
2020-02-25,nepal,Asia,30112649,0,1
2020-02-26,nepal,Asia,30112649,0,1
2020-02-27,nepal,Asia,30112649,0,1
2020-02-28,nepal,Asia,30112649,0,1
2020-02-29,nepal,Asia,30112649,0,1
2020-03-01,nepal,Asia,30112649,0,1
2020-03-02,nepal,Asia,30112649,0,1
2020-03-03,nepal,Asia,30112649,0,1
2020-03-04,nepal,Asia,30112649,0,1
2020-03-05,nepal,Asia,30112649,0,1
2020-03-06,nepal,Asia,30112649,0,1
2020-03-07,nepal,Asia,30112649,0,1
2020-03-08,nepal,Asia,30112649,0,1
2020-03-09,nepal,Asia,30112649,0,1
2020-03-10,nepal,Asia,30112649,0,1
2020-03-11,nepal,Asia,30112649,0,1
2020-03-12,nepal,Asia,30112649,0,1
2020-03-13,nepal,Asia,30112649,0,1
2020-03-14,nepal,Asia,30112649,0,1
2020-03-15,nepal,Asia,30112649,0,1
2020-03-16,nepal,Asia,30112649,0,1
2020-03-17,nepal,Asia,30112649,0,1
2020-03-18,nepal,Asia,30112649,0,1
2020-03-19,nepal,Asia,30112649,0,1
2020-03-20,nepal,Asia,30112649,0,1
2020-03-21,nepal,Asia,30112649,0,1
2020-03-22,nepal,Asia,30112649,0,1
2020-03-23,nepal,Asia,30112649,1,2
2020-03-24,nepal,Asia,30112649,0,2
2020-03-25,nepal,Asia,30112649,1,3
2020-03-26,nepal,Asia,30112649,0,3
2020-03-27,nepal,Asia,30112649,1,4
2020-03-28,nepal,Asia,30112649,1,5
2020-03-29,nepal,Asia,30112649,0,5
2020-03-30,nepal,Asia,30112649,0,5
2020-03-31,nepal,Asia,30112649,0,5
2020-04-01,nepal,Asia,30112649,0,5
2020-04-02,nepal,Asia,30112649,1,6
2020-04-03,nepal,Asia,30112649,0,6
2020-04-04,nepal,Asia,30112649,3,9
2020-04-05,nepal,Asia,30112649,0,9
2020-04-06,nepal,Asia,30112649,0,9
2020-04-07,nepal,Asia,30112649,0,9
2020-04-08,nepal,Asia,30112649,0,9
2020-04-09,nepal,Asia,30112649,0,9
2020-04-10,nepal,Asia,30112649,0,9
2020-04-11,nepal,Asia,30112649,0,9
2020-04-12,nepal,Asia,30112649,3,12
2020-04-13,nepal,Asia,30112649,2,14
2020-04-14,nepal,Asia,30112649,2,16
2020-04-15,nepal,Asia,30112649,0,16
2020-04-16,nepal,Asia,30112649,0,16
2020-04-17,nepal,Asia,30112649,14,30
2020-04-18,nepal,Asia,30112649,1,31
2020-04-19,nepal,Asia,30112649,0,31
2020-04-20,nepal,Asia,30112649,0,31
2020-04-21,nepal,Asia,30112649,11,42
2020-04-22,nepal,Asia,30112649,3,45
2020-04-23,nepal,Asia,30112649,3,48
2020-04-24,nepal,Asia,30112649,1,49
2020-04-25,nepal,Asia,30112649,0,49
2020-04-26,nepal,Asia,30112649,3,52
2020-04-27,nepal,Asia,30112649,0,52
2020-04-28,nepal,Asia,30112649,2,54
2020-04-29,nepal,Asia,30112649,3,57
2020-04-30,nepal,Asia,30112649,0,57
2020-05-01,nepal,Asia,30112649,2,59
2020-05-02,nepal,Asia,30112649,0,59
2020-05-03,nepal,Asia,30112649,16,75
2020-05-04,nepal,Asia,30112649,0,75
2020-05-05,nepal,Asia,30112649,7,82
2020-05-06,nepal,Asia,30112649,17,99
2020-05-07,nepal,Asia,30112649,2,101
2020-05-08,nepal,Asia,30112649,1,102
2020-05-09,nepal,Asia,30112649,7,109
2020-05-10,nepal,Asia,30112649,1,110
2020-05-11,nepal,Asia,30112649,24,134
2020-05-12,nepal,Asia,30112649,83,217
2020-05-13,nepal,Asia,30112649,26,243
2020-05-14,nepal,Asia,30112649,6,249
2020-05-15,nepal,Asia,30112649,18,267
2020-05-16,nepal,Asia,30112649,14,281
2020-05-17,nepal,Asia,30112649,14,295
2020-05-18,nepal,Asia,30112649,80,375
2020-05-19,nepal,Asia,30112649,27,402
2020-05-20,nepal,Asia,30112649,25,427
2020-05-21,nepal,Asia,30112649,30,457
2020-05-22,nepal,Asia,30112649,59,516
2020-05-23,nepal,Asia,30112649,68,584
2020-05-24,nepal,Asia,30112649,19,603
2020-05-25,nepal,Asia,30112649,79,682
2020-05-26,nepal,Asia,30112649,90,772
2020-05-27,nepal,Asia,30112649,114,886
2020-05-28,nepal,Asia,30112649,156,1042
2020-05-29,nepal,Asia,30112649,170,1212
2020-05-30,nepal,Asia,30112649,189,1401
2020-05-31,nepal,Asia,30112649,171,1572
2020-06-01,nepal,Asia,30112649,239,1811
2020-06-02,nepal,Asia,30112649,288,2099
2020-06-03,nepal,Asia,30112649,201,2300
2020-06-04,nepal,Asia,30112649,334,2634
2020-06-05,nepal,Asia,30112649,278,2912
2020-06-06,nepal,Asia,30112649,323,3235
2020-06-07,nepal,Asia,30112649,213,3448
2020-06-08,nepal,Asia,30112649,314,3762
2020-06-09,nepal,Asia,30112649,324,4086
2020-06-10,nepal,Asia,30112649,278,4364
2020-06-11,nepal,Asia,30112649,250,4614
2020-06-12,nepal,Asia,30112649,448,5062
2020-06-13,nepal,Asia,30112649,273,5335
2020-06-14,nepal,Asia,30112649,425,5760
2020-06-15,nepal,Asia,30112649,451,6211
2020-06-16,nepal,Asia,30112649,380,6591
2020-06-17,nepal,Asia,30112649,586,7177
2020-06-18,nepal,Asia,30112649,671,7848
2020-06-19,nepal,Asia,30112649,426,8274
2020-06-20,nepal,Asia,30112649,331,8605
2020-06-21,nepal,Asia,30112649,421,9026
2020-06-22,nepal,Asia,30112649,535,9561
2020-06-23,nepal,Asia,30112649,538,10099
2020-06-24,nepal,Asia,30112649,629,10728
2020-06-25,nepal,Asia,30112649,434,11162
2020-06-26,nepal,Asia,30112649,593,11755
2020-06-27,nepal,Asia,30112649,554,12309
2020-06-28,nepal,Asia,30112649,463,12772
2020-06-29,nepal,Asia,30112649,476,13248
2020-06-30,nepal,Asia,30112649,316,13564
2020-07-01,nepal,Asia,30112649,482,14046
2020-07-02,nepal,Asia,30112649,473,14519
2020-07-03,nepal,Asia,30112649,740,15259
2020-07-04,nepal,Asia,30112649,232,15491
2020-07-05,nepal,Asia,30112649,293,15784
2020-07-06,nepal,Asia,30112649,180,15964
2020-07-07,nepal,Asia,30112649,204,16168
2020-07-08,nepal,Asia,30112649,255,16423
2020-07-09,nepal,Asia,30112649,108,16531
2020-07-10,nepal,Asia,30112649,118,16649
2020-07-11,nepal,Asia,30112649,70,16719
2020-07-12,nepal,Asia,30112649,82,16801
2020-07-13,nepal,Asia,30112649,144,16945
2020-07-14,nepal,Asia,30112649,116,17061
2020-07-15,nepal,Asia,30112649,116,17177
2020-07-16,nepal,Asia,30112649,167,17344
2020-07-17,nepal,Asia,30112649,101,17445
2020-07-18,nepal,Asia,30112649,57,17502
2020-07-19,nepal,Asia,30112649,156,17658
2020-07-20,nepal,Asia,30112649,186,17844
2020-07-21,nepal,Asia,30112649,150,17994
2020-07-22,nepal,Asia,30112649,100,18094
2020-07-23,nepal,Asia,30112649,147,18241
2020-07-24,nepal,Asia,30112649,133,18374
2020-07-25,nepal,Asia,30112649,109,18483
2020-07-26,nepal,Asia,30112649,130,18613
2020-07-27,nepal,Asia,30112649,139,18752
2020-07-28,nepal,Asia,30112649,311,19063
2020-07-29,nepal,Asia,30112649,210,19273
2020-07-30,nepal,Asia,30112649,274,19547
2020-07-31,nepal,Asia,30112649,224,19771
2020-08-01,nepal,Asia,30112649,315,20086
2020-08-02,nepal,Asia,30112649,246,20332
2020-08-03,nepal,Asia,30112649,418,20750
2020-08-04,nepal,Asia,30112649,259,21009
2020-08-05,nepal,Asia,30112649,381,21390
2020-08-06,nepal,Asia,30112649,360,21750
2020-08-07,nepal,Asia,30112649,464,22214
2020-08-08,nepal,Asia,30112649,378,22592
2020-08-09,nepal,Asia,30112649,380,22972
2020-08-10,nepal,Asia,30112649,338,23310
2020-08-11,nepal,Asia,30112649,638,23948
2020-08-12,nepal,Asia,30112649,484,24432
2020-08-13,nepal,Asia,30112649,525,24957
2020-08-14,nepal,Asia,30112649,594,25551
2020-08-15,nepal,Asia,30112649,468,26019
2020-08-16,nepal,Asia,30112649,641,26660
2020-08-17,nepal,Asia,30112649,581,27241
2020-08-18,nepal,Asia,30112649,1016,28257
2020-08-19,nepal,Asia,30112649,681,28938
2020-08-20,nepal,Asia,30112649,707,29645
2020-08-21,nepal,Asia,30112649,838,30483
2020-08-22,nepal,Asia,30112649,634,31117
2020-08-23,nepal,Asia,30112649,818,31935
2020-08-24,nepal,Asia,30112649,743,32678
2020-08-25,nepal,Asia,30112649,855,33533
2020-08-26,nepal,Asia,30112649,885,34418
2020-08-27,nepal,Asia,30112649,1111,35529
2020-08-28,nepal,Asia,30112649,927,36456
2020-08-29,nepal,Asia,30112649,884,37340
2020-08-30,nepal,Asia,30112649,1221,38561
2020-08-31,nepal,Asia,30112649,899,39460
2020-09-01,nepal,Asia,30112649,1069,40529
2020-09-02,nepal,Asia,30112649,1120,41649
2020-09-03,nepal,Asia,30112649,1228,42877
2020-09-04,nepal,Asia,30112649,1359,44236
2020-09-05,nepal,Asia,30112649,1041,45277
2020-09-06,nepal,Asia,30112649,980,46257
2020-09-07,nepal,Asia,30112649,979,47236
2020-09-08,nepal,Asia,30112649,902,48138
2020-09-09,nepal,Asia,30112649,1081,49219
2020-09-10,nepal,Asia,30112649,1246,50465
2020-09-11,nepal,Asia,30112649,1453,51918
2020-09-12,nepal,Asia,30112649,1202,53120
2020-09-13,nepal,Asia,30112649,1039,54159
2020-09-14,nepal,Asia,30112649,1170,55329
2020-09-15,nepal,Asia,30112649,1459,56788
2020-09-16,nepal,Asia,30112649,1539,58327
2020-09-17,nepal,Asia,30112649,1246,59573
2020-09-18,nepal,Asia,30112649,2020,61593
2020-09-19,nepal,Asia,30112649,1204,62797
2020-09-20,nepal,Asia,30112649,1325,64122
2020-09-21,nepal,Asia,30112649,1154,65276
2020-09-22,nepal,Asia,30112649,1356,66632
2020-09-23,nepal,Asia,30112649,1172,67804
2020-09-24,nepal,Asia,30112649,1497,69301
2020-09-25,nepal,Asia,30112649,1313,70614
2020-09-26,nepal,Asia,30112649,1207,71821
2020-09-27,nepal,Asia,30112649,1573,73394
2020-09-28,nepal,Asia,30112649,1351,74745
2020-09-29,nepal,Asia,30112649,1513,76258
2020-09-30,nepal,Asia,30112649,1559,77817
2020-10-01,nepal,Asia,30112649,1911,79728
2020-10-02,nepal,Asia,30112649,2722,82450
2020-10-03,nepal,Asia,30112649,2120,84570
2020-10-04,nepal,Asia,30112649,2253,86823
2020-10-05,nepal,Asia,30112649,2440,89263
2020-10-06,nepal,Asia,30112649,1551,90814
2020-10-07,nepal,Asia,30112649,3439,94253
2020-10-08,nepal,Asia,30112649,4364,98617
2020-10-09,nepal,Asia,30112649,2059,100676
2020-10-10,nepal,Asia,30112649,5008,105684
2020-10-11,nepal,Asia,30112649,2071,107755
2020-10-12,nepal,Asia,30112649,4047,111802
2020-10-13,nepal,Asia,30112649,3556,115358
2020-10-14,nepal,Asia,30112649,2638,117996
2020-10-15,nepal,Asia,30112649,3749,121745
2020-10-16,nepal,Asia,30112649,4392,126137
2020-10-17,nepal,Asia,30112649,3167,129304
2020-10-18,nepal,Asia,30112649,2942,132246
2020-10-19,nepal,Asia,30112649,3790,136036
2020-10-20,nepal,Asia,30112649,3093,139129
2020-10-21,nepal,Asia,30112649,5743,144872
2020-10-22,nepal,Asia,30112649,3637,148509
2020-10-23,nepal,Asia,30112649,4499,153008
2020-10-24,nepal,Asia,30112649,2225,155233
2020-10-25,nepal,Asia,30112649,2856,158089
2020-10-26,nepal,Asia,30112649,1741,159830
2020-10-27,nepal,Asia,30112649,570,160400
2020-10-28,nepal,Asia,30112649,1954,162354
2020-10-29,nepal,Asia,30112649,2364,164718
2020-10-30,nepal,Asia,30112649,3517,168235
2020-10-31,nepal,Asia,30112649,2508,170743
2020-11-01,nepal,Asia,30112649,2824,173567
2020-11-02,nepal,Asia,30112649,2933,176500
2020-11-03,nepal,Asia,30112649,3114,179614
2020-11-04,nepal,Asia,30112649,3309,182923
2020-11-05,nepal,Asia,30112649,3051,185974
2020-11-06,nepal,Asia,30112649,2909,188883
2020-11-07,nepal,Asia,30112649,2753,191636
2020-11-08,nepal,Asia,30112649,2817,194453
2020-11-09,nepal,Asia,30112649,2571,197024
2020-11-10,nepal,Asia,30112649,2736,199760
2020-11-11,nepal,Asia,30112649,2569,202329
2020-11-12,nepal,Asia,30112649,1913,204242
2020-11-13,nepal,Asia,30112649,2111,206353
2020-11-14,nepal,Asia,30112649,1946,208299
2020-11-15,nepal,Asia,30112649,1477,209776
2020-11-16,nepal,Asia,30112649,1197,210973
2020-11-17,nepal,Asia,30112649,502,211475
2020-11-18,nepal,Asia,30112649,1442,212917
2020-11-19,nepal,Asia,30112649,2103,215020
2020-11-20,nepal,Asia,30112649,1945,216965
2020-11-21,nepal,Asia,30112649,1674,218639
2020-11-22,nepal,Asia,30112649,1669,220308
2020-11-23,nepal,Asia,30112649,1980,222288
2020-11-24,nepal,Asia,30112649,1790,224078
2020-11-25,nepal,Asia,30112649,1948,226026
2020-11-26,nepal,Asia,30112649,1614,227640
2020-11-27,nepal,Asia,30112649,1703,229343
2020-11-28,nepal,Asia,30112649,1380,230723
2020-11-29,nepal,Asia,30112649,1255,231978
2020-11-30,nepal,Asia,30112649,1474,233452
2020-12-01,nepal,Asia,30112649,1304,234756
2020-12-02,nepal,Asia,30112649,1490,236246
2020-12-03,nepal,Asia,30112649,1343,237589
2020-12-04,nepal,Asia,30112649,1272,238861
2020-12-05,nepal,Asia,30112649,1024,239885
2020-12-06,nepal,Asia,30112649,1096,240981
2020-12-07,nepal,Asia,30112649,1014,241995
2020-12-08,nepal,Asia,30112649,1382,243377
2020-12-09,nepal,Asia,30112649,1056,244433
2020-12-10,nepal,Asia,30112649,1217,245650
2020-12-11,nepal,Asia,30112649,1044,246694
2020-12-12,nepal,Asia,30112649,899,247593
2020-12-13,nepal,Asia,30112649,830,248423
2020-12-14,nepal,Asia,30112649,821,249244
2020-12-15,nepal,Asia,30112649,936,250180
2020-12-16,nepal,Asia,30112649,736,250916
2020-12-17,nepal,Asia,30112649,776,251692
2020-12-18,nepal,Asia,30112649,782,252474
2020-12-19,nepal,Asia,30112649,710,253184
2020-12-20,nepal,Asia,30112649,588,253772
2020-12-21,nepal,Asia,30112649,742,254514
2020-12-22,nepal,Asia,30112649,722,255236
2020-12-23,nepal,Asia,30112649,743,255979
2020-12-24,nepal,Asia,30112649,613,256592
2020-12-25,nepal,Asia,30112649,608,257200
2020-12-26,nepal,Asia,30112649,500,257700
2020-12-27,nepal,Asia,30112649,481,258181
2020-12-28,nepal,Asia,30112649,659,258840
2020-12-29,nepal,Asia,30112649,708,259548
2020-12-30,nepal,Asia,30112649,511,260059
2020-12-31,nepal,Asia,30112649,534,260593
2021-01-01,nepal,Asia,30112649,426,261019
2021-01-02,nepal,Asia,30112649,419,261438
2021-01-03,nepal,Asia,30112649,421,261859
2021-01-04,nepal,Asia,30112649,403,262262
2021-01-05,nepal,Asia,30112649,522,262784
2021-01-06,nepal,Asia,30112649,409,263193
2021-01-07,nepal,Asia,30112649,412,263605
2021-01-08,nepal,Asia,30112649,554,264159
2021-01-09,nepal,Asia,30112649,362,264521
2021-01-10,nepal,Asia,30112649,259,264780
2021-01-11,nepal,Asia,30112649,488,265268
2021-01-12,nepal,Asia,30112649,430,265698
2021-01-13,nepal,Asia,30112649,445,266143
2021-01-14,nepal,Asia,30112649,403,266546
2021-01-15,nepal,Asia,30112649,270,266816
2021-01-16,nepal,Asia,30112649,240,267056
2021-01-17,nepal,Asia,30112649,266,267322
2021-01-18,nepal,Asia,30112649,322,267644
2021-01-19,nepal,Asia,30112649,348,267992
2021-01-20,nepal,Asia,30112649,318,268310
2021-01-21,nepal,Asia,30112649,336,268646
2021-01-22,nepal,Asia,30112649,302,268948
2021-01-23,nepal,Asia,30112649,232,269180
2021-01-24,nepal,Asia,30112649,270,269450
2021-01-25,nepal,Asia,30112649,339,269789
2021-01-26,nepal,Asia,30112649,303,270092
2021-01-27,nepal,Asia,30112649,283,270375
2021-01-28,nepal,Asia,30112649,213,270588
2021-01-29,nepal,Asia,30112649,157,270745
2021-01-30,nepal,Asia,30112649,109,270854
2021-01-31,nepal,Asia,30112649,105,270959
2021-02-01,nepal,Asia,30112649,159,271118
2021-02-02,nepal,Asia,30112649,171,271289
2021-02-03,nepal,Asia,30112649,142,271431
2021-02-04,nepal,Asia,30112649,171,271602
2021-02-05,nepal,Asia,30112649,105,271707
2021-02-06,nepal,Asia,30112649,99,271806
2021-02-07,nepal,Asia,30112649,119,271925
2021-02-08,nepal,Asia,30112649,130,272055
2021-02-09,nepal,Asia,30112649,160,272215
2021-02-10,nepal,Asia,30112649,134,272349
2021-02-11,nepal,Asia,30112649,81,272430
2021-02-12,nepal,Asia,30112649,127,272557
2021-02-13,nepal,Asia,30112649,57,272614
2021-02-14,nepal,Asia,30112649,104,272718
2021-02-15,nepal,Asia,30112649,122,272840
2021-02-16,nepal,Asia,30112649,105,272945
2021-02-17,nepal,Asia,30112649,125,273070
2021-02-18,nepal,Asia,30112649,96,273166
2021-02-19,nepal,Asia,30112649,97,273263
2021-02-20,nepal,Asia,30112649,88,273351
2021-02-21,nepal,Asia,30112649,80,273431
2021-02-22,nepal,Asia,30112649,125,273556
2021-02-23,nepal,Asia,30112649,110,273666
2021-02-24,nepal,Asia,30112649,94,273760
2021-02-25,nepal,Asia,30112649,112,273872
2021-02-26,nepal,Asia,30112649,112,273984
2021-02-27,nepal,Asia,30112649,81,274065
2021-02-28,nepal,Asia,30112649,78,274143
2021-03-01,nepal,Asia,30112649,73,274216
2021-03-02,nepal,Asia,30112649,78,274294
2021-03-03,nepal,Asia,30112649,87,274381
2021-03-04,nepal,Asia,30112649,107,274488
2021-03-05,nepal,Asia,30112649,120,274608
2021-03-06,nepal,Asia,30112649,47,274655
2021-03-07,nepal,Asia,30112649,66,274721
2021-03-08,nepal,Asia,30112649,89,274810
2021-03-09,nepal,Asia,30112649,59,274869
2021-03-10,nepal,Asia,30112649,104,274973
2021-03-11,nepal,Asia,30112649,97,275070
2021-03-12,nepal,Asia,30112649,48,275118
2021-03-13,nepal,Asia,30112649,60,275178
2021-03-14,nepal,Asia,30112649,53,275231
2021-03-15,nepal,Asia,30112649,79,275310
2021-03-16,nepal,Asia,30112649,114,275424
2021-03-17,nepal,Asia,30112649,94,275518
2021-03-18,nepal,Asia,30112649,107,275625
2021-03-19,nepal,Asia,30112649,125,275750
2021-03-20,nepal,Asia,30112649,79,275829
2021-03-21,nepal,Asia,30112649,77,275906
2021-03-22,nepal,Asia,30112649,150,276056
2021-03-23,nepal,Asia,30112649,188,276244
2021-03-24,nepal,Asia,30112649,145,276389
2021-03-25,nepal,Asia,30112649,120,276509
2021-03-26,nepal,Asia,30112649,156,276665
2021-03-27,nepal,Asia,30112649,85,276750
2021-03-28,nepal,Asia,30112649,89,276839
2021-03-29,nepal,Asia,30112649,141,276980
2021-03-30,nepal,Asia,30112649,167,277147
2021-03-31,nepal,Asia,30112649,162,277309
2021-04-01,nepal,Asia,30112649,152,277461
2021-04-02,nepal,Asia,30112649,179,277640
2021-04-03,nepal,Asia,30112649,128,277768
2021-04-04,nepal,Asia,30112649,176,277944
2021-04-05,nepal,Asia,30112649,266,278210
2021-04-06,nepal,Asia,30112649,260,278470
2021-04-07,nepal,Asia,30112649,298,278768
2021-04-08,nepal,Asia,30112649,332,279100
2021-04-09,nepal,Asia,30112649,288,279388
2021-04-10,nepal,Asia,30112649,337,279725
2021-04-11,nepal,Asia,30112649,303,280028
2021-04-12,nepal,Asia,30112649,496,280524
2021-04-13,nepal,Asia,30112649,460,280984
2021-04-14,nepal,Asia,30112649,580,281564
2021-04-15,nepal,Asia,30112649,490,282054
2021-04-16,nepal,Asia,30112649,836,282890
2021-04-17,nepal,Asia,30112649,768,283658
2021-04-18,nepal,Asia,30112649,1015,284673
2021-04-19,nepal,Asia,30112649,1227,285900
2021-04-20,nepal,Asia,30112649,1667,287567
2021-04-21,nepal,Asia,30112649,2220,289787
2021-04-22,nepal,Asia,30112649,2365,292152
2021-04-23,nepal,Asia,30112649,2449,294601
2021-04-24,nepal,Asia,30112649,2486,297087
2021-04-25,nepal,Asia,30112649,3032,300119
2021-04-26,nepal,Asia,30112649,3442,303561
2021-04-27,nepal,Asia,30112649,4364,307925
2021-04-28,nepal,Asia,30112649,4774,312699
2021-04-29,nepal,Asia,30112649,4831,317530
2021-04-30,nepal,Asia,30112649,5657,323187
2021-05-01,nepal,Asia,30112649,5706,328893
2021-05-02,nepal,Asia,30112649,7137,336030
2021-05-03,nepal,Asia,30112649,7388,343418
2021-05-04,nepal,Asia,30112649,7587,351005
2021-05-05,nepal,Asia,30112649,8605,359610
2021-05-06,nepal,Asia,30112649,8970,368580
2021-05-07,nepal,Asia,30112649,9023,377603
2021-05-08,nepal,Asia,30112649,8287,385890
2021-05-09,nepal,Asia,30112649,8777,394667
2021-05-10,nepal,Asia,30112649,9127,403794
2021-05-11,nepal,Asia,30112649,9317,413111
2021-05-12,nepal,Asia,30112649,9238,422349
2021-05-13,nepal,Asia,30112649,8842,431191
2021-05-14,nepal,Asia,30112649,8467,439658
2021-05-15,nepal,Asia,30112649,8046,447704
2021-05-16,nepal,Asia,30112649,7316,455020
2021-05-17,nepal,Asia,30112649,9198,464218
2020-02-28,netherlands,Europe,17205480,1,2
2020-02-29,netherlands,Europe,17205480,5,7
2020-03-01,netherlands,Europe,17205480,3,10
2020-03-02,netherlands,Europe,17205480,8,18
2020-03-03,netherlands,Europe,17205480,5,23
2020-03-04,netherlands,Europe,17205480,15,38
2020-03-05,netherlands,Europe,17205480,44,82
2020-03-06,netherlands,Europe,17205480,46,128
2020-03-07,netherlands,Europe,17205480,60,188
2020-03-08,netherlands,Europe,17205480,77,265
2020-03-09,netherlands,Europe,17205480,56,321
2020-03-10,netherlands,Europe,17205480,61,382
2020-03-11,netherlands,Europe,17205480,121,503
2020-03-12,netherlands,Europe,17205480,111,614
2020-03-13,netherlands,Europe,17205480,190,804
2020-03-14,netherlands,Europe,17205480,155,959
2020-03-15,netherlands,Europe,17205480,176,1135
2020-03-16,netherlands,Europe,17205480,278,1413
2020-03-17,netherlands,Europe,17205480,292,1705
2020-03-18,netherlands,Europe,17205480,346,2051
2020-03-19,netherlands,Europe,17205480,409,2460
2020-03-20,netherlands,Europe,17205480,534,2994
2020-03-21,netherlands,Europe,17205480,637,3631
2020-03-22,netherlands,Europe,17205480,573,4204
2020-03-23,netherlands,Europe,17205480,545,4749
2020-03-24,netherlands,Europe,17205480,811,5560
2020-03-25,netherlands,Europe,17205480,852,6412
2020-03-26,netherlands,Europe,17205480,1019,7431
2020-03-27,netherlands,Europe,17205480,1172,8603
2020-03-28,netherlands,Europe,17205480,1159,9762
2020-03-29,netherlands,Europe,17205480,1104,10866
2020-03-30,netherlands,Europe,17205480,884,11750
2020-03-31,netherlands,Europe,17205480,845,12595
2020-04-01,netherlands,Europe,17205480,1019,13614
2020-04-02,netherlands,Europe,17205480,1083,14697
2020-04-03,netherlands,Europe,17205480,1026,15723
2020-04-04,netherlands,Europe,17205480,904,16627
2020-04-05,netherlands,Europe,17205480,1224,17851
2020-04-06,netherlands,Europe,17205480,952,18803
2020-04-07,netherlands,Europe,17205480,777,19580
2020-04-08,netherlands,Europe,17205480,969,20549
2020-04-09,netherlands,Europe,17205480,1213,21762
2020-04-10,netherlands,Europe,17205480,1335,23097
2020-04-11,netherlands,Europe,17205480,1316,24413
2020-04-12,netherlands,Europe,17205480,1174,25587
2020-04-13,netherlands,Europe,17205480,964,26551
2020-04-14,netherlands,Europe,17205480,868,27419
2020-04-15,netherlands,Europe,17205480,734,28153
2020-04-16,netherlands,Europe,17205480,1061,29214
2020-04-17,netherlands,Europe,17205480,1235,30449
2020-04-18,netherlands,Europe,17205480,1140,31589
2020-04-19,netherlands,Europe,17205480,1066,32655
2020-04-20,netherlands,Europe,17205480,750,33405
2020-04-21,netherlands,Europe,17205480,729,34134
2020-04-22,netherlands,Europe,17205480,708,34842
2020-04-23,netherlands,Europe,17205480,887,35729
2020-04-24,netherlands,Europe,17205480,806,36535
2020-04-25,netherlands,Europe,17205480,655,37190
2020-04-26,netherlands,Europe,17205480,655,37845
2020-04-27,netherlands,Europe,17205480,400,38245
2020-04-28,netherlands,Europe,17205480,171,38416
2020-04-29,netherlands,Europe,17205480,386,38802
2020-04-30,netherlands,Europe,17205480,514,39316
2020-05-01,netherlands,Europe,17205480,475,39791
2020-05-02,netherlands,Europe,17205480,445,40236
2020-05-03,netherlands,Europe,17205480,335,40571
2020-05-04,netherlands,Europe,17205480,199,40770
2020-05-05,netherlands,Europe,17205480,317,41087
2020-05-06,netherlands,Europe,17205480,232,41319
2020-05-07,netherlands,Europe,17205480,455,41774
2020-05-08,netherlands,Europe,17205480,319,42093
2020-05-09,netherlands,Europe,17205480,289,42382
2020-05-10,netherlands,Europe,17205480,245,42627
2020-05-11,netherlands,Europe,17205480,161,42788
2020-05-12,netherlands,Europe,17205480,196,42984
2020-05-13,netherlands,Europe,17205480,227,43211
2020-05-14,netherlands,Europe,17205480,270,43481
2020-05-15,netherlands,Europe,17205480,200,43681
2020-05-16,netherlands,Europe,17205480,189,43870
2020-05-17,netherlands,Europe,17205480,125,43995
2020-05-18,netherlands,Europe,17205480,146,44141
2020-05-19,netherlands,Europe,17205480,108,44249
2020-05-20,netherlands,Europe,17205480,198,44447
2020-05-21,netherlands,Europe,17205480,253,44700
2020-05-22,netherlands,Europe,17205480,188,44888
2020-05-23,netherlands,Europe,17205480,176,45064
2020-05-24,netherlands,Europe,17205480,172,45236
2020-05-25,netherlands,Europe,17205480,209,45445
2020-05-26,netherlands,Europe,17205480,133,45578
2020-05-27,netherlands,Europe,17205480,190,45768
2020-05-28,netherlands,Europe,17205480,182,45950
2020-05-29,netherlands,Europe,17205480,176,46126
2020-05-30,netherlands,Europe,17205480,131,46257
2020-05-31,netherlands,Europe,17205480,185,46442
2020-06-01,netherlands,Europe,17205480,103,46545
2020-06-02,netherlands,Europe,17205480,102,46647
2020-06-03,netherlands,Europe,17205480,86,46733
2020-06-04,netherlands,Europe,17205480,209,46942
2020-06-05,netherlands,Europe,17205480,210,47152
2020-06-06,netherlands,Europe,17205480,183,47335
2020-06-07,netherlands,Europe,17205480,239,47574
2020-06-08,netherlands,Europe,17205480,165,47739
2020-06-09,netherlands,Europe,17205480,164,47903
2020-06-10,netherlands,Europe,17205480,184,48087
2020-06-11,netherlands,Europe,17205480,164,48251
2020-06-12,netherlands,Europe,17205480,210,48461
2020-06-13,netherlands,Europe,17205480,179,48640
2020-06-14,netherlands,Europe,17205480,143,48783
2020-06-15,netherlands,Europe,17205480,165,48948
2020-06-16,netherlands,Europe,17205480,139,49087
2020-06-17,netherlands,Europe,17205480,117,49204
2020-06-18,netherlands,Europe,17205480,115,49319
2020-06-19,netherlands,Europe,17205480,107,49426
2020-06-20,netherlands,Europe,17205480,76,49502
2020-06-21,netherlands,Europe,17205480,91,49593
2020-06-22,netherlands,Europe,17205480,65,49658
2020-06-23,netherlands,Europe,17205480,64,49722
2020-06-24,netherlands,Europe,17205480,82,49804
2020-06-25,netherlands,Europe,17205480,110,49914
2020-06-26,netherlands,Europe,17205480,91,50005
2020-06-27,netherlands,Europe,17205480,69,50074
2020-06-28,netherlands,Europe,17205480,73,50147
2020-06-29,netherlands,Europe,17205480,76,50223
2020-06-30,netherlands,Europe,17205480,50,50273
2020-07-01,netherlands,Europe,17205480,62,50335
2020-07-02,netherlands,Europe,17205480,77,50412
2020-07-03,netherlands,Europe,17205480,75,50487
2020-07-04,netherlands,Europe,17205480,61,50548
2020-07-05,netherlands,Europe,17205480,73,50621
2020-07-06,netherlands,Europe,17205480,36,50657
2020-07-07,netherlands,Europe,17205480,37,50694
2020-07-08,netherlands,Europe,17205480,52,50746
2020-07-09,netherlands,Europe,17205480,52,50798
2020-07-10,netherlands,Europe,17205480,42,50840
2020-07-11,netherlands,Europe,17205480,81,50921
2020-07-12,netherlands,Europe,17205480,101,51022
2020-07-13,netherlands,Europe,17205480,71,51093
2020-07-14,netherlands,Europe,17205480,53,51146
2020-07-15,netherlands,Europe,17205480,106,51252
2020-07-16,netherlands,Europe,17205480,99,51351
2020-07-17,netherlands,Europe,17205480,103,51454
2020-07-18,netherlands,Europe,17205480,127,51581
2020-07-19,netherlands,Europe,17205480,144,51725
2020-07-20,netherlands,Europe,17205480,185,51910
2020-07-21,netherlands,Europe,17205480,163,52073
2020-07-22,netherlands,Europe,17205480,168,52241
2020-07-23,netherlands,Europe,17205480,163,52404
2020-07-24,netherlands,Europe,17205480,191,52595
2020-07-25,netherlands,Europe,17205480,137,52732
2020-07-26,netherlands,Europe,17205480,214,52946
2020-07-27,netherlands,Europe,17205480,205,53151
2020-07-28,netherlands,Europe,17205480,223,53374
2020-07-29,netherlands,Europe,17205480,247,53621
2020-07-30,netherlands,Europe,17205480,342,53963
2020-07-31,netherlands,Europe,17205480,338,54301
2020-08-01,netherlands,Europe,17205480,431,54732
2020-08-02,netherlands,Europe,17205480,366,55098
2020-08-03,netherlands,Europe,17205480,372,55470
2020-08-04,netherlands,Europe,17205480,485,55955
2020-08-05,netherlands,Europe,17205480,426,56381
2020-08-06,netherlands,Europe,17205480,601,56982
2020-08-07,netherlands,Europe,17205480,519,57501
2020-08-08,netherlands,Europe,17205480,486,57987
2020-08-09,netherlands,Europe,17205480,577,58564
2020-08-10,netherlands,Europe,17205480,630,59194
2020-08-11,netherlands,Europe,17205480,779,59973
2020-08-12,netherlands,Europe,17205480,654,60627
2020-08-13,netherlands,Europe,17205480,577,61204
2020-08-14,netherlands,Europe,17205480,636,61840
2020-08-15,netherlands,Europe,17205480,655,62495
2020-08-16,netherlands,Europe,17205480,507,63002
2020-08-17,netherlands,Europe,17205480,482,63484
2020-08-18,netherlands,Europe,17205480,489,63973
2020-08-19,netherlands,Europe,17205480,552,64525
2020-08-20,netherlands,Europe,17205480,529,65054
2020-08-21,netherlands,Europe,17205480,535,65589
2020-08-22,netherlands,Europe,17205480,508,66097
2020-08-23,netherlands,Europe,17205480,457,66554
2020-08-24,netherlands,Europe,17205480,574,67128
2020-08-25,netherlands,Europe,17205480,415,67543
2020-08-26,netherlands,Europe,17205480,571,68114
2020-08-27,netherlands,Europe,17205480,510,68624
2020-08-28,netherlands,Europe,17205480,507,69131
2020-08-29,netherlands,Europe,17205480,501,69632
2020-08-30,netherlands,Europe,17205480,508,70140
2020-08-31,netherlands,Europe,17205480,527,70667
2020-09-01,netherlands,Europe,17205480,462,71129
2020-09-02,netherlands,Europe,17205480,734,71863
2020-09-03,netherlands,Europe,17205480,601,72464
2020-09-04,netherlands,Europe,17205480,744,73208
2020-09-05,netherlands,Europe,17205480,654,73862
2020-09-06,netherlands,Europe,17205480,925,74787
2020-09-07,netherlands,Europe,17205480,797,75584
2020-09-08,netherlands,Europe,17205480,964,76548
2020-09-09,netherlands,Europe,17205480,1140,77688
2020-09-10,netherlands,Europe,17205480,823,78511
2020-09-11,netherlands,Europe,17205480,1270,79781
2020-09-12,netherlands,Europe,17205480,1231,81012
2020-09-13,netherlands,Europe,17205480,1087,82099
2020-09-14,netherlands,Europe,17205480,1300,83399
2020-09-15,netherlands,Europe,17205480,1379,84778
2020-09-16,netherlands,Europe,17205480,1542,86320
2020-09-17,netherlands,Europe,17205480,1753,88073
2020-09-18,netherlands,Europe,17205480,1974,90047
2020-09-19,netherlands,Europe,17205480,1887,91934
2020-09-20,netherlands,Europe,17205480,1844,93778
2020-09-21,netherlands,Europe,17205480,2217,95995
2020-09-22,netherlands,Europe,17205480,2245,98240
2020-09-23,netherlands,Europe,17205480,2357,100597
2020-09-24,netherlands,Europe,17205480,2544,103141
2020-09-25,netherlands,Europe,17205480,2777,105918
2020-09-26,netherlands,Europe,17205480,2713,108631
2020-09-27,netherlands,Europe,17205480,2995,111626
2020-09-28,netherlands,Europe,17205480,2914,114540
2020-09-29,netherlands,Europe,17205480,3011,117551
2020-09-30,netherlands,Europe,17205480,3294,120845
2020-10-01,netherlands,Europe,17205480,3252,124097
2020-10-02,netherlands,Europe,17205480,3825,127922
2020-10-03,netherlands,Europe,17205480,3967,131889
2020-10-04,netherlands,Europe,17205480,4003,135892
2020-10-05,netherlands,Europe,17205480,4579,140471
2020-10-06,netherlands,Europe,17205480,4528,144999
2020-10-07,netherlands,Europe,17205480,4989,149988
2020-10-08,netherlands,Europe,17205480,5822,155810
2020-10-09,netherlands,Europe,17205480,5971,161781
2020-10-10,netherlands,Europe,17205480,6499,168280
2020-10-11,netherlands,Europe,17205480,6373,174653
2020-10-12,netherlands,Europe,17205480,6845,181498
2020-10-13,netherlands,Europe,17205480,7378,188876
2020-10-14,netherlands,Europe,17205480,7287,196163
2020-10-15,netherlands,Europe,17205480,7791,203954
2020-10-16,netherlands,Europe,17205480,7984,211938
2020-10-17,netherlands,Europe,17205480,8114,220052
2020-10-18,netherlands,Europe,17205480,8182,228234
2020-10-19,netherlands,Europe,17205480,7992,236226
2020-10-20,netherlands,Europe,17205480,8165,244391
2020-10-21,netherlands,Europe,17205480,8743,253134
2020-10-22,netherlands,Europe,17205480,9271,262405
2020-10-23,netherlands,Europe,17205480,9996,272401
2020-10-24,netherlands,Europe,17205480,8651,281052
2020-10-25,netherlands,Europe,17205480,10202,291254
2020-10-26,netherlands,Europe,17205480,10343,301597
2020-10-27,netherlands,Europe,17205480,10292,311889
2020-10-28,netherlands,Europe,17205480,8102,319991
2020-10-29,netherlands,Europe,17205480,10264,330255
2020-10-30,netherlands,Europe,17205480,11119,341374
2020-10-31,netherlands,Europe,17205480,9804,351178
2020-11-01,netherlands,Europe,17205480,8683,359861
2020-11-02,netherlands,Europe,17205480,8286,368147
2020-11-03,netherlands,Europe,17205480,7743,375890
2020-11-04,netherlands,Europe,17205480,7633,383523
2020-11-05,netherlands,Europe,17205480,6965,390488
2020-11-06,netherlands,Europe,17205480,7242,397730
2020-11-07,netherlands,Europe,17205480,6671,404401
2020-11-08,netherlands,Europe,17205480,5664,410065
2020-11-09,netherlands,Europe,17205480,4680,414745
2020-11-10,netherlands,Europe,17205480,4667,419412
2020-11-11,netherlands,Europe,17205480,5407,424819
2020-11-12,netherlands,Europe,17205480,5634,430453
2020-11-13,netherlands,Europe,17205480,6091,436544
2020-11-14,netherlands,Europe,17205480,5914,442458
2020-11-15,netherlands,Europe,17205480,5413,447871
2020-11-16,netherlands,Europe,17205480,4830,452701
2020-11-17,netherlands,Europe,17205480,4302,457003
2020-11-18,netherlands,Europe,17205480,4609,461612
2020-11-19,netherlands,Europe,17205480,5645,467257
2020-11-20,netherlands,Europe,17205480,5933,473190
2020-11-21,netherlands,Europe,17205480,6070,479260
2020-11-22,netherlands,Europe,17205480,5388,484648
2020-11-23,netherlands,Europe,17205480,5170,489818
2020-11-24,netherlands,Europe,17205480,3926,493744
2020-11-25,netherlands,Europe,17205480,4909,498653
2020-11-26,netherlands,Europe,17205480,4470,503123
2020-11-27,netherlands,Europe,17205480,5743,508866
2020-11-28,netherlands,Europe,17205480,4459,513325
2020-11-29,netherlands,Europe,17205480,5585,518910
2020-11-30,netherlands,Europe,17205480,4568,523478
2020-12-01,netherlands,Europe,17205480,4045,527523
2020-12-02,netherlands,Europe,17205480,4921,532444
2020-12-03,netherlands,Europe,17205480,5606,538050
2020-12-04,netherlands,Europe,17205480,5874,543924
2020-12-05,netherlands,Europe,17205480,6521,550445
2020-12-06,netherlands,Europe,17205480,6779,557224
2020-12-07,netherlands,Europe,17205480,7067,564291
2020-12-08,netherlands,Europe,17205480,6146,570437
2020-12-09,netherlands,Europe,17205480,6528,576965
2020-12-10,netherlands,Europe,17205480,8720,585685
2020-12-11,netherlands,Europe,17205480,8838,594523
2020-12-12,netherlands,Europe,17205480,9080,603603
2020-12-13,netherlands,Europe,17205480,9884,613487
2020-12-14,netherlands,Europe,17205480,8457,621944
2020-12-15,netherlands,Europe,17205480,6633,628577
2020-12-16,netherlands,Europe,17205480,11169,639746
2020-12-17,netherlands,Europe,17205480,12779,652525
2020-12-18,netherlands,Europe,17205480,11931,664456
2020-12-19,netherlands,Europe,17205480,12217,676673
2020-12-20,netherlands,Europe,17205480,13032,689705
2020-12-21,netherlands,Europe,17205480,11168,700873
2020-12-22,netherlands,Europe,17205480,9810,710683
2020-12-23,netherlands,Europe,17205480,10388,721071
2020-12-24,netherlands,Europe,17205480,11499,732570
2020-12-25,netherlands,Europe,17205480,11487,744057
2020-12-26,netherlands,Europe,17205480,9848,753905
2020-12-27,netherlands,Europe,17205480,9080,762985
2020-12-28,netherlands,Europe,17205480,7415,770400
2020-12-29,netherlands,Europe,17205480,7502,777902
2020-12-30,netherlands,Europe,17205480,9398,787300
2020-12-31,netherlands,Europe,17205480,9681,796981
2021-01-01,netherlands,Europe,17205480,8183,805164
2021-01-02,netherlands,Europe,17205480,8601,813765
2021-01-03,netherlands,Europe,17205480,7398,821163
2021-01-04,netherlands,Europe,17205480,6563,827726
2021-01-05,netherlands,Europe,17205480,6338,834064
2021-01-06,netherlands,Europe,17205480,7099,841163
2021-01-07,netherlands,Europe,17205480,9627,850790
2021-01-08,netherlands,Europe,17205480,8124,858914
2021-01-09,netherlands,Europe,17205480,7321,866235
2021-01-10,netherlands,Europe,17205480,6612,872847
2021-01-11,netherlands,Europe,17205480,5416,878263
2021-01-12,netherlands,Europe,17205480,4872,883135
2021-01-13,netherlands,Europe,17205480,6086,889221
2021-01-14,netherlands,Europe,17205480,6466,895687
2021-01-15,netherlands,Europe,17205480,6009,901696
2021-01-16,netherlands,Europe,17205480,5260,906956
2021-01-17,netherlands,Europe,17205480,5598,912554
2021-01-18,netherlands,Europe,17205480,4754,917308
2021-01-19,netherlands,Europe,17205480,4272,921580
2021-01-20,netherlands,Europe,17205480,5530,927110
2021-01-21,netherlands,Europe,17205480,5774,932884
2021-01-22,netherlands,Europe,17205480,5744,938628
2021-01-23,netherlands,Europe,17205480,5414,944042
2021-01-24,netherlands,Europe,17205480,4891,948933
2021-01-25,netherlands,Europe,17205480,4017,952950
2021-01-26,netherlands,Europe,17205480,3917,956867
2021-01-27,netherlands,Europe,17205480,4726,961593
2021-01-28,netherlands,Europe,17205480,4659,966252
2021-01-29,netherlands,Europe,17205480,4350,970602
2021-01-30,netherlands,Europe,17205480,4173,974775
2021-01-31,netherlands,Europe,17205480,3700,978475
2021-02-01,netherlands,Europe,17205480,3188,981663
2021-02-02,netherlands,Europe,17205480,3561,985224
2021-02-03,netherlands,Europe,17205480,4013,989237
2021-02-04,netherlands,Europe,17205480,4193,993430
2021-02-05,netherlands,Europe,17205480,4321,997751
2021-02-06,netherlands,Europe,17205480,4075,1001826
2021-02-07,netherlands,Europe,17205480,3934,1005760
2021-02-08,netherlands,Europe,17205480,2221,1007981
2021-02-09,netherlands,Europe,17205480,1744,1009725
2021-02-10,netherlands,Europe,17205480,3183,1012908
2021-02-11,netherlands,Europe,17205480,4394,1017302
2021-02-12,netherlands,Europe,17205480,4341,1021643
2021-02-13,netherlands,Europe,17205480,4194,1025837
2021-02-14,netherlands,Europe,17205480,3447,1029284
2021-02-15,netherlands,Europe,17205480,2810,1032094
2021-02-16,netherlands,Europe,17205480,2701,1034795
2021-02-17,netherlands,Europe,17205480,3361,1038156
2021-02-18,netherlands,Europe,17205480,4518,1042674
2021-02-19,netherlands,Europe,17205480,4726,1047400
2021-02-20,netherlands,Europe,17205480,4565,1051965
2021-02-21,netherlands,Europe,17205480,4674,1056639
2021-02-22,netherlands,Europe,17205480,4162,1060801
2021-02-23,netherlands,Europe,17205480,3797,1064598
2021-02-24,netherlands,Europe,17205480,4362,1068960
2021-02-25,netherlands,Europe,17205480,5011,1073971
2021-02-26,netherlands,Europe,17205480,5113,1079084
2021-02-27,netherlands,Europe,17205480,4937,1084021
2021-02-28,netherlands,Europe,17205480,4669,1088690
2021-03-01,netherlands,Europe,17205480,3762,1092452
2021-03-02,netherlands,Europe,17205480,3981,1096433
2021-03-03,netherlands,Europe,17205480,4997,1101430
2021-03-04,netherlands,Europe,17205480,4114,1105544
2021-03-05,netherlands,Europe,17205480,4669,1110213
2021-03-06,netherlands,Europe,17205480,5336,1115549
2021-03-07,netherlands,Europe,17205480,4526,1120075
2021-03-08,netherlands,Europe,17205480,3834,1123909
2021-03-09,netherlands,Europe,17205480,4293,1128202
2021-03-10,netherlands,Europe,17205480,5272,1133474
2021-03-11,netherlands,Europe,17205480,5322,1138796
2021-03-12,netherlands,Europe,17205480,6026,1144822
2021-03-13,netherlands,Europe,17205480,6396,1151218
2021-03-14,netherlands,Europe,17205480,5974,1157192
2021-03-15,netherlands,Europe,17205480,5469,1162661
2021-03-16,netherlands,Europe,17205480,4902,1167563
2021-03-17,netherlands,Europe,17205480,5924,1173487
2021-03-18,netherlands,Europe,17205480,6125,1179612
2021-03-19,netherlands,Europe,17205480,7375,1186987
2021-03-20,netherlands,Europe,17205480,7593,1194580
2021-03-21,netherlands,Europe,17205480,6965,1201545
2021-03-22,netherlands,Europe,17205480,6261,1207806
2021-03-23,netherlands,Europe,17205480,5560,1213366
2021-03-24,netherlands,Europe,17205480,7579,1220945
2021-03-25,netherlands,Europe,17205480,7702,1228647
2021-03-26,netherlands,Europe,17205480,7562,1236209
2021-03-27,netherlands,Europe,17205480,8798,1245007
2021-03-28,netherlands,Europe,17205480,7430,1252437
2021-03-29,netherlands,Europe,17205480,6718,1259155
2021-03-30,netherlands,Europe,17205480,5828,1264983
2021-03-31,netherlands,Europe,17205480,7633,1272616
2021-04-01,netherlands,Europe,17205480,7827,1280443
2021-04-02,netherlands,Europe,17205480,7253,1287696
2021-04-03,netherlands,Europe,17205480,7628,1295324
2021-04-04,netherlands,Europe,17205480,6822,1302146
2021-04-05,netherlands,Europe,17205480,5320,1307466
2021-04-06,netherlands,Europe,17205480,5541,1313007
2021-04-07,netherlands,Europe,17205480,6346,1319353
2021-04-08,netherlands,Europe,17205480,7783,1327136
2021-04-09,netherlands,Europe,17205480,7635,1334771
2021-04-10,netherlands,Europe,17205480,7676,1342447
2021-04-11,netherlands,Europe,17205480,8218,1350665
2021-04-12,netherlands,Europe,17205480,6675,1357340
2021-04-13,netherlands,Europe,17205480,6685,1364025
2021-04-14,netherlands,Europe,17205480,5386,1369411
2021-04-15,netherlands,Europe,17205480,8734,1378145
2021-04-16,netherlands,Europe,17205480,8898,1387043
2021-04-17,netherlands,Europe,17205480,8285,1395328
2021-04-18,netherlands,Europe,17205480,8505,1403833
2021-04-19,netherlands,Europe,17205480,7117,1410950
2021-04-20,netherlands,Europe,17205480,6822,1417772
2021-04-21,netherlands,Europe,17205480,8471,1426243
2021-04-22,netherlands,Europe,17205480,9611,1435854
2021-04-23,netherlands,Europe,17205480,9210,1445064
2021-04-24,netherlands,Europe,17205480,8060,1453124
2021-04-25,netherlands,Europe,17205480,8013,1461137
2021-04-26,netherlands,Europe,17205480,6200,1467337
2021-04-27,netherlands,Europe,17205480,5337,1472674
2021-04-28,netherlands,Europe,17205480,8649,1481323
2021-04-29,netherlands,Europe,17205480,7271,1488594
2021-04-30,netherlands,Europe,17205480,7758,1496352
2021-05-01,netherlands,Europe,17205480,5755,1502107
2021-05-02,netherlands,Europe,17205480,5508,1507615
2021-05-03,netherlands,Europe,17205480,9187,1516802
2021-05-04,netherlands,Europe,17205480,7725,1524527
2021-05-05,netherlands,Europe,17205480,7273,1531800
2021-05-06,netherlands,Europe,17205480,6789,1538589
2021-05-07,netherlands,Europe,17205480,7481,1546070
2021-05-08,netherlands,Europe,17205480,7399,1553469
2021-05-09,netherlands,Europe,17205480,6553,1560022
2021-05-10,netherlands,Europe,17205480,5858,1565880
2021-05-11,netherlands,Europe,17205480,5518,1571398
2021-05-12,netherlands,Europe,17205480,6356,1577754
2021-05-13,netherlands,Europe,17205480,6013,1583767
2021-05-14,netherlands,Europe,17205480,5515,1589282
2021-05-15,netherlands,Europe,17205480,4446,1593728
2021-05-16,netherlands,Europe,17205480,4436,1598164
2021-05-17,netherlands,Europe,17205480,2829,1600993
2021-05-18,netherlands,Europe,17205480,5326,1606319
2021-05-19,netherlands,Europe,17205480,4549,1610868
2021-05-20,netherlands,Europe,17205480,4632,1615500
2021-05-21,netherlands,Europe,17205480,4148,1619648
2021-05-22,netherlands,Europe,17205480,3162,1622810
2021-05-23,netherlands,Europe,17205480,3422,1626232
2021-05-24,netherlands,Europe,17205480,2690,1628922
2021-05-25,netherlands,Europe,17205480,2462,1631384
2021-05-26,netherlands,Europe,17205480,2754,1634138
2021-05-27,netherlands,Europe,17205480,3328,1637466
2021-05-28,netherlands,Europe,17205480,3852,1641318
2021-05-29,netherlands,Europe,17205480,3381,1644699
2021-05-30,netherlands,Europe,17205480,2719,1647418
2021-05-31,netherlands,Europe,17205480,2042,1649460
2021-06-01,netherlands,Europe,17205480,2320,1651780
2021-06-02,netherlands,Europe,17205480,2502,1654282
2021-06-03,netherlands,Europe,17205480,2735,1657017
2021-06-04,netherlands,Europe,17205480,2382,1659399
2021-06-05,netherlands,Europe,17205480,2121,1661520
2021-06-06,netherlands,Europe,17205480,1530,1663050
2021-06-07,netherlands,Europe,17205480,1377,1664427
2021-06-08,netherlands,Europe,17205480,1419,1665846
2021-06-09,netherlands,Europe,17205480,1714,1667560
2021-06-10,netherlands,Europe,17205480,1561,1669121
2021-06-11,netherlands,Europe,17205480,1377,1670498
2021-06-12,netherlands,Europe,17205480,1205,1671703
2021-06-13,netherlands,Europe,17205480,1041,1672744
2021-06-14,netherlands,Europe,17205480,852,1673596
2021-06-15,netherlands,Europe,17205480,1032,1674628
2021-06-16,netherlands,Europe,17205480,1016,1675644
2021-06-17,netherlands,Europe,17205480,1064,1676708
2021-06-18,netherlands,Europe,17205480,888,1677596
2021-06-19,netherlands,Europe,17205480,686,1678282
2021-06-20,netherlands,Europe,17205480,701,1678983
2021-06-21,netherlands,Europe,17205480,559,1679542
2021-06-22,netherlands,Europe,17205480,686,1680228
2021-06-23,netherlands,Europe,17205480,652,1680880
2021-06-24,netherlands,Europe,17205480,700,1681580
2021-06-25,netherlands,Europe,17205480,641,1682221
2021-06-26,netherlands,Europe,17205480,552,1682773
2021-06-27,netherlands,Europe,17205480,498,1683271
2021-06-28,netherlands,Europe,17205480,557,1683828
2021-06-29,netherlands,Europe,17205480,538,1684366
2021-06-30,netherlands,Europe,17205480,634,1685000
2021-07-01,netherlands,Europe,17205480,825,1685825
2021-07-02,netherlands,Europe,17205480,941,1686766
2021-07-03,netherlands,Europe,17205480,1125,1687891
2021-07-04,netherlands,Europe,17205480,1215,1689106
2021-07-05,netherlands,Europe,17205480,1519,1690625
2021-07-06,netherlands,Europe,17205480,2209,1692834
2021-07-07,netherlands,Europe,17205480,3646,1696480
2021-07-08,netherlands,Europe,17205480,5431,1701911
2021-07-09,netherlands,Europe,17205480,6926,1708837
2021-07-10,netherlands,Europe,17205480,10283,1719120
2021-07-11,netherlands,Europe,17205480,9318,1728438
2021-07-12,netherlands,Europe,17205480,8441,1736879
2021-07-13,netherlands,Europe,17205480,7821,1744700
2021-07-14,netherlands,Europe,17205480,10426,1755126
2021-07-15,netherlands,Europe,17205480,10976,1766102
2021-07-16,netherlands,Europe,17205480,11297,1777399
2021-07-17,netherlands,Europe,17205480,11036,1788435
2021-07-18,netherlands,Europe,17205480,10135,1798570
2021-07-19,netherlands,Europe,17205480,8874,1807444
2021-07-20,netherlands,Europe,17205480,6699,1814143
2021-07-21,netherlands,Europe,17205480,6897,1821040
2021-07-22,netherlands,Europe,17205480,6233,1827273
2021-07-23,netherlands,Europe,17205480,6395,1833668
2021-07-24,netherlands,Europe,17205480,5269,1838937
2021-07-25,netherlands,Europe,17205480,4584,1843521
2021-07-26,netherlands,Europe,17205480,3851,1847372
2021-07-27,netherlands,Europe,17205480,3957,1851329
2021-07-28,netherlands,Europe,17205480,3455,1854784
2021-07-29,netherlands,Europe,17205480,4415,1859199
2021-07-30,netherlands,Europe,17205480,3387,1862586
2021-07-31,netherlands,Europe,17205480,2925,1865511
2021-08-01,netherlands,Europe,17205480,2304,1867815
2021-08-02,netherlands,Europe,17205480,2094,1869909
2021-08-03,netherlands,Europe,17205480,2184,1872093
2021-08-04,netherlands,Europe,17205480,2763,1874856
2021-08-05,netherlands,Europe,17205480,3358,1878214
2021-08-06,netherlands,Europe,17205480,2907,1881121
2021-08-07,netherlands,Europe,17205480,2392,1883513
2021-08-08,netherlands,Europe,17205480,2292,1885805
2021-08-09,netherlands,Europe,17205480,2026,1887831
2021-08-10,netherlands,Europe,17205480,2161,1889992
2021-08-11,netherlands,Europe,17205480,2112,1892104
2021-08-12,netherlands,Europe,17205480,2563,1894667
2021-08-13,netherlands,Europe,17205480,2677,1897344
2021-08-14,netherlands,Europe,17205480,2303,1899647
2021-08-15,netherlands,Europe,17205480,2253,1901900
2021-08-16,netherlands,Europe,17205480,2228,1904128
2021-08-17,netherlands,Europe,17205480,2306,1906434
2021-08-18,netherlands,Europe,17205480,2777,1909211
2021-08-19,netherlands,Europe,17205480,2488,1911699
2021-08-20,netherlands,Europe,17205480,2209,1913908
2021-08-21,netherlands,Europe,17205480,2408,1916316
2021-08-22,netherlands,Europe,17205480,2453,1918769
2021-08-23,netherlands,Europe,17205480,2390,1921159
2021-08-24,netherlands,Europe,17205480,2437,1923596
2021-08-25,netherlands,Europe,17205480,2828,1926424
2021-08-26,netherlands,Europe,17205480,2594,1929018
2021-08-27,netherlands,Europe,17205480,2815,1931833
2021-08-28,netherlands,Europe,17205480,2450,1934283
2021-08-29,netherlands,Europe,17205480,2289,1936572
2021-08-30,netherlands,Europe,17205480,2171,1938743
2021-08-31,netherlands,Europe,17205480,2312,1941055
2021-09-01,netherlands,Europe,17205480,2827,1943882
2021-09-02,netherlands,Europe,17205480,2773,1946655
2021-09-03,netherlands,Europe,17205480,2540,1949195
2021-09-04,netherlands,Europe,17205480,2691,1951886
2021-09-05,netherlands,Europe,17205480,2347,1954233
2021-09-06,netherlands,Europe,17205480,2115,1956348
2021-09-07,netherlands,Europe,17205480,2456,1958804
2021-09-08,netherlands,Europe,17205480,2781,1961585
2021-09-09,netherlands,Europe,17205480,2362,1963947
2021-09-10,netherlands,Europe,17205480,2687,1966634
2021-09-11,netherlands,Europe,17205480,2198,1968832
2021-09-12,netherlands,Europe,17205480,2082,1970914
2021-09-13,netherlands,Europe,17205480,1739,1972653
2021-09-14,netherlands,Europe,17205480,2009,1974662
2021-09-15,netherlands,Europe,17205480,2354,1977016
2021-09-16,netherlands,Europe,17205480,2098,1979114
2021-09-17,netherlands,Europe,17205480,2138,1981252
2021-09-18,netherlands,Europe,17205480,2000,1983252
2021-09-19,netherlands,Europe,17205480,1663,1984915
2021-09-20,netherlands,Europe,17205480,1326,1986241
2021-09-21,netherlands,Europe,17205480,1664,1987905
2021-09-22,netherlands,Europe,17205480,1900,1989805
2021-09-23,netherlands,Europe,17205480,1823,1991628
2021-09-24,netherlands,Europe,17205480,1681,1993309
2021-09-25,netherlands,Europe,17205480,1592,1994901
2021-09-26,netherlands,Europe,17205480,1597,1996498
2021-09-27,netherlands,Europe,17205480,1387,1997885
2021-09-28,netherlands,Europe,17205480,1707,1999592
2021-09-29,netherlands,Europe,17205480,1755,2001347
2021-09-30,netherlands,Europe,17205480,1703,2003050
2021-10-01,netherlands,Europe,17205480,1713,2004763
2021-10-02,netherlands,Europe,17205480,1658,2006421
2021-10-03,netherlands,Europe,17205480,1603,2008024
2021-10-04,netherlands,Europe,17205480,1624,2009648
2021-10-05,netherlands,Europe,17205480,1882,2011530
2021-10-06,netherlands,Europe,17205480,1895,2013425
2021-10-07,netherlands,Europe,17205480,2746,2016171
2021-10-08,netherlands,Europe,17205480,2761,2018932
2021-10-09,netherlands,Europe,17205480,2501,2021433
2021-10-10,netherlands,Europe,17205480,2258,2023691
2021-10-11,netherlands,Europe,17205480,2711,2026402
2021-10-12,netherlands,Europe,17205480,2887,2029289
2021-10-13,netherlands,Europe,17205480,3716,2033005
2021-10-14,netherlands,Europe,17205480,3623,2036628
2021-10-15,netherlands,Europe,17205480,3709,2040337
2021-10-16,netherlands,Europe,17205480,3702,2044039
2021-10-17,netherlands,Europe,17205480,3672,2047711
2021-10-18,netherlands,Europe,17205480,3354,2051065
2021-10-19,netherlands,Europe,17205480,3895,2054960
2021-10-20,netherlands,Europe,17205480,4574,2059534
2021-10-21,netherlands,Europe,17205480,5195,2064729
2021-10-22,netherlands,Europe,17205480,5868,2070597
2021-10-23,netherlands,Europe,17205480,5676,2076273
2021-10-24,netherlands,Europe,17205480,6290,2082563
2021-10-25,netherlands,Europe,17205480,5296,2087859
2021-10-26,netherlands,Europe,17205480,5747,2093606
2021-10-27,netherlands,Europe,17205480,7260,2100866
2021-10-28,netherlands,Europe,17205480,7683,2108549
2021-10-29,netherlands,Europe,17205480,7389,2115938
2021-10-30,netherlands,Europe,17205480,7942,2123880
2021-10-31,netherlands,Europe,17205480,8172,2132052
2021-11-01,netherlands,Europe,17205480,7694,2139746
2021-11-02,netherlands,Europe,17205480,7727,2147473
2021-11-03,netherlands,Europe,17205480,9109,2156582
2021-11-04,netherlands,Europe,17205480,10214,2166796
2021-11-05,netherlands,Europe,17205480,10911,2177707
2021-11-06,netherlands,Europe,17205480,11954,2189661
2021-11-07,netherlands,Europe,17205480,11349,2201010
2021-11-08,netherlands,Europe,17205480,11804,2212814
2021-11-09,netherlands,Europe,17205480,11282,2224096
2021-11-10,netherlands,Europe,17205480,12648,2236744
2021-11-11,netherlands,Europe,17205480,16287,2253031
2021-11-12,netherlands,Europe,17205480,16204,2269235
2021-11-13,netherlands,Europe,17205480,13848,2283083
2021-11-14,netherlands,Europe,17205480,12024,2295107
2021-11-15,netherlands,Europe,17205480,19197,2314304
2021-11-16,netherlands,Europe,17205480,20168,2334472
2021-11-17,netherlands,Europe,17205480,20760,2355232
2021-11-18,netherlands,Europe,17205480,23591,2378823
2021-11-19,netherlands,Europe,17205480,21026,2399849
2021-11-20,netherlands,Europe,17205480,21794,2421643
2021-11-21,netherlands,Europe,17205480,20643,2442286
2021-11-22,netherlands,Europe,17205480,23002,2465288
2021-11-23,netherlands,Europe,17205480,22956,2488244
2021-11-24,netherlands,Europe,17205480,23709,2511953
2021-11-25,netherlands,Europe,17205480,22184,2534137
2021-11-26,netherlands,Europe,17205480,21278,2555415
2020-02-29,new_zealand,Australia/Oceania,5002100,0,1
2020-03-01,new_zealand,Australia/Oceania,5002100,0,1
2020-03-02,new_zealand,Australia/Oceania,5002100,0,1
2020-03-03,new_zealand,Australia/Oceania,5002100,1,2
2020-03-04,new_zealand,Australia/Oceania,5002100,1,3
2020-03-05,new_zealand,Australia/Oceania,5002100,1,4
2020-03-06,new_zealand,Australia/Oceania,5002100,0,4
2020-03-07,new_zealand,Australia/Oceania,5002100,1,5
2020-03-08,new_zealand,Australia/Oceania,5002100,0,5
2020-03-09,new_zealand,Australia/Oceania,5002100,0,5
2020-03-10,new_zealand,Australia/Oceania,5002100,0,5
2020-03-11,new_zealand,Australia/Oceania,5002100,0,5
2020-03-12,new_zealand,Australia/Oceania,5002100,0,5
2020-03-13,new_zealand,Australia/Oceania,5002100,1,6
2020-03-14,new_zealand,Australia/Oceania,5002100,2,8
2020-03-15,new_zealand,Australia/Oceania,5002100,0,8
2020-03-16,new_zealand,Australia/Oceania,5002100,0,8
2020-03-17,new_zealand,Australia/Oceania,5002100,12,20
2020-03-18,new_zealand,Australia/Oceania,5002100,0,20
2020-03-19,new_zealand,Australia/Oceania,5002100,8,28
2020-03-20,new_zealand,Australia/Oceania,5002100,24,52
2020-03-21,new_zealand,Australia/Oceania,5002100,0,52
2020-03-22,new_zealand,Australia/Oceania,5002100,50,102
2020-03-23,new_zealand,Australia/Oceania,5002100,0,102
2020-03-24,new_zealand,Australia/Oceania,5002100,103,205
2020-03-25,new_zealand,Australia/Oceania,5002100,78,283
2020-03-26,new_zealand,Australia/Oceania,5002100,85,368
2020-03-27,new_zealand,Australia/Oceania,5002100,0,368
2020-03-28,new_zealand,Australia/Oceania,5002100,146,514
2020-03-29,new_zealand,Australia/Oceania,5002100,0,514
2020-03-30,new_zealand,Australia/Oceania,5002100,75,589
2020-03-31,new_zealand,Australia/Oceania,5002100,58,647
2020-04-01,new_zealand,Australia/Oceania,5002100,61,708
2020-04-02,new_zealand,Australia/Oceania,5002100,89,797
2020-04-03,new_zealand,Australia/Oceania,5002100,71,868
2020-04-04,new_zealand,Australia/Oceania,5002100,82,950
2020-04-05,new_zealand,Australia/Oceania,5002100,89,1039
2020-04-06,new_zealand,Australia/Oceania,5002100,67,1106
2020-04-07,new_zealand,Australia/Oceania,5002100,54,1160
2020-04-08,new_zealand,Australia/Oceania,5002100,50,1210
2020-04-09,new_zealand,Australia/Oceania,5002100,29,1239
2020-04-10,new_zealand,Australia/Oceania,5002100,44,1283
2020-04-11,new_zealand,Australia/Oceania,5002100,29,1312
2020-04-12,new_zealand,Australia/Oceania,5002100,18,1330
2020-04-13,new_zealand,Australia/Oceania,5002100,19,1349
2020-04-14,new_zealand,Australia/Oceania,5002100,17,1366
2020-04-15,new_zealand,Australia/Oceania,5002100,20,1386
2020-04-16,new_zealand,Australia/Oceania,5002100,15,1401
2020-04-17,new_zealand,Australia/Oceania,5002100,8,1409
2020-04-18,new_zealand,Australia/Oceania,5002100,13,1422
2020-04-19,new_zealand,Australia/Oceania,5002100,9,1431
2020-04-20,new_zealand,Australia/Oceania,5002100,9,1440
2020-04-21,new_zealand,Australia/Oceania,5002100,5,1445
2020-04-22,new_zealand,Australia/Oceania,5002100,3,1448
2020-04-23,new_zealand,Australia/Oceania,5002100,3,1451
2020-04-24,new_zealand,Australia/Oceania,5002100,5,1456
2020-04-25,new_zealand,Australia/Oceania,5002100,5,1461
2020-04-26,new_zealand,Australia/Oceania,5002100,8,1469
2020-04-27,new_zealand,Australia/Oceania,5002100,0,1469
2020-04-28,new_zealand,Australia/Oceania,5002100,3,1472
2020-04-29,new_zealand,Australia/Oceania,5002100,2,1474
2020-04-30,new_zealand,Australia/Oceania,5002100,2,1476
2020-05-01,new_zealand,Australia/Oceania,5002100,3,1479
2020-05-02,new_zealand,Australia/Oceania,5002100,6,1485
2020-05-03,new_zealand,Australia/Oceania,5002100,0,1485
2020-05-04,new_zealand,Australia/Oceania,5002100,0,1485
2020-05-05,new_zealand,Australia/Oceania,5002100,1,1486
2020-05-06,new_zealand,Australia/Oceania,5002100,2,1488
2020-05-07,new_zealand,Australia/Oceania,5002100,1,1489
2020-05-08,new_zealand,Australia/Oceania,5002100,1,1490
2020-05-09,new_zealand,Australia/Oceania,5002100,2,1492
2020-05-10,new_zealand,Australia/Oceania,5002100,2,1494
2020-05-11,new_zealand,Australia/Oceania,5002100,3,1497
2020-05-12,new_zealand,Australia/Oceania,5002100,0,1497
2020-05-13,new_zealand,Australia/Oceania,5002100,0,1497
2020-05-14,new_zealand,Australia/Oceania,5002100,0,1497
2020-05-15,new_zealand,Australia/Oceania,5002100,1,1498
2020-05-16,new_zealand,Australia/Oceania,5002100,0,1498
2020-05-17,new_zealand,Australia/Oceania,5002100,1,1499
2020-05-18,new_zealand,Australia/Oceania,5002100,0,1499
2020-05-19,new_zealand,Australia/Oceania,5002100,4,1503
2020-05-20,new_zealand,Australia/Oceania,5002100,0,1503
2020-05-21,new_zealand,Australia/Oceania,5002100,0,1503
2020-05-22,new_zealand,Australia/Oceania,5002100,1,1504
2020-05-23,new_zealand,Australia/Oceania,5002100,0,1504
2020-05-24,new_zealand,Australia/Oceania,5002100,0,1504
2020-05-25,new_zealand,Australia/Oceania,5002100,0,1504
2020-05-26,new_zealand,Australia/Oceania,5002100,0,1504
2020-05-27,new_zealand,Australia/Oceania,5002100,0,1504
2020-05-28,new_zealand,Australia/Oceania,5002100,0,1504
2020-05-29,new_zealand,Australia/Oceania,5002100,0,1504
2020-05-30,new_zealand,Australia/Oceania,5002100,0,1504
2020-05-31,new_zealand,Australia/Oceania,5002100,0,1504
2020-06-01,new_zealand,Australia/Oceania,5002100,0,1504
2020-06-02,new_zealand,Australia/Oceania,5002100,0,1504
2020-06-03,new_zealand,Australia/Oceania,5002100,0,1504
2020-06-04,new_zealand,Australia/Oceania,5002100,0,1504
2020-06-05,new_zealand,Australia/Oceania,5002100,0,1504
2020-06-06,new_zealand,Australia/Oceania,5002100,0,1504
2020-06-07,new_zealand,Australia/Oceania,5002100,0,1504
2020-06-08,new_zealand,Australia/Oceania,5002100,0,1504
2020-06-09,new_zealand,Australia/Oceania,5002100,0,1504
2020-06-10,new_zealand,Australia/Oceania,5002100,0,1504
2020-06-11,new_zealand,Australia/Oceania,5002100,0,1504
2020-06-12,new_zealand,Australia/Oceania,5002100,0,1504
2020-06-13,new_zealand,Australia/Oceania,5002100,0,1504
2020-06-14,new_zealand,Australia/Oceania,5002100,0,1504
2020-06-15,new_zealand,Australia/Oceania,5002100,0,1504
2020-06-16,new_zealand,Australia/Oceania,5002100,2,1506
2020-06-17,new_zealand,Australia/Oceania,5002100,0,1506
2020-06-18,new_zealand,Australia/Oceania,5002100,1,1507
2020-06-19,new_zealand,Australia/Oceania,5002100,0,1507
2020-06-20,new_zealand,Australia/Oceania,5002100,2,1509
2020-06-21,new_zealand,Australia/Oceania,5002100,2,1511
2020-06-22,new_zealand,Australia/Oceania,5002100,2,1513
2020-06-23,new_zealand,Australia/Oceania,5002100,2,1515
2020-06-24,new_zealand,Australia/Oceania,5002100,1,1516
2020-06-25,new_zealand,Australia/Oceania,5002100,3,1519
2020-06-26,new_zealand,Australia/Oceania,5002100,1,1520
2020-06-27,new_zealand,Australia/Oceania,5002100,2,1522
2020-06-28,new_zealand,Australia/Oceania,5002100,4,1526
2020-06-29,new_zealand,Australia/Oceania,5002100,2,1528
2020-06-30,new_zealand,Australia/Oceania,5002100,0,1528
2020-07-01,new_zealand,Australia/Oceania,5002100,0,1528
2020-07-02,new_zealand,Australia/Oceania,5002100,2,1530
2020-07-03,new_zealand,Australia/Oceania,5002100,0,1530
2020-07-04,new_zealand,Australia/Oceania,5002100,0,1530
2020-07-05,new_zealand,Australia/Oceania,5002100,3,1533
2020-07-06,new_zealand,Australia/Oceania,5002100,1,1534
2020-07-07,new_zealand,Australia/Oceania,5002100,2,1536
2020-07-08,new_zealand,Australia/Oceania,5002100,1,1537
2020-07-09,new_zealand,Australia/Oceania,5002100,3,1540
2020-07-10,new_zealand,Australia/Oceania,5002100,2,1542
2020-07-11,new_zealand,Australia/Oceania,5002100,1,1543
2020-07-12,new_zealand,Australia/Oceania,5002100,1,1544
2020-07-13,new_zealand,Australia/Oceania,5002100,0,1544
2020-07-14,new_zealand,Australia/Oceania,5002100,1,1545
2020-07-15,new_zealand,Australia/Oceania,5002100,2,1547
2020-07-16,new_zealand,Australia/Oceania,5002100,1,1548
2020-07-17,new_zealand,Australia/Oceania,5002100,1,1549
2020-07-18,new_zealand,Australia/Oceania,5002100,1,1550
2020-07-19,new_zealand,Australia/Oceania,5002100,3,1553
2020-07-20,new_zealand,Australia/Oceania,5002100,1,1554
2020-07-21,new_zealand,Australia/Oceania,5002100,1,1555
2020-07-22,new_zealand,Australia/Oceania,5002100,0,1555
2020-07-23,new_zealand,Australia/Oceania,5002100,0,1555
2020-07-24,new_zealand,Australia/Oceania,5002100,1,1556
2020-07-25,new_zealand,Australia/Oceania,5002100,0,1556
2020-07-26,new_zealand,Australia/Oceania,5002100,0,1556
2020-07-27,new_zealand,Australia/Oceania,5002100,0,1556
2020-07-28,new_zealand,Australia/Oceania,5002100,1,1557
2020-07-29,new_zealand,Australia/Oceania,5002100,2,1559
2020-07-30,new_zealand,Australia/Oceania,5002100,1,1560
2020-07-31,new_zealand,Australia/Oceania,5002100,0,1560
2020-08-01,new_zealand,Australia/Oceania,5002100,2,1562
2020-08-02,new_zealand,Australia/Oceania,5002100,3,1565
2020-08-03,new_zealand,Australia/Oceania,5002100,2,1567
2020-08-04,new_zealand,Australia/Oceania,5002100,0,1567
2020-08-05,new_zealand,Australia/Oceania,5002100,2,1569
2020-08-06,new_zealand,Australia/Oceania,5002100,0,1569
2020-08-07,new_zealand,Australia/Oceania,5002100,0,1569
2020-08-08,new_zealand,Australia/Oceania,5002100,0,1569
2020-08-09,new_zealand,Australia/Oceania,5002100,0,1569
2020-08-10,new_zealand,Australia/Oceania,5002100,0,1569
2020-08-11,new_zealand,Australia/Oceania,5002100,1,1570
2020-08-12,new_zealand,Australia/Oceania,5002100,9,1579
2020-08-13,new_zealand,Australia/Oceania,5002100,10,1589
2020-08-14,new_zealand,Australia/Oceania,5002100,13,1602
2020-08-15,new_zealand,Australia/Oceania,5002100,7,1609
2020-08-16,new_zealand,Australia/Oceania,5002100,13,1622
2020-08-17,new_zealand,Australia/Oceania,5002100,9,1631
2020-08-18,new_zealand,Australia/Oceania,5002100,12,1643
2020-08-19,new_zealand,Australia/Oceania,5002100,6,1649
2020-08-20,new_zealand,Australia/Oceania,5002100,5,1654
2020-08-21,new_zealand,Australia/Oceania,5002100,11,1665
2020-08-22,new_zealand,Australia/Oceania,5002100,6,1671
2020-08-23,new_zealand,Australia/Oceania,5002100,3,1674
2020-08-24,new_zealand,Australia/Oceania,5002100,9,1683
2020-08-25,new_zealand,Australia/Oceania,5002100,7,1690
2020-08-26,new_zealand,Australia/Oceania,5002100,5,1695
2020-08-27,new_zealand,Australia/Oceania,5002100,7,1702
2020-08-28,new_zealand,Australia/Oceania,5002100,12,1714
2020-08-29,new_zealand,Australia/Oceania,5002100,13,1727
2020-08-30,new_zealand,Australia/Oceania,5002100,2,1729
2020-08-31,new_zealand,Australia/Oceania,5002100,9,1738
2020-09-01,new_zealand,Australia/Oceania,5002100,14,1752
2020-09-02,new_zealand,Australia/Oceania,5002100,5,1757
2020-09-03,new_zealand,Australia/Oceania,5002100,2,1759
2020-09-04,new_zealand,Australia/Oceania,5002100,5,1764
2020-09-05,new_zealand,Australia/Oceania,5002100,3,1767
2020-09-06,new_zealand,Australia/Oceania,5002100,5,1772
2020-09-07,new_zealand,Australia/Oceania,5002100,4,1776
2020-09-08,new_zealand,Australia/Oceania,5002100,6,1782
2020-09-09,new_zealand,Australia/Oceania,5002100,6,1788
2020-09-10,new_zealand,Australia/Oceania,5002100,4,1792
2020-09-11,new_zealand,Australia/Oceania,5002100,1,1793
2020-09-12,new_zealand,Australia/Oceania,5002100,2,1795
2020-09-13,new_zealand,Australia/Oceania,5002100,2,1797
2020-09-14,new_zealand,Australia/Oceania,5002100,1,1798
2020-09-15,new_zealand,Australia/Oceania,5002100,3,1801
2020-09-16,new_zealand,Australia/Oceania,5002100,1,1802
2020-09-17,new_zealand,Australia/Oceania,5002100,7,1809
2020-09-18,new_zealand,Australia/Oceania,5002100,0,1809
2020-09-19,new_zealand,Australia/Oceania,5002100,2,1811
2020-09-20,new_zealand,Australia/Oceania,5002100,4,1815
2020-09-21,new_zealand,Australia/Oceania,5002100,0,1815
2020-09-22,new_zealand,Australia/Oceania,5002100,0,1815
2020-09-23,new_zealand,Australia/Oceania,5002100,9,1824
2020-09-24,new_zealand,Australia/Oceania,5002100,3,1827
2020-09-25,new_zealand,Australia/Oceania,5002100,2,1829
2020-09-26,new_zealand,Australia/Oceania,5002100,2,1831
2020-09-27,new_zealand,Australia/Oceania,5002100,2,1833
2020-09-28,new_zealand,Australia/Oceania,5002100,0,1833
2020-09-29,new_zealand,Australia/Oceania,5002100,2,1835
2020-09-30,new_zealand,Australia/Oceania,5002100,1,1836
2020-10-01,new_zealand,Australia/Oceania,5002100,12,1848
2020-10-02,new_zealand,Australia/Oceania,5002100,0,1848
2020-10-03,new_zealand,Australia/Oceania,5002100,1,1849
2020-10-04,new_zealand,Australia/Oceania,5002100,5,1854
2020-10-05,new_zealand,Australia/Oceania,5002100,1,1855
2020-10-06,new_zealand,Australia/Oceania,5002100,3,1858
2020-10-07,new_zealand,Australia/Oceania,5002100,3,1861
2020-10-08,new_zealand,Australia/Oceania,5002100,3,1864
2020-10-09,new_zealand,Australia/Oceania,5002100,2,1866
2020-10-10,new_zealand,Australia/Oceania,5002100,4,1870
2020-10-11,new_zealand,Australia/Oceania,5002100,1,1871
2020-10-12,new_zealand,Australia/Oceania,5002100,0,1871
2020-10-13,new_zealand,Australia/Oceania,5002100,1,1872
2020-10-14,new_zealand,Australia/Oceania,5002100,2,1874
2020-10-15,new_zealand,Australia/Oceania,5002100,2,1876
2020-10-16,new_zealand,Australia/Oceania,5002100,4,1880
2020-10-17,new_zealand,Australia/Oceania,5002100,3,1883
2020-10-18,new_zealand,Australia/Oceania,5002100,3,1886
2020-10-19,new_zealand,Australia/Oceania,5002100,0,1886
2020-10-20,new_zealand,Australia/Oceania,5002100,1,1887
2020-10-21,new_zealand,Australia/Oceania,5002100,25,1912
2020-10-22,new_zealand,Australia/Oceania,5002100,2,1914
2020-10-23,new_zealand,Australia/Oceania,5002100,9,1923
2020-10-24,new_zealand,Australia/Oceania,5002100,11,1934
2020-10-25,new_zealand,Australia/Oceania,5002100,1,1935
2020-10-26,new_zealand,Australia/Oceania,5002100,5,1940
2020-10-27,new_zealand,Australia/Oceania,5002100,1,1941
2020-10-28,new_zealand,Australia/Oceania,5002100,2,1943
2020-10-29,new_zealand,Australia/Oceania,5002100,6,1949
2020-10-30,new_zealand,Australia/Oceania,5002100,1,1950
2020-10-31,new_zealand,Australia/Oceania,5002100,7,1957
2020-11-01,new_zealand,Australia/Oceania,5002100,2,1959
2020-11-02,new_zealand,Australia/Oceania,5002100,4,1963
2020-11-03,new_zealand,Australia/Oceania,5002100,5,1968
2020-11-04,new_zealand,Australia/Oceania,5002100,3,1971
2020-11-05,new_zealand,Australia/Oceania,5002100,2,1973
2020-11-06,new_zealand,Australia/Oceania,5002100,1,1974
2020-11-07,new_zealand,Australia/Oceania,5002100,2,1976
2020-11-08,new_zealand,Australia/Oceania,5002100,6,1982
2020-11-09,new_zealand,Australia/Oceania,5002100,4,1986
2020-11-10,new_zealand,Australia/Oceania,5002100,1,1987
2020-11-11,new_zealand,Australia/Oceania,5002100,1,1988
2020-11-12,new_zealand,Australia/Oceania,5002100,3,1991
2020-11-13,new_zealand,Australia/Oceania,5002100,4,1995
2020-11-14,new_zealand,Australia/Oceania,5002100,3,1998
2020-11-15,new_zealand,Australia/Oceania,5002100,3,2001
2020-11-16,new_zealand,Australia/Oceania,5002100,0,2001
2020-11-17,new_zealand,Australia/Oceania,5002100,4,2005
2020-11-18,new_zealand,Australia/Oceania,5002100,3,2008
2020-11-19,new_zealand,Australia/Oceania,5002100,2,2010
2020-11-20,new_zealand,Australia/Oceania,5002100,3,2013
2020-11-21,new_zealand,Australia/Oceania,5002100,6,2019
2020-11-22,new_zealand,Australia/Oceania,5002100,9,2028
2020-11-23,new_zealand,Australia/Oceania,5002100,2,2030
2020-11-24,new_zealand,Australia/Oceania,5002100,1,2031
2020-11-25,new_zealand,Australia/Oceania,5002100,8,2039
2020-11-26,new_zealand,Australia/Oceania,5002100,1,2040
2020-11-27,new_zealand,Australia/Oceania,5002100,7,2047
2020-11-28,new_zealand,Australia/Oceania,5002100,3,2050
2020-11-29,new_zealand,Australia/Oceania,5002100,0,2050
2020-11-30,new_zealand,Australia/Oceania,5002100,6,2056
2020-12-01,new_zealand,Australia/Oceania,5002100,3,2059
2020-12-02,new_zealand,Australia/Oceania,5002100,1,2060
2020-12-03,new_zealand,Australia/Oceania,5002100,9,2069
2020-12-04,new_zealand,Australia/Oceania,5002100,0,2069
2020-12-05,new_zealand,Australia/Oceania,5002100,9,2078
2020-12-06,new_zealand,Australia/Oceania,5002100,0,2078
2020-12-07,new_zealand,Australia/Oceania,5002100,1,2079
2020-12-08,new_zealand,Australia/Oceania,5002100,6,2085
2020-12-09,new_zealand,Australia/Oceania,5002100,3,2088
2020-12-10,new_zealand,Australia/Oceania,5002100,0,2088
2020-12-11,new_zealand,Australia/Oceania,5002100,4,2092
2020-12-12,new_zealand,Australia/Oceania,5002100,0,2092
2020-12-13,new_zealand,Australia/Oceania,5002100,4,2096
2020-12-14,new_zealand,Australia/Oceania,5002100,0,2096
2020-12-15,new_zealand,Australia/Oceania,5002100,0,2096
2020-12-16,new_zealand,Australia/Oceania,5002100,4,2100
2020-12-17,new_zealand,Australia/Oceania,5002100,0,2100
2020-12-18,new_zealand,Australia/Oceania,5002100,10,2110
2020-12-19,new_zealand,Australia/Oceania,5002100,0,2110
2020-12-20,new_zealand,Australia/Oceania,5002100,6,2116
2020-12-21,new_zealand,Australia/Oceania,5002100,5,2121
2020-12-22,new_zealand,Australia/Oceania,5002100,0,2121
2020-12-23,new_zealand,Australia/Oceania,5002100,7,2128
2020-12-24,new_zealand,Australia/Oceania,5002100,0,2128
2020-12-25,new_zealand,Australia/Oceania,5002100,0,2128
2020-12-26,new_zealand,Australia/Oceania,5002100,0,2128
2020-12-27,new_zealand,Australia/Oceania,5002100,16,2144
2020-12-28,new_zealand,Australia/Oceania,5002100,0,2144
2020-12-29,new_zealand,Australia/Oceania,5002100,7,2151
2020-12-30,new_zealand,Australia/Oceania,5002100,0,2151
2020-12-31,new_zealand,Australia/Oceania,5002100,11,2162
2021-01-01,new_zealand,Australia/Oceania,5002100,0,2162
2021-01-02,new_zealand,Australia/Oceania,5002100,0,2162
2021-01-03,new_zealand,Australia/Oceania,5002100,19,2181
2021-01-04,new_zealand,Australia/Oceania,5002100,0,2181
2021-01-05,new_zealand,Australia/Oceania,5002100,5,2186
2021-01-06,new_zealand,Australia/Oceania,5002100,0,2186
2021-01-07,new_zealand,Australia/Oceania,5002100,2,2188
2021-01-08,new_zealand,Australia/Oceania,5002100,0,2188
2021-01-09,new_zealand,Australia/Oceania,5002100,0,2188
2021-01-10,new_zealand,Australia/Oceania,5002100,31,2219
2021-01-11,new_zealand,Australia/Oceania,5002100,3,2222
2021-01-12,new_zealand,Australia/Oceania,5002100,0,2222
2021-01-13,new_zealand,Australia/Oceania,5002100,6,2228
2021-01-14,new_zealand,Australia/Oceania,5002100,0,2228
2021-01-15,new_zealand,Australia/Oceania,5002100,18,2246
2021-01-16,new_zealand,Australia/Oceania,5002100,0,2246
2021-01-17,new_zealand,Australia/Oceania,5002100,10,2256
2021-01-18,new_zealand,Australia/Oceania,5002100,6,2262
2021-01-19,new_zealand,Australia/Oceania,5002100,0,2262
2021-01-20,new_zealand,Australia/Oceania,5002100,5,2267
2021-01-21,new_zealand,Australia/Oceania,5002100,0,2267
2021-01-22,new_zealand,Australia/Oceania,5002100,9,2276
2021-01-23,new_zealand,Australia/Oceania,5002100,0,2276
2021-01-24,new_zealand,Australia/Oceania,5002100,7,2283
2021-01-25,new_zealand,Australia/Oceania,5002100,5,2288
2021-01-26,new_zealand,Australia/Oceania,5002100,2,2290
2021-01-27,new_zealand,Australia/Oceania,5002100,5,2295
2021-01-28,new_zealand,Australia/Oceania,5002100,4,2299
2021-01-29,new_zealand,Australia/Oceania,5002100,3,2302
2021-01-30,new_zealand,Australia/Oceania,5002100,1,2303
2021-01-31,new_zealand,Australia/Oceania,5002100,1,2304
2021-02-01,new_zealand,Australia/Oceania,5002100,0,2304
2021-02-02,new_zealand,Australia/Oceania,5002100,3,2307
2021-02-03,new_zealand,Australia/Oceania,5002100,1,2308
2021-02-04,new_zealand,Australia/Oceania,5002100,5,2313
2021-02-05,new_zealand,Australia/Oceania,5002100,2,2315
2021-02-06,new_zealand,Australia/Oceania,5002100,0,2315
2021-02-07,new_zealand,Australia/Oceania,5002100,5,2320
2021-02-08,new_zealand,Australia/Oceania,5002100,0,2320
2021-02-09,new_zealand,Australia/Oceania,5002100,2,2322
2021-02-10,new_zealand,Australia/Oceania,5002100,2,2324
2021-02-11,new_zealand,Australia/Oceania,5002100,0,2324
2021-02-12,new_zealand,Australia/Oceania,5002100,2,2326
2021-02-13,new_zealand,Australia/Oceania,5002100,2,2328
2021-02-14,new_zealand,Australia/Oceania,5002100,2,2330
2021-02-15,new_zealand,Australia/Oceania,5002100,7,2337
2021-02-16,new_zealand,Australia/Oceania,5002100,0,2337
2021-02-17,new_zealand,Australia/Oceania,5002100,3,2340
2021-02-18,new_zealand,Australia/Oceania,5002100,4,2344
2021-02-19,new_zealand,Australia/Oceania,5002100,4,2348
2021-02-20,new_zealand,Australia/Oceania,5002100,2,2350
2021-02-21,new_zealand,Australia/Oceania,5002100,0,2350
2021-02-22,new_zealand,Australia/Oceania,5002100,7,2357
2021-02-23,new_zealand,Australia/Oceania,5002100,6,2363
2021-02-24,new_zealand,Australia/Oceania,5002100,2,2365
2021-02-25,new_zealand,Australia/Oceania,5002100,3,2368
2021-02-26,new_zealand,Australia/Oceania,5002100,3,2371
2021-02-27,new_zealand,Australia/Oceania,5002100,1,2372
2021-02-28,new_zealand,Australia/Oceania,5002100,4,2376
2021-03-01,new_zealand,Australia/Oceania,5002100,2,2378
2021-03-02,new_zealand,Australia/Oceania,5002100,4,2382
2021-03-03,new_zealand,Australia/Oceania,5002100,2,2384
2021-03-04,new_zealand,Australia/Oceania,5002100,5,2389
2021-03-05,new_zealand,Australia/Oceania,5002100,0,2389
2021-03-06,new_zealand,Australia/Oceania,5002100,9,2398
2021-03-07,new_zealand,Australia/Oceania,5002100,1,2399
2021-03-08,new_zealand,Australia/Oceania,5002100,6,2405
2021-03-09,new_zealand,Australia/Oceania,5002100,4,2409
2021-03-10,new_zealand,Australia/Oceania,5002100,1,2410
2021-03-11,new_zealand,Australia/Oceania,5002100,6,2416
2021-03-12,new_zealand,Australia/Oceania,5002100,1,2417
2021-03-13,new_zealand,Australia/Oceania,5002100,5,2422
2021-03-14,new_zealand,Australia/Oceania,5002100,1,2423
2021-03-15,new_zealand,Australia/Oceania,5002100,7,2430
2021-03-16,new_zealand,Australia/Oceania,5002100,2,2432
2021-03-17,new_zealand,Australia/Oceania,5002100,2,2434
2021-03-18,new_zealand,Australia/Oceania,5002100,0,2434
2021-03-19,new_zealand,Australia/Oceania,5002100,10,2444
2021-03-20,new_zealand,Australia/Oceania,5002100,0,2444
2021-03-21,new_zealand,Australia/Oceania,5002100,9,2453
2021-03-22,new_zealand,Australia/Oceania,5002100,9,2462
2021-03-23,new_zealand,Australia/Oceania,5002100,0,2462
2021-03-24,new_zealand,Australia/Oceania,5002100,8,2470
2021-03-25,new_zealand,Australia/Oceania,5002100,6,2476
2021-03-26,new_zealand,Australia/Oceania,5002100,3,2479
2021-03-27,new_zealand,Australia/Oceania,5002100,2,2481
2021-03-28,new_zealand,Australia/Oceania,5002100,1,2482
2021-03-29,new_zealand,Australia/Oceania,5002100,11,2493
2021-03-30,new_zealand,Australia/Oceania,5002100,2,2495
2021-03-31,new_zealand,Australia/Oceania,5002100,2,2497
2021-04-01,new_zealand,Australia/Oceania,5002100,4,2501
2021-04-02,new_zealand,Australia/Oceania,5002100,0,2501
2021-04-03,new_zealand,Australia/Oceania,5002100,0,2501
2021-04-04,new_zealand,Australia/Oceania,5002100,6,2507
2021-04-05,new_zealand,Australia/Oceania,5002100,0,2507
2021-04-06,new_zealand,Australia/Oceania,5002100,17,2524
2021-04-07,new_zealand,Australia/Oceania,5002100,7,2531
2021-04-08,new_zealand,Australia/Oceania,5002100,24,2555
2021-04-09,new_zealand,Australia/Oceania,5002100,6,2561
2021-04-10,new_zealand,Australia/Oceania,5002100,10,2571
2021-04-11,new_zealand,Australia/Oceania,5002100,3,2574
2021-04-12,new_zealand,Australia/Oceania,5002100,9,2583
2021-04-13,new_zealand,Australia/Oceania,5002100,4,2587
2021-04-14,new_zealand,Australia/Oceania,5002100,2,2589
2021-04-15,new_zealand,Australia/Oceania,5002100,2,2591
2021-04-16,new_zealand,Australia/Oceania,5002100,0,2591
2021-04-17,new_zealand,Australia/Oceania,5002100,0,2591
2021-04-18,new_zealand,Australia/Oceania,5002100,4,2595
2021-04-19,new_zealand,Australia/Oceania,5002100,1,2596
2021-04-20,new_zealand,Australia/Oceania,5002100,1,2597
2021-04-21,new_zealand,Australia/Oceania,5002100,2,2599
2021-04-22,new_zealand,Australia/Oceania,5002100,1,2600
2021-04-23,new_zealand,Australia/Oceania,5002100,0,2600
2021-04-24,new_zealand,Australia/Oceania,5002100,1,2601
2021-04-25,new_zealand,Australia/Oceania,5002100,0,2601
2021-04-26,new_zealand,Australia/Oceania,5002100,0,2601
2021-04-27,new_zealand,Australia/Oceania,5002100,8,2609
2021-04-28,new_zealand,Australia/Oceania,5002100,1,2610
2021-04-29,new_zealand,Australia/Oceania,5002100,3,2613
2021-04-30,new_zealand,Australia/Oceania,5002100,0,2613
2021-05-01,new_zealand,Australia/Oceania,5002100,0,2613
2021-05-02,new_zealand,Australia/Oceania,5002100,5,2618
2021-05-03,new_zealand,Australia/Oceania,5002100,4,2622
2021-05-04,new_zealand,Australia/Oceania,5002100,1,2623
2021-05-05,new_zealand,Australia/Oceania,5002100,6,2629
2021-05-06,new_zealand,Australia/Oceania,5002100,4,2633
2021-05-07,new_zealand,Australia/Oceania,5002100,1,2634
2021-05-08,new_zealand,Australia/Oceania,5002100,6,2640
2021-05-09,new_zealand,Australia/Oceania,5002100,2,2642
2021-05-10,new_zealand,Australia/Oceania,5002100,1,2643
2021-05-11,new_zealand,Australia/Oceania,5002100,0,2643
2021-05-12,new_zealand,Australia/Oceania,5002100,0,2643
2021-05-13,new_zealand,Australia/Oceania,5002100,1,2644
2021-05-14,new_zealand,Australia/Oceania,5002100,1,2645
2021-05-15,new_zealand,Australia/Oceania,5002100,0,2645
2021-05-16,new_zealand,Australia/Oceania,5002100,1,2646
2021-05-17,new_zealand,Australia/Oceania,5002100,5,2651
2021-05-18,new_zealand,Australia/Oceania,5002100,2,2653
2021-05-19,new_zealand,Australia/Oceania,5002100,5,2658
2021-05-20,new_zealand,Australia/Oceania,5002100,1,2659
2021-05-21,new_zealand,Australia/Oceania,5002100,3,2662
2021-05-22,new_zealand,Australia/Oceania,5002100,0,2662
2021-05-23,new_zealand,Australia/Oceania,5002100,6,2668
2021-05-24,new_zealand,Australia/Oceania,5002100,0,2668
2021-05-25,new_zealand,Australia/Oceania,5002100,1,2669
2021-05-26,new_zealand,Australia/Oceania,5002100,0,2669
2021-05-27,new_zealand,Australia/Oceania,5002100,1,2670
2021-05-28,new_zealand,Australia/Oceania,5002100,0,2670
2021-05-29,new_zealand,Australia/Oceania,5002100,0,2670
2021-05-30,new_zealand,Australia/Oceania,5002100,2,2672
2021-05-31,new_zealand,Australia/Oceania,5002100,1,2673
2021-06-01,new_zealand,Australia/Oceania,5002100,0,2673
2021-06-02,new_zealand,Australia/Oceania,5002100,6,2679
2021-06-03,new_zealand,Australia/Oceania,5002100,2,2681
2021-06-04,new_zealand,Australia/Oceania,5002100,1,2682
2021-06-05,new_zealand,Australia/Oceania,5002100,0,2682
2021-06-06,new_zealand,Australia/Oceania,5002100,0,2682
2021-06-07,new_zealand,Australia/Oceania,5002100,0,2682
2021-06-08,new_zealand,Australia/Oceania,5002100,10,2692
2021-06-09,new_zealand,Australia/Oceania,5002100,4,2696
2021-06-10,new_zealand,Australia/Oceania,5002100,1,2697
2021-06-11,new_zealand,Australia/Oceania,5002100,5,2702
2021-06-12,new_zealand,Australia/Oceania,5002100,0,2702
2021-06-13,new_zealand,Australia/Oceania,5002100,6,2708
2021-06-14,new_zealand,Australia/Oceania,5002100,1,2709
2021-06-15,new_zealand,Australia/Oceania,5002100,0,2709
2021-06-16,new_zealand,Australia/Oceania,5002100,2,2711
2021-06-17,new_zealand,Australia/Oceania,5002100,2,2713
2021-06-18,new_zealand,Australia/Oceania,5002100,1,2714
2021-06-19,new_zealand,Australia/Oceania,5002100,0,2714
2021-06-20,new_zealand,Australia/Oceania,5002100,4,2718
2021-06-21,new_zealand,Australia/Oceania,5002100,2,2720
2021-06-22,new_zealand,Australia/Oceania,5002100,0,2720
2021-06-23,new_zealand,Australia/Oceania,5002100,3,2723
2021-06-24,new_zealand,Australia/Oceania,5002100,0,2723
2021-06-25,new_zealand,Australia/Oceania,5002100,2,2725
2021-06-26,new_zealand,Australia/Oceania,5002100,4,2729
2021-06-27,new_zealand,Australia/Oceania,5002100,0,2729
2021-06-28,new_zealand,Australia/Oceania,5002100,9,2738
2021-06-29,new_zealand,Australia/Oceania,5002100,3,2741
2021-06-30,new_zealand,Australia/Oceania,5002100,1,2742
2021-07-01,new_zealand,Australia/Oceania,5002100,0,2742
2021-07-02,new_zealand,Australia/Oceania,5002100,0,2742
2021-07-03,new_zealand,Australia/Oceania,5002100,0,2742
2021-07-04,new_zealand,Australia/Oceania,5002100,9,2751
2021-07-05,new_zealand,Australia/Oceania,5002100,7,2758
2021-07-06,new_zealand,Australia/Oceania,5002100,0,2758
2021-07-07,new_zealand,Australia/Oceania,5002100,5,2763
2021-07-08,new_zealand,Australia/Oceania,5002100,1,2764
2021-07-09,new_zealand,Australia/Oceania,5002100,1,2765
2021-07-10,new_zealand,Australia/Oceania,5002100,0,2765
2021-07-11,new_zealand,Australia/Oceania,5002100,2,2767
2021-07-12,new_zealand,Australia/Oceania,5002100,1,2768
2021-07-13,new_zealand,Australia/Oceania,5002100,18,2786
2021-07-14,new_zealand,Australia/Oceania,5002100,4,2790
2021-07-15,new_zealand,Australia/Oceania,5002100,4,2794
2021-07-16,new_zealand,Australia/Oceania,5002100,9,2803
2021-07-17,new_zealand,Australia/Oceania,5002100,0,2803
2021-07-18,new_zealand,Australia/Oceania,5002100,11,2814
2021-07-19,new_zealand,Australia/Oceania,5002100,3,2817
2021-07-20,new_zealand,Australia/Oceania,5002100,5,2822
2021-07-21,new_zealand,Australia/Oceania,5002100,6,2828
2021-07-22,new_zealand,Australia/Oceania,5002100,7,2835
2021-07-23,new_zealand,Australia/Oceania,5002100,20,2855
2021-07-24,new_zealand,Australia/Oceania,5002100,0,2855
2021-07-25,new_zealand,Australia/Oceania,5002100,7,2862
2021-07-26,new_zealand,Australia/Oceania,5002100,1,2863
2021-07-27,new_zealand,Australia/Oceania,5002100,0,2863
2021-07-28,new_zealand,Australia/Oceania,5002100,1,2864
2021-07-29,new_zealand,Australia/Oceania,5002100,3,2867
2021-07-30,new_zealand,Australia/Oceania,5002100,3,2870
2021-07-31,new_zealand,Australia/Oceania,5002100,0,2870
2021-08-01,new_zealand,Australia/Oceania,5002100,3,2873
2021-08-02,new_zealand,Australia/Oceania,5002100,4,2877
2021-08-03,new_zealand,Australia/Oceania,5002100,0,2877
2021-08-04,new_zealand,Australia/Oceania,5002100,2,2879
2021-08-05,new_zealand,Australia/Oceania,5002100,1,2880
2021-08-06,new_zealand,Australia/Oceania,5002100,0,2880
2021-08-07,new_zealand,Australia/Oceania,5002100,0,2880
2021-08-08,new_zealand,Australia/Oceania,5002100,6,2886
2021-08-09,new_zealand,Australia/Oceania,5002100,4,2890
2021-08-10,new_zealand,Australia/Oceania,5002100,12,2902
2021-08-11,new_zealand,Australia/Oceania,5002100,2,2904
2021-08-12,new_zealand,Australia/Oceania,5002100,9,2913
2021-08-13,new_zealand,Australia/Oceania,5002100,1,2914
2021-08-14,new_zealand,Australia/Oceania,5002100,0,2914
2021-08-15,new_zealand,Australia/Oceania,5002100,5,2919
2021-08-16,new_zealand,Australia/Oceania,5002100,7,2926
2021-08-17,new_zealand,Australia/Oceania,5002100,0,2926
2021-08-18,new_zealand,Australia/Oceania,5002100,12,2938
2021-08-19,new_zealand,Australia/Oceania,5002100,16,2954
2021-08-20,new_zealand,Australia/Oceania,5002100,14,2968
2021-08-21,new_zealand,Australia/Oceania,5002100,24,2992
2021-08-22,new_zealand,Australia/Oceania,5002100,24,3016
2021-08-23,new_zealand,Australia/Oceania,5002100,38,3054
2021-08-24,new_zealand,Australia/Oceania,5002100,42,3096
2021-08-25,new_zealand,Australia/Oceania,5002100,63,3159
2021-08-26,new_zealand,Australia/Oceania,5002100,68,3227
2021-08-27,new_zealand,Australia/Oceania,5002100,70,3297
2021-08-28,new_zealand,Australia/Oceania,5002100,83,3380
2021-08-29,new_zealand,Australia/Oceania,5002100,84,3464
2021-08-30,new_zealand,Australia/Oceania,5002100,55,3519
2021-08-31,new_zealand,Australia/Oceania,5002100,50,3569
2021-09-01,new_zealand,Australia/Oceania,5002100,76,3645
2021-09-02,new_zealand,Australia/Oceania,5002100,52,3697
2021-09-03,new_zealand,Australia/Oceania,5002100,32,3729
2021-09-04,new_zealand,Australia/Oceania,5002100,19,3748
2021-09-05,new_zealand,Australia/Oceania,5002100,20,3768
2021-09-06,new_zealand,Australia/Oceania,5002100,24,3792
2021-09-07,new_zealand,Australia/Oceania,5002100,21,3813
2021-09-08,new_zealand,Australia/Oceania,5002100,16,3829
2021-09-09,new_zealand,Australia/Oceania,5002100,18,3847
2021-09-10,new_zealand,Australia/Oceania,5002100,19,3866
2021-09-11,new_zealand,Australia/Oceania,5002100,24,3890
2021-09-12,new_zealand,Australia/Oceania,5002100,23,3913
2021-09-13,new_zealand,Australia/Oceania,5002100,36,3949
2021-09-14,new_zealand,Australia/Oceania,5002100,17,3966
2021-09-15,new_zealand,Australia/Oceania,5002100,15,3981
2021-09-16,new_zealand,Australia/Oceania,5002100,18,3999
2021-09-17,new_zealand,Australia/Oceania,5002100,15,4014
2021-09-18,new_zealand,Australia/Oceania,5002100,24,4038
2021-09-19,new_zealand,Australia/Oceania,5002100,22,4060
2021-09-20,new_zealand,Australia/Oceania,5002100,22,4082
2021-09-21,new_zealand,Australia/Oceania,5002100,13,4095
2021-09-22,new_zealand,Australia/Oceania,5002100,24,4119
2021-09-23,new_zealand,Australia/Oceania,5002100,16,4135
2021-09-24,new_zealand,Australia/Oceania,5002100,9,4144
2021-09-25,new_zealand,Australia/Oceania,5002100,18,4162
2021-09-26,new_zealand,Australia/Oceania,5002100,21,4183
2021-09-27,new_zealand,Australia/Oceania,5002100,11,4194
2021-09-28,new_zealand,Australia/Oceania,5002100,10,4204
2021-09-29,new_zealand,Australia/Oceania,5002100,44,4248
2021-09-30,new_zealand,Australia/Oceania,5002100,25,4273
2021-10-01,new_zealand,Australia/Oceania,5002100,18,4291
2021-10-02,new_zealand,Australia/Oceania,5002100,28,4319
2021-10-03,new_zealand,Australia/Oceania,5002100,33,4352
2021-10-04,new_zealand,Australia/Oceania,5002100,30,4382
2021-10-05,new_zealand,Australia/Oceania,5002100,26,4408
2020-03-26,niger,Africa,25837472,3,10
2020-02-28,nigeria,Africa,215651424,1,1
2020-02-29,nigeria,Africa,215651424,0,1
2020-03-01,nigeria,Africa,215651424,0,1
2020-03-02,nigeria,Africa,215651424,0,1
2020-03-03,nigeria,Africa,215651424,0,1
2020-03-04,nigeria,Africa,215651424,0,1
2020-03-05,nigeria,Africa,215651424,0,1
2020-03-06,nigeria,Africa,215651424,0,1
2020-03-07,nigeria,Africa,215651424,0,1
2020-03-08,nigeria,Africa,215651424,0,1
2020-03-09,nigeria,Africa,215651424,1,2
2020-03-10,nigeria,Africa,215651424,0,2
2020-03-11,nigeria,Africa,215651424,0,2
2020-03-12,nigeria,Africa,215651424,0,2
2020-03-13,nigeria,Africa,215651424,0,2
2020-03-14,nigeria,Africa,215651424,0,2
2020-03-15,nigeria,Africa,215651424,0,2
2020-03-16,nigeria,Africa,215651424,0,2
2020-03-17,nigeria,Africa,215651424,1,3
2020-03-18,nigeria,Africa,215651424,5,8
2020-03-19,nigeria,Africa,215651424,4,12
2020-03-20,nigeria,Africa,215651424,0,12
2020-03-21,nigeria,Africa,215651424,10,22
2020-03-22,nigeria,Africa,215651424,8,30
2020-03-23,nigeria,Africa,215651424,10,40
2020-03-24,nigeria,Africa,215651424,4,44
2020-03-25,nigeria,Africa,215651424,7,51
2020-03-26,nigeria,Africa,215651424,14,65
2020-03-27,nigeria,Africa,215651424,5,70
2020-03-28,nigeria,Africa,215651424,27,97
2020-03-29,nigeria,Africa,215651424,14,111
2020-03-30,nigeria,Africa,215651424,20,131
2020-03-31,nigeria,Africa,215651424,4,135
2020-04-01,nigeria,Africa,215651424,39,174
2020-04-02,nigeria,Africa,215651424,10,184
2020-04-03,nigeria,Africa,215651424,26,210
2020-04-04,nigeria,Africa,215651424,4,214
2020-04-05,nigeria,Africa,215651424,18,232
2020-04-06,nigeria,Africa,215651424,6,238
2020-04-07,nigeria,Africa,215651424,16,254
2020-04-08,nigeria,Africa,215651424,22,276
2020-04-09,nigeria,Africa,215651424,12,288
2020-04-10,nigeria,Africa,215651424,17,305
2020-04-11,nigeria,Africa,215651424,13,318
2020-04-12,nigeria,Africa,215651424,5,323
2020-04-13,nigeria,Africa,215651424,20,343
2020-04-14,nigeria,Africa,215651424,30,373
2020-04-15,nigeria,Africa,215651424,34,407
2020-04-16,nigeria,Africa,215651424,35,442
2020-04-17,nigeria,Africa,215651424,51,493
2020-04-18,nigeria,Africa,215651424,49,542
2020-04-19,nigeria,Africa,215651424,85,627
2020-04-20,nigeria,Africa,215651424,38,665
2020-04-21,nigeria,Africa,215651424,117,782
2020-04-22,nigeria,Africa,215651424,91,873
2020-04-23,nigeria,Africa,215651424,108,981
2020-04-24,nigeria,Africa,215651424,114,1095
2020-04-25,nigeria,Africa,215651424,87,1182
2020-04-26,nigeria,Africa,215651424,91,1273
2020-04-27,nigeria,Africa,215651424,64,1337
2020-04-28,nigeria,Africa,215651424,195,1532
2020-04-29,nigeria,Africa,215651424,196,1728
2020-04-30,nigeria,Africa,215651424,204,1932
2020-05-01,nigeria,Africa,215651424,238,2170
2020-05-02,nigeria,Africa,215651424,218,2388
2020-05-03,nigeria,Africa,215651424,170,2558
2020-05-04,nigeria,Africa,215651424,244,2802
2020-05-05,nigeria,Africa,215651424,148,2950
2020-05-06,nigeria,Africa,215651424,195,3145
2020-05-07,nigeria,Africa,215651424,381,3526
2020-05-08,nigeria,Africa,215651424,386,3912
2020-05-09,nigeria,Africa,215651424,239,4151
2020-05-10,nigeria,Africa,215651424,248,4399
2020-05-11,nigeria,Africa,215651424,242,4641
2020-05-12,nigeria,Africa,215651424,146,4787
2020-05-13,nigeria,Africa,215651424,184,4971
2020-05-14,nigeria,Africa,215651424,191,5162
2020-05-15,nigeria,Africa,215651424,283,5445
2020-05-16,nigeria,Africa,215651424,176,5621
2020-05-17,nigeria,Africa,215651424,338,5959
2020-05-18,nigeria,Africa,215651424,216,6175
2020-05-19,nigeria,Africa,215651424,226,6401
2020-05-20,nigeria,Africa,215651424,276,6677
2020-05-21,nigeria,Africa,215651424,339,7016
2020-05-22,nigeria,Africa,215651424,245,7261
2020-05-23,nigeria,Africa,215651424,265,7526
2020-05-24,nigeria,Africa,215651424,313,7839
2020-05-25,nigeria,Africa,215651424,229,8068
2020-05-26,nigeria,Africa,215651424,276,8344
2020-05-27,nigeria,Africa,215651424,389,8733
2020-05-28,nigeria,Africa,215651424,182,8915
2020-05-29,nigeria,Africa,215651424,387,9302
2020-05-30,nigeria,Africa,215651424,553,9855
2020-05-31,nigeria,Africa,215651424,307,10162
2020-06-01,nigeria,Africa,215651424,416,10578
2020-06-02,nigeria,Africa,215651424,241,10819
2020-06-03,nigeria,Africa,215651424,347,11166
2020-06-04,nigeria,Africa,215651424,350,11516
2020-06-05,nigeria,Africa,215651424,328,11844
2020-06-06,nigeria,Africa,215651424,389,12233
2020-06-07,nigeria,Africa,215651424,253,12486
2020-06-08,nigeria,Africa,215651424,315,12801
2020-06-09,nigeria,Africa,215651424,663,13464
2020-06-10,nigeria,Africa,215651424,409,13873
2020-06-11,nigeria,Africa,215651424,681,14554
2020-06-12,nigeria,Africa,215651424,627,15181
2020-06-13,nigeria,Africa,215651424,501,15682
2020-06-14,nigeria,Africa,215651424,403,16085
2020-06-15,nigeria,Africa,215651424,573,16658
2020-06-16,nigeria,Africa,215651424,490,17148
2020-06-17,nigeria,Africa,215651424,587,17735
2020-06-18,nigeria,Africa,215651424,745,18480
2020-06-19,nigeria,Africa,215651424,667,19147
2020-06-20,nigeria,Africa,215651424,661,19808
2020-06-21,nigeria,Africa,215651424,436,20244
2020-06-22,nigeria,Africa,215651424,675,20919
2020-06-23,nigeria,Africa,215651424,452,21371
2020-06-24,nigeria,Africa,215651424,649,22020
2020-06-25,nigeria,Africa,215651424,594,22614
2020-06-26,nigeria,Africa,215651424,684,23298
2020-06-27,nigeria,Africa,215651424,779,24077
2020-06-28,nigeria,Africa,215651424,490,24567
2020-06-29,nigeria,Africa,215651424,566,25133
2020-06-30,nigeria,Africa,215651424,561,25694
2020-07-01,nigeria,Africa,215651424,790,26484
2020-07-02,nigeria,Africa,215651424,626,27110
2020-07-03,nigeria,Africa,215651424,454,27564
2020-07-04,nigeria,Africa,215651424,603,28167
2020-07-05,nigeria,Africa,215651424,544,28711
2020-07-06,nigeria,Africa,215651424,575,29286
2020-07-07,nigeria,Africa,215651424,503,29789
2020-07-08,nigeria,Africa,215651424,460,30249
2020-07-09,nigeria,Africa,215651424,499,30748
2020-07-10,nigeria,Africa,215651424,575,31323
2020-07-11,nigeria,Africa,215651424,664,31987
2020-07-12,nigeria,Africa,215651424,571,32558
2020-07-13,nigeria,Africa,215651424,595,33153
2020-07-14,nigeria,Africa,215651424,463,33616
2020-07-15,nigeria,Africa,215651424,643,34259
2020-07-16,nigeria,Africa,215651424,595,34854
2020-07-17,nigeria,Africa,215651424,600,35454
2020-07-18,nigeria,Africa,215651424,653,36107
2020-07-19,nigeria,Africa,215651424,556,36663
2020-07-20,nigeria,Africa,215651424,562,37225
2020-07-21,nigeria,Africa,215651424,576,37801
2020-07-22,nigeria,Africa,215651424,543,38344
2020-07-23,nigeria,Africa,215651424,604,38948
2020-07-24,nigeria,Africa,215651424,591,39539
2020-07-25,nigeria,Africa,215651424,438,39977
2020-07-26,nigeria,Africa,215651424,555,40532
2020-07-27,nigeria,Africa,215651424,648,41180
2020-07-28,nigeria,Africa,215651424,624,41804
2020-07-29,nigeria,Africa,215651424,404,42208
2020-07-30,nigeria,Africa,215651424,481,42689
2020-07-31,nigeria,Africa,215651424,462,43151
2020-08-01,nigeria,Africa,215651424,386,43537
2020-08-02,nigeria,Africa,215651424,304,43841
2020-08-03,nigeria,Africa,215651424,288,44129
2020-08-04,nigeria,Africa,215651424,304,44433
2020-08-05,nigeria,Africa,215651424,457,44890
2020-08-06,nigeria,Africa,215651424,354,45244
2020-08-07,nigeria,Africa,215651424,443,45687
2020-08-08,nigeria,Africa,215651424,453,46140
2020-08-09,nigeria,Africa,215651424,437,46577
2020-08-10,nigeria,Africa,215651424,290,46867
2020-08-11,nigeria,Africa,215651424,423,47290
2020-08-12,nigeria,Africa,215651424,453,47743
2020-08-13,nigeria,Africa,215651424,373,48116
2020-08-14,nigeria,Africa,215651424,329,48445
2020-08-15,nigeria,Africa,215651424,325,48770
2020-08-16,nigeria,Africa,215651424,298,49068
2020-08-17,nigeria,Africa,215651424,417,49485
2020-08-18,nigeria,Africa,215651424,410,49895
2020-08-19,nigeria,Africa,215651424,593,50488
2020-08-20,nigeria,Africa,215651424,476,50964
2020-08-21,nigeria,Africa,215651424,340,51304
2020-08-22,nigeria,Africa,215651424,601,51905
2020-08-23,nigeria,Africa,215651424,322,52227
2020-08-24,nigeria,Africa,215651424,321,52548
2020-08-25,nigeria,Africa,215651424,252,52800
2020-08-26,nigeria,Africa,215651424,221,53021
2020-08-27,nigeria,Africa,215651424,296,53317
2020-08-28,nigeria,Africa,215651424,160,53477
2020-08-29,nigeria,Africa,215651424,250,53727
2020-08-30,nigeria,Africa,215651424,138,53865
2020-08-31,nigeria,Africa,215651424,143,54008
2020-09-01,nigeria,Africa,215651424,239,54247
2020-09-02,nigeria,Africa,215651424,216,54463
2020-09-03,nigeria,Africa,215651424,124,54587
2020-09-04,nigeria,Africa,215651424,156,54743
2020-09-05,nigeria,Africa,215651424,162,54905
2020-09-06,nigeria,Africa,215651424,100,55005
2020-09-07,nigeria,Africa,215651424,155,55160
2020-09-08,nigeria,Africa,215651424,296,55456
2020-09-09,nigeria,Africa,215651424,176,55632
2020-09-10,nigeria,Africa,215651424,197,55829
2020-09-11,nigeria,Africa,215651424,188,56017
2020-09-12,nigeria,Africa,215651424,160,56177
2020-09-13,nigeria,Africa,215651424,79,56256
2020-09-14,nigeria,Africa,215651424,132,56388
2020-09-15,nigeria,Africa,215651424,90,56478
2020-09-16,nigeria,Africa,215651424,126,56604
2020-09-17,nigeria,Africa,215651424,131,56735
2020-09-18,nigeria,Africa,215651424,221,56956
2020-09-19,nigeria,Africa,215651424,189,57145
2020-09-20,nigeria,Africa,215651424,97,57242
2020-09-21,nigeria,Africa,215651424,195,57437
2020-09-22,nigeria,Africa,215651424,176,57613
2020-09-23,nigeria,Africa,215651424,111,57724
2020-09-24,nigeria,Africa,215651424,125,57849
2020-09-25,nigeria,Africa,215651424,213,58062
2020-09-26,nigeria,Africa,215651424,136,58198
2020-09-27,nigeria,Africa,215651424,126,58324
2020-09-28,nigeria,Africa,215651424,136,58460
2020-09-29,nigeria,Africa,215651424,187,58647
2020-09-30,nigeria,Africa,215651424,201,58848
2020-10-01,nigeria,Africa,215651424,153,59001
2020-10-02,nigeria,Africa,215651424,126,59127
2020-10-03,nigeria,Africa,215651424,160,59287
2020-10-04,nigeria,Africa,215651424,58,59345
2020-10-05,nigeria,Africa,215651424,120,59465
2020-02-25,oman,Asia,5348410,2,4
2020-02-26,oman,Asia,5348410,0,4
2020-02-27,oman,Asia,5348410,2,6
2020-02-28,oman,Asia,5348410,0,6
2020-02-29,oman,Asia,5348410,0,6
2020-03-01,oman,Asia,5348410,0,6
2020-03-02,oman,Asia,5348410,0,6
2020-03-03,oman,Asia,5348410,6,12
2020-03-04,oman,Asia,5348410,3,15
2020-03-05,oman,Asia,5348410,1,16
2020-03-06,oman,Asia,5348410,0,16
2020-03-07,oman,Asia,5348410,0,16
2020-03-08,oman,Asia,5348410,0,16
2020-03-09,oman,Asia,5348410,2,18
2020-03-10,oman,Asia,5348410,0,18
2020-03-11,oman,Asia,5348410,0,18
2020-03-12,oman,Asia,5348410,0,18
2020-03-13,oman,Asia,5348410,1,19
2020-03-14,oman,Asia,5348410,1,20
2020-03-15,oman,Asia,5348410,2,22
2020-03-16,oman,Asia,5348410,2,24
2020-03-17,oman,Asia,5348410,9,33
2020-03-18,oman,Asia,5348410,6,39
2020-03-19,oman,Asia,5348410,9,48
2020-03-20,oman,Asia,5348410,0,48
2020-03-21,oman,Asia,5348410,4,52
2020-03-22,oman,Asia,5348410,3,55
2020-03-23,oman,Asia,5348410,11,66
2020-03-24,oman,Asia,5348410,18,84
2020-03-25,oman,Asia,5348410,15,99
2020-03-26,oman,Asia,5348410,10,109
2020-03-27,oman,Asia,5348410,22,131
2020-03-28,oman,Asia,5348410,21,152
2020-03-29,oman,Asia,5348410,15,167
2020-03-30,oman,Asia,5348410,12,179
2020-03-31,oman,Asia,5348410,13,192
2020-04-01,oman,Asia,5348410,18,210
2020-04-02,oman,Asia,5348410,21,231
2020-04-03,oman,Asia,5348410,21,252
2020-04-04,oman,Asia,5348410,25,277
2020-04-05,oman,Asia,5348410,21,298
2020-04-06,oman,Asia,5348410,33,331
2020-04-07,oman,Asia,5348410,40,371
2020-04-08,oman,Asia,5348410,48,419
2020-04-09,oman,Asia,5348410,38,457
2020-04-10,oman,Asia,5348410,27,484
2020-04-11,oman,Asia,5348410,62,546
2020-04-12,oman,Asia,5348410,53,599
2020-04-13,oman,Asia,5348410,128,727
2020-04-14,oman,Asia,5348410,86,813
2020-04-15,oman,Asia,5348410,97,910
2020-04-16,oman,Asia,5348410,109,1019
2020-04-17,oman,Asia,5348410,50,1069
2020-04-18,oman,Asia,5348410,111,1180
2020-04-19,oman,Asia,5348410,86,1266
2020-04-20,oman,Asia,5348410,144,1410
2020-04-21,oman,Asia,5348410,98,1508
2020-04-22,oman,Asia,5348410,106,1614
2020-04-23,oman,Asia,5348410,102,1716
2020-04-24,oman,Asia,5348410,74,1790
2020-04-25,oman,Asia,5348410,115,1905
2020-04-26,oman,Asia,5348410,93,1998
2020-04-27,oman,Asia,5348410,51,2049
2020-04-28,oman,Asia,5348410,82,2131
2020-04-29,oman,Asia,5348410,143,2274
2020-04-30,oman,Asia,5348410,74,2348
2020-05-01,oman,Asia,5348410,99,2447
2020-05-02,oman,Asia,5348410,36,2483
2020-05-03,oman,Asia,5348410,85,2568
2020-05-04,oman,Asia,5348410,69,2637
2020-05-05,oman,Asia,5348410,98,2735
2020-05-06,oman,Asia,5348410,168,2903
2020-05-07,oman,Asia,5348410,55,2958
2020-05-08,oman,Asia,5348410,154,3112
2020-05-09,oman,Asia,5348410,112,3224
2020-05-10,oman,Asia,5348410,175,3399
2020-05-11,oman,Asia,5348410,174,3573
2020-05-12,oman,Asia,5348410,148,3721
2020-05-13,oman,Asia,5348410,298,4019
2020-05-14,oman,Asia,5348410,322,4341
2020-05-15,oman,Asia,5348410,284,4625
2020-05-16,oman,Asia,5348410,404,5029
2020-05-17,oman,Asia,5348410,157,5186
2020-05-18,oman,Asia,5348410,193,5379
2020-05-19,oman,Asia,5348410,292,5671
2020-05-20,oman,Asia,5348410,372,6043
2020-05-21,oman,Asia,5348410,327,6370
2020-05-22,oman,Asia,5348410,424,6794
2020-05-23,oman,Asia,5348410,463,7257
2020-05-24,oman,Asia,5348410,513,7770
2020-05-25,oman,Asia,5348410,0,7770
2020-05-26,oman,Asia,5348410,348,8118
2020-05-27,oman,Asia,5348410,255,8373
2020-05-28,oman,Asia,5348410,636,9009
2020-05-29,oman,Asia,5348410,811,9820
2020-05-30,oman,Asia,5348410,603,10423
2020-05-31,oman,Asia,5348410,1014,11437
2020-06-01,oman,Asia,5348410,786,12223
2020-06-02,oman,Asia,5348410,576,12799
2020-06-03,oman,Asia,5348410,739,13538
2020-06-04,oman,Asia,5348410,778,14316
2020-06-05,oman,Asia,5348410,770,15086
2020-06-06,oman,Asia,5348410,930,16016
2020-06-07,oman,Asia,5348410,866,16882
2020-06-08,oman,Asia,5348410,604,17486
2020-06-09,oman,Asia,5348410,712,18198
2020-06-10,oman,Asia,5348410,689,18887
2020-06-11,oman,Asia,5348410,1067,19954
2020-06-12,oman,Asia,5348410,1117,21071
2020-06-13,oman,Asia,5348410,1006,22077
2020-06-14,oman,Asia,5348410,1404,23481
2020-06-15,oman,Asia,5348410,1043,24524
2020-06-16,oman,Asia,5348410,745,25269
2020-06-17,oman,Asia,5348410,810,26079
2020-06-18,oman,Asia,5348410,739,26818
2020-06-19,oman,Asia,5348410,852,27670
2020-06-20,oman,Asia,5348410,896,28566
2020-06-21,oman,Asia,5348410,905,29471
2020-06-22,oman,Asia,5348410,1605,31076
2020-06-23,oman,Asia,5348410,1318,32394
2020-06-24,oman,Asia,5348410,1142,33536
2020-06-25,oman,Asia,5348410,1366,34902
2020-06-26,oman,Asia,5348410,1132,36034
2020-06-27,oman,Asia,5348410,919,36953
2020-06-28,oman,Asia,5348410,1197,38150
2020-06-29,oman,Asia,5348410,910,39060
2020-06-30,oman,Asia,5348410,1010,40070
2020-07-01,oman,Asia,5348410,1124,41194
2020-07-02,oman,Asia,5348410,1361,42555
2020-07-03,oman,Asia,5348410,1374,43929
2020-07-04,oman,Asia,5348410,1177,45106
2020-07-05,oman,Asia,5348410,1072,46178
2020-07-06,oman,Asia,5348410,1557,47735
2020-07-07,oman,Asia,5348410,1262,48997
2020-07-08,oman,Asia,5348410,1210,50207
2020-07-09,oman,Asia,5348410,1518,51725
2020-07-10,oman,Asia,5348410,1889,53614
2020-07-11,oman,Asia,5348410,1083,54697
2020-07-12,oman,Asia,5348410,1318,56015
2020-07-13,oman,Asia,5348410,2164,58179
2020-07-14,oman,Asia,5348410,1389,59568
2020-07-15,oman,Asia,5348410,1679,61247
2020-07-16,oman,Asia,5348410,1327,62574
2020-07-17,oman,Asia,5348410,1619,64193
2020-07-18,oman,Asia,5348410,1311,65504
2020-07-19,oman,Asia,5348410,1157,66661
2020-07-20,oman,Asia,5348410,1739,68400
2020-07-21,oman,Asia,5348410,1487,69887
2020-07-22,oman,Asia,5348410,1660,71547
2020-07-23,oman,Asia,5348410,1099,72646
2020-07-24,oman,Asia,5348410,1145,73791
2020-07-25,oman,Asia,5348410,1067,74858
2020-07-26,oman,Asia,5348410,1147,76005
2020-07-27,oman,Asia,5348410,1053,77058
2020-07-28,oman,Asia,5348410,846,77904
2020-07-29,oman,Asia,5348410,665,78569
2020-07-30,oman,Asia,5348410,590,79159
2020-07-31,oman,Asia,5348410,108,79267
2020-08-01,oman,Asia,5348410,108,79375
2020-08-02,oman,Asia,5348410,108,79483
2020-08-03,oman,Asia,5348410,110,79593
2020-08-04,oman,Asia,5348410,108,79701
2020-08-05,oman,Asia,5348410,585,80286
2020-08-06,oman,Asia,5348410,427,80713
2020-08-07,oman,Asia,5348410,354,81067
2020-08-08,oman,Asia,5348410,290,81357
2020-08-09,oman,Asia,5348410,223,81580
2020-08-10,oman,Asia,5348410,207,81787
2020-08-11,oman,Asia,5348410,263,82050
2020-08-12,oman,Asia,5348410,249,82299
2020-08-13,oman,Asia,5348410,232,82531
2020-08-14,oman,Asia,5348410,212,82743
2020-08-15,oman,Asia,5348410,181,82924
2020-08-16,oman,Asia,5348410,162,83086
2020-08-17,oman,Asia,5348410,140,83226
2020-08-18,oman,Asia,5348410,192,83418
2020-08-19,oman,Asia,5348410,188,83606
2020-08-20,oman,Asia,5348410,163,83769
2020-08-21,oman,Asia,5348410,0,83769
2020-08-22,oman,Asia,5348410,0,83769
2020-08-23,oman,Asia,5348410,0,83769
2020-08-24,oman,Asia,5348410,740,84509
2020-08-25,oman,Asia,5348410,143,84652
2020-08-26,oman,Asia,5348410,166,84818
2020-08-27,oman,Asia,5348410,187,85005
2020-08-28,oman,Asia,5348410,0,85005
2020-08-29,oman,Asia,5348410,0,85005
2020-08-30,oman,Asia,5348410,539,85544
2020-08-31,oman,Asia,5348410,178,85722
2020-09-01,oman,Asia,5348410,206,85928
2020-09-02,oman,Asia,5348410,196,86124
2020-09-03,oman,Asia,5348410,256,86380
2020-09-04,oman,Asia,5348410,0,86380
2020-09-05,oman,Asia,5348410,0,86380
2020-09-06,oman,Asia,5348410,692,87072
2020-09-07,oman,Asia,5348410,256,87328
2020-09-08,oman,Asia,5348410,262,87590
2020-09-09,oman,Asia,5348410,349,87939
2020-09-10,oman,Asia,5348410,398,88337
2020-09-11,oman,Asia,5348410,0,88337
2020-09-12,oman,Asia,5348410,0,88337
2020-09-13,oman,Asia,5348410,1409,89746
2020-09-14,oman,Asia,5348410,476,90222
2020-09-15,oman,Asia,5348410,438,90660
2020-09-16,oman,Asia,5348410,536,91196
2020-09-17,oman,Asia,5348410,557,91753
2020-09-18,oman,Asia,5348410,0,91753
2020-09-19,oman,Asia,5348410,0,91753
2020-09-20,oman,Asia,5348410,1722,93475
2020-09-21,oman,Asia,5348410,576,94051
2020-09-22,oman,Asia,5348410,660,94711
2020-09-23,oman,Asia,5348410,628,95339
2020-09-24,oman,Asia,5348410,568,95907
2020-09-25,oman,Asia,5348410,0,95907
2020-09-26,oman,Asia,5348410,0,95907
2020-09-27,oman,Asia,5348410,1543,97450
2020-09-28,oman,Asia,5348410,607,98057
2020-09-29,oman,Asia,5348410,528,98585
2020-09-30,oman,Asia,5348410,0,98585
2020-10-01,oman,Asia,5348410,0,98585
2020-10-02,oman,Asia,5348410,0,98585
2020-10-03,oman,Asia,5348410,0,98585
2020-10-04,oman,Asia,5348410,2685,101270
2020-10-05,oman,Asia,5348410,544,101814
2020-10-06,oman,Asia,5348410,834,102648
2020-10-07,oman,Asia,5348410,817,103465
2020-10-08,oman,Asia,5348410,664,104129
2020-10-09,oman,Asia,5348410,0,104129
2020-10-10,oman,Asia,5348410,0,104129
2020-10-11,oman,Asia,5348410,1761,105890
2020-10-12,oman,Asia,5348410,685,106575
2020-10-13,oman,Asia,5348410,638,107213
2020-10-14,oman,Asia,5348410,563,107776
2020-10-15,oman,Asia,5348410,520,108296
2020-10-16,oman,Asia,5348410,0,108296
2020-10-17,oman,Asia,5348410,0,108296
2020-10-18,oman,Asia,5348410,1657,109953
2020-10-19,oman,Asia,5348410,641,110594
2020-10-20,oman,Asia,5348410,439,111033
2020-10-21,oman,Asia,5348410,451,111484
2020-10-22,oman,Asia,5348410,353,111837
2020-10-23,oman,Asia,5348410,0,111837
2020-10-24,oman,Asia,5348410,0,111837
2020-10-25,oman,Asia,5348410,1095,112932
2020-10-26,oman,Asia,5348410,422,113354
2020-10-27,oman,Asia,5348410,466,113820
2020-10-28,oman,Asia,5348410,614,114434
2020-10-29,oman,Asia,5348410,0,114434
2020-10-30,oman,Asia,5348410,0,114434
2020-10-31,oman,Asia,5348410,0,114434
2020-11-01,oman,Asia,5348410,1300,115734
2020-11-02,oman,Asia,5348410,418,116152
2020-11-03,oman,Asia,5348410,376,116528
2020-11-04,oman,Asia,5348410,319,116847
2020-11-05,oman,Asia,5348410,320,117167
2020-11-06,oman,Asia,5348410,0,117167
2020-11-07,oman,Asia,5348410,0,117167
2020-11-08,oman,Asia,5348410,973,118140
2020-11-09,oman,Asia,5348410,363,118503
2020-11-10,oman,Asia,5348410,381,118884
2020-11-11,oman,Asia,5348410,302,119186
2020-11-12,oman,Asia,5348410,256,119442
2020-11-13,oman,Asia,5348410,0,119442
2020-11-14,oman,Asia,5348410,0,119442
2020-11-15,oman,Asia,5348410,947,120389
2020-11-16,oman,Asia,5348410,329,120718
2020-11-17,oman,Asia,5348410,0,120718
2020-11-18,oman,Asia,5348410,411,121129
2020-11-19,oman,Asia,5348410,231,121360
2020-11-20,oman,Asia,5348410,0,121360
2020-11-21,oman,Asia,5348410,0,121360
2020-11-22,oman,Asia,5348410,721,122081
2020-11-23,oman,Asia,5348410,275,122356
2020-11-24,oman,Asia,5348410,223,122579
2020-11-25,oman,Asia,5348410,0,122579
2020-11-26,oman,Asia,5348410,0,122579
2020-11-27,oman,Asia,5348410,0,122579
2020-11-28,oman,Asia,5348410,0,122579
2020-11-29,oman,Asia,5348410,905,123484
2020-11-30,oman,Asia,5348410,215,123699
2020-12-01,oman,Asia,5348410,209,123908
2020-12-02,oman,Asia,5348410,237,124145
2020-12-03,oman,Asia,5348410,184,124329
2020-12-04,oman,Asia,5348410,0,124329
2020-12-05,oman,Asia,5348410,0,124329
2020-12-06,oman,Asia,5348410,557,124886
2020-12-07,oman,Asia,5348410,229,125115
2020-12-08,oman,Asia,5348410,210,125325
2020-12-09,oman,Asia,5348410,165,125490
2020-12-10,oman,Asia,5348410,179,125669
2020-12-11,oman,Asia,5348410,0,125669
2020-12-12,oman,Asia,5348410,0,125669
2020-12-13,oman,Asia,5348410,571,126240
2020-12-14,oman,Asia,5348410,264,126504
2020-12-15,oman,Asia,5348410,215,126719
2020-12-16,oman,Asia,5348410,116,126835
2020-12-17,oman,Asia,5348410,184,127019
2020-12-18,oman,Asia,5348410,0,127019
2020-12-19,oman,Asia,5348410,0,127019
2020-12-20,oman,Asia,5348410,648,127667
2020-12-21,oman,Asia,5348410,264,127931
2020-12-22,oman,Asia,5348410,212,128143
2020-12-23,oman,Asia,5348410,93,128236
2020-12-24,oman,Asia,5348410,54,128290
2020-12-25,oman,Asia,5348410,0,128290
2020-12-26,oman,Asia,5348410,0,128290
2020-12-27,oman,Asia,5348410,182,128472
2020-12-28,oman,Asia,5348410,91,128563
2020-12-29,oman,Asia,5348410,70,128633
2020-12-30,oman,Asia,5348410,86,128719
2020-12-31,oman,Asia,5348410,148,128867
2021-01-01,oman,Asia,5348410,0,128867
2021-01-02,oman,Asia,5348410,0,128867
2021-01-03,oman,Asia,5348410,537,129404
2021-01-04,oman,Asia,5348410,180,129584
2021-01-05,oman,Asia,5348410,190,129774
2021-01-06,oman,Asia,5348410,114,129888
2021-01-07,oman,Asia,5348410,182,130070
2021-01-08,oman,Asia,5348410,0,130070
2021-01-09,oman,Asia,5348410,0,130070
2021-01-10,oman,Asia,5348410,538,130608
2021-01-11,oman,Asia,5348410,172,130780
2021-01-12,oman,Asia,5348410,164,130944
2021-01-13,oman,Asia,5348410,142,131086
2021-01-14,oman,Asia,5348410,178,131264
2021-01-15,oman,Asia,5348410,0,131264
2021-01-16,oman,Asia,5348410,0,131264
2021-01-17,oman,Asia,5348410,526,131790
2021-01-18,oman,Asia,5348410,221,132011
2021-01-19,oman,Asia,5348410,135,132146
2021-01-20,oman,Asia,5348410,171,132317
2021-01-21,oman,Asia,5348410,169,132486
2021-01-22,oman,Asia,5348410,0,132486
2021-01-23,oman,Asia,5348410,0,132486
2021-01-24,oman,Asia,5348410,558,133044
2021-01-25,oman,Asia,5348410,209,133253
2021-01-26,oman,Asia,5348410,154,133407
2021-01-27,oman,Asia,5348410,167,133574
2021-01-28,oman,Asia,5348410,154,133728
2021-01-29,oman,Asia,5348410,0,133728
2021-01-30,oman,Asia,5348410,0,133728
2021-01-31,oman,Asia,5348410,598,134326
2021-02-01,oman,Asia,5348410,198,134524
2021-02-02,oman,Asia,5348410,161,134685
2021-02-03,oman,Asia,5348410,171,134856
2021-02-04,oman,Asia,5348410,185,135041
2021-02-05,oman,Asia,5348410,0,135041
2021-02-06,oman,Asia,5348410,0,135041
2021-02-07,oman,Asia,5348410,633,135674
2021-02-08,oman,Asia,5348410,316,135990
2021-02-09,oman,Asia,5348410,197,136187
2021-02-10,oman,Asia,5348410,190,136377
2021-02-11,oman,Asia,5348410,245,136622
2021-02-12,oman,Asia,5348410,0,136622
2021-02-13,oman,Asia,5348410,0,136622
2021-02-14,oman,Asia,5348410,684,137306
2021-02-15,oman,Asia,5348410,286,137592
2021-02-16,oman,Asia,5348410,337,137929
2021-02-17,oman,Asia,5348410,277,138206
2021-02-18,oman,Asia,5348410,288,138494
2021-02-19,oman,Asia,5348410,0,138494
2021-02-20,oman,Asia,5348410,0,138494
2021-02-21,oman,Asia,5348410,868,139362
2021-02-22,oman,Asia,5348410,330,139692
2021-02-23,oman,Asia,5348410,297,139989
2021-02-24,oman,Asia,5348410,311,140300
2021-02-25,oman,Asia,5348410,288,140588
2021-02-26,oman,Asia,5348410,0,140588
2021-02-27,oman,Asia,5348410,0,140588
2021-02-28,oman,Asia,5348410,908,141496
2021-03-01,oman,Asia,5348410,312,141808
2021-03-02,oman,Asia,5348410,361,142169
2021-03-03,oman,Asia,5348410,358,142527
2021-03-04,oman,Asia,5348410,369,142896
2021-03-05,oman,Asia,5348410,0,142896
2021-03-06,oman,Asia,5348410,0,142896
2021-03-07,oman,Asia,5348410,1059,143955
2021-03-08,oman,Asia,5348410,449,144404
2021-03-09,oman,Asia,5348410,427,144831
2021-03-10,oman,Asia,5348410,426,145257
2021-03-11,oman,Asia,5348410,0,145257
2021-03-12,oman,Asia,5348410,0,145257
2021-03-13,oman,Asia,5348410,0,145257
2021-03-14,oman,Asia,5348410,1610,146867
2021-03-15,oman,Asia,5348410,556,147423
2021-03-16,oman,Asia,5348410,587,148010
2021-03-17,oman,Asia,5348410,548,148558
2021-03-18,oman,Asia,5348410,577,149135
2021-03-19,oman,Asia,5348410,0,149135
2021-03-20,oman,Asia,5348410,0,149135
2021-03-21,oman,Asia,5348410,1665,150800
2021-03-22,oman,Asia,5348410,728,151528
2021-03-23,oman,Asia,5348410,836,152364
2021-03-24,oman,Asia,5348410,741,153105
2021-03-25,oman,Asia,5348410,733,153838
2021-03-26,oman,Asia,5348410,0,153838
2021-03-27,oman,Asia,5348410,0,153838
2021-03-28,oman,Asia,5348410,2249,156087
2021-03-29,oman,Asia,5348410,796,156883
2021-03-30,oman,Asia,5348410,1173,158056
2021-03-31,oman,Asia,5348410,1162,159218
2021-04-01,oman,Asia,5348410,800,160018
2021-04-02,oman,Asia,5348410,0,160018
2021-04-03,oman,Asia,5348410,0,160018
2021-04-04,oman,Asia,5348410,3139,163157
2021-04-05,oman,Asia,5348410,1117,164274
2021-04-06,oman,Asia,5348410,1206,165480
2021-04-07,oman,Asia,5348410,1205,166685
2021-04-08,oman,Asia,5348410,1320,168005
2021-04-09,oman,Asia,5348410,0,168005
2021-04-10,oman,Asia,5348410,0,168005
2021-04-11,oman,Asia,5348410,3544,171549
2021-04-12,oman,Asia,5348410,1480,173029
2021-04-13,oman,Asia,5348410,1335,174364
2020-02-27,pakistan,Asia,228878790,0,2
2020-02-28,pakistan,Asia,228878790,0,2
2020-02-29,pakistan,Asia,228878790,2,4
2020-03-01,pakistan,Asia,228878790,0,4
2020-03-02,pakistan,Asia,228878790,0,4
2020-03-03,pakistan,Asia,228878790,1,5
2020-03-04,pakistan,Asia,228878790,0,5
2020-03-05,pakistan,Asia,228878790,0,5
2020-03-06,pakistan,Asia,228878790,1,6
2020-03-07,pakistan,Asia,228878790,0,6
2020-03-08,pakistan,Asia,228878790,1,7
2020-03-09,pakistan,Asia,228878790,9,16
2020-03-10,pakistan,Asia,228878790,3,19
2020-03-11,pakistan,Asia,228878790,1,20
2020-03-12,pakistan,Asia,228878790,1,21
2020-03-13,pakistan,Asia,228878790,7,28
2020-03-14,pakistan,Asia,228878790,5,33
2020-03-15,pakistan,Asia,228878790,20,53
2020-03-16,pakistan,Asia,228878790,131,184
2020-03-17,pakistan,Asia,228878790,63,247
2020-03-18,pakistan,Asia,228878790,60,307
2020-03-19,pakistan,Asia,228878790,147,454
2020-03-20,pakistan,Asia,228878790,47,501
2020-03-21,pakistan,Asia,228878790,144,645
2020-03-22,pakistan,Asia,228878790,131,776
2020-03-23,pakistan,Asia,228878790,99,875
2020-03-24,pakistan,Asia,228878790,97,972
2020-03-25,pakistan,Asia,228878790,91,1063
2020-03-26,pakistan,Asia,228878790,138,1201
2020-03-27,pakistan,Asia,228878790,172,1373
2020-03-28,pakistan,Asia,228878790,122,1495
2020-03-29,pakistan,Asia,228878790,102,1597
2020-03-30,pakistan,Asia,228878790,120,1717
2020-03-31,pakistan,Asia,228878790,221,1938
2020-04-01,pakistan,Asia,228878790,180,2118
2020-04-02,pakistan,Asia,228878790,303,2421
2020-04-03,pakistan,Asia,228878790,265,2686
2020-04-04,pakistan,Asia,228878790,132,2818
2020-04-05,pakistan,Asia,228878790,339,3157
2020-04-06,pakistan,Asia,228878790,609,3766
2020-04-07,pakistan,Asia,228878790,269,4035
2020-04-08,pakistan,Asia,228878790,228,4263
2020-04-09,pakistan,Asia,228878790,226,4489
2020-04-10,pakistan,Asia,228878790,206,4695
2020-04-11,pakistan,Asia,228878790,316,5011
2020-04-12,pakistan,Asia,228878790,219,5230
2020-04-13,pakistan,Asia,228878790,266,5496
2020-04-14,pakistan,Asia,228878790,341,5837
2020-04-15,pakistan,Asia,228878790,546,6383
2020-04-16,pakistan,Asia,228878790,536,6919
2020-04-17,pakistan,Asia,228878790,106,7025
2020-04-18,pakistan,Asia,228878790,613,7638
2020-04-19,pakistan,Asia,228878790,710,8348
2020-04-20,pakistan,Asia,228878790,544,8892
2020-04-21,pakistan,Asia,228878790,673,9565
2020-04-22,pakistan,Asia,228878790,511,10076
2020-04-23,pakistan,Asia,228878790,981,11057
2020-04-24,pakistan,Asia,228878790,883,11940
2020-04-25,pakistan,Asia,228878790,783,12723
2020-04-26,pakistan,Asia,228878790,605,13328
2020-04-27,pakistan,Asia,228878790,587,13915
2020-04-28,pakistan,Asia,228878790,697,14612
2020-04-29,pakistan,Asia,228878790,913,15525
2020-04-30,pakistan,Asia,228878790,948,16473
2020-05-01,pakistan,Asia,228878790,1619,18092
2020-05-02,pakistan,Asia,228878790,930,19022
2020-05-03,pakistan,Asia,228878790,1062,20084
2020-05-04,pakistan,Asia,228878790,857,20941
2020-05-05,pakistan,Asia,228878790,1108,22049
2020-05-06,pakistan,Asia,228878790,1165,23214
2020-05-07,pakistan,Asia,228878790,1430,24644
2020-05-08,pakistan,Asia,228878790,1791,26435
2020-05-09,pakistan,Asia,228878790,2301,28736
2020-05-10,pakistan,Asia,228878790,1598,30334
2020-05-11,pakistan,Asia,228878790,607,30941
2020-05-12,pakistan,Asia,228878790,1733,32674
2020-05-13,pakistan,Asia,228878790,2624,35298
2020-05-14,pakistan,Asia,228878790,490,35788
2020-05-15,pakistan,Asia,228878790,1430,37218
2020-05-16,pakistan,Asia,228878790,1581,38799
2020-05-17,pakistan,Asia,228878790,1352,40151
2020-05-18,pakistan,Asia,228878790,1974,42125
2020-05-19,pakistan,Asia,228878790,1841,43966
2020-05-20,pakistan,Asia,228878790,1932,45898
2020-05-21,pakistan,Asia,228878790,2193,48091
2020-05-22,pakistan,Asia,228878790,2603,50694
2020-05-23,pakistan,Asia,228878790,1743,52437
2020-05-24,pakistan,Asia,228878790,2164,54601
2020-05-25,pakistan,Asia,228878790,1748,56349
2020-05-26,pakistan,Asia,228878790,1356,57705
2020-05-27,pakistan,Asia,228878790,1446,59151
2020-05-28,pakistan,Asia,228878790,2076,61227
2020-05-29,pakistan,Asia,228878790,2801,64028
2020-05-30,pakistan,Asia,228878790,2429,66457
2020-05-31,pakistan,Asia,228878790,3039,69496
2020-06-01,pakistan,Asia,228878790,2964,72460
2020-06-02,pakistan,Asia,228878790,3938,76398
2020-06-03,pakistan,Asia,228878790,4065,80463
2020-06-04,pakistan,Asia,228878790,4801,85264
2020-06-05,pakistan,Asia,228878790,3985,89249
2020-06-06,pakistan,Asia,228878790,4734,93983
2020-06-07,pakistan,Asia,228878790,4960,98943
2020-06-08,pakistan,Asia,228878790,4728,103671
2020-06-09,pakistan,Asia,228878790,4646,108317
2020-06-10,pakistan,Asia,228878790,5385,113702
2020-06-11,pakistan,Asia,228878790,5834,119536
2020-06-12,pakistan,Asia,228878790,6397,125933
2020-06-13,pakistan,Asia,228878790,6472,132405
2020-06-14,pakistan,Asia,228878790,6825,139230
2020-06-15,pakistan,Asia,228878790,5248,144478
2020-06-16,pakistan,Asia,228878790,4443,148921
2020-06-17,pakistan,Asia,228878790,5839,154760
2020-06-18,pakistan,Asia,228878790,5358,160118
2020-06-19,pakistan,Asia,228878790,4944,165062
2020-06-20,pakistan,Asia,228878790,6604,171666
2020-06-21,pakistan,Asia,228878790,4951,176617
2020-06-22,pakistan,Asia,228878790,4471,181088
2020-06-23,pakistan,Asia,228878790,3946,185034
2020-06-24,pakistan,Asia,228878790,3892,188926
2020-06-25,pakistan,Asia,228878790,4044,192970
2020-06-26,pakistan,Asia,228878790,2775,195745
2020-06-27,pakistan,Asia,228878790,3138,198883
2020-06-28,pakistan,Asia,228878790,4072,202955
2020-06-29,pakistan,Asia,228878790,3557,206512
2020-06-30,pakistan,Asia,228878790,2825,209337
2020-07-01,pakistan,Asia,228878790,4133,213470
2020-07-02,pakistan,Asia,228878790,4339,217809
2020-07-03,pakistan,Asia,228878790,4087,221896
2020-07-04,pakistan,Asia,228878790,3387,225283
2020-07-05,pakistan,Asia,228878790,3191,228474
2020-07-06,pakistan,Asia,228878790,3344,231818
2020-07-07,pakistan,Asia,228878790,2691,234509
2020-07-08,pakistan,Asia,228878790,2980,237489
2020-07-09,pakistan,Asia,228878790,3359,240848
2020-07-10,pakistan,Asia,228878790,2751,243599
2020-07-11,pakistan,Asia,228878790,2752,246351
2020-07-12,pakistan,Asia,228878790,2521,248872
2020-07-13,pakistan,Asia,228878790,2753,251625
2020-07-14,pakistan,Asia,228878790,1979,253604
2020-07-15,pakistan,Asia,228878790,2165,255769
2020-07-16,pakistan,Asia,228878790,2145,257914
2020-07-17,pakistan,Asia,228878790,2085,259999
2020-07-18,pakistan,Asia,228878790,1917,261916
2020-07-19,pakistan,Asia,228878790,1580,263496
2020-07-20,pakistan,Asia,228878790,1587,265083
2020-07-21,pakistan,Asia,228878790,1013,266096
2020-07-22,pakistan,Asia,228878790,1332,267428
2020-07-23,pakistan,Asia,228878790,1763,269191
2020-07-24,pakistan,Asia,228878790,1209,270400
2020-07-25,pakistan,Asia,228878790,1487,271887
2020-07-26,pakistan,Asia,228878790,1226,273113
2020-07-27,pakistan,Asia,228878790,1176,274289
2020-07-28,pakistan,Asia,228878790,936,275225
2020-07-29,pakistan,Asia,228878790,1063,276288
2020-07-30,pakistan,Asia,228878790,1114,277402
2020-07-31,pakistan,Asia,228878790,903,278305
2020-08-01,pakistan,Asia,228878790,841,279146
2020-08-02,pakistan,Asia,228878790,552,279698
2020-08-03,pakistan,Asia,228878790,331,280029
2020-08-04,pakistan,Asia,228878790,432,280461
2020-08-05,pakistan,Asia,228878790,675,281136
2020-08-06,pakistan,Asia,228878790,727,281863
2020-08-07,pakistan,Asia,228878790,782,282645
2020-08-08,pakistan,Asia,228878790,842,283487
2020-08-09,pakistan,Asia,228878790,634,284121
2020-08-10,pakistan,Asia,228878790,539,284660
2020-08-11,pakistan,Asia,228878790,531,285191
2020-08-12,pakistan,Asia,228878790,730,285921
2020-08-13,pakistan,Asia,228878790,753,286674
2020-08-14,pakistan,Asia,228878790,626,287300
2020-08-15,pakistan,Asia,228878790,747,288047
2020-08-16,pakistan,Asia,228878790,670,288717
2020-08-17,pakistan,Asia,228878790,498,289215
2020-08-18,pakistan,Asia,228878790,617,289832
2020-08-19,pakistan,Asia,228878790,613,290445
2020-08-20,pakistan,Asia,228878790,513,290958
2020-08-21,pakistan,Asia,228878790,630,291588
2020-08-22,pakistan,Asia,228878790,586,292174
2020-08-23,pakistan,Asia,228878790,591,292765
2020-08-24,pakistan,Asia,228878790,496,293261
2020-08-25,pakistan,Asia,228878790,450,293711
2020-08-26,pakistan,Asia,228878790,482,294193
2020-08-27,pakistan,Asia,228878790,445,294638
2020-08-28,pakistan,Asia,228878790,415,295053
2020-08-29,pakistan,Asia,228878790,319,295372
2020-08-30,pakistan,Asia,228878790,264,295636
2020-08-31,pakistan,Asia,228878790,213,295849
2020-09-01,pakistan,Asia,228878790,300,296149
2020-09-02,pakistan,Asia,228878790,441,296590
2020-09-03,pakistan,Asia,228878790,424,297014
2020-09-04,pakistan,Asia,228878790,498,297512
2020-09-05,pakistan,Asia,228878790,513,298025
2020-09-06,pakistan,Asia,228878790,484,298509
2020-09-07,pakistan,Asia,228878790,394,298903
2020-09-08,pakistan,Asia,228878790,330,299233
2020-09-09,pakistan,Asia,228878790,426,299659
2020-09-10,pakistan,Asia,228878790,196,299855
2020-09-11,pakistan,Asia,228878790,516,300371
2020-09-12,pakistan,Asia,228878790,584,300955
2020-09-13,pakistan,Asia,228878790,526,301481
2020-09-14,pakistan,Asia,228878790,539,302020
2020-09-15,pakistan,Asia,228878790,404,302424
2020-09-16,pakistan,Asia,228878790,665,303089
2020-09-17,pakistan,Asia,228878790,545,303634
2020-09-18,pakistan,Asia,228878790,752,304386
2020-09-19,pakistan,Asia,228878790,645,305031
2020-09-20,pakistan,Asia,228878790,640,305671
2020-09-21,pakistan,Asia,228878790,633,306304
2020-09-22,pakistan,Asia,228878790,582,306886
2020-09-23,pakistan,Asia,228878790,532,307418
2020-09-24,pakistan,Asia,228878790,799,308217
2020-09-25,pakistan,Asia,228878790,798,309015
2020-09-26,pakistan,Asia,228878790,566,309581
2020-09-27,pakistan,Asia,228878790,694,310275
2020-09-28,pakistan,Asia,228878790,566,310841
2020-09-29,pakistan,Asia,228878790,675,311516
2020-09-30,pakistan,Asia,228878790,747,312263
2020-10-01,pakistan,Asia,228878790,543,312806
2020-10-02,pakistan,Asia,228878790,625,313431
2020-10-03,pakistan,Asia,228878790,553,313984
2020-10-04,pakistan,Asia,228878790,632,314616
2020-10-05,pakistan,Asia,228878790,644,315260
2020-10-06,pakistan,Asia,228878790,467,315727
2020-10-07,pakistan,Asia,228878790,624,316351
2020-10-08,pakistan,Asia,228878790,583,316934
2020-10-09,pakistan,Asia,228878790,661,317595
2020-10-10,pakistan,Asia,228878790,671,318266
2020-10-11,pakistan,Asia,228878790,666,318932
2020-10-12,pakistan,Asia,228878790,385,319317
2020-10-13,pakistan,Asia,228878790,531,319848
2020-10-14,pakistan,Asia,228878790,615,320463
2020-10-15,pakistan,Asia,228878790,755,321218
2020-10-16,pakistan,Asia,228878790,659,321877
2020-10-17,pakistan,Asia,228878790,575,322452
2020-10-18,pakistan,Asia,228878790,567,323019
2020-10-19,pakistan,Asia,228878790,440,323459
2020-10-20,pakistan,Asia,228878790,618,324077
2020-10-21,pakistan,Asia,228878790,667,324744
2020-10-22,pakistan,Asia,228878790,736,325480
2020-10-23,pakistan,Asia,228878790,736,326216
2020-10-24,pakistan,Asia,228878790,847,327063
2020-10-25,pakistan,Asia,228878790,832,327895
2020-10-26,pakistan,Asia,228878790,707,328602
2020-10-27,pakistan,Asia,228878790,773,329375
2020-10-28,pakistan,Asia,228878790,825,330200
2020-10-29,pakistan,Asia,228878790,908,331108
2020-10-30,pakistan,Asia,228878790,1078,332186
2020-10-31,pakistan,Asia,228878790,807,332993
2020-11-01,pakistan,Asia,228878790,977,333970
2020-11-02,pakistan,Asia,228878790,1123,335093
2020-11-03,pakistan,Asia,228878790,1167,336260
2020-11-04,pakistan,Asia,228878790,1313,337573
2020-11-05,pakistan,Asia,228878790,1302,338875
2020-11-06,pakistan,Asia,228878790,1376,340251
2020-11-07,pakistan,Asia,228878790,1502,341753
2020-11-08,pakistan,Asia,228878790,1436,343189
2020-11-09,pakistan,Asia,228878790,1650,344839
2020-11-10,pakistan,Asia,228878790,1637,346476
2020-11-11,pakistan,Asia,228878790,1708,348184
2020-11-12,pakistan,Asia,228878790,1808,349992
2020-11-13,pakistan,Asia,228878790,2304,352296
2020-11-14,pakistan,Asia,228878790,2165,354461
2020-11-15,pakistan,Asia,228878790,2443,356904
2020-11-16,pakistan,Asia,228878790,2128,359032
2020-11-17,pakistan,Asia,228878790,2050,361082
2020-11-18,pakistan,Asia,228878790,2298,363380
2020-11-19,pakistan,Asia,228878790,2547,365927
2020-11-20,pakistan,Asia,228878790,2738,368665
2020-11-21,pakistan,Asia,228878790,2843,371508
2020-11-22,pakistan,Asia,228878790,2665,374173
2020-11-23,pakistan,Asia,228878790,2756,376929
2020-11-24,pakistan,Asia,228878790,2954,379883
2020-11-25,pakistan,Asia,228878790,3009,382892
2020-11-26,pakistan,Asia,228878790,3306,386198
2020-11-27,pakistan,Asia,228878790,3113,389311
2020-11-28,pakistan,Asia,228878790,3045,392356
2020-11-29,pakistan,Asia,228878790,2829,395185
2020-11-30,pakistan,Asia,228878790,2839,398024
2020-12-01,pakistan,Asia,228878790,2458,400482
2020-12-02,pakistan,Asia,228878790,2829,403311
2020-12-03,pakistan,Asia,228878790,3499,406810
2020-12-04,pakistan,Asia,228878790,3262,410072
2020-12-05,pakistan,Asia,228878790,3119,413191
2020-12-06,pakistan,Asia,228878790,3308,416499
2020-12-07,pakistan,Asia,228878790,3795,420294
2020-12-08,pakistan,Asia,228878790,2885,423179
2020-12-09,pakistan,Asia,228878790,2963,426142
2020-12-10,pakistan,Asia,228878790,3138,429280
2020-12-11,pakistan,Asia,228878790,3047,432327
2020-12-12,pakistan,Asia,228878790,2729,435056
2020-12-13,pakistan,Asia,228878790,3369,438425
2020-12-14,pakistan,Asia,228878790,2362,440787
2020-12-15,pakistan,Asia,228878790,2459,443246
2020-12-16,pakistan,Asia,228878790,2731,445977
2020-12-17,pakistan,Asia,228878790,2545,448522
2020-12-18,pakistan,Asia,228878790,2972,451494
2020-12-19,pakistan,Asia,228878790,3179,454673
2020-12-20,pakistan,Asia,228878790,2503,457176
2020-12-21,pakistan,Asia,228878790,1792,458968
2020-12-22,pakistan,Asia,228878790,1704,460672
2020-12-23,pakistan,Asia,228878790,2142,462814
2020-12-24,pakistan,Asia,228878790,2256,465070
2020-12-25,pakistan,Asia,228878790,2152,467222
2020-12-26,pakistan,Asia,228878790,2260,469482
2020-12-27,pakistan,Asia,228878790,1853,471335
2020-12-28,pakistan,Asia,228878790,1974,473309
2020-12-29,pakistan,Asia,228878790,1776,475085
2020-12-30,pakistan,Asia,228878790,2155,477240
2020-12-31,pakistan,Asia,228878790,2475,479715
2021-01-01,pakistan,Asia,228878790,2463,482178
2021-01-02,pakistan,Asia,228878790,2184,484362
2021-01-03,pakistan,Asia,228878790,2272,486634
2021-01-04,pakistan,Asia,228878790,1895,488529
2021-01-05,pakistan,Asia,228878790,1947,490476
2021-01-06,pakistan,Asia,228878790,2118,492594
2021-01-07,pakistan,Asia,228878790,2481,495075
2021-01-08,pakistan,Asia,228878790,2435,497510
2021-01-09,pakistan,Asia,228878790,2007,499517
2021-01-10,pakistan,Asia,228878790,2899,502416
2021-01-11,pakistan,Asia,228878790,1877,504293
2021-01-12,pakistan,Asia,228878790,2408,506701
2021-01-13,pakistan,Asia,228878790,2123,508824
2021-01-14,pakistan,Asia,228878790,3097,511921
2021-01-15,pakistan,Asia,228878790,2417,514338
2021-01-16,pakistan,Asia,228878790,2432,516770
2021-01-17,pakistan,Asia,228878790,2521,519291
2021-01-18,pakistan,Asia,228878790,1920,521211
2021-01-19,pakistan,Asia,228878790,1800,523011
2021-01-20,pakistan,Asia,228878790,1772,524783
2021-01-21,pakistan,Asia,228878790,2363,527146
2021-01-22,pakistan,Asia,228878790,1745,528891
2021-01-23,pakistan,Asia,228878790,1927,530818
2021-01-24,pakistan,Asia,228878790,1594,532412
2021-01-25,pakistan,Asia,228878790,1629,534041
2021-01-26,pakistan,Asia,228878790,1873,535914
2021-01-27,pakistan,Asia,228878790,1563,537477
2021-01-28,pakistan,Asia,228878790,1910,539387
2021-01-29,pakistan,Asia,228878790,1644,541031
2021-01-30,pakistan,Asia,228878790,2183,543214
2021-01-31,pakistan,Asia,228878790,1599,544813
2021-02-01,pakistan,Asia,228878790,1615,546428
2021-02-02,pakistan,Asia,228878790,1220,547648
2021-02-03,pakistan,Asia,228878790,1384,549032
2021-02-04,pakistan,Asia,228878790,1508,550540
2021-02-05,pakistan,Asia,228878790,1302,551842
2021-02-06,pakistan,Asia,228878790,1286,553128
2021-02-07,pakistan,Asia,228878790,1346,554474
2021-02-08,pakistan,Asia,228878790,1037,555511
2021-02-09,pakistan,Asia,228878790,1008,556519
2021-02-10,pakistan,Asia,228878790,1072,557591
2021-02-11,pakistan,Asia,228878790,1502,559093
2021-02-12,pakistan,Asia,228878790,1270,560363
2021-02-13,pakistan,Asia,228878790,1262,561625
2021-02-14,pakistan,Asia,228878790,1404,563029
2021-02-15,pakistan,Asia,228878790,1048,564077
2021-02-16,pakistan,Asia,228878790,747,564824
2021-02-17,pakistan,Asia,228878790,1165,565989
2021-02-18,pakistan,Asia,228878790,1272,567261
2021-02-19,pakistan,Asia,228878790,1245,568506
2021-02-20,pakistan,Asia,228878790,1340,569846
2021-02-21,pakistan,Asia,228878790,1328,571174
2021-02-22,pakistan,Asia,228878790,1160,572334
2021-02-23,pakistan,Asia,228878790,1050,573384
2021-02-24,pakistan,Asia,228878790,1196,574580
2021-02-25,pakistan,Asia,228878790,1361,575941
2021-02-26,pakistan,Asia,228878790,1541,577482
2021-02-27,pakistan,Asia,228878790,1315,578797
2021-02-28,pakistan,Asia,228878790,1176,579973
2021-03-01,pakistan,Asia,228878790,1392,581365
2021-03-02,pakistan,Asia,228878790,1163,582528
2021-03-03,pakistan,Asia,228878790,1388,583916
2021-03-04,pakistan,Asia,228878790,1519,585435
2021-03-05,pakistan,Asia,228878790,1579,587014
2021-03-06,pakistan,Asia,228878790,1714,588728
2021-03-07,pakistan,Asia,228878790,1780,590508
2021-03-08,pakistan,Asia,228878790,1592,592100
2021-03-09,pakistan,Asia,228878790,1353,593453
2021-03-10,pakistan,Asia,228878790,1786,595239
2021-03-11,pakistan,Asia,228878790,2258,597497
2021-03-12,pakistan,Asia,228878790,2701,600198
2021-03-13,pakistan,Asia,228878790,2338,602536
2021-03-14,pakistan,Asia,228878790,2664,605200
2021-03-15,pakistan,Asia,228878790,2253,607453
2021-03-16,pakistan,Asia,228878790,2511,609964
2021-03-17,pakistan,Asia,228878790,2351,612315
2021-03-18,pakistan,Asia,228878790,3495,615810
2021-03-19,pakistan,Asia,228878790,3449,619259
2021-03-20,pakistan,Asia,228878790,3876,623135
2021-03-21,pakistan,Asia,228878790,3667,626802
2021-03-22,pakistan,Asia,228878790,3669,630471
2021-03-23,pakistan,Asia,228878790,3270,633741
2021-03-24,pakistan,Asia,228878790,3301,637042
2021-03-25,pakistan,Asia,228878790,3946,640988
2021-03-26,pakistan,Asia,228878790,4368,645356
2021-03-27,pakistan,Asia,228878790,4468,649824
2021-03-28,pakistan,Asia,228878790,4767,654591
2021-03-29,pakistan,Asia,228878790,4525,659116
2021-03-30,pakistan,Asia,228878790,4084,663200
2021-03-31,pakistan,Asia,228878790,4757,667957
2021-04-01,pakistan,Asia,228878790,4974,672931
2021-04-02,pakistan,Asia,228878790,5234,678165
2021-04-03,pakistan,Asia,228878790,4723,682888
2021-04-04,pakistan,Asia,228878790,5020,687908
2021-04-05,pakistan,Asia,228878790,4323,692231
2021-04-06,pakistan,Asia,228878790,3953,696184
2021-04-07,pakistan,Asia,228878790,4004,700188
2021-04-08,pakistan,Asia,228878790,5329,705517
2021-04-09,pakistan,Asia,228878790,5312,710829
2021-04-10,pakistan,Asia,228878790,5139,715968
2021-04-11,pakistan,Asia,228878790,5050,721018
2021-04-12,pakistan,Asia,228878790,4584,725602
2021-04-13,pakistan,Asia,228878790,4318,729920
2021-04-14,pakistan,Asia,228878790,4503,734423
2021-04-15,pakistan,Asia,228878790,5395,739818
2021-04-16,pakistan,Asia,228878790,5364,745182
2021-04-17,pakistan,Asia,228878790,4976,750158
2021-04-18,pakistan,Asia,228878790,6127,756285
2021-04-19,pakistan,Asia,228878790,5152,761437
2021-04-20,pakistan,Asia,228878790,5445,766882
2021-04-21,pakistan,Asia,228878790,5499,772381
2021-04-22,pakistan,Asia,228878790,5857,778238
2021-04-23,pakistan,Asia,228878790,5870,784108
2021-04-24,pakistan,Asia,228878790,5908,790016
2021-04-25,pakistan,Asia,228878790,5611,795627
2021-04-26,pakistan,Asia,228878790,4825,800452
2021-04-27,pakistan,Asia,228878790,4487,804939
2021-04-28,pakistan,Asia,228878790,5292,810231
2021-04-29,pakistan,Asia,228878790,5480,815711
2021-04-30,pakistan,Asia,228878790,5112,820823
2021-05-01,pakistan,Asia,228878790,4696,825519
2021-05-02,pakistan,Asia,228878790,4414,829933
2021-05-03,pakistan,Asia,228878790,4213,834146
2021-05-04,pakistan,Asia,228878790,3377,837523
2021-05-05,pakistan,Asia,228878790,4113,841636
2021-05-06,pakistan,Asia,228878790,4197,845833
2021-05-07,pakistan,Asia,228878790,4298,850131
2021-05-08,pakistan,Asia,228878790,4109,854240
2021-05-09,pakistan,Asia,228878790,3786,858026
2021-05-10,pakistan,Asia,228878790,3447,861473
2021-05-11,pakistan,Asia,228878790,3084,864557
2021-05-12,pakistan,Asia,228878790,2881,867438
2021-05-13,pakistan,Asia,228878790,3265,870703
2021-05-14,pakistan,Asia,228878790,2517,873220
2021-05-15,pakistan,Asia,228878790,1531,874751
2021-05-16,pakistan,Asia,228878790,2379,877130
2021-05-17,pakistan,Asia,228878790,3232,880362
2021-05-18,pakistan,Asia,228878790,2566,882928
2021-05-19,pakistan,Asia,228878790,3256,886184
2021-05-20,pakistan,Asia,228878790,4207,890391
2021-05-21,pakistan,Asia,228878790,3070,893461
2021-05-22,pakistan,Asia,228878790,4007,897468
2021-05-23,pakistan,Asia,228878790,3084,900552
2021-05-24,pakistan,Asia,228878790,3047,903599
2021-05-25,pakistan,Asia,228878790,2253,905852
2021-05-26,pakistan,Asia,228878790,2724,908576
2021-05-27,pakistan,Asia,228878790,2726,911302
2021-05-28,pakistan,Asia,228878790,2482,913784
2021-05-29,pakistan,Asia,228878790,2455,916239
2021-05-30,pakistan,Asia,228878790,2697,918936
2021-05-31,pakistan,Asia,228878790,2117,921053
2021-06-01,pakistan,Asia,228878790,1771,922824
2021-06-02,pakistan,Asia,228878790,1843,924667
2021-06-03,pakistan,Asia,228878790,2028,926695
2021-06-04,pakistan,Asia,228878790,1893,928588
2021-06-05,pakistan,Asia,228878790,1923,930511
2021-06-06,pakistan,Asia,228878790,1629,932140
2021-06-07,pakistan,Asia,228878790,1490,933630
2021-06-08,pakistan,Asia,228878790,1383,935013
2021-06-09,pakistan,Asia,228878790,1118,936131
2021-06-10,pakistan,Asia,228878790,1303,937434
2021-06-11,pakistan,Asia,228878790,1303,938737
2021-06-12,pakistan,Asia,228878790,1194,939931
2021-06-13,pakistan,Asia,228878790,1239,941170
2021-06-14,pakistan,Asia,228878790,1019,942189
2021-06-15,pakistan,Asia,228878790,838,943027
2021-06-16,pakistan,Asia,228878790,1038,944065
2021-06-17,pakistan,Asia,228878790,1119,945184
2021-06-18,pakistan,Asia,228878790,1043,946227
2021-06-19,pakistan,Asia,228878790,991,947218
2021-06-20,pakistan,Asia,228878790,1050,948268
2021-06-21,pakistan,Asia,228878790,907,949175
2021-06-22,pakistan,Asia,228878790,663,949838
2021-06-23,pakistan,Asia,228878790,930,950768
2021-06-24,pakistan,Asia,228878790,1097,951865
2021-06-25,pakistan,Asia,228878790,1042,952907
2021-06-26,pakistan,Asia,228878790,935,953842
2021-06-27,pakistan,Asia,228878790,901,954743
2021-06-28,pakistan,Asia,228878790,914,955657
2021-06-29,pakistan,Asia,228878790,735,956392
2021-06-30,pakistan,Asia,228878790,979,957371
2021-07-01,pakistan,Asia,228878790,1037,958408
2021-07-02,pakistan,Asia,228878790,1277,959685
2021-07-03,pakistan,Asia,228878790,1400,961085
2021-07-04,pakistan,Asia,228878790,1228,962313
2021-07-05,pakistan,Asia,228878790,1347,963660
2021-07-06,pakistan,Asia,228878790,830,964490
2021-07-07,pakistan,Asia,228878790,1517,966007
2021-07-08,pakistan,Asia,228878790,1626,967633
2021-07-09,pakistan,Asia,228878790,1843,969476
2021-07-10,pakistan,Asia,228878790,1828,971304
2021-07-11,pakistan,Asia,228878790,1980,973284
2021-07-12,pakistan,Asia,228878790,1808,975092
2021-07-13,pakistan,Asia,228878790,1775,976867
2021-07-14,pakistan,Asia,228878790,1980,978847
2021-07-15,pakistan,Asia,228878790,2545,981392
2021-07-16,pakistan,Asia,228878790,2327,983719
2021-07-17,pakistan,Asia,228878790,2949,986668
2021-07-18,pakistan,Asia,228878790,2607,989275
2021-07-19,pakistan,Asia,228878790,2452,991727
2021-07-20,pakistan,Asia,228878790,2145,993872
2021-07-21,pakistan,Asia,228878790,2579,996451
2021-07-22,pakistan,Asia,228878790,2158,998609
2021-07-23,pakistan,Asia,228878790,1425,1000034
2021-07-24,pakistan,Asia,228878790,1841,1001875
2021-07-25,pakistan,Asia,228878790,2819,1004694
2021-07-26,pakistan,Asia,228878790,3752,1008446
2021-07-27,pakistan,Asia,228878790,3262,1011708
2021-07-28,pakistan,Asia,228878790,4119,1015827
2021-07-29,pakistan,Asia,228878790,4497,1020324
2021-07-30,pakistan,Asia,228878790,4537,1024861
2021-07-31,pakistan,Asia,228878790,4950,1029811
2021-08-01,pakistan,Asia,228878790,5026,1034837
2021-08-02,pakistan,Asia,228878790,4858,1039695
2021-08-03,pakistan,Asia,228878790,3582,1043277
2021-08-04,pakistan,Asia,228878790,4722,1047999
2021-08-05,pakistan,Asia,228878790,5661,1053660
2021-08-06,pakistan,Asia,228878790,4745,1058405
2021-08-07,pakistan,Asia,228878790,4720,1063125
2021-08-08,pakistan,Asia,228878790,4455,1067580
2021-08-09,pakistan,Asia,228878790,4040,1071620
2021-08-10,pakistan,Asia,228878790,3884,1075504
2021-08-11,pakistan,Asia,228878790,4856,1080360
2021-08-12,pakistan,Asia,228878790,4934,1085294
2021-08-13,pakistan,Asia,228878790,4619,1089913
2021-08-14,pakistan,Asia,228878790,4786,1094699
2021-08-15,pakistan,Asia,228878790,3711,1098410
2021-08-16,pakistan,Asia,228878790,3669,1102079
2021-08-17,pakistan,Asia,228878790,3221,1105300
2021-08-18,pakistan,Asia,228878790,3974,1109274
2021-08-19,pakistan,Asia,228878790,4373,1113647
2021-08-20,pakistan,Asia,228878790,3239,1116886
2021-08-21,pakistan,Asia,228878790,3084,1119970
2021-08-22,pakistan,Asia,228878790,3842,1123812
2021-08-23,pakistan,Asia,228878790,3772,1127584
2021-08-24,pakistan,Asia,228878790,4075,1131659
2021-08-25,pakistan,Asia,228878790,4199,1135858
2021-08-26,pakistan,Asia,228878790,4553,1140411
2021-08-27,pakistan,Asia,228878790,3930,1144341
2021-08-28,pakistan,Asia,228878790,4231,1148572
2021-08-29,pakistan,Asia,228878790,3909,1152481
2021-08-30,pakistan,Asia,228878790,3800,1156281
2021-08-31,pakistan,Asia,228878790,3838,1160119
2021-09-01,pakistan,Asia,228878790,3569,1163688
2021-09-02,pakistan,Asia,228878790,4103,1167791
2021-09-03,pakistan,Asia,228878790,3787,1171578
2021-09-04,pakistan,Asia,228878790,3980,1175558
2021-09-05,pakistan,Asia,228878790,3747,1179305
2021-09-06,pakistan,Asia,228878790,3613,1182918
2021-09-07,pakistan,Asia,228878790,3316,1186234
2021-09-08,pakistan,Asia,228878790,3902,1190136
2021-09-09,pakistan,Asia,228878790,4062,1194198
2021-09-10,pakistan,Asia,228878790,3689,1197887
2021-09-11,pakistan,Asia,228878790,3480,1201367
2021-09-12,pakistan,Asia,228878790,3153,1204520
2021-09-13,pakistan,Asia,228878790,2988,1207508
2021-09-14,pakistan,Asia,228878790,2574,1210082
2021-09-15,pakistan,Asia,228878790,2727,1212809
2021-09-16,pakistan,Asia,228878790,3012,1215821
2021-09-17,pakistan,Asia,228878790,2928,1218749
2021-09-18,pakistan,Asia,228878790,2512,1221261
2021-09-19,pakistan,Asia,228878790,2580,1223841
2021-09-20,pakistan,Asia,228878790,2167,1226008
2021-09-21,pakistan,Asia,228878790,1897,1227905
2021-09-22,pakistan,Asia,228878790,2333,1230238
2021-09-23,pakistan,Asia,228878790,2357,1232595
2021-09-24,pakistan,Asia,228878790,2233,1234828
2021-09-25,pakistan,Asia,228878790,2060,1236888
2021-09-26,pakistan,Asia,228878790,1780,1238668
2021-09-27,pakistan,Asia,228878790,1757,1240425
2021-09-28,pakistan,Asia,228878790,1400,1241825
2021-09-29,pakistan,Asia,228878790,1560,1243385
2021-09-30,pakistan,Asia,228878790,1742,1245127
2021-10-01,pakistan,Asia,228878790,1411,1246538
2021-10-02,pakistan,Asia,228878790,1664,1248202
2021-10-03,pakistan,Asia,228878790,1656,1249858
2021-10-04,pakistan,Asia,228878790,1490,1251348
2021-10-05,pakistan,Asia,228878790,1308,1252656
2021-10-06,pakistan,Asia,228878790,1212,1253868
2021-10-07,pakistan,Asia,228878790,1453,1255321
2021-10-08,pakistan,Asia,228878790,912,1256233
2021-10-09,pakistan,Asia,228878790,955,1257188
2021-10-10,pakistan,Asia,228878790,767,1257955
2021-10-11,pakistan,Asia,228878790,1004,1258959
2021-10-12,pakistan,Asia,228878790,689,1259648
2021-10-13,pakistan,Asia,228878790,1021,1260669
2021-10-14,pakistan,Asia,228878790,1016,1261685
2021-10-15,pakistan,Asia,228878790,1086,1262771
2021-10-16,pakistan,Asia,228878790,893,1263664
2021-10-17,pakistan,Asia,228878790,720,1264384
2021-10-18,pakistan,Asia,228878790,663,1265047
2021-10-19,pakistan,Asia,228878790,603,1265650
2021-10-20,pakistan,Asia,228878790,554,1266204
2021-10-21,pakistan,Asia,228878790,622,1266826
2021-10-22,pakistan,Asia,228878790,567,1267393
2020-03-11,panama,North America,4441253,13,14
2020-03-12,panama,North America,4441253,0,14
2020-03-13,panama,North America,4441253,13,27
2020-03-14,panama,North America,4441253,16,43
2020-03-15,panama,North America,4441253,12,55
2020-03-16,panama,North America,4441253,14,69
2020-03-17,panama,North America,4441253,0,69
2020-03-18,panama,North America,4441253,40,109
2020-03-19,panama,North America,4441253,28,137
2020-03-20,panama,North America,4441253,63,200
2020-03-21,panama,North America,4441253,45,245
2020-03-22,panama,North America,4441253,68,313
2020-03-23,panama,North America,4441253,32,345
2020-03-24,panama,North America,4441253,98,443
2020-03-25,panama,North America,4441253,115,558
2020-03-26,panama,North America,4441253,116,674
2020-03-27,panama,North America,4441253,112,786
2020-03-28,panama,North America,4441253,115,901
2020-03-29,panama,North America,4441253,88,989
2020-03-30,panama,North America,4441253,86,1075
2020-03-31,panama,North America,4441253,106,1181
2020-04-01,panama,North America,4441253,136,1317
2020-04-02,panama,North America,4441253,158,1475
2020-04-03,panama,North America,4441253,198,1673
2020-04-04,panama,North America,4441253,128,1801
2020-04-05,panama,North America,4441253,0,1801
2020-04-06,panama,North America,4441253,299,2100
2020-04-07,panama,North America,4441253,0,2100
2020-04-08,panama,North America,4441253,428,2528
2020-04-09,panama,North America,4441253,224,2752
2020-04-10,panama,North America,4441253,222,2974
2020-04-11,panama,North America,4441253,260,3234
2020-04-12,panama,North America,4441253,166,3400
2020-04-13,panama,North America,4441253,72,3472
2020-04-14,panama,North America,4441253,102,3574
2020-04-15,panama,North America,4441253,177,3751
2020-04-16,panama,North America,4441253,0,3751
2020-04-17,panama,North America,4441253,265,4016
2020-04-18,panama,North America,4441253,194,4210
2020-04-19,panama,North America,4441253,63,4273
2020-04-20,panama,North America,4441253,194,4467
2020-04-21,panama,North America,4441253,191,4658
2020-04-22,panama,North America,4441253,163,4821
2020-04-23,panama,North America,4441253,171,4992
2020-04-24,panama,North America,4441253,174,5166
2020-04-25,panama,North America,4441253,172,5338
2020-04-26,panama,North America,4441253,200,5538
2020-04-27,panama,North America,4441253,241,5779
2020-04-28,panama,North America,4441253,242,6021
2020-04-29,panama,North America,4441253,179,6200
2020-04-30,panama,North America,4441253,178,6378
2020-05-01,panama,North America,4441253,154,6532
2020-05-02,panama,North America,4441253,188,6720
2020-05-03,panama,North America,4441253,370,7090
2020-05-04,panama,North America,4441253,107,7197
2020-05-05,panama,North America,4441253,190,7387
2020-05-06,panama,North America,4441253,136,7523
2020-05-07,panama,North America,4441253,208,7731
2020-05-08,panama,North America,4441253,137,7868
2020-05-09,panama,North America,4441253,202,8070
2020-05-10,panama,North America,4441253,212,8282
2020-05-11,panama,North America,4441253,166,8448
2020-05-12,panama,North America,4441253,168,8616
2020-05-13,panama,North America,4441253,167,8783
2020-05-14,panama,North America,4441253,161,8944
2020-05-15,panama,North America,4441253,174,9118
2020-05-16,panama,North America,4441253,150,9268
2020-05-17,panama,North America,4441253,181,9449
2020-05-18,panama,North America,4441253,157,9606
2020-05-19,panama,North America,4441253,261,9867
2020-05-20,panama,North America,4441253,110,9977
2020-05-21,panama,North America,4441253,139,10116
2020-05-22,panama,North America,4441253,151,10267
2020-05-23,panama,North America,4441253,310,10577
2020-05-24,panama,North America,4441253,349,10926
2020-05-25,panama,North America,4441253,257,11183
2020-05-26,panama,North America,4441253,264,11447
2020-05-27,panama,North America,4441253,281,11728
2020-05-28,panama,North America,4441253,403,12131
2020-05-29,panama,North America,4441253,400,12531
2020-05-30,panama,North America,4441253,487,13018
2020-05-31,panama,North America,4441253,445,13463
2020-06-01,panama,North America,4441253,374,13837
2020-06-02,panama,North America,4441253,258,14095
2020-06-03,panama,North America,4441253,514,14609
2020-06-04,panama,North America,4441253,435,15044
2020-06-05,panama,North America,4441253,419,15463
2020-06-06,panama,North America,4441253,541,16004
2020-06-07,panama,North America,4441253,421,16425
2020-06-08,panama,North America,4441253,429,16854
2020-06-09,panama,North America,4441253,379,17233
2020-06-10,panama,North America,4441253,656,17889
2020-06-11,panama,North America,4441253,697,18586
2020-06-12,panama,North America,4441253,625,19211
2020-06-13,panama,North America,4441253,848,20059
2020-06-14,panama,North America,4441253,627,20686
2020-06-15,panama,North America,4441253,736,21422
2020-06-16,panama,North America,4441253,540,21962
2020-06-17,panama,North America,4441253,635,22597
2020-06-18,panama,North America,4441253,754,23351
2020-06-19,panama,North America,4441253,923,24274
2020-06-20,panama,North America,4441253,948,25222
2020-06-21,panama,North America,4441253,808,26030
2020-06-22,panama,North America,4441253,722,26752
2020-06-23,panama,North America,4441253,562,27314
2020-06-24,panama,North America,4441253,716,28030
2020-06-25,panama,North America,4441253,1007,29037
2020-06-26,panama,North America,4441253,868,29905
2020-06-27,panama,North America,4441253,753,30658
2020-06-28,panama,North America,4441253,1028,31686
2020-06-29,panama,North America,4441253,1099,32785
2020-06-30,panama,North America,4441253,765,33550
2020-07-01,panama,North America,4441253,913,34463
2020-07-02,panama,North America,4441253,774,35237
2020-07-03,panama,North America,4441253,758,35995
2020-07-04,panama,North America,4441253,988,36983
2020-07-05,panama,North America,4441253,1166,38149
2020-07-06,panama,North America,4441253,1185,39334
2020-07-07,panama,North America,4441253,957,40291
2020-07-08,panama,North America,4441253,960,41251
2020-07-09,panama,North America,4441253,965,42216
2020-07-10,panama,North America,4441253,1041,43257
2020-07-11,panama,North America,4441253,1075,44332
2020-07-12,panama,North America,4441253,1301,45633
2020-07-13,panama,North America,4441253,1540,47173
2020-07-14,panama,North America,4441253,923,48096
2020-07-15,panama,North America,4441253,1147,49243
2020-07-16,panama,North America,4441253,1130,50373
2020-07-17,panama,North America,4441253,1035,51408
2020-07-18,panama,North America,4441253,853,52261
2020-07-19,panama,North America,4441253,1207,53468
2020-07-20,panama,North America,4441253,958,54426
2020-07-21,panama,North America,4441253,727,55153
2020-07-22,panama,North America,4441253,753,55906
2020-07-23,panama,North America,4441253,911,56817
2020-07-24,panama,North America,4441253,1176,57993
2020-07-25,panama,North America,4441253,871,58864
2020-07-26,panama,North America,4441253,1432,60296
2020-07-27,panama,North America,4441253,1146,61442
2020-07-28,panama,North America,4441253,781,62223
2020-07-29,panama,North America,4441253,1046,63269
2020-07-30,panama,North America,4441253,922,64191
2020-07-31,panama,North America,4441253,1065,65256
2020-08-01,panama,North America,4441253,1127,66383
2020-08-02,panama,North America,4441253,1070,67453
2020-08-03,panama,North America,4441253,1003,68456
2020-08-04,panama,North America,4441253,968,69424
2020-08-05,panama,North America,4441253,807,70231
2020-08-06,panama,North America,4441253,1187,71418
2020-08-07,panama,North America,4441253,1142,72560
2020-08-08,panama,North America,4441253,1091,73651
2020-08-09,panama,North America,4441253,841,74492
2020-08-10,panama,North America,4441253,902,75394
2020-08-11,panama,North America,4441253,1070,76464
2020-08-12,panama,North America,4441253,913,77377
2020-08-13,panama,North America,4441253,1069,78446
2020-08-14,panama,North America,4441253,956,79402
2020-08-15,panama,North America,4441253,1263,80665
2020-08-16,panama,North America,4441253,1275,81940
2020-08-17,panama,North America,4441253,603,82543
2020-08-18,panama,North America,4441253,247,82790
2020-08-19,panama,North America,4441253,964,83754
2020-08-20,panama,North America,4441253,101,83855
2020-08-21,panama,North America,4441253,537,84392
2020-08-22,panama,North America,4441253,1088,85480
2020-08-23,panama,North America,4441253,1420,86900
2020-08-24,panama,North America,4441253,585,87485
2020-08-25,panama,North America,4441253,896,88381
2020-08-26,panama,North America,4441253,701,89082
2020-08-27,panama,North America,4441253,900,89982
2020-08-28,panama,North America,4441253,642,90624
2020-08-29,panama,North America,4441253,713,91337
2020-08-30,panama,North America,4441253,728,92065
2020-08-31,panama,North America,4441253,917,92982
2020-09-01,panama,North America,4441253,570,93552
2020-09-02,panama,North America,4441253,532,94084
2020-09-03,panama,North America,4441253,830,94914
2020-09-04,panama,North America,4441253,682,95596
2020-09-05,panama,North America,4441253,709,96305
2020-09-06,panama,North America,4441253,738,97043
2020-09-07,panama,North America,4441253,535,97578
2020-09-08,panama,North America,4441253,829,98407
2020-09-09,panama,North America,4441253,635,99042
2020-09-10,panama,North America,4441253,673,99715
2020-09-11,panama,North America,4441253,615,100330
2020-09-12,panama,North America,4441253,711,101041
2020-09-13,panama,North America,4441253,704,101745
2020-09-14,panama,North America,4441253,459,102204
2020-09-15,panama,North America,4441253,628,102832
2020-09-16,panama,North America,4441253,634,103466
2020-09-17,panama,North America,4441253,672,104138
2020-09-18,panama,North America,4441253,741,104879
2020-09-19,panama,North America,4441253,722,105601
2020-09-20,panama,North America,4441253,602,106203
2020-09-21,panama,North America,4441253,607,106810
2020-09-22,panama,North America,4441253,474,107284
2020-09-23,panama,North America,4441253,706,107990
2020-09-24,panama,North America,4441253,736,108726
2020-09-25,panama,North America,4441253,705,109431
2020-09-26,panama,North America,4441253,677,110108
2020-09-27,panama,North America,4441253,447,110555
2020-09-28,panama,North America,4441253,722,111277
2020-09-29,panama,North America,4441253,576,111853
2020-09-30,panama,North America,4441253,742,112595
2020-10-01,panama,North America,4441253,747,113342
2020-10-02,panama,North America,4441253,620,113962
2020-10-03,panama,North America,4441253,691,114653
2020-10-04,panama,North America,4441253,633,115286
2020-10-05,panama,North America,4441253,633,115919
2020-10-06,panama,North America,4441253,683,116602
2020-10-07,panama,North America,4441253,698,117300
2020-10-08,panama,North America,4441253,754,118054
2020-10-09,panama,North America,4441253,787,118841
2020-10-10,panama,North America,4441253,825,119666
2020-10-11,panama,North America,4441253,647,120313
2020-10-12,panama,North America,4441253,489,120802
2020-10-13,panama,North America,4441253,494,121296
2020-10-14,panama,North America,4441253,832,122128
2020-10-15,panama,North America,4441253,755,122883
2020-10-16,panama,North America,4441253,615,123498
2020-10-17,panama,North America,4441253,609,124107
2020-10-18,panama,North America,4441253,638,124745
2020-10-19,panama,North America,4441253,436,125181
2020-10-20,panama,North America,4441253,558,125739
2020-10-21,panama,North America,4441253,696,126435
2020-10-22,panama,North America,4441253,792,127227
2020-10-23,panama,North America,4441253,639,127866
2020-10-24,panama,North America,4441253,649,128515
2020-10-25,panama,North America,4441253,685,129200
2020-10-26,panama,North America,4441253,551,129751
2020-10-27,panama,North America,4441253,671,130422
2020-10-28,panama,North America,4441253,825,131247
2020-10-29,panama,North America,4441253,798,132045
2020-10-30,panama,North America,4441253,822,132867
2020-10-31,panama,North America,4441253,731,133598
2020-11-01,panama,North America,4441253,738,134336
2020-11-02,panama,North America,4441253,579,134915
2020-11-03,panama,North America,4441253,677,135592
2020-11-04,panama,North America,4441253,432,136024
2020-11-05,panama,North America,4441253,543,136567
2020-11-06,panama,North America,4441253,1193,137760
2020-11-07,panama,North America,4441253,746,138506
2020-11-08,panama,North America,4441253,1021,139527
2020-11-09,panama,North America,4441253,804,140331
2020-11-10,panama,North America,4441253,971,141302
2020-11-11,panama,North America,4441253,1163,142465
2020-11-12,panama,North America,4441253,887,143352
2020-11-13,panama,North America,4441253,1125,144477
2020-11-14,panama,North America,4441253,832,145309
2020-11-15,panama,North America,4441253,1344,146653
2020-11-16,panama,North America,4441253,1014,147667
2020-11-17,panama,North America,4441253,1054,148721
2020-11-18,panama,North America,4441253,1112,149833
2020-11-19,panama,North America,4441253,1256,151089
2020-11-20,panama,North America,4441253,1200,152289
2020-11-21,panama,North America,4441253,1288,153577
2020-11-22,panama,North America,4441253,1206,154783
2020-11-23,panama,North America,4441253,875,155658
2020-11-24,panama,North America,4441253,1272,156930
2020-11-25,panama,North America,4441253,1602,158532
2020-11-26,panama,North America,4441253,1755,160287
2020-11-27,panama,North America,4441253,1457,161744
2020-11-28,panama,North America,4441253,1709,163453
2020-11-29,panama,North America,4441253,1276,164729
2020-11-30,panama,North America,4441253,1077,165806
2020-12-01,panama,North America,4441253,1505,167311
2020-12-02,panama,North America,4441253,2028,169339
2020-12-03,panama,North America,4441253,1880,171219
2020-12-04,panama,North America,4441253,2388,173607
2020-12-05,panama,North America,4441253,2300,175907
2020-12-06,panama,North America,4441253,1812,177719
2020-12-07,panama,North America,4441253,1511,179230
2020-12-08,panama,North America,4441253,1936,181166
2020-12-09,panama,North America,4441253,1811,182977
2020-12-10,panama,North America,4441253,2447,185424
2020-12-11,panama,North America,4441253,2355,187779
2020-12-12,panama,North America,4441253,2806,190585
2020-12-13,panama,North America,4441253,2422,193007
2020-12-14,panama,North America,4441253,1612,194619
2020-12-15,panama,North America,4441253,2368,196987
2020-12-16,panama,North America,4441253,2960,199947
2020-12-17,panama,North America,4441253,3348,203295
2020-12-18,panama,North America,4441253,3015,206310
2020-12-19,panama,North America,4441253,3274,209584
2020-12-20,panama,North America,4441253,2755,212339
2020-12-21,panama,North America,4441253,1699,214038
2020-12-22,panama,North America,4441253,3164,217202
2020-12-23,panama,North America,4441253,3059,220261
2020-12-24,panama,North America,4441253,3413,223674
2020-12-25,panama,North America,4441253,2986,226660
2020-12-26,panama,North America,4441253,2064,228724
2020-12-27,panama,North America,4441253,2633,231357
2020-12-28,panama,North America,4441253,2348,233705
2020-12-29,panama,North America,4441253,4574,238279
2020-12-30,panama,North America,4441253,4465,242744
2020-12-31,panama,North America,4441253,4046,246790
2021-01-01,panama,North America,4441253,2943,249733
2021-01-02,panama,North America,4441253,2031,251764
2021-01-03,panama,North America,4441253,1972,253736
2021-01-04,panama,North America,4441253,2494,256230
2021-01-05,panama,North America,4441253,3540,259770
2021-01-06,panama,North America,4441253,5186,264956
2021-01-07,panama,North America,4441253,4135,269091
2021-01-08,panama,North America,4441253,3946,273037
2021-01-09,panama,North America,4441253,3735,276772
2021-01-10,panama,North America,4441253,2424,279196
2021-01-11,panama,North America,4441253,2157,281353
2021-01-12,panama,North America,4441253,3740,285093
2021-01-13,panama,North America,4441253,3315,288408
2021-01-14,panama,North America,4441253,2877,291285
2021-01-15,panama,North America,4441253,2307,293592
2021-01-16,panama,North America,4441253,2677,296269
2021-01-17,panama,North America,4441253,1750,298019
2021-01-18,panama,North America,4441253,1342,299361
2021-01-19,panama,North America,4441253,2173,301534
2021-01-20,panama,North America,4441253,2243,303777
2021-01-21,panama,North America,4441253,1975,305752
2021-01-22,panama,North America,4441253,2041,307793
2021-01-23,panama,North America,4441253,2058,309851
2021-01-24,panama,North America,4441253,1393,311244
2021-01-25,panama,North America,4441253,914,312158
2021-01-26,panama,North America,4441253,1676,313834
2021-01-27,panama,North America,4441253,1566,315400
2021-01-28,panama,North America,4441253,1408,316808
2021-01-29,panama,North America,4441253,1445,318253
2021-01-30,panama,North America,4441253,1200,319453
2021-01-31,panama,North America,4441253,926,320379
2021-02-01,panama,North America,4441253,724,321103
2021-02-02,panama,North America,4441253,1098,322201
2021-02-03,panama,North America,4441253,1181,323382
2021-02-04,panama,North America,4441253,1107,324489
2021-02-05,panama,North America,4441253,998,325487
2021-02-06,panama,North America,4441253,977,326464
2021-02-07,panama,North America,4441253,627,327091
2021-02-08,panama,North America,4441253,563,327654
2021-02-09,panama,North America,4441253,822,328476
2021-02-10,panama,North America,4441253,891,329367
2021-02-11,panama,North America,4441253,708,330075
2021-02-12,panama,North America,4441253,910,330985
2021-02-13,panama,North America,4441253,707,331692
2021-02-14,panama,North America,4441253,487,332179
2021-02-15,panama,North America,4441253,500,332679
2021-02-16,panama,North America,4441253,572,333251
2021-02-17,panama,North America,4441253,504,333755
2021-02-18,panama,North America,4441253,708,334463
2021-02-19,panama,North America,4441253,876,335339
2021-02-20,panama,North America,4441253,698,336037
2021-02-21,panama,North America,4441253,484,336521
2021-02-22,panama,North America,4441253,566,337087
2021-02-23,panama,North America,4441253,718,337805
2021-02-24,panama,North America,4441253,896,338701
2021-02-25,panama,North America,4441253,682,339383
2021-02-26,panama,North America,4441253,398,339781
2021-02-27,panama,North America,4441253,664,340445
2021-02-28,panama,North America,4441253,470,340915
2021-03-01,panama,North America,4441253,505,341420
2021-03-02,panama,North America,4441253,599,342019
2021-03-03,panama,North America,4441253,722,342741
2021-03-04,panama,North America,4441253,540,343281
2021-03-05,panama,North America,4441253,462,343743
2021-03-06,panama,North America,4441253,734,344477
2021-03-07,panama,North America,4441253,357,344834
2021-03-08,panama,North America,4441253,402,345236
2021-03-09,panama,North America,4441253,523,345759
2021-03-10,panama,North America,4441253,542,346301
2021-03-11,panama,North America,4441253,474,346775
2021-03-12,panama,North America,4441253,451,347226
2021-03-13,panama,North America,4441253,415,347641
2021-03-14,panama,North America,4441253,278,347919
2021-03-15,panama,North America,4441253,236,348155
2021-03-16,panama,North America,4441253,425,348580
2021-03-17,panama,North America,4441253,440,349020
2021-03-18,panama,North America,4441253,485,349505
2021-03-19,panama,North America,4441253,715,350220
2021-03-20,panama,North America,4441253,445,350665
2021-03-21,panama,North America,4441253,326,350991
2021-03-22,panama,North America,4441253,222,351213
2021-03-23,panama,North America,4441253,454,351667
2021-03-24,panama,North America,4441253,415,352082
2021-03-25,panama,North America,4441253,497,352579
2021-03-26,panama,North America,4441253,438,353017
2021-03-27,panama,North America,4441253,480,353497
2021-03-28,panama,North America,4441253,342,353839
2021-03-29,panama,North America,4441253,246,354085
2021-03-30,panama,North America,4441253,519,354604
2021-03-31,panama,North America,4441253,447,355051
2021-04-01,panama,North America,4441253,448,355499
2021-04-02,panama,North America,4441253,351,355850
2021-04-03,panama,North America,4441253,223,356073
2021-04-04,panama,North America,4441253,304,356377
2021-04-05,panama,North America,4441253,179,356556
2021-04-06,panama,North America,4441253,357,356913
2021-04-07,panama,North America,4441253,364,357277
2021-04-08,panama,North America,4441253,427,357704
2021-04-09,panama,North America,4441253,394,358098
2021-04-10,panama,North America,4441253,279,358377
2021-04-11,panama,North America,4441253,234,358611
2021-04-12,panama,North America,4441253,181,358792
2021-04-13,panama,North America,4441253,329,359121
2021-04-14,panama,North America,4441253,395,359516
2021-04-15,panama,North America,4441253,314,359830
2021-04-16,panama,North America,4441253,419,360249
2021-04-17,panama,North America,4441253,348,360597
2021-04-18,panama,North America,4441253,244,360841
2021-04-19,panama,North America,4441253,203,361044
2021-04-20,panama,North America,4441253,275,361319
2021-04-21,panama,North America,4441253,359,361678
2021-04-22,panama,North America,4441253,314,361992
2021-04-23,panama,North America,4441253,366,362358
2021-04-24,panama,North America,4441253,338,362696
2021-04-25,panama,North America,4441253,271,362967
2021-04-26,panama,North America,4441253,198,363165
2021-04-27,panama,North America,4441253,368,363533
2021-04-28,panama,North America,4441253,362,363895
2021-04-29,panama,North America,4441253,323,364218
2021-04-30,panama,North America,4441253,358,364576
2021-05-01,panama,North America,4441253,268,364844
2021-05-02,panama,North America,4441253,260,365104
2021-05-03,panama,North America,4441253,195,365299
2021-05-04,panama,North America,4441253,320,365619
2021-05-05,panama,North America,4441253,356,365975
2021-05-06,panama,North America,4441253,389,366364
2021-05-07,panama,North America,4441253,398,366762
2021-05-08,panama,North America,4441253,508,367270
2021-05-09,panama,North America,4441253,386,367656
2021-05-10,panama,North America,4441253,252,367908
2021-05-11,panama,North America,4441253,460,368368
2021-05-12,panama,North America,4441253,562,368930
2021-05-13,panama,North America,4441253,525,369455
2021-05-14,panama,North America,4441253,588,370043
2021-05-15,panama,North America,4441253,490,370533
2021-05-16,panama,North America,4441253,344,370877
2021-05-17,panama,North America,4441253,268,371145
2021-05-18,panama,North America,4441253,539,371684
2021-05-19,panama,North America,4441253,537,372221
2021-05-20,panama,North America,4441253,579,372800
2021-05-21,panama,North America,4441253,508,373308
2021-05-22,panama,North America,4441253,466,373774
2021-05-23,panama,North America,4441253,347,374121
2021-05-24,panama,North America,4441253,235,374356
2021-05-25,panama,North America,4441253,581,374937
2021-05-26,panama,North America,4441253,663,375600
2021-05-27,panama,North America,4441253,637,376237
2021-05-28,panama,North America,4441253,617,376854
2021-05-29,panama,North America,4441253,574,377428
2021-05-30,panama,North America,4441253,348,377776
2021-05-31,panama,North America,4441253,321,378097
2021-06-01,panama,North America,4441253,731,378828
2021-06-02,panama,North America,4441253,678,379506
2021-06-03,panama,North America,4441253,701,380207
2021-06-04,panama,North America,4441253,915,381122
2021-06-05,panama,North America,4441253,827,381949
2021-06-06,panama,North America,4441253,526,382475
2021-06-07,panama,North America,4441253,376,382851
2021-06-08,panama,North America,4441253,882,383733
2021-06-09,panama,North America,4441253,779,384512
2021-06-10,panama,North America,4441253,841,385353
2021-06-11,panama,North America,4441253,916,386269
2021-06-12,panama,North America,4441253,858,387127
2021-06-13,panama,North America,4441253,715,387842
2021-06-14,panama,North America,4441253,483,388325
2021-06-15,panama,North America,4441253,848,389173
2021-06-16,panama,North America,4441253,1048,390221
2021-06-17,panama,North America,4441253,969,391190
2021-06-18,panama,North America,4441253,976,392166
2021-06-19,panama,North America,4441253,978,393144
2021-06-20,panama,North America,4441253,583,393727
2021-06-21,panama,North America,4441253,514,394241
2021-06-22,panama,North America,4441253,1208,395449
2021-06-23,panama,North America,4441253,1077,396526
2021-06-24,panama,North America,4441253,1201,397727
2021-06-25,panama,North America,4441253,1093,398820
2021-06-26,panama,North America,4441253,1057,399877
2021-06-27,panama,North America,4441253,789,400666
2021-06-28,panama,North America,4441253,666,401332
2021-06-29,panama,North America,4441253,1249,402581
2021-06-30,panama,North America,4441253,1197,403778
2021-07-01,panama,North America,4441253,1205,404983
2021-07-02,panama,North America,4441253,1030,406013
2021-07-03,panama,North America,4441253,1317,407330
2021-07-04,panama,North America,4441253,793,408123
2021-07-05,panama,North America,4441253,605,408728
2021-07-06,panama,North America,4441253,1276,410004
2021-07-07,panama,North America,4441253,1222,411226
2021-07-08,panama,North America,4441253,1240,412466
2021-07-09,panama,North America,4441253,1160,413626
2021-07-10,panama,North America,4441253,1021,414647
2021-07-11,panama,North America,4441253,833,415480
2021-07-12,panama,North America,4441253,752,416232
2021-07-13,panama,North America,4441253,855,417087
2021-07-14,panama,North America,4441253,1517,418604
2021-07-15,panama,North America,4441253,1225,419829
2021-07-16,panama,North America,4441253,1087,420916
2021-07-17,panama,North America,4441253,1041,421957
2021-07-18,panama,North America,4441253,721,422678
2021-07-19,panama,North America,4441253,688,423366
2021-07-20,panama,North America,4441253,1089,424455
2021-07-21,panama,North America,4441253,1144,425599
2021-07-22,panama,North America,4441253,1250,426849
2021-07-23,panama,North America,4441253,1138,427987
2021-07-24,panama,North America,4441253,1096,429083
2021-07-25,panama,North America,4441253,866,429949
2021-07-26,panama,North America,4441253,495,430444
2021-07-27,panama,North America,4441253,1110,431554
2021-07-28,panama,North America,4441253,969,432523
2021-07-29,panama,North America,4441253,1022,433545
2021-07-30,panama,North America,4441253,915,434460
2021-07-31,panama,North America,4441253,1195,435655
2021-08-01,panama,North America,4441253,820,436475
2021-08-02,panama,North America,4441253,337,436812
2021-08-03,panama,North America,4441253,932,437744
2021-08-04,panama,North America,4441253,1037,438781
2021-08-05,panama,North America,4441253,818,439599
2021-08-06,panama,North America,4441253,895,440494
2021-08-07,panama,North America,4441253,822,441316
2021-08-08,panama,North America,4441253,979,442295
2021-08-09,panama,North America,4441253,523,442818
2021-08-10,panama,North America,4441253,900,443718
2021-08-11,panama,North America,4441253,977,444695
2021-08-12,panama,North America,4441253,956,445651
2021-08-13,panama,North America,4441253,758,446409
2021-08-14,panama,North America,4441253,852,447261
2021-08-15,panama,North America,4441253,563,447824
2021-08-16,panama,North America,4441253,444,448268
2021-08-17,panama,North America,4441253,656,448924
2021-08-18,panama,North America,4441253,838,449762
2021-08-19,panama,North America,4441253,862,450624
2021-08-20,panama,North America,4441253,669,451293
2021-08-21,panama,North America,4441253,691,451984
2021-08-22,panama,North America,4441253,614,452598
2021-08-23,panama,North America,4441253,388,452986
2021-08-24,panama,North America,4441253,480,453466
2021-08-25,panama,North America,4441253,864,454330
2021-08-26,panama,North America,4441253,548,454878
2021-08-27,panama,North America,4441253,649,455527
2021-08-28,panama,North America,4441253,676,456203
2021-08-29,panama,North America,4441253,463,456666
2021-08-30,panama,North America,4441253,371,457037
2021-08-31,panama,North America,4441253,450,457487
2021-09-01,panama,North America,4441253,670,458157
2021-09-02,panama,North America,4441253,481,458638
2021-09-03,panama,North America,4441253,439,459077
2021-09-04,panama,North America,4441253,442,459519
2021-09-05,panama,North America,4441253,325,459844
2021-09-06,panama,North America,4441253,229,460073
2021-09-07,panama,North America,4441253,426,460499
2021-09-08,panama,North America,4441253,330,460829
2021-09-09,panama,North America,4441253,401,461230
2021-09-10,panama,North America,4441253,360,461590
2021-09-11,panama,North America,4441253,420,462010
2021-09-12,panama,North America,4441253,214,462224
2021-09-13,panama,North America,4441253,223,462447
2021-09-14,panama,North America,4441253,323,462770
2021-09-15,panama,North America,4441253,316,463086
2021-09-16,panama,North America,4441253,373,463459
2021-09-17,panama,North America,4441253,324,463783
2021-09-18,panama,North America,4441253,255,464038
2021-09-19,panama,North America,4441253,250,464288
2021-09-20,panama,North America,4441253,152,464440
2021-09-21,panama,North America,4441253,341,464781
2021-09-22,panama,North America,4441253,366,465147
2021-09-23,panama,North America,4441253,324,465471
2021-09-24,panama,North America,4441253,265,465736
2021-09-25,panama,North America,4441253,257,465993
2021-09-26,panama,North America,4441253,185,466178
2021-09-27,panama,North America,4441253,179,466357
2021-09-28,panama,North America,4441253,232,466589
2021-09-29,panama,North America,4441253,262,466851
2021-09-30,panama,North America,4441253,262,467113
2021-10-01,panama,North America,4441253,225,467338
2021-10-02,panama,North America,4441253,227,467565
2021-10-03,panama,North America,4441253,175,467740
2021-10-04,panama,North America,4441253,121,467861
2021-10-05,panama,North America,4441253,253,468114
2021-10-06,panama,North America,4441253,211,468325
2021-10-07,panama,North America,4441253,220,468545
2021-10-08,panama,North America,4441253,195,468740
2021-10-09,panama,North America,4441253,223,468963
2021-10-10,panama,North America,4441253,119,469082
2021-10-11,panama,North America,4441253,108,469190
2021-10-12,panama,North America,4441253,250,469440
2021-10-13,panama,North America,4441253,129,469569
2021-10-14,panama,North America,4441253,227,469796
2021-10-15,panama,North America,4441253,202,469998
2021-10-16,panama,North America,4441253,164,470162
2021-10-17,panama,North America,4441253,102,470264
2021-10-18,panama,North America,4441253,131,470395
2021-10-19,panama,North America,4441253,203,470598
2021-10-20,panama,North America,4441253,257,470855
2021-10-21,panama,North America,4441253,205,471060
2021-10-22,panama,North America,4441253,193,471253
2021-10-23,panama,North America,4441253,150,471403
2021-10-24,panama,North America,4441253,134,471537
2021-10-25,panama,North America,4441253,132,471669
2021-10-26,panama,North America,4441253,215,471884
2021-10-27,panama,North America,4441253,173,472057
2021-10-28,panama,North America,4441253,140,472197
2021-10-29,panama,North America,4441253,201,472398
2021-10-30,panama,North America,4441253,136,472534
2021-10-31,panama,North America,4441253,130,472664
2021-11-01,panama,North America,4441253,72,472736
2021-11-02,panama,North America,4441253,141,472877
2021-11-03,panama,North America,4441253,128,473005
2021-11-04,panama,North America,4441253,84,473089
2021-11-05,panama,North America,4441253,94,473183
2021-11-06,panama,North America,4441253,120,473303
2021-11-07,panama,North America,4441253,113,473416
2021-11-08,panama,North America,4441253,106,473522
2021-11-09,panama,North America,4441253,196,473718
2021-11-10,panama,North America,4441253,185,473903
2021-11-11,panama,North America,4441253,99,474002
2021-11-12,panama,North America,4441253,229,474231
2021-11-13,panama,North America,4441253,222,474453
2021-11-14,panama,North America,4441253,168,474621
2021-11-15,panama,North America,4441253,114,474735
2021-11-16,panama,North America,4441253,193,474928
2021-11-17,panama,North America,4441253,238,475166
2021-11-18,panama,North America,4441253,203,475369
2021-11-19,panama,North America,4441253,208,475577
2021-11-20,panama,North America,4441253,258,475835
2021-11-21,panama,North America,4441253,162,475997
2021-11-22,panama,North America,4441253,132,476129
2021-11-23,panama,North America,4441253,214,476343
2021-11-24,panama,North America,4441253,268,476611
2021-11-25,panama,North America,4441253,202,476813
2021-11-26,panama,North America,4441253,283,477096
2021-11-27,panama,North America,4441253,210,477306
2021-11-28,panama,North America,4441253,208,477514
2021-11-29,panama,North America,4441253,94,477608
2021-11-30,panama,North America,4441253,134,477742
2021-12-01,panama,North America,4441253,248,477990
2021-12-02,panama,North America,4441253,285,478275
2021-12-03,panama,North America,4441253,268,478543
2021-12-04,panama,North America,4441253,288,478831
2021-12-05,panama,North America,4441253,222,479053
2021-12-06,panama,North America,4441253,178,479231
2021-12-07,panama,North America,4441253,332,479563
2021-12-08,panama,North America,4441253,338,479901
2021-12-09,panama,North America,4441253,189,480090
2021-12-10,panama,North America,4441253,127,480217
2021-12-11,panama,North America,4441253,356,480573
2021-12-12,panama,North America,4441253,208,480781
2021-12-13,panama,North America,4441253,275,481056
2021-12-14,panama,North America,4441253,382,481438
2021-12-15,panama,North America,4441253,386,481824
2021-12-16,panama,North America,4441253,406,482230
2021-12-17,panama,North America,4441253,447,482677
2021-12-18,panama,North America,4441253,386,483063
2021-12-19,panama,North America,4441253,323,483386
2021-12-20,panama,North America,4441253,252,483638
2021-12-21,panama,North America,4441253,487,484125
2021-12-22,panama,North America,4441253,668,484793
2021-12-23,panama,North America,4441253,719,485512
2021-12-24,panama,North America,4441253,865,486377
2021-12-25,panama,North America,4441253,827,487204
2021-12-26,panama,North America,4441253,563,487767
2021-12-27,panama,North America,4441253,574,488341
2021-12-28,panama,North America,4441253,1354,489695
2021-12-29,panama,North America,4441253,1348,491043
2021-12-30,panama,North America,4441253,2664,493707
2021-12-31,panama,North America,4441253,2213,495920
2022-01-01,panama,North America,4441253,1888,497808
2022-01-02,panama,North America,4441253,977,498785
2022-01-03,panama,North America,4441253,1363,500148
2022-01-04,panama,North America,4441253,3259,503407
2022-01-05,panama,North America,4441253,4372,507779
2022-01-06,panama,North America,4441253,4623,512402
2022-01-07,panama,North America,4441253,5043,517445
2022-01-08,panama,North America,4441253,4804,522249
2022-01-09,panama,North America,4441253,4066,526315
2022-01-10,panama,North America,4441253,3139,529454
2022-01-11,panama,North America,4441253,4105,533559
2022-01-12,panama,North America,4441253,6513,540072
2022-01-13,panama,North America,4441253,9074,549146
2022-01-14,panama,North America,4441253,9530,558676
2022-01-15,panama,North America,4441253,8902,567578
2022-01-16,panama,North America,4441253,7278,574856
2022-01-17,panama,North America,4441253,5468,580324
2022-01-18,panama,North America,4441253,11519,591843
2022-01-19,panama,North America,4441253,10763,602606
2022-01-20,panama,North America,4441253,12351,614957
2022-01-21,panama,North America,4441253,11933,626890
2022-01-22,panama,North America,4441253,10629,637519
2022-01-23,panama,North America,4441253,7164,644683
2022-01-24,panama,North America,4441253,5455,650138
2022-01-25,panama,North America,4441253,9241,659379
2022-01-26,panama,North America,4441253,10481,669860
2022-01-27,panama,North America,4441253,8268,678128
2022-01-28,panama,North America,4441253,7502,685630
2022-01-29,panama,North America,4441253,7004,692634
2022-01-30,panama,North America,4441253,4490,697124
2022-01-31,panama,North America,4441253,3150,700274
2022-02-01,panama,North America,4441253,5606,705880
2022-02-02,panama,North America,4441253,5811,711691
2022-02-03,panama,North America,4441253,5480,717171
2022-02-04,panama,North America,4441253,4308,721479
2022-02-05,panama,North America,4441253,3589,725068
2022-02-06,panama,North America,4441253,2345,727413
2022-02-07,panama,North America,4441253,1614,729027
2022-02-08,panama,North America,4441253,3180,732207
2022-02-09,panama,North America,4441253,3028,735235
2022-02-10,panama,North America,4441253,2424,737659
2022-02-11,panama,North America,4441253,2111,739770
2022-02-12,panama,North America,4441253,1881,741651
2020-03-22,paraguay,South America,7295705,0,22
2020-03-23,paraguay,South America,7295705,0,22
2020-03-24,paraguay,South America,7295705,5,27
2020-03-25,paraguay,South America,7295705,10,37
2020-03-26,paraguay,South America,7295705,4,41
2020-03-27,paraguay,South America,7295705,11,52
2020-03-28,paraguay,South America,7295705,4,56
2020-03-29,paraguay,South America,7295705,3,59
2020-03-30,paraguay,South America,7295705,5,64
2020-03-31,paraguay,South America,7295705,1,65
2020-04-01,paraguay,South America,7295705,4,69
2020-04-02,paraguay,South America,7295705,8,77
2020-04-03,paraguay,South America,7295705,15,92
2020-04-04,paraguay,South America,7295705,4,96
2020-04-05,paraguay,South America,7295705,8,104
2020-04-06,paraguay,South America,7295705,9,113
2020-04-07,paraguay,South America,7295705,2,115
2020-04-08,paraguay,South America,7295705,4,119
2020-04-09,paraguay,South America,7295705,5,124
2020-04-10,paraguay,South America,7295705,5,129
2020-04-11,paraguay,South America,7295705,4,133
2020-04-12,paraguay,South America,7295705,1,134
2020-04-13,paraguay,South America,7295705,13,147
2020-04-14,paraguay,South America,7295705,12,159
2020-04-15,paraguay,South America,7295705,2,161
2020-04-16,paraguay,South America,7295705,13,174
2020-04-17,paraguay,South America,7295705,25,199
2020-04-18,paraguay,South America,7295705,3,202
2020-04-19,paraguay,South America,7295705,4,206
2020-04-20,paraguay,South America,7295705,2,208
2020-04-21,paraguay,South America,7295705,0,208
2020-04-22,paraguay,South America,7295705,5,213
2020-04-23,paraguay,South America,7295705,0,213
2020-04-24,paraguay,South America,7295705,7,220
2020-04-25,paraguay,South America,7295705,3,223
2020-04-26,paraguay,South America,7295705,5,228
2020-04-27,paraguay,South America,7295705,0,228
2020-04-28,paraguay,South America,7295705,2,230
2020-04-29,paraguay,South America,7295705,9,239
2020-04-30,paraguay,South America,7295705,10,249
2020-05-01,paraguay,South America,7295705,17,266
2020-05-02,paraguay,South America,7295705,67,333
2020-05-03,paraguay,South America,7295705,37,370
2020-05-04,paraguay,South America,7295705,26,396
2020-05-05,paraguay,South America,7295705,35,431
2020-05-06,paraguay,South America,7295705,9,440
2020-05-07,paraguay,South America,7295705,22,462
2020-05-08,paraguay,South America,7295705,101,563
2020-05-09,paraguay,South America,7295705,126,689
2020-05-10,paraguay,South America,7295705,24,713
2020-05-11,paraguay,South America,7295705,11,724
2020-05-12,paraguay,South America,7295705,13,737
2020-05-13,paraguay,South America,7295705,3,740
2020-05-14,paraguay,South America,7295705,14,754
2020-05-15,paraguay,South America,7295705,5,759
2020-05-16,paraguay,South America,7295705,19,778
2020-05-17,paraguay,South America,7295705,8,786
2020-05-18,paraguay,South America,7295705,2,788
2020-05-19,paraguay,South America,7295705,41,829
2020-05-20,paraguay,South America,7295705,4,833
2020-05-21,paraguay,South America,7295705,3,836
2020-05-22,paraguay,South America,7295705,2,838
2020-05-23,paraguay,South America,7295705,12,850
2020-05-24,paraguay,South America,7295705,12,862
2020-05-25,paraguay,South America,7295705,3,865
2020-05-26,paraguay,South America,7295705,12,877
2020-05-27,paraguay,South America,7295705,7,884
2020-05-28,paraguay,South America,7295705,16,900
2020-05-29,paraguay,South America,7295705,17,917
2020-05-30,paraguay,South America,7295705,47,964
2020-05-31,paraguay,South America,7295705,22,986
2020-06-01,paraguay,South America,7295705,9,995
2020-06-02,paraguay,South America,7295705,18,1013
2020-06-03,paraguay,South America,7295705,57,1070
2020-06-04,paraguay,South America,7295705,16,1086
2020-06-05,paraguay,South America,7295705,1,1087
2020-06-06,paraguay,South America,7295705,3,1090
2020-06-07,paraguay,South America,7295705,45,1135
2020-06-08,paraguay,South America,7295705,10,1145
2020-06-09,paraguay,South America,7295705,42,1187
2020-06-10,paraguay,South America,7295705,15,1202
2020-06-11,paraguay,South America,7295705,28,1230
2020-06-12,paraguay,South America,7295705,24,1254
2020-06-13,paraguay,South America,7295705,7,1261
2020-06-14,paraguay,South America,7295705,28,1289
2020-06-15,paraguay,South America,7295705,7,1296
2020-06-16,paraguay,South America,7295705,7,1303
2020-06-17,paraguay,South America,7295705,5,1308
2020-06-18,paraguay,South America,7295705,22,1330
2020-06-19,paraguay,South America,7295705,6,1336
2020-06-20,paraguay,South America,7295705,26,1362
2020-06-21,paraguay,South America,7295705,17,1379
2020-06-22,paraguay,South America,7295705,13,1392
2020-06-23,paraguay,South America,7295705,30,1422
2020-06-24,paraguay,South America,7295705,106,1528
2020-06-25,paraguay,South America,7295705,41,1569
2020-06-26,paraguay,South America,7295705,142,1711
2020-06-27,paraguay,South America,7295705,231,1942
2020-06-28,paraguay,South America,7295705,185,2127
2020-06-29,paraguay,South America,7295705,64,2191
2020-06-30,paraguay,South America,7295705,30,2221
2020-07-01,paraguay,South America,7295705,39,2260
2020-07-02,paraguay,South America,7295705,43,2303
2020-07-03,paraguay,South America,7295705,46,2349
2020-07-04,paraguay,South America,7295705,36,2385
2020-07-05,paraguay,South America,7295705,42,2427
2020-07-06,paraguay,South America,7295705,29,2456
2020-07-07,paraguay,South America,7295705,46,2502
2020-07-08,paraguay,South America,7295705,52,2554
2020-07-09,paraguay,South America,7295705,84,2638
2020-07-10,paraguay,South America,7295705,98,2736
2020-07-11,paraguay,South America,7295705,84,2820
2020-07-12,paraguay,South America,7295705,128,2948
2020-07-13,paraguay,South America,7295705,32,2980
2020-07-14,paraguay,South America,7295705,94,3074
2020-07-15,paraguay,South America,7295705,124,3198
2020-07-16,paraguay,South America,7295705,144,3342
2020-07-17,paraguay,South America,7295705,115,3457
2020-07-18,paraguay,South America,7295705,172,3629
2020-07-19,paraguay,South America,7295705,92,3721
2020-07-20,paraguay,South America,7295705,27,3748
2020-07-21,paraguay,South America,7295705,69,3817
2020-07-22,paraguay,South America,7295705,183,4000
2020-07-23,paraguay,South America,7295705,113,4113
2020-07-24,paraguay,South America,7295705,111,4224
2020-07-25,paraguay,South America,7295705,104,4328
2020-07-26,paraguay,South America,7295705,116,4444
2020-07-27,paraguay,South America,7295705,104,4548
2020-07-28,paraguay,South America,7295705,126,4674
2020-07-29,paraguay,South America,7295705,192,4866
2020-07-30,paraguay,South America,7295705,341,5207
2020-07-31,paraguay,South America,7295705,131,5338
2020-08-01,paraguay,South America,7295705,147,5485
2020-08-02,paraguay,South America,7295705,159,5644
2020-08-03,paraguay,South America,7295705,80,5724
2020-08-04,paraguay,South America,7295705,128,5852
2020-08-05,paraguay,South America,7295705,208,6060
2020-08-06,paraguay,South America,7295705,315,6375
2020-08-07,paraguay,South America,7295705,133,6508
2020-08-08,paraguay,South America,7295705,197,6705
2020-08-09,paraguay,South America,7295705,202,6907
2020-08-10,paraguay,South America,7295705,327,7234
2020-08-11,paraguay,South America,7295705,285,7519
2020-08-12,paraguay,South America,7295705,499,8018
2020-08-13,paraguay,South America,7295705,371,8389
2020-08-14,paraguay,South America,7295705,633,9022
2020-08-15,paraguay,South America,7295705,359,9381
2020-08-16,paraguay,South America,7295705,410,9791
2020-08-17,paraguay,South America,7295705,344,10135
2020-08-18,paraguay,South America,7295705,471,10606
2020-08-19,paraguay,South America,7295705,527,11133
2020-08-20,paraguay,South America,7295705,684,11817
2020-08-21,paraguay,South America,7295705,719,12536
2020-08-22,paraguay,South America,7295705,438,12974
2020-08-23,paraguay,South America,7295705,259,13233
2020-08-24,paraguay,South America,7295705,369,13602
2020-08-25,paraguay,South America,7295705,626,14228
2020-08-26,paraguay,South America,7295705,644,14872
2020-08-27,paraguay,South America,7295705,418,15290
2020-08-28,paraguay,South America,7295705,583,15873
2020-08-29,paraguay,South America,7295705,601,16474
2020-08-30,paraguay,South America,7295705,631,17105
2020-08-31,paraguay,South America,7295705,557,17662
2020-09-01,paraguay,South America,7295705,676,18338
2020-09-02,paraguay,South America,7295705,800,19138
2020-09-03,paraguay,South America,7295705,821,19959
2020-09-04,paraguay,South America,7295705,695,20654
2020-09-05,paraguay,South America,7295705,1218,21872
2020-09-06,paraguay,South America,7295705,615,22487
2020-09-07,paraguay,South America,7295705,868,23355
2020-09-08,paraguay,South America,7295705,862,24217
2020-09-09,paraguay,South America,7295705,812,25029
2020-09-10,paraguay,South America,7295705,605,25634
2020-09-11,paraguay,South America,7295705,882,26516
2020-09-12,paraguay,South America,7295705,812,27328
2020-09-13,paraguay,South America,7295705,493,27821
2020-09-14,paraguay,South America,7295705,670,28491
2020-09-15,paraguay,South America,7295705,811,29302
2020-09-16,paraguay,South America,7295705,1122,30424
2020-09-17,paraguay,South America,7295705,694,31118
2020-09-18,paraguay,South America,7295705,1015,32133
2020-09-19,paraguay,South America,7295705,889,33022
2020-09-20,paraguay,South America,7295705,505,33527
2020-09-21,paraguay,South America,7295705,740,34267
2020-09-22,paraguay,South America,7295705,568,34835
2020-09-23,paraguay,South America,7295705,743,35578
2020-09-24,paraguay,South America,7295705,834,36412
2020-09-25,paraguay,South America,7295705,822,37234
2020-09-26,paraguay,South America,7295705,696,37930
2020-09-27,paraguay,South America,7295705,762,38692
2020-09-28,paraguay,South America,7295705,748,39440
2020-09-29,paraguay,South America,7295705,669,40109
2020-09-30,paraguay,South America,7295705,657,40766
2020-10-01,paraguay,South America,7295705,1042,41808
2020-10-02,paraguay,South America,7295705,886,42694
2020-10-03,paraguay,South America,7295705,768,43462
2020-10-04,paraguay,South America,7295705,730,44192
2020-10-05,paraguay,South America,7295705,533,44725
2020-10-06,paraguay,South America,7295705,933,45658
2020-10-07,paraguay,South America,7295705,788,46446
2020-10-08,paraguay,South America,7295705,882,47328
2020-10-09,paraguay,South America,7295705,960,48288
2020-10-10,paraguay,South America,7295705,703,48991
2020-10-11,paraguay,South America,7295705,697,49688
2020-10-12,paraguay,South America,7295705,669,50357
2020-10-13,paraguay,South America,7295705,854,51211
2020-10-14,paraguay,South America,7295705,648,51859
2020-10-15,paraguay,South America,7295705,751,52610
2020-10-16,paraguay,South America,7295705,887,53497
2020-10-17,paraguay,South America,7295705,533,54030
2020-10-18,paraguay,South America,7295705,709,54739
2020-10-19,paraguay,South America,7295705,728,55467
2020-10-20,paraguay,South America,7295705,621,56088
2020-10-21,paraguay,South America,7295705,746,56834
2020-10-22,paraguay,South America,7295705,707,57541
2020-10-23,paraguay,South America,7295705,733,58274
2020-10-24,paraguay,South America,7295705,784,59058
2020-10-25,paraguay,South America,7295705,551,59609
2020-10-26,paraguay,South America,7295705,515,60124
2020-10-27,paraguay,South America,7295705,448,60572
2020-10-28,paraguay,South America,7295705,733,61305
2020-10-29,paraguay,South America,7295705,760,62065
2020-10-30,paraguay,South America,7295705,546,62611
2020-10-31,paraguay,South America,7295705,589,63200
2020-11-01,paraguay,South America,7295705,546,63746
2020-11-02,paraguay,South America,7295705,425,64171
2020-11-03,paraguay,South America,7295705,472,64643
2020-11-04,paraguay,South America,7295705,630,65273
2020-11-05,paraguay,South America,7295705,520,65793
2020-11-06,paraguay,South America,7295705,703,66496
2020-11-07,paraguay,South America,7295705,460,66956
2020-11-08,paraguay,South America,7295705,648,67604
2020-11-09,paraguay,South America,7295705,359,67963
2020-11-10,paraguay,South America,7295705,549,68512
2020-11-11,paraguay,South America,7295705,609,69121
2020-11-12,paraguay,South America,7295705,547,69668
2020-11-13,paraguay,South America,7295705,739,70407
2020-11-14,paraguay,South America,7295705,673,71080
2020-11-15,paraguay,South America,7295705,509,71589
2020-11-16,paraguay,South America,7295705,525,72114
2020-11-17,paraguay,South America,7295705,758,72872
2020-11-18,paraguay,South America,7295705,782,73654
2020-11-19,paraguay,South America,7295705,857,74511
2020-11-20,paraguay,South America,7295705,563,75074
2020-11-21,paraguay,South America,7295705,799,75873
2020-11-22,paraguay,South America,7295705,619,76492
2020-02-16,philippines,Asia,112297269,0,3
2020-02-17,philippines,Asia,112297269,0,3
2020-02-18,philippines,Asia,112297269,0,3
2020-02-19,philippines,Asia,112297269,0,3
2020-02-20,philippines,Asia,112297269,0,3
2020-02-21,philippines,Asia,112297269,0,3
2020-02-22,philippines,Asia,112297269,0,3
2020-02-23,philippines,Asia,112297269,0,3
2020-02-24,philippines,Asia,112297269,0,3
2020-02-25,philippines,Asia,112297269,0,3
2020-02-26,philippines,Asia,112297269,0,3
2020-02-27,philippines,Asia,112297269,0,3
2020-02-28,philippines,Asia,112297269,0,3
2020-02-29,philippines,Asia,112297269,0,3
2020-03-01,philippines,Asia,112297269,0,3
2020-03-02,philippines,Asia,112297269,0,3
2020-03-03,philippines,Asia,112297269,0,3
2020-03-04,philippines,Asia,112297269,0,3
2020-03-05,philippines,Asia,112297269,0,3
2020-03-06,philippines,Asia,112297269,2,5
2020-03-07,philippines,Asia,112297269,1,6
2020-03-08,philippines,Asia,112297269,4,10
2020-03-09,philippines,Asia,112297269,14,24
2020-03-10,philippines,Asia,112297269,9,33
2020-03-11,philippines,Asia,112297269,16,49
2020-03-12,philippines,Asia,112297269,3,52
2020-03-13,philippines,Asia,112297269,12,64
2020-03-14,philippines,Asia,112297269,47,111
2020-03-15,philippines,Asia,112297269,29,140
2020-03-16,philippines,Asia,112297269,2,142
2020-03-17,philippines,Asia,112297269,45,187
2020-03-18,philippines,Asia,112297269,15,202
2020-03-19,philippines,Asia,112297269,15,217
2020-03-20,philippines,Asia,112297269,13,230
2020-03-21,philippines,Asia,112297269,77,307
2020-03-22,philippines,Asia,112297269,73,380
2020-03-23,philippines,Asia,112297269,82,462
2020-03-24,philippines,Asia,112297269,90,552
2020-03-25,philippines,Asia,112297269,84,636
2020-03-26,philippines,Asia,112297269,71,707
2020-03-27,philippines,Asia,112297269,96,803
2020-03-28,philippines,Asia,112297269,272,1075
2020-03-29,philippines,Asia,112297269,343,1418
2020-03-30,philippines,Asia,112297269,128,1546
2020-03-31,philippines,Asia,112297269,538,2084
2020-04-01,philippines,Asia,112297269,227,2311
2020-04-02,philippines,Asia,112297269,322,2633
2020-04-03,philippines,Asia,112297269,385,3018
2020-04-04,philippines,Asia,112297269,76,3094
2020-04-05,philippines,Asia,112297269,152,3246
2020-04-06,philippines,Asia,112297269,414,3660
2020-04-07,philippines,Asia,112297269,104,3764
2020-04-08,philippines,Asia,112297269,106,3870
2020-04-09,philippines,Asia,112297269,206,4076
2020-04-10,philippines,Asia,112297269,119,4195
2020-04-11,philippines,Asia,112297269,233,4428
2020-04-12,philippines,Asia,112297269,220,4648
2020-04-13,philippines,Asia,112297269,284,4932
2020-04-14,philippines,Asia,112297269,291,5223
2020-04-15,philippines,Asia,112297269,230,5453
2020-04-16,philippines,Asia,112297269,207,5660
2020-04-17,philippines,Asia,112297269,218,5878
2020-04-18,philippines,Asia,112297269,209,6087
2020-04-19,philippines,Asia,112297269,172,6259
2020-04-20,philippines,Asia,112297269,200,6459
2020-04-21,philippines,Asia,112297269,140,6599
2020-04-22,philippines,Asia,112297269,111,6710
2020-04-23,philippines,Asia,112297269,271,6981
2020-04-24,philippines,Asia,112297269,211,7192
2020-04-25,philippines,Asia,112297269,102,7294
2020-04-26,philippines,Asia,112297269,285,7579
2020-04-27,philippines,Asia,112297269,198,7777
2020-04-28,philippines,Asia,112297269,181,7958
2020-04-29,philippines,Asia,112297269,254,8212
2020-04-30,philippines,Asia,112297269,276,8488
2020-05-01,philippines,Asia,112297269,284,8772
2020-05-02,philippines,Asia,112297269,156,8928
2020-05-03,philippines,Asia,112297269,295,9223
2020-05-04,philippines,Asia,112297269,262,9485
2020-05-05,philippines,Asia,112297269,199,9684
2020-05-06,philippines,Asia,112297269,320,10004
2020-05-07,philippines,Asia,112297269,339,10343
2020-05-08,philippines,Asia,112297269,120,10463
2020-05-09,philippines,Asia,112297269,147,10610
2020-05-10,philippines,Asia,112297269,184,10794
2020-05-11,philippines,Asia,112297269,292,11086
2020-05-12,philippines,Asia,112297269,264,11350
2020-05-13,philippines,Asia,112297269,268,11618
2020-05-14,philippines,Asia,112297269,258,11876
2020-05-15,philippines,Asia,112297269,215,12091
2020-05-16,philippines,Asia,112297269,214,12305
2020-05-17,philippines,Asia,112297269,208,12513
2020-05-18,philippines,Asia,112297269,205,12718
2020-05-19,philippines,Asia,112297269,224,12942
2020-05-20,philippines,Asia,112297269,279,13221
2020-05-21,philippines,Asia,112297269,213,13434
2020-05-22,philippines,Asia,112297269,163,13597
2020-05-23,philippines,Asia,112297269,180,13777
2020-05-24,philippines,Asia,112297269,258,14035
2020-05-25,philippines,Asia,112297269,284,14319
2020-05-26,philippines,Asia,112297269,350,14669
2020-05-27,philippines,Asia,112297269,380,15049
2020-05-28,philippines,Asia,112297269,539,15588
2020-05-29,philippines,Asia,112297269,1046,16634
2020-05-30,philippines,Asia,112297269,590,17224
2020-05-31,philippines,Asia,112297269,862,18086
2020-06-01,philippines,Asia,112297269,552,18638
2020-06-02,philippines,Asia,112297269,359,18997
2020-06-03,philippines,Asia,112297269,751,19748
2020-06-04,philippines,Asia,112297269,634,20382
2020-06-05,philippines,Asia,112297269,244,20626
2020-06-06,philippines,Asia,112297269,714,21340
2020-06-07,philippines,Asia,112297269,555,21895
2020-06-08,philippines,Asia,112297269,579,22474
2020-06-09,philippines,Asia,112297269,518,22992
2020-06-10,philippines,Asia,112297269,740,23732
2020-06-11,philippines,Asia,112297269,443,24175
2020-06-12,philippines,Asia,112297269,612,24787
2020-06-13,philippines,Asia,112297269,605,25392
2020-06-14,philippines,Asia,112297269,538,25930
2020-06-15,philippines,Asia,112297269,490,26420
2020-06-16,philippines,Asia,112297269,361,26781
2020-06-17,philippines,Asia,112297269,457,27238
2020-06-18,philippines,Asia,112297269,561,27799
2020-06-19,philippines,Asia,112297269,660,28459
2020-06-20,philippines,Asia,112297269,941,29400
2020-06-21,philippines,Asia,112297269,652,30052
2020-06-22,philippines,Asia,112297269,630,30682
2020-06-23,philippines,Asia,112297269,1143,31825
2020-06-24,philippines,Asia,112297269,470,32295
2020-06-25,philippines,Asia,112297269,774,33069
2020-06-26,philippines,Asia,112297269,1004,34073
2020-06-27,philippines,Asia,112297269,730,34803
2020-06-28,philippines,Asia,112297269,652,35455
2020-06-29,philippines,Asia,112297269,983,36438
2020-06-30,philippines,Asia,112297269,1076,37514
2020-07-01,philippines,Asia,112297269,997,38511
2020-07-02,philippines,Asia,112297269,294,38805
2020-07-03,philippines,Asia,112297269,1531,40336
2020-07-04,philippines,Asia,112297269,1494,41830
2020-07-05,philippines,Asia,112297269,2424,44254
2020-07-06,philippines,Asia,112297269,2079,46333
2020-07-07,philippines,Asia,112297269,1540,47873
2020-07-08,philippines,Asia,112297269,2486,50359
2020-07-09,philippines,Asia,112297269,1395,51754
2020-07-10,philippines,Asia,112297269,1160,52914
2020-07-11,philippines,Asia,112297269,1308,54222
2020-07-12,philippines,Asia,112297269,2037,56259
2020-07-13,philippines,Asia,112297269,652,56911
2020-07-14,philippines,Asia,112297269,547,57458
2020-07-15,philippines,Asia,112297269,1310,58768
2020-07-16,philippines,Asia,112297269,2392,61160
2020-07-17,philippines,Asia,112297269,1787,62947
2020-07-18,philippines,Asia,112297269,2268,65215
2020-07-19,philippines,Asia,112297269,2162,67377
2020-07-20,philippines,Asia,112297269,1436,68813
2020-07-21,philippines,Asia,112297269,1862,70675
2020-07-22,philippines,Asia,112297269,1515,72190
2020-07-23,philippines,Asia,112297269,2151,74341
2020-07-24,philippines,Asia,112297269,2103,76444
2020-07-25,philippines,Asia,112297269,1968,78412
2020-07-26,philippines,Asia,112297269,1971,80383
2020-07-27,philippines,Asia,112297269,1612,81995
2020-07-28,philippines,Asia,112297269,1617,83612
2020-07-29,philippines,Asia,112297269,1808,85420
2020-07-30,philippines,Asia,112297269,3871,89291
2020-07-31,philippines,Asia,112297269,3978,93269
2020-08-01,philippines,Asia,112297269,4884,98153
2020-08-02,philippines,Asia,112297269,4951,103104
2020-08-03,philippines,Asia,112297269,3137,106241
2020-08-04,philippines,Asia,112297269,6277,112518
2020-08-05,philippines,Asia,112297269,3381,115899
2020-08-06,philippines,Asia,112297269,3476,119375
2020-08-07,philippines,Asia,112297269,3379,122754
2020-08-08,philippines,Asia,112297269,4131,126885
2020-08-09,philippines,Asia,112297269,2795,129680
2020-08-10,philippines,Asia,112297269,6871,136551
2020-08-11,philippines,Asia,112297269,2754,139305
2020-08-12,philippines,Asia,112297269,4219,143524
2020-08-13,philippines,Asia,112297269,3920,147444
2020-08-14,philippines,Asia,112297269,6123,153567
2020-08-15,philippines,Asia,112297269,4266,157833
2020-08-16,philippines,Asia,112297269,3327,161160
2020-08-17,philippines,Asia,112297269,3217,164377
2020-08-18,philippines,Asia,112297269,4747,169124
2020-08-19,philippines,Asia,112297269,4559,173683
2020-08-20,philippines,Asia,112297269,3896,177579
2020-08-21,philippines,Asia,112297269,4786,182365
2020-08-22,philippines,Asia,112297269,4884,187249
2020-08-23,philippines,Asia,112297269,2317,189566
2020-08-24,philippines,Asia,112297269,4633,194199
2020-08-25,philippines,Asia,112297269,2885,197084
2020-08-26,philippines,Asia,112297269,5248,202332
2020-08-27,philippines,Asia,112297269,3213,205545
2020-08-28,philippines,Asia,112297269,3949,209494
2020-08-29,philippines,Asia,112297269,3618,213112
2020-08-30,philippines,Asia,112297269,4261,217373
2020-08-31,philippines,Asia,112297269,3408,220781
2020-09-01,philippines,Asia,112297269,3441,224222
2020-09-02,philippines,Asia,112297269,2194,226416
2020-09-03,philippines,Asia,112297269,1942,228358
2020-09-04,philippines,Asia,112297269,3683,232041
2020-09-05,philippines,Asia,112297269,2485,234526
2020-09-06,philippines,Asia,112297269,2818,237344
2020-09-07,philippines,Asia,112297269,1383,238727
2020-09-08,philippines,Asia,112297269,3240,241967
2020-09-09,philippines,Asia,112297269,3159,245126
2020-09-10,philippines,Asia,112297269,3798,248924
2020-09-11,philippines,Asia,112297269,4004,252928
2020-09-12,philippines,Asia,112297269,4916,257844
2020-09-13,philippines,Asia,112297269,3345,261189
2020-09-14,philippines,Asia,112297269,4674,265863
2020-09-15,philippines,Asia,112297269,3521,269384
2020-09-16,philippines,Asia,112297269,3530,272914
2020-09-17,philippines,Asia,112297269,3355,276269
2020-09-18,philippines,Asia,112297269,3229,279498
2020-09-19,philippines,Asia,112297269,3934,283432
2020-09-20,philippines,Asia,112297269,3283,286715
2020-09-21,philippines,Asia,112297269,3439,290154
2020-09-22,philippines,Asia,112297269,1604,291758
2020-09-23,philippines,Asia,112297269,2817,294575
2020-09-24,philippines,Asia,112297269,2156,296731
2020-09-25,philippines,Asia,112297269,1778,298509
2020-09-26,philippines,Asia,112297269,2722,301231
2020-09-27,philippines,Asia,112297269,2984,304215
2020-09-28,philippines,Asia,112297269,3063,307278
2020-09-29,philippines,Asia,112297269,1990,309268
2020-09-30,philippines,Asia,112297269,2396,311664
2020-10-01,philippines,Asia,112297269,2403,314067
2020-10-02,philippines,Asia,112297269,2589,316656
2020-10-03,philippines,Asia,112297269,2651,319307
2020-10-04,philippines,Asia,112297269,3164,322471
2020-10-05,philippines,Asia,112297269,2269,324740
2020-10-06,philippines,Asia,112297269,2072,326812
2020-10-07,philippines,Asia,112297269,2694,329506
2020-10-08,philippines,Asia,112297269,2268,331774
2020-10-09,philippines,Asia,112297269,2903,334677
2020-10-10,philippines,Asia,112297269,2162,336839
2020-10-11,philippines,Asia,112297269,2413,339252
2020-10-12,philippines,Asia,112297269,3471,342723
2020-10-13,philippines,Asia,112297269,1903,344626
2020-10-14,philippines,Asia,112297269,1811,346437
2020-10-15,philippines,Asia,112297269,2174,348611
2020-10-16,philippines,Asia,112297269,3054,351665
2020-10-17,philippines,Asia,112297269,2574,354239
2020-10-18,philippines,Asia,112297269,2292,356531
2020-10-19,philippines,Asia,112297269,2604,359135
2020-10-20,philippines,Asia,112297269,1599,360734
2020-10-21,philippines,Asia,112297269,1490,362224
2020-10-22,philippines,Asia,112297269,1652,363876
2020-10-23,philippines,Asia,112297269,1886,365762
2020-10-24,philippines,Asia,112297269,2043,367805
2020-10-25,philippines,Asia,112297269,2218,370023
2020-10-26,philippines,Asia,112297269,1597,371620
2020-10-27,philippines,Asia,112297269,1507,373127
2020-10-28,philippines,Asia,112297269,2047,375174
2020-10-29,philippines,Asia,112297269,1753,376927
2020-10-30,philippines,Asia,112297269,1999,378926
2020-10-31,philippines,Asia,112297269,1791,380717
2020-11-01,philippines,Asia,112297269,2385,383102
2020-11-02,philippines,Asia,112297269,2287,385389
2020-11-03,philippines,Asia,112297269,1761,387150
2020-11-04,philippines,Asia,112297269,981,388131
2020-11-05,philippines,Asia,112297269,1586,389717
2020-11-06,philippines,Asia,112297269,2087,391804
2020-11-07,philippines,Asia,112297269,2149,393953
2020-11-08,philippines,Asia,112297269,2438,396391
2020-11-09,philippines,Asia,112297269,2011,398402
2020-11-10,philippines,Asia,112297269,1342,399744
2020-11-11,philippines,Asia,112297269,1669,401413
2020-11-12,philippines,Asia,112297269,1398,402811
2020-11-13,philippines,Asia,112297269,1876,404687
2020-11-14,philippines,Asia,112297269,1621,406308
2020-11-15,philippines,Asia,112297269,1528,407836
2020-11-16,philippines,Asia,112297269,1734,409570
2020-11-17,philippines,Asia,112297269,1144,410714
2020-11-18,philippines,Asia,112297269,1379,412093
2020-11-19,philippines,Asia,112297269,1335,413428
2020-11-20,philippines,Asia,112297269,1633,415061
2020-11-21,philippines,Asia,112297269,1789,416850
2020-11-22,philippines,Asia,112297269,1965,418815
2020-11-23,philippines,Asia,112297269,1789,420604
2020-11-24,philippines,Asia,112297269,1109,421713
2020-11-25,philippines,Asia,112297269,1192,422905
2020-11-26,philippines,Asia,112297269,1382,424287
2020-11-27,philippines,Asia,112297269,1617,425904
2020-11-28,philippines,Asia,112297269,1884,427788
2020-11-29,philippines,Asia,112297269,2069,429857
2020-11-30,philippines,Asia,112297269,1770,431627
2020-12-01,philippines,Asia,112297269,1292,432919
2020-12-02,philippines,Asia,112297269,1433,434352
2020-12-03,philippines,Asia,112297269,1059,435411
2020-12-04,philippines,Asia,112297269,934,436345
2020-12-05,philippines,Asia,112297269,1721,438066
2020-12-06,philippines,Asia,112297269,1759,439825
2020-12-07,philippines,Asia,112297269,1560,441385
2020-12-08,philippines,Asia,112297269,1392,442777
2020-12-09,philippines,Asia,112297269,1380,444157
2020-12-10,philippines,Asia,112297269,1378,445535
2020-12-11,philippines,Asia,112297269,1495,447030
2020-12-12,philippines,Asia,112297269,1285,448315
2020-12-13,philippines,Asia,112297269,1079,449394
2020-12-14,philippines,Asia,112297269,1310,450704
2020-12-15,philippines,Asia,112297269,1128,451832
2020-12-16,philippines,Asia,112297269,1145,452977
2020-12-17,philippines,Asia,112297269,1463,454440
2020-12-18,philippines,Asia,112297269,2113,456553
2020-12-19,philippines,Asia,112297269,1482,458035
2020-12-20,philippines,Asia,112297269,1749,459784
2020-12-21,philippines,Asia,112297269,1717,461501
2020-12-22,philippines,Asia,112297269,1307,462808
2020-12-23,philippines,Asia,112297269,1140,463948
2020-12-24,philippines,Asia,112297269,1768,465716
2020-12-25,philippines,Asia,112297269,1883,467599
2020-12-26,philippines,Asia,112297269,1404,469003
2020-12-27,philippines,Asia,112297269,881,469884
2020-12-28,philippines,Asia,112297269,756,470640
2020-12-29,philippines,Asia,112297269,878,471518
2020-12-30,philippines,Asia,112297269,1005,472523
2020-12-31,philippines,Asia,112297269,1532,474055
2021-01-01,philippines,Asia,112297269,1764,475819
2021-01-02,philippines,Asia,112297269,1097,476916
2021-01-03,philippines,Asia,112297269,886,477802
2021-01-04,philippines,Asia,112297269,954,478756
2021-01-05,philippines,Asia,112297269,934,479690
2021-01-06,philippines,Asia,112297269,1040,480730
2021-01-07,philippines,Asia,112297269,1346,482076
2021-01-08,philippines,Asia,112297269,1769,483845
2021-01-09,philippines,Asia,112297269,1939,485784
2021-01-10,philippines,Asia,112297269,1900,487684
2021-01-11,philippines,Asia,112297269,2050,489734
2021-01-12,philippines,Asia,112297269,1513,491247
2021-01-13,philippines,Asia,112297269,1446,492693
2021-01-14,philippines,Asia,112297269,1905,494598
2021-01-15,philippines,Asia,112297269,2035,496633
2021-01-16,philippines,Asia,112297269,2049,498682
2021-01-17,philippines,Asia,112297269,1891,500573
2021-01-18,philippines,Asia,112297269,2154,502727
2021-01-19,philippines,Asia,112297269,1350,504077
2021-01-20,philippines,Asia,112297269,1857,505934
2021-01-21,philippines,Asia,112297269,1775,507709
2021-01-22,philippines,Asia,112297269,2173,509882
2021-01-23,philippines,Asia,112297269,1788,511670
2021-01-24,philippines,Asia,112297269,1745,513415
2021-01-25,philippines,Asia,112297269,1578,514993
2021-01-26,philippines,Asia,112297269,1169,516162
2021-01-27,philippines,Asia,112297269,2244,518406
2021-01-28,philippines,Asia,112297269,1158,519564
2021-01-29,philippines,Asia,112297269,1843,521407
2021-01-30,philippines,Asia,112297269,2108,523515
2021-01-31,philippines,Asia,112297269,2099,525614
2021-02-01,philippines,Asia,112297269,1656,527270
2021-02-02,philippines,Asia,112297269,1582,528852
2021-02-03,philippines,Asia,112297269,1257,530109
2021-02-04,philippines,Asia,112297269,1584,531693
2021-02-05,philippines,Asia,112297269,1887,533580
2021-02-06,philippines,Asia,112297269,1940,535520
2021-02-07,philippines,Asia,112297269,1785,537305
2021-02-08,philippines,Asia,112297269,1687,538992
2021-02-09,philippines,Asia,112297269,1223,540215
2021-02-10,philippines,Asia,112297269,1333,541548
2021-02-11,philippines,Asia,112297269,1730,543278
2021-02-12,philippines,Asia,112297269,2017,545295
2021-02-13,philippines,Asia,112297269,1953,547248
2021-02-14,philippines,Asia,112297269,1927,549175
2021-02-15,philippines,Asia,112297269,1680,550855
2021-02-16,philippines,Asia,112297269,1385,552240
2021-02-17,philippines,Asia,112297269,1179,553419
2021-02-18,philippines,Asia,112297269,1738,555157
2021-02-19,philippines,Asia,112297269,1891,557048
2021-02-20,philippines,Asia,112297269,2233,559281
2021-02-21,philippines,Asia,112297269,1887,561168
2021-02-22,philippines,Asia,112297269,2283,563451
2021-02-23,philippines,Asia,112297269,1412,564863
2021-02-24,philippines,Asia,112297269,1548,566411
2021-02-25,philippines,Asia,112297269,2265,568676
2021-02-26,philippines,Asia,112297269,2650,571326
2021-02-27,philippines,Asia,112297269,2913,574239
2021-02-28,philippines,Asia,112297269,2105,576344
2021-03-01,philippines,Asia,112297269,2031,578375
2021-03-02,philippines,Asia,112297269,2065,580440
2021-03-03,philippines,Asia,112297269,1775,582215
2021-03-04,philippines,Asia,112297269,2444,584659
2021-03-05,philippines,Asia,112297269,3040,587699
2021-03-06,philippines,Asia,112297269,3437,591136
2021-03-07,philippines,Asia,112297269,3271,594407
2021-03-08,philippines,Asia,112297269,3353,597760
2021-03-09,philippines,Asia,112297269,2662,600422
2021-03-10,philippines,Asia,112297269,2877,603299
2021-03-11,philippines,Asia,112297269,3741,607040
2021-03-12,philippines,Asia,112297269,4571,611611
2021-03-13,philippines,Asia,112297269,4988,616599
2021-03-14,philippines,Asia,112297269,4890,621489
2021-03-15,philippines,Asia,112297269,5394,626883
2021-03-16,philippines,Asia,112297269,4428,631311
2021-03-17,philippines,Asia,112297269,4383,635694
2021-03-18,philippines,Asia,112297269,5269,640963
2021-03-19,philippines,Asia,112297269,7094,648057
2021-03-20,philippines,Asia,112297269,7980,656037
2021-03-21,philippines,Asia,112297269,7736,663773
2021-03-22,philippines,Asia,112297269,8013,671786
2021-03-23,philippines,Asia,112297269,5859,677645
2021-03-24,philippines,Asia,112297269,6630,684275
2021-03-25,philippines,Asia,112297269,8743,693018
2021-03-26,philippines,Asia,112297269,9829,702847
2021-03-27,philippines,Asia,112297269,9570,712417
2021-03-28,philippines,Asia,112297269,9461,721878
2021-03-29,philippines,Asia,112297269,10007,731885
2021-03-30,philippines,Asia,112297269,9275,741160
2021-03-31,philippines,Asia,112297269,6119,747279
2021-04-01,philippines,Asia,112297269,8908,756187
2021-04-02,philippines,Asia,112297269,15280,771467
2021-04-03,philippines,Asia,112297269,12556,784023
2021-04-04,philippines,Asia,112297269,11020,795043
2021-04-05,philippines,Asia,112297269,8344,803387
2021-04-06,philippines,Asia,112297269,9363,812750
2021-04-07,philippines,Asia,112297269,6400,819150
2021-04-08,philippines,Asia,112297269,9179,828329
2021-04-09,philippines,Asia,112297269,12206,840535
2021-04-10,philippines,Asia,112297269,12652,853187
2021-04-11,philippines,Asia,112297269,11660,864847
2021-04-12,philippines,Asia,112297269,11365,876212
2021-04-13,philippines,Asia,112297269,8546,884758
2021-04-14,philippines,Asia,112297269,8098,892856
2021-04-15,philippines,Asia,112297269,11389,904245
2021-04-16,philippines,Asia,112297269,10706,914951
2021-04-17,philippines,Asia,112297269,11084,926035
2021-04-18,philippines,Asia,112297269,10082,936117
2021-04-19,philippines,Asia,112297269,9610,945727
2021-04-20,philippines,Asia,112297269,7353,953080
2021-04-21,philippines,Asia,112297269,9202,962282
2021-04-22,philippines,Asia,112297269,8739,971021
2021-04-23,philippines,Asia,112297269,8698,979719
2021-04-24,philippines,Asia,112297269,9642,989361
2021-04-25,philippines,Asia,112297269,8138,997499
2021-04-26,philippines,Asia,112297269,8915,1006414
2021-04-27,philippines,Asia,112297269,7186,1013600
2021-04-28,philippines,Asia,112297269,6862,1020462
2021-04-29,philippines,Asia,112297269,8250,1028712
2021-04-30,philippines,Asia,112297269,8715,1037427
2021-05-01,philippines,Asia,112297269,9210,1046637
2021-05-02,philippines,Asia,112297269,8333,1054970
2021-05-03,philippines,Asia,112297269,7239,1062209
2021-05-04,philippines,Asia,112297269,5661,1067870
2021-05-05,philippines,Asia,112297269,5665,1073535
2021-05-06,philippines,Asia,112297269,6617,1080152
2021-05-07,philippines,Asia,112297269,7718,1087870
2021-05-08,philippines,Asia,112297269,6946,1094816
2021-05-09,philippines,Asia,112297269,7164,1101980
2021-05-10,philippines,Asia,112297269,6833,1108813
2021-05-11,philippines,Asia,112297269,4704,1113517
2021-05-12,philippines,Asia,112297269,4822,1118339
2021-05-13,philippines,Asia,112297269,6344,1124683
2021-05-14,philippines,Asia,112297269,6765,1131448
2021-05-15,philippines,Asia,112297269,6725,1138173
2021-05-16,philippines,Asia,112297269,5773,1143946
2021-05-17,philippines,Asia,112297269,5955,1149901
2021-05-18,philippines,Asia,112297269,4470,1154371
2021-05-19,philippines,Asia,112297269,4684,1159055
2021-05-20,philippines,Asia,112297269,6090,1165145
2021-05-21,philippines,Asia,112297269,6241,1171386
2021-05-22,philippines,Asia,112297269,5343,1176729
2020-03-13,poland,Europe,37769420,17,68
2020-03-14,poland,Europe,37769420,36,104
2020-03-15,poland,Europe,37769420,21,125
2020-03-16,poland,Europe,37769420,52,177
2020-03-17,poland,Europe,37769420,61,238
2020-03-18,poland,Europe,37769420,49,287
2020-03-19,poland,Europe,37769420,68,355
2020-03-20,poland,Europe,37769420,70,425
2020-03-21,poland,Europe,37769420,111,536
2020-03-22,poland,Europe,37769420,98,634
2020-03-23,poland,Europe,37769420,115,749
2020-03-24,poland,Europe,37769420,152,901
2020-03-25,poland,Europe,37769420,150,1051
2020-03-26,poland,Europe,37769420,170,1221
2020-03-27,poland,Europe,37769420,168,1389
2020-03-28,poland,Europe,37769420,249,1638
2020-03-29,poland,Europe,37769420,224,1862
2020-03-30,poland,Europe,37769420,193,2055
2020-03-31,poland,Europe,37769420,256,2311
2020-04-01,poland,Europe,37769420,243,2554
2020-04-02,poland,Europe,37769420,392,2946
2020-04-03,poland,Europe,37769420,437,3383
2020-04-04,poland,Europe,37769420,244,3627
2020-04-05,poland,Europe,37769420,475,4102
2020-04-06,poland,Europe,37769420,311,4413
2020-04-07,poland,Europe,37769420,435,4848
2020-04-08,poland,Europe,37769420,357,5205
2020-04-09,poland,Europe,37769420,370,5575
2020-04-10,poland,Europe,37769420,380,5955
2020-04-11,poland,Europe,37769420,401,6356
2020-04-12,poland,Europe,37769420,318,6674
2020-04-13,poland,Europe,37769420,260,6934
2020-04-14,poland,Europe,37769420,268,7202
2020-04-15,poland,Europe,37769420,380,7582
2020-04-16,poland,Europe,37769420,336,7918
2020-04-17,poland,Europe,37769420,461,8379
2020-04-18,poland,Europe,37769420,363,8742
2020-04-19,poland,Europe,37769420,545,9287
2020-04-20,poland,Europe,37769420,306,9593
2020-04-21,poland,Europe,37769420,263,9856
2020-04-22,poland,Europe,37769420,313,10169
2020-04-23,poland,Europe,37769420,342,10511
2020-04-24,poland,Europe,37769420,381,10892
2020-04-25,poland,Europe,37769420,381,11273
2020-04-26,poland,Europe,37769420,344,11617
2020-04-27,poland,Europe,37769420,285,11902
2020-04-28,poland,Europe,37769420,316,12218
2020-04-29,poland,Europe,37769420,422,12640
2020-04-30,poland,Europe,37769420,237,12877
2020-05-01,poland,Europe,37769420,228,13105
2020-05-02,poland,Europe,37769420,270,13375
2020-05-03,poland,Europe,37769420,318,13693
2020-05-04,poland,Europe,37769420,313,14006
2020-05-05,poland,Europe,37769420,425,14431
2020-05-06,poland,Europe,37769420,309,14740
2020-05-07,poland,Europe,37769420,307,15047
2020-05-08,poland,Europe,37769420,319,15366
2020-05-09,poland,Europe,37769420,285,15651
2020-05-10,poland,Europe,37769420,345,15996
2020-05-11,poland,Europe,37769420,330,16326
2020-05-12,poland,Europe,37769420,595,16921
2020-05-13,poland,Europe,37769420,283,17204
2020-05-14,poland,Europe,37769420,411,17615
2020-05-15,poland,Europe,37769420,401,18016
2020-05-16,poland,Europe,37769420,241,18257
2020-05-17,poland,Europe,37769420,272,18529
2020-05-18,poland,Europe,37769420,356,18885
2020-05-19,poland,Europe,37769420,383,19268
2020-05-20,poland,Europe,37769420,471,19739
2020-05-21,poland,Europe,37769420,404,20143
2020-05-22,poland,Europe,37769420,476,20619
2020-05-23,poland,Europe,37769420,312,20931
2020-05-24,poland,Europe,37769420,395,21326
2020-05-25,poland,Europe,37769420,305,21631
2020-05-26,poland,Europe,37769420,443,22074
2020-05-27,poland,Europe,37769420,399,22473
2020-05-28,poland,Europe,37769420,352,22825
2020-05-29,poland,Europe,37769420,330,23155
2020-05-30,poland,Europe,37769420,416,23571
2020-05-31,poland,Europe,37769420,215,23786
2020-06-01,poland,Europe,37769420,379,24165
2020-06-02,poland,Europe,37769420,230,24395
2020-06-03,poland,Europe,37769420,292,24687
2020-06-04,poland,Europe,37769420,361,25048
2020-06-05,poland,Europe,37769420,362,25410
2020-06-06,poland,Europe,37769420,576,25986
2020-06-07,poland,Europe,37769420,575,26561
2020-06-08,poland,Europe,37769420,599,27160
2020-06-09,poland,Europe,37769420,400,27560
2020-06-10,poland,Europe,37769420,282,27842
2020-06-11,poland,Europe,37769420,359,28201
2020-06-12,poland,Europe,37769420,376,28577
2020-06-13,poland,Europe,37769420,440,29017
2020-06-14,poland,Europe,37769420,375,29392
2020-06-15,poland,Europe,37769420,396,29788
2020-06-16,poland,Europe,37769420,407,30195
2020-06-17,poland,Europe,37769420,506,30701
2020-06-18,poland,Europe,37769420,314,31015
2020-06-19,poland,Europe,37769420,301,31316
2020-06-20,poland,Europe,37769420,304,31620
2020-06-21,poland,Europe,37769420,311,31931
2020-06-22,poland,Europe,37769420,296,32227
2020-06-23,poland,Europe,37769420,300,32527
2020-06-24,poland,Europe,37769420,294,32821
2020-06-25,poland,Europe,37769420,298,33119
2020-06-26,poland,Europe,37769420,276,33395
2020-06-27,poland,Europe,37769420,319,33714
2020-06-28,poland,Europe,37769420,193,33907
2020-06-29,poland,Europe,37769420,247,34154
2020-06-30,poland,Europe,37769420,239,34393
2020-07-01,poland,Europe,37769420,382,34775
2020-07-02,poland,Europe,37769420,371,35146
2020-07-03,poland,Europe,37769420,259,35405
2020-07-04,poland,Europe,37769420,314,35719
2020-07-05,poland,Europe,37769420,231,35950
2020-07-06,poland,Europe,37769420,205,36155
2020-07-07,poland,Europe,37769420,257,36412
2020-07-08,poland,Europe,37769420,277,36689
2020-07-09,poland,Europe,37769420,262,36951
2020-07-10,poland,Europe,37769420,265,37216
2020-07-11,poland,Europe,37769420,305,37521
2020-07-12,poland,Europe,37769420,370,37891
2020-07-13,poland,Europe,37769420,299,38190
2020-07-14,poland,Europe,37769420,267,38457
2020-07-15,poland,Europe,37769420,264,38721
2020-07-16,poland,Europe,37769420,333,39054
2020-07-17,poland,Europe,37769420,353,39407
2020-07-18,poland,Europe,37769420,339,39746
2020-07-19,poland,Europe,37769420,358,40104
2020-07-20,poland,Europe,37769420,279,40383
2020-07-21,poland,Europe,37769420,399,40782
2020-07-22,poland,Europe,37769420,380,41162
2020-07-23,poland,Europe,37769420,418,41580
2020-07-24,poland,Europe,37769420,458,42038
2020-07-25,poland,Europe,37769420,584,42622
2020-07-26,poland,Europe,37769420,443,43065
2020-07-27,poland,Europe,37769420,337,43402
2020-07-28,poland,Europe,37769420,502,43904
2020-07-29,poland,Europe,37769420,512,44416
2020-07-30,poland,Europe,37769420,615,45031
2020-07-31,poland,Europe,37769420,657,45688
2020-08-01,poland,Europe,37769420,658,46346
2020-08-02,poland,Europe,37769420,548,46894
2020-08-03,poland,Europe,37769420,575,47469
2020-08-04,poland,Europe,37769420,680,48149
2020-08-05,poland,Europe,37769420,640,48789
2020-08-06,poland,Europe,37769420,726,49515
2020-08-07,poland,Europe,37769420,809,50324
2020-08-08,poland,Europe,37769420,843,51167
2020-08-09,poland,Europe,37769420,624,51791
2020-08-10,poland,Europe,37769420,619,52410
2020-08-11,poland,Europe,37769420,551,52961
2020-08-12,poland,Europe,37769420,715,53676
2020-08-13,poland,Europe,37769420,811,54487
2020-08-14,poland,Europe,37769420,832,55319
2020-08-15,poland,Europe,37769420,771,56090
2020-08-16,poland,Europe,37769420,594,56684
2020-08-17,poland,Europe,37769420,595,57279
2020-08-18,poland,Europe,37769420,597,57876
2020-08-19,poland,Europe,37769420,735,58611
2020-08-20,poland,Europe,37769420,767,59378
2020-08-21,poland,Europe,37769420,903,60281
2020-08-22,poland,Europe,37769420,900,61181
2020-08-23,poland,Europe,37769420,581,61762
2020-08-24,poland,Europe,37769420,548,62310
2020-08-25,poland,Europe,37769420,763,63073
2020-08-26,poland,Europe,37769420,729,63802
2020-08-27,poland,Europe,37769420,887,64689
2020-08-28,poland,Europe,37769420,791,65480
2020-08-29,poland,Europe,37769420,759,66239
2020-08-30,poland,Europe,37769420,631,66870
2020-08-31,poland,Europe,37769420,502,67372
2020-09-01,poland,Europe,37769420,550,67922
2020-09-02,poland,Europe,37769420,595,68517
2020-09-03,poland,Europe,37769420,612,69129
2020-09-04,poland,Europe,37769420,691,69820
2020-09-05,poland,Europe,37769420,567,70387
2020-09-06,poland,Europe,37769420,437,70824
2020-09-07,poland,Europe,37769420,302,71126
2020-09-08,poland,Europe,37769420,400,71526
2020-09-09,poland,Europe,37769420,421,71947
2020-09-10,poland,Europe,37769420,506,72453
2020-09-11,poland,Europe,37769420,594,73047
2020-09-12,poland,Europe,37769420,603,73650
2020-09-13,poland,Europe,37769420,502,74152
2020-09-14,poland,Europe,37769420,377,74529
2020-09-15,poland,Europe,37769420,605,75134
2020-09-16,poland,Europe,37769420,600,75734
2020-09-17,poland,Europe,37769420,837,76571
2020-09-18,poland,Europe,37769420,757,77328
2020-09-19,poland,Europe,37769420,1002,78330
2020-09-20,poland,Europe,37769420,910,79240
2020-09-21,poland,Europe,37769420,748,79988
2020-09-22,poland,Europe,37769420,711,80699
2020-09-23,poland,Europe,37769420,974,81673
2020-09-24,poland,Europe,37769420,1136,82809
2020-09-25,poland,Europe,37769420,1587,84396
2020-09-26,poland,Europe,37769420,1584,85980
2020-09-27,poland,Europe,37769420,1350,87330
2020-09-28,poland,Europe,37769420,1306,88636
2020-09-29,poland,Europe,37769420,1326,89962
2020-09-30,poland,Europe,37769420,1552,91514
2020-10-01,poland,Europe,37769420,1967,93481
2020-10-02,poland,Europe,37769420,2292,95773
2020-10-03,poland,Europe,37769420,2367,98140
2020-10-04,poland,Europe,37769420,1934,100074
2020-10-05,poland,Europe,37769420,2006,102080
2020-10-06,poland,Europe,37769420,2236,104316
2020-10-07,poland,Europe,37769420,3003,107319
2020-10-08,poland,Europe,37769420,4280,111599
2020-10-09,poland,Europe,37769420,4739,116338
2020-10-10,poland,Europe,37769420,5300,121638
2020-10-11,poland,Europe,37769420,4178,125816
2020-10-12,poland,Europe,37769420,4394,130210
2020-10-13,poland,Europe,37769420,5068,135278
2020-10-14,poland,Europe,37769420,6526,141804
2020-10-15,poland,Europe,37769420,8099,149903
2020-10-16,poland,Europe,37769420,7705,157608
2020-10-17,poland,Europe,37769420,9622,167230
2020-10-18,poland,Europe,37769420,8536,175766
2020-10-19,poland,Europe,37769420,7482,183248
2020-10-20,poland,Europe,37769420,9291,192539
2020-10-21,poland,Europe,37769420,10040,202579
2020-10-22,poland,Europe,37769420,12107,214686
2020-10-23,poland,Europe,37769420,13632,228318
2020-10-24,poland,Europe,37769420,13628,241946
2020-10-25,poland,Europe,37769420,11742,253688
2020-10-26,poland,Europe,37769420,10241,263929
2020-10-27,poland,Europe,37769420,16300,280229
2020-10-28,poland,Europe,37769420,18820,299049
2020-10-29,poland,Europe,37769420,20156,319205
2020-10-30,poland,Europe,37769420,21629,340834
2020-10-31,poland,Europe,37769420,21897,362731
2020-11-01,poland,Europe,37769420,17171,379902
2020-11-02,poland,Europe,37769420,15578,395480
2020-11-03,poland,Europe,37769420,19364,414844
2020-11-04,poland,Europe,37769420,24692,439536
2020-11-05,poland,Europe,37769420,27143,466679
2020-11-06,poland,Europe,37769420,27086,493765
2020-11-07,poland,Europe,37769420,27875,521640
2020-11-08,poland,Europe,37769420,24785,546425
2020-11-09,poland,Europe,37769420,21713,568138
2020-11-10,poland,Europe,37769420,25454,593592
2020-11-11,poland,Europe,37769420,25221,618813
2020-11-12,poland,Europe,37769420,22683,641496
2020-11-13,poland,Europe,37769420,24051,665547
2020-11-14,poland,Europe,37769420,25571,691118
2020-11-15,poland,Europe,37769420,21854,712972
2020-11-16,poland,Europe,37769420,20816,733788
2020-11-17,poland,Europe,37769420,19152,752940
2020-11-18,poland,Europe,37769420,19883,772823
2020-11-19,poland,Europe,37769420,23975,796798
2020-11-20,poland,Europe,37769420,22464,819262
2020-11-21,poland,Europe,37769420,23602,842864
2020-11-22,poland,Europe,37769420,18467,861331
2020-11-23,poland,Europe,37769420,37596,898927
2020-11-24,poland,Europe,37769420,10133,909060
2020-11-25,poland,Europe,37769420,15365,924425
2020-11-26,poland,Europe,37769420,16931,941356
2020-11-27,poland,Europe,37769420,17059,958415
2020-11-28,poland,Europe,37769420,15177,973592
2020-11-29,poland,Europe,37769420,11486,985078
2020-11-30,poland,Europe,37769420,5741,990819
2020-12-01,poland,Europe,37769420,9073,999892
2020-12-02,poland,Europe,37769420,13880,1013772
2020-12-03,poland,Europe,37769420,14835,1028607
2020-12-04,poland,Europe,37769420,13236,1041843
2020-12-05,poland,Europe,37769420,12430,1054273
2020-12-06,poland,Europe,37769420,9174,1063447
2020-12-07,poland,Europe,37769420,4421,1067868
2020-12-08,poland,Europe,37769420,8310,1076178
2020-12-09,poland,Europe,37769420,12169,1088347
2020-12-10,poland,Europe,37769420,13744,1102091
2020-12-11,poland,Europe,37769420,13112,1115203
2020-12-12,poland,Europe,37769420,11496,1126699
2020-12-13,poland,Europe,37769420,8977,1135676
2020-12-14,poland,Europe,37769420,4863,1140539
2020-12-15,poland,Europe,37769420,6908,1147447
2020-12-16,poland,Europe,37769420,12454,1159901
2020-12-17,poland,Europe,37769420,11950,1171851
2020-12-18,poland,Europe,37769420,10992,1182843
2020-12-19,poland,Europe,37769420,11263,1194106
2020-12-20,poland,Europe,37769420,8594,1202700
2020-12-21,poland,Europe,37769420,4633,1207333
2020-12-22,poland,Europe,37769420,7189,1214522
2020-12-23,poland,Europe,37769420,12361,1226883
2020-12-24,poland,Europe,37769420,13119,1240002
2020-12-25,poland,Europe,37769420,8907,1248909
2020-12-26,poland,Europe,37769420,5212,1254121
2020-12-27,poland,Europe,37769420,3678,1257799
2020-12-28,poland,Europe,37769420,2921,1260720
2020-12-29,poland,Europe,37769420,7739,1268459
2020-12-30,poland,Europe,37769420,13022,1281481
2020-12-31,poland,Europe,37769420,13285,1294766
2021-01-01,poland,Europe,37769420,11069,1305835
2021-01-02,poland,Europe,37769420,6988,1312823
2021-01-03,poland,Europe,37769420,5692,1318515
2021-01-04,poland,Europe,37769420,4404,1322919
2021-01-05,poland,Europe,37769420,7693,1330612
2021-01-06,poland,Europe,37769420,14216,1344828
2021-01-07,poland,Europe,37769420,12027,1356855
2021-01-08,poland,Europe,37769420,8986,1365841
2021-01-09,poland,Europe,37769420,10271,1376112
2021-01-10,poland,Europe,37769420,9651,1385763
2021-01-11,poland,Europe,37769420,4447,1390210
2021-01-12,poland,Europe,37769420,5642,1395852
2021-01-13,poland,Europe,37769420,9074,1404926
2021-01-14,poland,Europe,37769420,9599,1414525
2021-01-15,poland,Europe,37769420,7675,1422200
2021-01-16,poland,Europe,37769420,7327,1429527
2021-01-17,poland,Europe,37769420,6116,1435643
2021-01-18,poland,Europe,37769420,3326,1438969
2021-01-19,poland,Europe,37769420,4859,1443828
2021-01-20,poland,Europe,37769420,6775,1450603
2021-01-21,poland,Europe,37769420,7205,1457808
2021-01-22,poland,Europe,37769420,6749,1464557
2021-01-23,poland,Europe,37769420,6205,1470762
2021-01-24,poland,Europe,37769420,4938,1475700
2021-01-25,poland,Europe,37769420,2418,1478118
2021-01-26,poland,Europe,37769420,4605,1482723
2021-01-27,poland,Europe,37769420,6786,1489509
2021-01-28,poland,Europe,37769420,7157,1496666
2021-01-29,poland,Europe,37769420,6144,1502810
2021-01-30,poland,Europe,37769420,5869,1508679
2021-01-31,poland,Europe,37769420,4703,1513382
2021-02-01,poland,Europe,37769420,2507,1515889
2021-02-02,poland,Europe,37769420,4325,1520214
2021-02-03,poland,Europe,37769420,6801,1527015
2021-02-04,poland,Europe,37769420,6496,1533511
2021-02-05,poland,Europe,37769420,6054,1539565
2021-02-06,poland,Europe,37769420,5962,1545527
2021-02-07,poland,Europe,37769420,4728,1550255
2021-02-08,poland,Europe,37769420,2401,1552656
2021-02-09,poland,Europe,37769420,4059,1556715
2021-02-10,poland,Europe,37769420,6935,1563650
2021-02-11,poland,Europe,37769420,7007,1570657
2021-02-12,poland,Europe,37769420,6378,1577035
2021-02-13,poland,Europe,37769420,6586,1583621
2021-02-14,poland,Europe,37769420,5333,1588954
2021-02-15,poland,Europe,37769420,2541,1591495
2021-02-16,poland,Europe,37769420,5183,1596678
2021-02-17,poland,Europe,37769420,8695,1605373
2021-02-18,poland,Europe,37769420,9068,1614441
2021-02-19,poland,Europe,37769420,8776,1623217
2021-02-20,poland,Europe,37769420,8512,1631729
2021-02-21,poland,Europe,37769420,7039,1638768
2021-02-22,poland,Europe,37769420,3884,1642652
2021-02-23,poland,Europe,37769420,6311,1648963
2021-02-24,poland,Europe,37769420,12147,1661110
2021-02-25,poland,Europe,37769420,12139,1673249
2021-02-26,poland,Europe,37769420,11536,1684785
2021-02-27,poland,Europe,37769420,12102,1696887
2021-02-28,poland,Europe,37769420,10099,1706986
2021-03-01,poland,Europe,37769420,4785,1711771
2021-03-02,poland,Europe,37769420,7937,1719708
2021-03-03,poland,Europe,37769420,15701,1735409
2021-03-04,poland,Europe,37769420,15252,1750661
2021-03-05,poland,Europe,37769420,15827,1766488
2021-03-06,poland,Europe,37769420,14852,1781340
2021-03-07,poland,Europe,37769420,13573,1794913
2021-03-08,poland,Europe,37769420,6169,1801082
2021-03-09,poland,Europe,37769420,9971,1811053
2021-03-10,poland,Europe,37769420,17326,1828379
2021-03-11,poland,Europe,37769420,21143,1849522
2021-03-12,poland,Europe,37769420,18789,1868311
2021-03-13,poland,Europe,37769420,21062,1889373
2021-03-14,poland,Europe,37769420,17258,1906631
2021-03-15,poland,Europe,37769420,10894,1917525
2021-03-16,poland,Europe,37769420,14397,1931922
2021-03-17,poland,Europe,37769420,25048,1956970
2021-03-18,poland,Europe,37769420,27276,1984246
2021-03-19,poland,Europe,37769420,26049,2010295
2021-03-20,poland,Europe,37769420,26406,2036701
2021-03-21,poland,Europe,37769420,21850,2058551
2021-03-22,poland,Europe,37769420,14577,2073128
2021-03-23,poland,Europe,37769420,17565,2090693
2021-03-24,poland,Europe,37769420,29977,2120670
2021-03-25,poland,Europe,37769420,34153,2154823
2021-03-26,poland,Europe,37769420,35145,2189968
2021-03-27,poland,Europe,37769420,31770,2221738
2021-03-28,poland,Europe,37769420,29261,2250999
2021-03-29,poland,Europe,37769420,16957,2267956
2021-03-30,poland,Europe,37769420,20887,2288843
2021-03-31,poland,Europe,37769420,32876,2321719
2021-04-01,poland,Europe,37769420,35246,2356965
2021-04-02,poland,Europe,37769420,30546,2387511
2021-04-03,poland,Europe,37769420,28084,2415595
2021-04-04,poland,Europe,37769420,22966,2438561
2021-04-05,poland,Europe,37769420,9903,2448464
2021-04-06,poland,Europe,37769420,8243,2456707
2021-04-07,poland,Europe,37769420,14913,2471620
2021-04-08,poland,Europe,37769420,27899,2499519
2021-04-09,poland,Europe,37769420,28523,2528042
2021-04-10,poland,Europe,37769420,24886,2552928
2021-04-11,poland,Europe,37769420,21706,2574634
2021-04-12,poland,Europe,37769420,11989,2586623
2021-04-13,poland,Europe,37769420,13210,2599833
2021-04-14,poland,Europe,37769420,21279,2621112
2021-04-15,poland,Europe,37769420,21129,2642241
2021-04-16,poland,Europe,37769420,17870,2660111
2021-04-17,poland,Europe,37769420,15761,2675872
2021-04-18,poland,Europe,37769420,12172,2688044
2021-04-19,poland,Europe,37769420,7281,2695325
2021-04-20,poland,Europe,37769420,9242,2704567
2021-04-21,poland,Europe,37769420,13927,2718494
2021-04-22,poland,Europe,37769420,12770,2731264
2021-04-23,poland,Europe,37769420,10863,2742127
2021-04-24,poland,Europe,37769420,9510,2751637
2021-04-25,poland,Europe,37769420,7235,2758872
2021-04-26,poland,Europe,37769420,3453,2762325
2021-04-27,poland,Europe,37769420,5707,2768032
2021-04-28,poland,Europe,37769420,8894,2776926
2021-04-29,poland,Europe,37769420,8420,2785346
2021-04-30,poland,Europe,37769420,6802,2792148
2021-05-01,poland,Europe,37769420,6473,2798621
2021-05-02,poland,Europe,37769420,4610,2803231
2021-05-03,poland,Europe,37769420,2525,2805756
2021-05-04,poland,Europe,37769420,2299,2808055
2021-05-05,poland,Europe,37769420,3892,2811947
2021-05-06,poland,Europe,37769420,6431,2818378
2021-05-07,poland,Europe,37769420,6053,2824431
2021-05-08,poland,Europe,37769420,4769,2829200
2021-05-09,poland,Europe,37769420,3851,2833051
2021-05-10,poland,Europe,37769420,2031,2835082
2021-05-11,poland,Europe,37769420,3002,2838084
2021-05-12,poland,Europe,37769420,3948,2842032
2021-05-13,poland,Europe,37769420,3694,2845726
2021-05-14,poland,Europe,37769420,3289,2849015
2021-05-15,poland,Europe,37769420,2897,2851912
2021-05-16,poland,Europe,37769420,2169,2854081
2021-05-17,poland,Europe,37769420,1109,2855190
2021-05-18,poland,Europe,37769420,1727,2856917
2021-05-19,poland,Europe,37769420,2348,2859265
2021-05-20,poland,Europe,37769420,2087,2861352
2021-05-21,poland,Europe,37769420,1678,2863030
2021-05-22,poland,Europe,37769420,1517,2864547
2021-05-23,poland,Europe,37769420,1075,2865622
2021-05-24,poland,Europe,37769420,565,2866187
2021-05-25,poland,Europe,37769420,996,2867183
2021-05-26,poland,Europe,37769420,1239,2868422
2021-05-27,poland,Europe,37769420,1227,2869649
2021-05-28,poland,Europe,37769420,947,2870596
2021-05-29,poland,Europe,37769420,775,2871371
2021-05-30,poland,Europe,37769420,579,2871950
2021-05-31,poland,Europe,37769420,330,2872280
2021-06-01,poland,Europe,37769420,583,2872863
2021-06-02,poland,Europe,37769420,657,2873520
2021-06-03,poland,Europe,37769420,572,2874092
2021-06-04,poland,Europe,37769420,317,2874409
2021-06-05,poland,Europe,37769420,415,2874824
2021-06-06,poland,Europe,37769420,310,2875134
2021-06-07,poland,Europe,37769420,195,2875329
2021-06-08,poland,Europe,37769420,532,2875861
2021-06-09,poland,Europe,37769420,424,2876285
2021-06-10,poland,Europe,37769420,381,2876666
2021-06-11,poland,Europe,37769420,338,2877004
2021-06-12,poland,Europe,37769420,238,2877242
2021-06-13,poland,Europe,37769420,226,2877468
2021-06-14,poland,Europe,37769420,136,2877604
2021-06-15,poland,Europe,37769420,216,2877820
2021-06-16,poland,Europe,37769420,238,2878058
2021-06-17,poland,Europe,37769420,218,2878276
2021-06-18,poland,Europe,37769420,190,2878466
2021-06-19,poland,Europe,37769420,168,2878634
2021-06-20,poland,Europe,37769420,133,2878767
2021-06-21,poland,Europe,37769420,75,2878842
2021-06-22,poland,Europe,37769420,185,2879027
2021-06-23,poland,Europe,37769420,162,2879189
2021-06-24,poland,Europe,37769420,148,2879337
2021-06-25,poland,Europe,37769420,132,2879469
2021-06-26,poland,Europe,37769420,98,2879567
2021-06-27,poland,Europe,37769420,70,2879637
2021-06-28,poland,Europe,37769420,51,2879688
2021-06-29,poland,Europe,37769420,120,2879808
2021-06-30,poland,Europe,37769420,104,2879912
2021-07-01,poland,Europe,37769420,99,2880011
2021-07-02,poland,Europe,37769420,97,2880108
2021-07-03,poland,Europe,37769420,108,2880216
2021-07-04,poland,Europe,37769420,54,2880270
2021-07-05,poland,Europe,37769420,37,2880307
2021-07-06,poland,Europe,37769420,93,2880400
2021-07-07,poland,Europe,37769420,103,2880503
2021-07-08,poland,Europe,37769420,91,2880594
2021-07-09,poland,Europe,37769420,75,2880669
2021-07-10,poland,Europe,37769420,86,2880755
2021-07-11,poland,Europe,37769420,66,2880821
2021-07-12,poland,Europe,37769420,42,2880863
2021-07-13,poland,Europe,37769420,97,2880960
2021-07-14,poland,Europe,37769420,86,2881046
2021-07-15,poland,Europe,37769420,102,2881148
2021-07-16,poland,Europe,37769420,93,2881241
2021-07-17,poland,Europe,37769420,114,2881355
2021-07-18,poland,Europe,37769420,69,2881424
2021-07-19,poland,Europe,37769420,66,2881490
2021-07-20,poland,Europe,37769420,104,2881594
2021-07-21,poland,Europe,37769420,120,2881714
2021-07-22,poland,Europe,37769420,126,2881840
2021-07-23,poland,Europe,37769420,104,2881944
2021-07-24,poland,Europe,37769420,120,2882064
2021-07-25,poland,Europe,37769420,82,2882146
2021-07-26,poland,Europe,37769420,75,2882221
2021-07-27,poland,Europe,37769420,106,2882327
2021-07-28,poland,Europe,37769420,136,2882463
2021-07-29,poland,Europe,37769420,170,2882633
2021-07-30,poland,Europe,37769420,153,2882786
2021-07-31,poland,Europe,37769420,152,2882938
2021-08-01,poland,Europe,37769420,91,2883029
2021-08-02,poland,Europe,37769420,91,2883120
2021-08-03,poland,Europe,37769420,164,2883284
2021-08-04,poland,Europe,37769420,164,2883448
2021-08-05,poland,Europe,37769420,176,2883624
2021-08-06,poland,Europe,37769420,171,2883795
2021-08-07,poland,Europe,37769420,181,2883976
2021-08-08,poland,Europe,37769420,122,2884098
2021-08-09,poland,Europe,37769420,63,2884161
2021-08-10,poland,Europe,37769420,198,2884359
2021-08-11,poland,Europe,37769420,198,2884557
2021-08-12,poland,Europe,37769420,221,2884778
2021-08-13,poland,Europe,37769420,196,2884974
2021-08-14,poland,Europe,37769420,211,2885185
2021-08-15,poland,Europe,37769420,148,2885333
2021-08-16,poland,Europe,37769420,122,2885455
2021-08-17,poland,Europe,37769420,220,2885675
2021-08-18,poland,Europe,37769420,207,2885882
2021-08-19,poland,Europe,37769420,197,2886079
2021-08-20,poland,Europe,37769420,212,2886291
2021-08-21,poland,Europe,37769420,222,2886513
2021-08-22,poland,Europe,37769420,185,2886698
2021-08-23,poland,Europe,37769420,106,2886804
2021-08-24,poland,Europe,37769420,232,2887036
2021-08-25,poland,Europe,37769420,198,2887234
2021-08-26,poland,Europe,37769420,247,2887481
2021-08-27,poland,Europe,37769420,257,2887738
2021-08-28,poland,Europe,37769420,289,2888027
2021-08-29,poland,Europe,37769420,207,2888234
2021-08-30,poland,Europe,37769420,151,2888385
2021-08-31,poland,Europe,37769420,285,2888670
2021-09-01,poland,Europe,37769420,352,2889022
2021-09-02,poland,Europe,37769420,402,2889424
2021-09-03,poland,Europe,37769420,348,2889772
2021-09-04,poland,Europe,37769420,389,2890161
2021-09-05,poland,Europe,37769420,322,2890483
2021-09-06,poland,Europe,37769420,182,2890665
2021-09-07,poland,Europe,37769420,404,2891069
2021-09-08,poland,Europe,37769420,533,2891602
2021-09-09,poland,Europe,37769420,512,2892114
2021-09-10,poland,Europe,37769420,529,2892643
2021-09-11,poland,Europe,37769420,530,2893173
2021-09-12,poland,Europe,37769420,477,2893650
2021-09-13,poland,Europe,37769420,268,2893918
2021-09-14,poland,Europe,37769420,538,2894456
2021-09-15,poland,Europe,37769420,769,2895225
2021-09-16,poland,Europe,37769420,722,2895947
2021-09-17,poland,Europe,37769420,651,2896598
2021-09-18,poland,Europe,37769420,797,2897395
2021-09-19,poland,Europe,37769420,541,2897936
2021-09-20,poland,Europe,37769420,361,2898297
2021-09-21,poland,Europe,37769420,709,2899006
2021-09-22,poland,Europe,37769420,882,2899888
2021-09-23,poland,Europe,37769420,973,2900861
2021-09-24,poland,Europe,37769420,813,2901674
2021-09-25,poland,Europe,37769420,917,2902591
2021-09-26,poland,Europe,37769420,643,2903234
2021-09-27,poland,Europe,37769420,422,2903656
2021-09-28,poland,Europe,37769420,976,2904632
2021-09-29,poland,Europe,37769420,1231,2905863
2021-09-30,poland,Europe,37769420,1207,2907070
2021-10-01,poland,Europe,37769420,1362,2908432
2021-10-02,poland,Europe,37769420,1344,2909776
2021-10-03,poland,Europe,37769420,1089,2910865
2021-10-04,poland,Europe,37769420,686,2911551
2021-10-05,poland,Europe,37769420,1326,2912877
2021-10-06,poland,Europe,37769420,2085,2914962
2021-10-07,poland,Europe,37769420,2006,2916968
2021-10-08,poland,Europe,37769420,1894,2918862
2021-10-09,poland,Europe,37769420,2012,2920874
2021-10-10,poland,Europe,37769420,1527,2922401
2021-10-11,poland,Europe,37769420,906,2923307
2021-10-12,poland,Europe,37769420,2118,2925425
2021-10-13,poland,Europe,37769420,2639,2928064
2021-10-14,poland,Europe,37769420,2999,2931063
2021-10-15,poland,Europe,37769420,2770,2933833
2021-10-16,poland,Europe,37769420,3234,2937067
2021-10-17,poland,Europe,37769420,2522,2939589
2021-10-18,poland,Europe,37769420,1536,2941125
2021-10-19,poland,Europe,37769420,3932,2945057
2021-10-20,poland,Europe,37769420,5558,2950615
2021-10-21,poland,Europe,37769420,5602,2956217
2021-10-22,poland,Europe,37769420,5709,2961926
2021-10-23,poland,Europe,37769420,6273,2968199
2021-10-24,poland,Europe,37769420,4731,2972930
2021-10-25,poland,Europe,37769420,2948,2975878
2021-10-26,poland,Europe,37769420,6270,2982148
2021-10-27,poland,Europe,37769420,8365,2990513
2021-10-28,poland,Europe,37769420,8394,2998907
2021-10-29,poland,Europe,37769420,9395,3008302
2021-10-30,poland,Europe,37769420,9800,3018102
2021-10-31,poland,Europe,37769420,7155,3025257
2021-11-01,poland,Europe,37769420,4897,3030154
2021-11-02,poland,Europe,37769420,4519,3034673
2021-11-03,poland,Europe,37769420,10425,3045098
2021-11-04,poland,Europe,37769420,15516,3060614
2021-11-05,poland,Europe,37769420,15909,3076523
2021-11-06,poland,Europe,37769420,15204,3091727
2021-11-07,poland,Europe,37769420,12491,3104218
2021-11-08,poland,Europe,37769420,7317,3111535
2021-11-09,poland,Europe,37769420,13640,3125175
2021-11-10,poland,Europe,37769420,18555,3143730
2021-11-11,poland,Europe,37769420,19074,3162804
2021-11-12,poland,Europe,37769420,12971,3175775
2021-11-13,poland,Europe,37769420,14292,3190067
2021-11-14,poland,Europe,37769420,14444,3204511
2021-11-15,poland,Europe,37769420,9533,3214044
2021-11-16,poland,Europe,37769420,16592,3230636
2021-11-17,poland,Europe,37769420,24269,3254905
2021-11-18,poland,Europe,37769420,24899,3279804
2021-11-19,poland,Europe,37769420,23246,3303050
2021-11-20,poland,Europe,37769420,23455,3326505
2021-11-21,poland,Europe,37769420,18924,3345429
2021-11-22,poland,Europe,37769420,12333,3357762
2021-11-23,poland,Europe,37769420,19987,3377749
2021-11-24,poland,Europe,37769420,28395,3406144
2021-11-25,poland,Europe,37769420,28187,3434331
2021-11-26,poland,Europe,37769420,26741,3461072
2021-11-27,poland,Europe,37769420,26180,3487252
2021-11-28,poland,Europe,37769420,20594,3507846
2021-11-29,poland,Europe,37769420,13141,3520987
2021-11-30,poland,Europe,37769420,19086,3540073
2021-12-01,poland,Europe,37769420,29062,3569135
2021-12-02,poland,Europe,37769420,27352,3596487
2021-12-03,poland,Europe,37769420,26964,3623451
2021-12-04,poland,Europe,37769420,25581,3649032
2021-12-05,poland,Europe,37769420,22389,3671421
2021-12-06,poland,Europe,37769420,13253,3684674
2021-12-07,poland,Europe,37769420,19373,3704047
2021-12-08,poland,Europe,37769420,28543,3732590
2021-12-09,poland,Europe,37769420,27455,3760045
2021-12-10,poland,Europe,37769420,24989,3785034
2021-12-11,poland,Europe,37769420,23762,3808796
2021-12-12,poland,Europe,37769420,19450,3828246
2021-12-13,poland,Europe,37769420,11379,3839625
2021-12-14,poland,Europe,37769420,17458,3857083
2021-12-15,poland,Europe,37769420,24265,3881348
2020-05-21,reunion,Africa,907212,2,449
2020-05-22,reunion,Africa,907212,0,449
2020-05-23,reunion,Africa,907212,3,452
2020-05-24,reunion,Africa,907212,0,452
2020-05-25,reunion,Africa,907212,4,456
2020-05-26,reunion,Africa,907212,3,459
2020-05-27,reunion,Africa,907212,1,460
2020-05-28,reunion,Africa,907212,5,465
2020-05-29,reunion,Africa,907212,5,470
2020-05-30,reunion,Africa,907212,1,471
2020-05-31,reunion,Africa,907212,0,471
2020-06-01,reunion,Africa,907212,2,473
2020-06-02,reunion,Africa,907212,4,477
2020-06-03,reunion,Africa,907212,1,478
2020-06-04,reunion,Africa,907212,1,479
2020-06-05,reunion,Africa,907212,1,480
2020-06-06,reunion,Africa,907212,0,480
2020-06-07,reunion,Africa,907212,0,480
2020-06-08,reunion,Africa,907212,1,481
2020-06-09,reunion,Africa,907212,0,481
2020-06-10,reunion,Africa,907212,5,486
2020-06-11,reunion,Africa,907212,1,487
2020-06-12,reunion,Africa,907212,1,488
2020-06-13,reunion,Africa,907212,1,489
2020-06-14,reunion,Africa,907212,6,495
2020-06-15,reunion,Africa,907212,1,496
2020-06-17,reunion,Africa,907212,2,497
2020-06-18,reunion,Africa,907212,5,502
2020-06-19,reunion,Africa,907212,2,504
2020-06-20,reunion,Africa,907212,1,505
2020-06-21,reunion,Africa,907212,1,506
2020-06-22,reunion,Africa,907212,1,507
2020-06-23,reunion,Africa,907212,0,507
2020-06-24,reunion,Africa,907212,1,508
2020-06-25,reunion,Africa,907212,8,516
2020-06-26,reunion,Africa,907212,1,517
2020-06-27,reunion,Africa,907212,3,520
2020-06-28,reunion,Africa,907212,1,521
2020-06-29,reunion,Africa,907212,1,522
2020-06-30,reunion,Africa,907212,4,526
2020-07-01,reunion,Africa,907212,2,528
2020-07-02,reunion,Africa,907212,3,531
2020-07-03,reunion,Africa,907212,2,533
2020-07-04,reunion,Africa,907212,3,536
2020-02-20,russia,Europe,146050996,0,2
2020-02-21,russia,Europe,146050996,0,2
2020-02-22,russia,Europe,146050996,0,2
2020-02-23,russia,Europe,146050996,0,2
2020-02-24,russia,Europe,146050996,0,2
2020-02-25,russia,Europe,146050996,0,2
2020-02-26,russia,Europe,146050996,0,2
2020-02-27,russia,Europe,146050996,0,2
2020-02-28,russia,Europe,146050996,0,2
2020-02-29,russia,Europe,146050996,0,2
2020-03-01,russia,Europe,146050996,0,2
2020-03-02,russia,Europe,146050996,1,3
2020-03-03,russia,Europe,146050996,0,3
2020-03-04,russia,Europe,146050996,0,3
2020-03-05,russia,Europe,146050996,4,7
2020-03-06,russia,Europe,146050996,6,13
2020-03-07,russia,Europe,146050996,1,14
2020-03-08,russia,Europe,146050996,3,17
2020-03-09,russia,Europe,146050996,3,20
2020-03-10,russia,Europe,146050996,0,20
2020-03-11,russia,Europe,146050996,8,28
2020-03-12,russia,Europe,146050996,6,34
2020-03-13,russia,Europe,146050996,11,45
2020-03-14,russia,Europe,146050996,14,59
2020-03-15,russia,Europe,146050996,4,63
2020-03-16,russia,Europe,146050996,30,93
2020-03-17,russia,Europe,146050996,21,114
2020-03-18,russia,Europe,146050996,33,147
2020-03-19,russia,Europe,146050996,52,199
2020-03-20,russia,Europe,146050996,54,253
2020-03-21,russia,Europe,146050996,53,306
2020-03-22,russia,Europe,146050996,61,367
2020-03-23,russia,Europe,146050996,71,438
2020-03-24,russia,Europe,146050996,57,495
2020-03-25,russia,Europe,146050996,163,658
2020-03-26,russia,Europe,146050996,182,840
2020-03-27,russia,Europe,146050996,196,1036
2020-03-28,russia,Europe,146050996,228,1264
2020-03-29,russia,Europe,146050996,270,1534
2020-03-30,russia,Europe,146050996,302,1836
2020-03-31,russia,Europe,146050996,501,2337
2020-04-01,russia,Europe,146050996,440,2777
2020-04-02,russia,Europe,146050996,771,3548
2020-04-03,russia,Europe,146050996,601,4149
2020-04-04,russia,Europe,146050996,582,4731
2020-04-05,russia,Europe,146050996,658,5389
2020-04-06,russia,Europe,146050996,954,6343
2020-04-07,russia,Europe,146050996,1154,7497
2020-04-08,russia,Europe,146050996,1175,8672
2020-04-09,russia,Europe,146050996,1459,10131
2020-04-10,russia,Europe,146050996,1786,11917
2020-04-11,russia,Europe,146050996,1667,13584
2020-04-12,russia,Europe,146050996,2186,15770
2020-04-13,russia,Europe,146050996,2558,18328
2020-04-14,russia,Europe,146050996,2774,21102
2020-04-15,russia,Europe,146050996,3388,24490
2020-04-16,russia,Europe,146050996,3448,27938
2020-04-17,russia,Europe,146050996,4070,32008
2020-04-18,russia,Europe,146050996,4785,36793
2020-04-19,russia,Europe,146050996,6060,42853
2020-04-20,russia,Europe,146050996,4268,47121
2020-04-21,russia,Europe,146050996,5642,52763
2020-04-22,russia,Europe,146050996,5236,57999
2020-04-23,russia,Europe,146050996,4774,62773
2020-04-24,russia,Europe,146050996,5849,68622
2020-04-25,russia,Europe,146050996,5966,74588
2020-04-26,russia,Europe,146050996,6361,80949
2020-04-27,russia,Europe,146050996,6198,87147
2020-04-28,russia,Europe,146050996,6411,93558
2020-04-29,russia,Europe,146050996,5841,99399
2020-04-30,russia,Europe,146050996,7099,106498
2020-05-01,russia,Europe,146050996,7933,114431
2020-05-02,russia,Europe,146050996,9623,124054
2020-05-03,russia,Europe,146050996,10633,134687
2020-05-04,russia,Europe,146050996,10581,145268
2020-05-05,russia,Europe,146050996,10102,155370
2020-05-06,russia,Europe,146050996,10559,165929
2020-05-07,russia,Europe,146050996,11231,177160
2020-05-08,russia,Europe,146050996,10699,187859
2020-05-09,russia,Europe,146050996,10817,198676
2020-05-10,russia,Europe,146050996,11012,209688
2020-05-11,russia,Europe,146050996,11656,221344
2020-05-12,russia,Europe,146050996,10899,232243
2020-05-13,russia,Europe,146050996,10028,242271
2020-05-14,russia,Europe,146050996,9974,252245
2020-05-15,russia,Europe,146050996,10598,262843
2020-05-16,russia,Europe,146050996,9200,272043
2020-05-17,russia,Europe,146050996,9709,281752
2020-05-18,russia,Europe,146050996,8926,290678
2020-05-19,russia,Europe,146050996,9263,299941
2020-05-20,russia,Europe,146050996,8764,308705
2020-05-21,russia,Europe,146050996,8849,317554
2020-05-22,russia,Europe,146050996,8894,326448
2020-05-23,russia,Europe,146050996,9434,335882
2020-05-24,russia,Europe,146050996,8599,344481
2020-05-25,russia,Europe,146050996,8946,353427
2020-05-26,russia,Europe,146050996,8915,362342
2020-05-27,russia,Europe,146050996,8338,370680
2020-05-28,russia,Europe,146050996,8371,379051
2020-05-29,russia,Europe,146050996,8572,387623
2020-05-30,russia,Europe,146050996,8952,396575
2020-05-31,russia,Europe,146050996,9268,405843
2020-06-01,russia,Europe,146050996,9035,414878
2020-06-02,russia,Europe,146050996,8863,423741
2020-06-03,russia,Europe,146050996,8536,432277
2020-06-04,russia,Europe,146050996,8831,441108
2020-06-05,russia,Europe,146050996,8726,449834
2020-06-06,russia,Europe,146050996,8855,458689
2020-06-07,russia,Europe,146050996,8984,467673
2020-06-08,russia,Europe,146050996,8985,476658
2020-06-09,russia,Europe,146050996,8595,485253
2020-06-10,russia,Europe,146050996,8404,493657
2020-06-11,russia,Europe,146050996,8779,502436
2020-06-12,russia,Europe,146050996,8987,511423
2020-06-13,russia,Europe,146050996,8706,520129
2020-06-14,russia,Europe,146050996,8835,528964
2020-06-15,russia,Europe,146050996,8246,537210
2020-06-16,russia,Europe,146050996,8248,545458
2020-06-17,russia,Europe,146050996,7843,553301
2020-06-18,russia,Europe,146050996,7790,561091
2020-06-19,russia,Europe,146050996,7972,569063
2020-06-20,russia,Europe,146050996,7889,576952
2020-06-21,russia,Europe,146050996,7728,584680
2020-06-22,russia,Europe,146050996,7600,592280
2020-06-23,russia,Europe,146050996,7425,599705
2020-06-24,russia,Europe,146050996,7176,606881
2020-06-25,russia,Europe,146050996,7113,613994
2020-06-26,russia,Europe,146050996,6800,620794
2020-06-27,russia,Europe,146050996,6852,627646
2020-06-28,russia,Europe,146050996,6791,634437
2020-06-29,russia,Europe,146050996,6719,641156
2020-06-30,russia,Europe,146050996,6693,647849
2020-07-01,russia,Europe,146050996,6556,654405
2020-07-02,russia,Europe,146050996,6760,661165
2020-07-03,russia,Europe,146050996,6718,667883
2020-07-04,russia,Europe,146050996,6632,674515
2020-07-05,russia,Europe,146050996,6736,681251
2020-07-06,russia,Europe,146050996,6611,687862
2020-07-07,russia,Europe,146050996,6368,694230
2020-07-08,russia,Europe,146050996,6562,700792
2020-07-09,russia,Europe,146050996,6509,707301
2020-07-10,russia,Europe,146050996,6635,713936
2020-07-11,russia,Europe,146050996,6611,720547
2020-07-12,russia,Europe,146050996,6615,727162
2020-07-13,russia,Europe,146050996,6537,733699
2020-07-14,russia,Europe,146050996,6248,739947
2020-07-15,russia,Europe,146050996,6422,746369
2020-07-16,russia,Europe,146050996,6428,752797
2020-07-17,russia,Europe,146050996,6406,759203
2020-07-18,russia,Europe,146050996,6234,765437
2020-07-19,russia,Europe,146050996,6109,771546
2020-07-20,russia,Europe,146050996,5940,777486
2020-07-21,russia,Europe,146050996,5842,783328
2020-07-22,russia,Europe,146050996,5862,789190
2020-07-23,russia,Europe,146050996,5848,795038
2020-07-24,russia,Europe,146050996,5811,800849
2020-07-25,russia,Europe,146050996,5871,806720
2020-07-26,russia,Europe,146050996,5765,812485
2020-07-27,russia,Europe,146050996,5635,818120
2020-07-28,russia,Europe,146050996,5395,823515
2020-07-29,russia,Europe,146050996,5475,828990
2020-07-30,russia,Europe,146050996,5509,834499
2020-07-31,russia,Europe,146050996,5482,839981
2020-08-01,russia,Europe,146050996,5462,845443
2020-08-02,russia,Europe,146050996,5427,850870
2020-08-03,russia,Europe,146050996,5394,856264
2020-08-04,russia,Europe,146050996,5159,861423
2020-08-05,russia,Europe,146050996,5204,866627
2020-08-06,russia,Europe,146050996,5267,871894
2020-08-07,russia,Europe,146050996,5241,877135
2020-08-08,russia,Europe,146050996,5212,882347
2020-08-09,russia,Europe,146050996,5189,887536
2020-08-10,russia,Europe,146050996,5118,892654
2020-08-11,russia,Europe,146050996,4945,897599
2020-08-12,russia,Europe,146050996,5102,902701
2020-08-13,russia,Europe,146050996,5057,907758
2020-08-14,russia,Europe,146050996,5065,912823
2020-08-15,russia,Europe,146050996,5061,917884
2020-08-16,russia,Europe,146050996,4969,922853
2020-08-17,russia,Europe,146050996,4892,927745
2020-08-18,russia,Europe,146050996,4748,932493
2020-08-19,russia,Europe,146050996,4828,937321
2020-08-20,russia,Europe,146050996,4785,942106
2020-08-21,russia,Europe,146050996,4870,946976
2020-08-22,russia,Europe,146050996,4921,951897
2020-08-23,russia,Europe,146050996,4852,956749
2020-08-24,russia,Europe,146050996,4744,961493
2020-08-25,russia,Europe,146050996,4696,966189
2020-08-26,russia,Europe,146050996,4676,970865
2020-08-27,russia,Europe,146050996,4711,975576
2020-08-28,russia,Europe,146050996,4829,980405
2020-08-29,russia,Europe,146050996,4941,985346
2020-08-30,russia,Europe,146050996,4980,990326
2020-08-31,russia,Europe,146050996,4993,995319
2020-09-01,russia,Europe,146050996,4729,1000048
2020-09-02,russia,Europe,146050996,4952,1005000
2020-09-03,russia,Europe,146050996,4995,1009995
2020-09-04,russia,Europe,146050996,5110,1015105
2020-09-05,russia,Europe,146050996,5205,1020310
2020-09-06,russia,Europe,146050996,5195,1025505
2020-09-07,russia,Europe,146050996,5185,1030690
2020-09-08,russia,Europe,146050996,5099,1035789
2020-09-09,russia,Europe,146050996,5218,1041007
2020-09-10,russia,Europe,146050996,5363,1046370
2020-09-11,russia,Europe,146050996,5504,1051874
2020-09-12,russia,Europe,146050996,5488,1057362
2020-09-13,russia,Europe,146050996,5449,1062811
2020-09-14,russia,Europe,146050996,5509,1068320
2020-09-15,russia,Europe,146050996,5529,1073849
2020-09-16,russia,Europe,146050996,5670,1079519
2020-09-17,russia,Europe,146050996,5762,1085281
2020-09-18,russia,Europe,146050996,5905,1091186
2020-09-19,russia,Europe,146050996,6065,1097251
2020-09-20,russia,Europe,146050996,6148,1103399
2020-09-21,russia,Europe,146050996,6196,1109595
2020-09-22,russia,Europe,146050996,6215,1115810
2020-09-23,russia,Europe,146050996,6431,1122241
2020-09-24,russia,Europe,146050996,6595,1128836
2020-09-25,russia,Europe,146050996,7212,1136048
2020-09-26,russia,Europe,146050996,7523,1143571
2020-09-27,russia,Europe,146050996,7867,1151438
2020-09-28,russia,Europe,146050996,8135,1159573
2020-09-29,russia,Europe,146050996,8232,1167805
2020-09-30,russia,Europe,146050996,8481,1176286
2020-10-01,russia,Europe,146050996,8945,1185231
2020-10-02,russia,Europe,146050996,9412,1194643
2020-10-03,russia,Europe,146050996,9859,1204502
2020-10-04,russia,Europe,146050996,10499,1215001
2020-10-05,russia,Europe,146050996,10888,1225889
2020-10-06,russia,Europe,146050996,11615,1237504
2020-10-07,russia,Europe,146050996,11115,1248619
2020-10-08,russia,Europe,146050996,11493,1260112
2020-10-09,russia,Europe,146050996,12126,1272238
2020-10-10,russia,Europe,146050996,12846,1285084
2020-10-11,russia,Europe,146050996,13634,1298718
2020-10-12,russia,Europe,146050996,13592,1312310
2020-10-13,russia,Europe,146050996,13868,1326178
2020-10-14,russia,Europe,146050996,14231,1340409
2020-10-15,russia,Europe,146050996,13754,1354163
2020-10-16,russia,Europe,146050996,15150,1369313
2020-10-17,russia,Europe,146050996,14922,1384235
2020-10-18,russia,Europe,146050996,15099,1399334
2020-10-19,russia,Europe,146050996,15982,1415316
2020-10-20,russia,Europe,146050996,16319,1431635
2020-10-21,russia,Europe,146050996,15700,1447335
2020-10-22,russia,Europe,146050996,15971,1463306
2020-10-23,russia,Europe,146050996,17340,1480646
2020-10-24,russia,Europe,146050996,16521,1497167
2020-10-25,russia,Europe,146050996,16710,1513877
2020-10-26,russia,Europe,146050996,17347,1531224
2020-10-27,russia,Europe,146050996,16550,1547774
2020-10-28,russia,Europe,146050996,16202,1563976
2020-10-29,russia,Europe,146050996,17717,1581693
2020-10-30,russia,Europe,146050996,18283,1599976
2020-10-31,russia,Europe,146050996,18140,1618116
2020-11-01,russia,Europe,146050996,18665,1636781
2020-11-02,russia,Europe,146050996,18257,1655038
2020-11-03,russia,Europe,146050996,18648,1673686
2020-11-04,russia,Europe,146050996,19768,1693454
2020-11-05,russia,Europe,146050996,19404,1712858
2020-11-06,russia,Europe,146050996,20582,1733440
2020-11-07,russia,Europe,146050996,20396,1753836
2020-11-08,russia,Europe,146050996,20498,1774334
2020-11-09,russia,Europe,146050996,21798,1796132
2020-11-10,russia,Europe,146050996,20977,1817109
2020-11-11,russia,Europe,146050996,19851,1836960
2020-11-12,russia,Europe,146050996,21608,1858568
2020-11-13,russia,Europe,146050996,21983,1880551
2020-11-14,russia,Europe,146050996,22702,1903253
2020-11-15,russia,Europe,146050996,22572,1925825
2020-11-16,russia,Europe,146050996,22778,1948603
2020-11-17,russia,Europe,146050996,22410,1971013
2020-11-18,russia,Europe,146050996,20985,1991998
2020-11-19,russia,Europe,146050996,23610,2015608
2020-11-20,russia,Europe,146050996,24318,2039926
2020-11-21,russia,Europe,146050996,24822,2064748
2020-11-22,russia,Europe,146050996,24581,2089329
2020-11-23,russia,Europe,146050996,25173,2114502
2020-11-24,russia,Europe,146050996,24326,2138828
2020-11-25,russia,Europe,146050996,23675,2162503
2020-11-26,russia,Europe,146050996,25487,2187990
2020-11-27,russia,Europe,146050996,27543,2215533
2020-11-28,russia,Europe,146050996,27100,2242633
2020-11-29,russia,Europe,146050996,26683,2269316
2020-11-30,russia,Europe,146050996,26338,2295654
2020-12-01,russia,Europe,146050996,26402,2322056
2020-12-02,russia,Europe,146050996,25345,2347401
2020-12-03,russia,Europe,146050996,28145,2375546
2020-12-04,russia,Europe,146050996,27403,2402949
2020-12-05,russia,Europe,146050996,28782,2431731
2020-12-06,russia,Europe,146050996,29039,2460770
2020-12-07,russia,Europe,146050996,28142,2488912
2020-12-08,russia,Europe,146050996,26097,2515009
2020-12-09,russia,Europe,146050996,26190,2541199
2020-12-10,russia,Europe,146050996,27927,2569126
2020-12-11,russia,Europe,146050996,28585,2597711
2020-12-12,russia,Europe,146050996,28137,2625848
2020-12-13,russia,Europe,146050996,28080,2653928
2020-12-14,russia,Europe,146050996,27328,2681256
2020-12-15,russia,Europe,146050996,26689,2707945
2020-12-16,russia,Europe,146050996,26509,2734454
2020-12-17,russia,Europe,146050996,28214,2762668
2020-12-18,russia,Europe,146050996,28552,2791220
2020-12-19,russia,Europe,146050996,28209,2819429
2020-12-20,russia,Europe,146050996,28948,2848377
2020-12-21,russia,Europe,146050996,29350,2877727
2020-12-22,russia,Europe,146050996,28776,2906503
2020-12-23,russia,Europe,146050996,27250,2933753
2020-12-24,russia,Europe,146050996,29935,2963688
2020-12-25,russia,Europe,146050996,29018,2992706
2020-12-26,russia,Europe,146050996,29258,3021964
2020-12-27,russia,Europe,146050996,28284,3050248
2020-12-28,russia,Europe,146050996,27787,3078035
2020-12-29,russia,Europe,146050996,27002,3105037
2020-12-30,russia,Europe,146050996,26513,3131550
2020-12-31,russia,Europe,146050996,27747,3159297
2021-01-01,russia,Europe,146050996,27039,3186336
2021-01-02,russia,Europe,146050996,26301,3212637
2021-01-03,russia,Europe,146050996,24150,3236787
2021-01-04,russia,Europe,146050996,23351,3260138
2021-01-05,russia,Europe,146050996,24246,3284384
2020-05-31,rwanda,Africa,13549956,11,370
2020-06-01,rwanda,Africa,13549956,7,377
2020-06-02,rwanda,Africa,13549956,7,384
2020-06-03,rwanda,Africa,13549956,13,397
2020-06-04,rwanda,Africa,13549956,13,410
2020-06-05,rwanda,Africa,13549956,10,420
2020-06-06,rwanda,Africa,13549956,11,431
2020-06-07,rwanda,Africa,13549956,8,439
2020-06-08,rwanda,Africa,13549956,12,451
2020-06-09,rwanda,Africa,13549956,12,463
2020-06-10,rwanda,Africa,13549956,13,476
2020-06-11,rwanda,Africa,13549956,18,494
2020-06-12,rwanda,Africa,13549956,16,510
2020-06-13,rwanda,Africa,13549956,31,541
2020-06-14,rwanda,Africa,13549956,41,582
2020-06-15,rwanda,Africa,13549956,30,612
2020-06-16,rwanda,Africa,13549956,24,636
2020-06-17,rwanda,Africa,13549956,3,639
2020-06-18,rwanda,Africa,13549956,7,646
2020-06-19,rwanda,Africa,13549956,15,661
2020-06-20,rwanda,Africa,13549956,41,702
2020-06-21,rwanda,Africa,13549956,26,728
2020-06-22,rwanda,Africa,13549956,59,787
2020-06-23,rwanda,Africa,13549956,11,798
2020-06-24,rwanda,Africa,13549956,32,830
2020-06-25,rwanda,Africa,13549956,20,850
2020-06-26,rwanda,Africa,13549956,8,858
2020-06-27,rwanda,Africa,13549956,20,878
2020-06-28,rwanda,Africa,13549956,22,900
2020-06-29,rwanda,Africa,13549956,101,1001
2020-06-30,rwanda,Africa,13549956,24,1025
2020-07-01,rwanda,Africa,13549956,17,1042
2020-07-02,rwanda,Africa,13549956,21,1063
2020-07-03,rwanda,Africa,13549956,18,1081
2020-07-04,rwanda,Africa,13549956,11,1092
2020-07-05,rwanda,Africa,13549956,13,1105
2020-07-06,rwanda,Africa,13549956,8,1113
2020-07-07,rwanda,Africa,13549956,59,1172
2020-07-08,rwanda,Africa,13549956,22,1194
2020-07-09,rwanda,Africa,13549956,16,1210
2020-07-10,rwanda,Africa,13549956,42,1252
2020-07-11,rwanda,Africa,13549956,47,1299
2020-07-12,rwanda,Africa,13549956,38,1337
2020-07-13,rwanda,Africa,13549956,41,1378
2020-07-14,rwanda,Africa,13549956,38,1416
2020-07-15,rwanda,Africa,13549956,19,1435
2020-07-16,rwanda,Africa,13549956,38,1473
2020-07-17,rwanda,Africa,13549956,12,1485
2020-07-18,rwanda,Africa,13549956,54,1539
2020-07-19,rwanda,Africa,13549956,43,1582
2020-07-20,rwanda,Africa,13549956,47,1629
2020-07-21,rwanda,Africa,13549956,26,1655
2020-07-22,rwanda,Africa,13549956,34,1689
2020-07-23,rwanda,Africa,13549956,21,1710
2020-07-24,rwanda,Africa,13549956,19,1729
2020-07-25,rwanda,Africa,13549956,23,1752
2020-07-26,rwanda,Africa,13549956,69,1821
2020-07-27,rwanda,Africa,13549956,58,1879
2020-07-28,rwanda,Africa,13549956,47,1926
2020-07-29,rwanda,Africa,13549956,37,1963
2020-07-30,rwanda,Africa,13549956,31,1994
2020-07-31,rwanda,Africa,13549956,28,2022
2020-08-01,rwanda,Africa,13549956,20,2042
2020-08-02,rwanda,Africa,13549956,20,2062
2020-08-03,rwanda,Africa,13549956,30,2092
2020-08-04,rwanda,Africa,13549956,7,2099
2020-08-05,rwanda,Africa,13549956,5,2104
2020-08-06,rwanda,Africa,13549956,7,2111
2020-08-07,rwanda,Africa,13549956,17,2128
2020-08-08,rwanda,Africa,13549956,6,2134
2020-08-09,rwanda,Africa,13549956,6,2140
2020-08-10,rwanda,Africa,13549956,12,2152
2020-08-11,rwanda,Africa,13549956,19,2171
2020-08-12,rwanda,Africa,13549956,18,2189
2020-08-13,rwanda,Africa,13549956,11,2200
2020-08-14,rwanda,Africa,13549956,93,2293
2020-08-15,rwanda,Africa,13549956,59,2352
2020-08-16,rwanda,Africa,13549956,101,2453
2020-08-17,rwanda,Africa,13549956,87,2540
2020-08-18,rwanda,Africa,13549956,37,2577
2020-08-19,rwanda,Africa,13549956,67,2644
2020-08-20,rwanda,Africa,13549956,73,2717
2020-08-21,rwanda,Africa,13549956,63,2780
2020-08-22,rwanda,Africa,13549956,109,2889
2020-08-23,rwanda,Africa,13549956,200,3089
2020-08-24,rwanda,Africa,13549956,217,3306
2020-08-25,rwanda,Africa,13549956,231,3537
2020-08-26,rwanda,Africa,13549956,88,3625
2020-08-27,rwanda,Africa,13549956,47,3672
2020-08-28,rwanda,Africa,13549956,70,3742
2020-08-29,rwanda,Africa,13549956,101,3843
2020-08-30,rwanda,Africa,13549956,177,4020
2020-08-31,rwanda,Africa,13549956,43,4063
2020-09-01,rwanda,Africa,13549956,79,4142
2020-09-02,rwanda,Africa,13549956,76,4218
2020-09-03,rwanda,Africa,13549956,37,4255
2020-09-04,rwanda,Africa,13549956,49,4304
2020-09-05,rwanda,Africa,13549956,45,4349
2020-09-06,rwanda,Africa,13549956,25,4374
2020-09-07,rwanda,Africa,13549956,35,4409
2020-09-08,rwanda,Africa,13549956,30,4439
2020-09-09,rwanda,Africa,13549956,21,4460
2020-09-10,rwanda,Africa,13549956,19,4479
2020-09-11,rwanda,Africa,13549956,55,4534
2020-09-12,rwanda,Africa,13549956,31,4565
2020-09-13,rwanda,Africa,13549956,26,4591
2020-09-14,rwanda,Africa,13549956,11,4602
2020-09-15,rwanda,Africa,13549956,22,4624
2020-09-16,rwanda,Africa,13549956,10,4634
2020-09-17,rwanda,Africa,13549956,19,4653
2020-09-18,rwanda,Africa,13549956,18,4671
2020-09-19,rwanda,Africa,13549956,18,4689
2020-09-20,rwanda,Africa,13549956,22,4711
2020-09-21,rwanda,Africa,13549956,11,4722
2020-09-22,rwanda,Africa,13549956,16,4738
2020-09-23,rwanda,Africa,13549956,41,4779
2020-09-24,rwanda,Africa,13549956,10,4789
2020-09-25,rwanda,Africa,13549956,9,4798
2020-09-26,rwanda,Africa,13549956,13,4811
2020-09-27,rwanda,Africa,13549956,9,4820
2020-09-28,rwanda,Africa,13549956,12,4832
2020-09-29,rwanda,Africa,13549956,4,4836
2020-09-30,rwanda,Africa,13549956,4,4840
2020-10-01,rwanda,Africa,13549956,3,4843
2020-10-02,rwanda,Africa,13549956,4,4847
2020-10-03,rwanda,Africa,13549956,5,4852
2020-10-04,rwanda,Africa,13549956,14,4866
2020-10-05,rwanda,Africa,13549956,1,4867
2020-10-06,rwanda,Africa,13549956,6,4873
2020-10-07,rwanda,Africa,13549956,10,4883
2020-10-08,rwanda,Africa,13549956,2,4885
2020-10-09,rwanda,Africa,13549956,5,4890
2020-10-10,rwanda,Africa,13549956,2,4892
2020-10-11,rwanda,Africa,13549956,4,4896
2020-10-12,rwanda,Africa,13549956,9,4905
2020-10-13,rwanda,Africa,13549956,3,4908
2020-10-14,rwanda,Africa,13549956,32,4940
2020-10-15,rwanda,Africa,13549956,13,4953
2020-10-16,rwanda,Africa,13549956,12,4965
2020-10-17,rwanda,Africa,13549956,6,4971
2020-10-18,rwanda,Africa,13549956,3,4974
2020-10-19,rwanda,Africa,13549956,18,4992
2020-10-20,rwanda,Africa,13549956,4,4996
2020-10-21,rwanda,Africa,13549956,16,5012
2020-10-22,rwanda,Africa,13549956,5,5017
2020-10-23,rwanda,Africa,13549956,35,5052
2020-10-24,rwanda,Africa,13549956,8,5060
2020-10-25,rwanda,Africa,13549956,6,5066
2020-10-26,rwanda,Africa,13549956,7,5073
2020-10-27,rwanda,Africa,13549956,11,5084
2020-10-28,rwanda,Africa,13549956,45,5129
2020-10-29,rwanda,Africa,13549956,2,5131
2020-10-30,rwanda,Africa,13549956,3,5134
2020-10-31,rwanda,Africa,13549956,3,5137
2020-11-01,rwanda,Africa,13549956,9,5146
2020-11-02,rwanda,Africa,13549956,9,5155
2020-11-03,rwanda,Africa,13549956,7,5162
2020-11-04,rwanda,Africa,13549956,12,5174
2020-11-05,rwanda,Africa,13549956,18,5192
2020-11-06,rwanda,Africa,13549956,16,5208
2020-11-07,rwanda,Africa,13549956,5,5213
2020-11-08,rwanda,Africa,13549956,9,5222
2020-11-09,rwanda,Africa,13549956,20,5242
2020-11-10,rwanda,Africa,13549956,20,5262
2020-11-11,rwanda,Africa,13549956,50,5312
2020-11-12,rwanda,Africa,13549956,7,5319
2020-11-13,rwanda,Africa,13549956,43,5362
2020-11-14,rwanda,Africa,13549956,32,5394
2020-11-15,rwanda,Africa,13549956,61,5455
2020-11-16,rwanda,Africa,13549956,36,5491
2020-11-17,rwanda,Africa,13549956,16,5507
2020-11-18,rwanda,Africa,13549956,36,5543
2020-11-19,rwanda,Africa,13549956,29,5572
2020-11-20,rwanda,Africa,13549956,14,5586
2020-11-21,rwanda,Africa,13549956,34,5620
2020-11-22,rwanda,Africa,13549956,45,5665
2020-11-23,rwanda,Africa,13549956,61,5726
2020-11-24,rwanda,Africa,13549956,24,5750
2020-11-25,rwanda,Africa,13549956,29,5779
2020-11-26,rwanda,Africa,13549956,72,5851
2020-11-27,rwanda,Africa,13549956,21,5872
2020-11-28,rwanda,Africa,13549956,19,5891
2020-11-29,rwanda,Africa,13549956,28,5919
2020-11-30,rwanda,Africa,13549956,15,5934
2020-12-01,rwanda,Africa,13549956,14,5948
2020-12-02,rwanda,Africa,13549956,46,5994
2020-12-03,rwanda,Africa,13549956,17,6011
2020-12-04,rwanda,Africa,13549956,32,6043
2020-12-05,rwanda,Africa,13549956,41,6084
2020-12-06,rwanda,Africa,13549956,45,6129
2020-12-07,rwanda,Africa,13549956,62,6191
2020-12-08,rwanda,Africa,13549956,46,6237
2020-12-09,rwanda,Africa,13549956,41,6278
2020-12-10,rwanda,Africa,13549956,71,6349
2020-12-11,rwanda,Africa,13549956,79,6428
2020-12-12,rwanda,Africa,13549956,100,6528
2020-12-13,rwanda,Africa,13549956,131,6659
2020-12-14,rwanda,Africa,13549956,88,6747
2020-12-15,rwanda,Africa,13549956,85,6832
2020-12-16,rwanda,Africa,13549956,122,6954
2020-12-17,rwanda,Africa,13549956,78,7032
2020-12-18,rwanda,Africa,13549956,73,7105
2020-12-19,rwanda,Africa,13549956,127,7232
2020-12-20,rwanda,Africa,13549956,61,7293
2020-12-21,rwanda,Africa,13549956,109,7402
2020-12-22,rwanda,Africa,13549956,109,7511
2020-12-23,rwanda,Africa,13549956,87,7598
2020-12-24,rwanda,Africa,13549956,72,7670
2020-12-25,rwanda,Africa,13549956,73,7743
2020-12-26,rwanda,Africa,13549956,74,7817
2020-12-27,rwanda,Africa,13549956,153,7970
2020-12-28,rwanda,Africa,13549956,51,8021
2020-12-29,rwanda,Africa,13549956,107,8128
2020-12-30,rwanda,Africa,13549956,122,8250
2020-12-31,rwanda,Africa,13549956,133,8383
2021-01-01,rwanda,Africa,13549956,77,8460
2021-01-02,rwanda,Africa,13549956,107,8567
2021-01-03,rwanda,Africa,13549956,109,8676
2021-01-04,rwanda,Africa,13549956,172,8848
2021-01-05,rwanda,Africa,13549956,107,8955
2021-01-06,rwanda,Africa,13549956,103,9058
2021-01-07,rwanda,Africa,13549956,167,9225
2021-01-08,rwanda,Africa,13549956,143,9368
2021-01-09,rwanda,Africa,13549956,93,9461
2021-01-10,rwanda,Africa,13549956,169,9630
2021-01-11,rwanda,Africa,13549956,154,9784
2021-01-12,rwanda,Africa,13549956,166,9950
2021-01-13,rwanda,Africa,13549956,172,10122
2021-01-14,rwanda,Africa,13549956,194,10316
2021-01-15,rwanda,Africa,13549956,257,10573
2021-01-16,rwanda,Africa,13549956,277,10850
2021-01-17,rwanda,Africa,13549956,182,11032
2021-01-18,rwanda,Africa,13549956,227,11259
2021-01-19,rwanda,Africa,13549956,289,11548
2021-01-20,rwanda,Africa,13549956,312,11860
2021-01-21,rwanda,Africa,13549956,310,12170
2021-01-22,rwanda,Africa,13549956,273,12443
2021-01-23,rwanda,Africa,13549956,204,12647
2021-01-24,rwanda,Africa,13549956,328,12975
2021-01-25,rwanda,Africa,13549956,336,13311
2021-01-26,rwanda,Africa,13549956,574,13885
2021-01-27,rwanda,Africa,13549956,281,14166
2021-01-28,rwanda,Africa,13549956,363,14529
2021-01-29,rwanda,Africa,13549956,255,14784
2021-01-30,rwanda,Africa,13549956,334,15118
2021-01-31,rwanda,Africa,13549956,186,15304
2021-02-01,rwanda,Africa,13549956,155,15459
2021-02-02,rwanda,Africa,13549956,229,15688
2021-02-03,rwanda,Africa,13549956,146,15834
2021-02-04,rwanda,Africa,13549956,154,15988
2021-02-05,rwanda,Africa,13549956,198,16186
2021-02-06,rwanda,Africa,13549956,151,16337
2021-02-07,rwanda,Africa,13549956,114,16451
2021-02-08,rwanda,Africa,13549956,170,16621
2021-02-09,rwanda,Africa,13549956,190,16811
2021-02-10,rwanda,Africa,13549956,130,16941
2021-02-11,rwanda,Africa,13549956,127,17068
2021-02-12,rwanda,Africa,13549956,132,17200
2021-02-13,rwanda,Africa,13549956,67,17267
2021-02-14,rwanda,Africa,13549956,76,17343
2021-02-15,rwanda,Africa,13549956,141,17484
2021-02-16,rwanda,Africa,13549956,110,17594
2021-02-17,rwanda,Africa,13549956,122,17716
2021-02-18,rwanda,Africa,13549956,119,17835
2021-02-19,rwanda,Africa,13549956,94,17929
2021-02-20,rwanda,Africa,13549956,59,17988
2021-02-21,rwanda,Africa,13549956,65,18053
2021-02-22,rwanda,Africa,13549956,146,18199
2021-02-23,rwanda,Africa,13549956,126,18325
2021-02-24,rwanda,Africa,13549956,118,18443
2021-02-25,rwanda,Africa,13549956,110,18553
2021-02-26,rwanda,Africa,13549956,136,18689
2021-02-27,rwanda,Africa,13549956,101,18790
2021-02-28,rwanda,Africa,13549956,60,18850
2021-03-01,rwanda,Africa,13549956,136,18986
2021-03-02,rwanda,Africa,13549956,125,19111
2021-03-03,rwanda,Africa,13549956,87,19198
2021-03-04,rwanda,Africa,13549956,136,19334
2021-03-05,rwanda,Africa,13549956,92,19426
2021-03-06,rwanda,Africa,13549956,83,19509
2021-03-07,rwanda,Africa,13549956,42,19551
2021-03-08,rwanda,Africa,13549956,108,19659
2021-03-09,rwanda,Africa,13549956,120,19779
2021-03-10,rwanda,Africa,13549956,67,19846
2021-03-11,rwanda,Africa,13549956,99,19945
2021-03-12,rwanda,Africa,13549956,112,20057
2021-03-13,rwanda,Africa,13549956,86,20143
2021-03-14,rwanda,Africa,13549956,43,20186
2021-03-15,rwanda,Africa,13549956,116,20302
2021-03-16,rwanda,Africa,13549956,110,20412
2021-03-17,rwanda,Africa,13549956,68,20480
2021-03-18,rwanda,Africa,13549956,71,20551
2021-03-19,rwanda,Africa,13549956,130,20681
2021-03-20,rwanda,Africa,13549956,80,20761
2021-03-21,rwanda,Africa,13549956,67,20828
2021-03-22,rwanda,Africa,13549956,68,20896
2021-03-23,rwanda,Africa,13549956,79,20975
2021-03-24,rwanda,Africa,13549956,131,21106
2021-03-25,rwanda,Africa,13549956,104,21210
2021-03-26,rwanda,Africa,13549956,99,21309
2021-03-27,rwanda,Africa,13549956,61,21370
2021-03-28,rwanda,Africa,13549956,49,21419
2021-03-29,rwanda,Africa,13549956,71,21490
2021-03-30,rwanda,Africa,13549956,155,21645
2021-03-31,rwanda,Africa,13549956,138,21783
2021-04-01,rwanda,Africa,13549956,135,21918
2021-04-02,rwanda,Africa,13549956,249,22167
2021-04-03,rwanda,Africa,13549956,76,22243
2021-04-04,rwanda,Africa,13549956,239,22482
2021-04-05,rwanda,Africa,13549956,202,22684
2021-04-06,rwanda,Africa,13549956,178,22862
2021-04-07,rwanda,Africa,13549956,179,23041
2021-04-08,rwanda,Africa,13549956,111,23152
2021-04-09,rwanda,Africa,13549956,108,23260
2021-04-10,rwanda,Africa,13549956,83,23343
2021-04-11,rwanda,Africa,13549956,83,23426
2021-04-12,rwanda,Africa,13549956,109,23535
2021-04-13,rwanda,Africa,13549956,68,23603
2021-04-14,rwanda,Africa,13549956,69,23672
2021-04-15,rwanda,Africa,13549956,72,23744
2021-04-16,rwanda,Africa,13549956,68,23812
2021-04-17,rwanda,Africa,13549956,54,23866
2021-04-18,rwanda,Africa,13549956,22,23888
2021-04-19,rwanda,Africa,13549956,46,23934
2021-04-20,rwanda,Africa,13549956,71,24005
2021-04-21,rwanda,Africa,13549956,107,24112
2021-04-22,rwanda,Africa,13549956,150,24262
2021-04-23,rwanda,Africa,13549956,197,24459
2021-04-24,rwanda,Africa,13549956,76,24535
2021-04-25,rwanda,Africa,13549956,58,24593
2021-04-26,rwanda,Africa,13549956,84,24677
2021-04-27,rwanda,Africa,13549956,137,24814
2021-04-28,rwanda,Africa,13549956,74,24888
2021-04-29,rwanda,Africa,13549956,107,24995
2021-04-30,rwanda,Africa,13549956,121,25116
2021-05-01,rwanda,Africa,13549956,109,25225
2021-05-02,rwanda,Africa,13549956,28,25253
2021-05-03,rwanda,Africa,13549956,58,25311
2021-05-04,rwanda,Africa,13549956,40,25351
2021-05-05,rwanda,Africa,13549956,70,25421
2021-05-06,rwanda,Africa,13549956,65,25486
2021-05-07,rwanda,Africa,13549956,53,25539
2021-05-08,rwanda,Africa,13549956,47,25586
2021-05-09,rwanda,Africa,13549956,66,25652
2021-05-10,rwanda,Africa,13549956,62,25714
2021-05-11,rwanda,Africa,13549956,59,25773
2021-05-12,rwanda,Africa,13549956,73,25846
2021-05-13,rwanda,Africa,13549956,88,25934
2021-05-14,rwanda,Africa,13549956,99,26033
2021-05-15,rwanda,Africa,13549956,66,26099
2021-05-16,rwanda,Africa,13549956,42,26141
2021-05-17,rwanda,Africa,13549956,74,26215
2021-05-18,rwanda,Africa,13549956,129,26344
2021-05-19,rwanda,Africa,13549956,80,26424
2021-05-20,rwanda,Africa,13549956,105,26529
2021-05-21,rwanda,Africa,13549956,72,26601
2021-05-22,rwanda,Africa,13549956,57,26658
2021-05-23,rwanda,Africa,13549956,30,26688
2021-05-24,rwanda,Africa,13549956,42,26730
2021-05-25,rwanda,Africa,13549956,50,26780
2021-05-26,rwanda,Africa,13549956,37,26817
2021-05-27,rwanda,Africa,13549956,26,26843
2021-05-28,rwanda,Africa,13549956,35,26878
2021-05-29,rwanda,Africa,13549956,14,26892
2021-05-30,rwanda,Africa,13549956,26,26918
2021-05-31,rwanda,Africa,13549956,45,26963
2021-06-01,rwanda,Africa,13549956,60,27023
2021-06-02,rwanda,Africa,13549956,41,27064
2021-06-03,rwanda,Africa,13549956,55,27119
2021-06-04,rwanda,Africa,13549956,43,27162
2021-06-05,rwanda,Africa,13549956,49,27211
2021-06-06,rwanda,Africa,13549956,34,27245
2021-06-07,rwanda,Africa,13549956,62,27307
2021-06-08,rwanda,Africa,13549956,127,27434
2021-06-09,rwanda,Africa,13549956,114,27548
2021-06-10,rwanda,Africa,13549956,112,27660
2021-06-11,rwanda,Africa,13549956,202,27862
2021-06-12,rwanda,Africa,13549956,284,28146
2021-06-13,rwanda,Africa,13549956,227,28373
2021-06-14,rwanda,Africa,13549956,241,28614
2021-06-15,rwanda,Africa,13549956,298,28912
2021-06-16,rwanda,Africa,13549956,263,29175
2021-06-17,rwanda,Africa,13549956,422,29597
2021-06-18,rwanda,Africa,13549956,451,30048
2021-06-19,rwanda,Africa,13549956,469,30517
2021-06-20,rwanda,Africa,13549956,296,30813
2021-06-21,rwanda,Africa,13549956,622,31435
2021-06-22,rwanda,Africa,13549956,861,32296
2021-06-23,rwanda,Africa,13549956,964,33260
2021-06-24,rwanda,Africa,13549956,883,34143
2021-06-25,rwanda,Africa,13549956,875,35018
2021-06-26,rwanda,Africa,13549956,868,35886
2021-06-27,rwanda,Africa,13549956,741,36627
2021-06-28,rwanda,Africa,13549956,757,37384
2021-06-29,rwanda,Africa,13549956,814,38198
2021-06-30,rwanda,Africa,13549956,849,39047
2021-07-01,rwanda,Africa,13549956,867,39914
2021-07-02,rwanda,Africa,13549956,884,40798
2021-07-03,rwanda,Africa,13549956,898,41696
2021-07-04,rwanda,Africa,13549956,889,42585
2021-07-05,rwanda,Africa,13549956,811,43396
2021-07-06,rwanda,Africa,13549956,883,44279
2021-07-07,rwanda,Africa,13549956,760,45039
2021-07-08,rwanda,Africa,13549956,911,45950
2021-07-09,rwanda,Africa,13549956,887,46837
2021-07-10,rwanda,Africa,13549956,830,47667
2021-07-11,rwanda,Africa,13549956,577,48244
2021-07-12,rwanda,Africa,13549956,772,49016
2021-07-13,rwanda,Africa,13549956,792,49808
2021-07-14,rwanda,Africa,13549956,934,50742
2021-07-15,rwanda,Africa,13549956,883,51625
2021-07-16,rwanda,Africa,13549956,927,52552
2021-07-17,rwanda,Africa,13549956,1997,54549
2021-07-18,rwanda,Africa,13549956,2773,57322
2021-07-19,rwanda,Africa,13549956,913,58235
2021-07-20,rwanda,Africa,13549956,906,59141
2021-07-21,rwanda,Africa,13549956,925,60066
2021-07-22,rwanda,Africa,13549956,1309,61375
2021-07-23,rwanda,Africa,13549956,953,62328
2021-07-24,rwanda,Africa,13549956,2281,64609
2021-07-25,rwanda,Africa,13549956,618,65227
2021-07-26,rwanda,Africa,13549956,791,66018
2021-07-27,rwanda,Africa,13549956,969,66987
2021-07-28,rwanda,Africa,13549956,915,67902
2021-07-29,rwanda,Africa,13549956,965,68867
2021-07-30,rwanda,Africa,13549956,971,69838
2021-07-31,rwanda,Africa,13549956,860,70698
2021-08-01,rwanda,Africa,13549956,648,71346
2021-08-02,rwanda,Africa,13549956,720,72066
2021-08-03,rwanda,Africa,13549956,775,72841
2021-08-04,rwanda,Africa,13549956,769,73610
2021-08-05,rwanda,Africa,13549956,754,74364
2021-08-06,rwanda,Africa,13549956,629,74993
2021-08-07,rwanda,Africa,13549956,650,75643
2021-08-08,rwanda,Africa,13549956,448,76091
2021-08-09,rwanda,Africa,13549956,544,76635
2021-08-10,rwanda,Africa,13549956,600,77235
2021-08-11,rwanda,Africa,13549956,619,77854
2021-08-12,rwanda,Africa,13549956,449,78303
2021-08-13,rwanda,Africa,13549956,515,78818
2021-08-14,rwanda,Africa,13549956,466,79284
2021-08-15,rwanda,Africa,13549956,418,79702
2021-08-16,rwanda,Africa,13549956,435,80137
2021-08-17,rwanda,Africa,13549956,557,80694
2021-08-18,rwanda,Africa,13549956,645,81339
2021-08-19,rwanda,Africa,13549956,496,81835
2021-08-20,rwanda,Africa,13549956,380,82215
2021-08-21,rwanda,Africa,13549956,415,82630
2021-08-22,rwanda,Africa,13549956,393,83023
2021-08-23,rwanda,Africa,13549956,496,83519
2021-08-24,rwanda,Africa,13549956,608,84127
2021-08-25,rwanda,Africa,13549956,504,84631
2021-08-26,rwanda,Africa,13549956,570,85201
2021-08-27,rwanda,Africa,13549956,522,85723
2021-08-28,rwanda,Africa,13549956,519,86242
2021-08-29,rwanda,Africa,13549956,371,86613
2021-08-30,rwanda,Africa,13549956,518,87131
2021-08-31,rwanda,Africa,13549956,496,87627
2021-09-01,rwanda,Africa,13549956,570,88197
2021-09-02,rwanda,Africa,13549956,485,88682
2021-09-03,rwanda,Africa,13549956,490,89172
2021-09-04,rwanda,Africa,13549956,352,89524
2021-09-05,rwanda,Africa,13549956,244,89768
2021-09-06,rwanda,Africa,13549956,377,90145
2021-09-07,rwanda,Africa,13549956,453,90598
2021-09-08,rwanda,Africa,13549956,483,91081
2021-09-09,rwanda,Africa,13549956,474,91555
2021-09-10,rwanda,Africa,13549956,470,92025
2021-09-11,rwanda,Africa,13549956,368,92393
2021-09-12,rwanda,Africa,13549956,227,92620
2021-09-13,rwanda,Africa,13549956,459,93079
2021-09-14,rwanda,Africa,13549956,488,93567
2021-09-15,rwanda,Africa,13549956,488,94055
2021-09-16,rwanda,Africa,13549956,423,94478
2021-09-17,rwanda,Africa,13549956,415,94893
2021-09-18,rwanda,Africa,13549956,224,95117
2021-09-19,rwanda,Africa,13549956,140,95257
2021-09-20,rwanda,Africa,13549956,246,95503
2021-09-21,rwanda,Africa,13549956,264,95767
2021-09-22,rwanda,Africa,13549956,256,96023
2021-09-23,rwanda,Africa,13549956,314,96337
2021-09-24,rwanda,Africa,13549956,233,96570
2021-09-25,rwanda,Africa,13549956,157,96727
2021-09-26,rwanda,Africa,13549956,112,96839
2021-09-27,rwanda,Africa,13549956,143,96982
2021-09-28,rwanda,Africa,13549956,208,97190
2021-09-29,rwanda,Africa,13549956,168,97358
2021-09-30,rwanda,Africa,13549956,159,97517
2021-10-01,rwanda,Africa,13549956,178,97695
2021-10-02,rwanda,Africa,13549956,86,97781
2021-10-03,rwanda,Africa,13549956,89,97870
2021-10-04,rwanda,Africa,13549956,81,97951
2021-10-05,rwanda,Africa,13549956,126,98077
2021-10-06,rwanda,Africa,13549956,132,98209
2021-10-07,rwanda,Africa,13549956,136,98345
2021-10-08,rwanda,Africa,13549956,140,98485
2021-10-09,rwanda,Africa,13549956,114,98599
2021-10-10,rwanda,Africa,13549956,98,98697
2021-10-11,rwanda,Africa,13549956,48,98745
2021-10-12,rwanda,Africa,13549956,95,98840
2021-10-13,rwanda,Africa,13549956,86,98926
2021-10-14,rwanda,Africa,13549956,61,98987
2021-10-15,rwanda,Africa,13549956,80,99067
2021-10-16,rwanda,Africa,13549956,61,99128
2021-10-17,rwanda,Africa,13549956,17,99145
2021-10-18,rwanda,Africa,13549956,36,99181
2020-11-11,saint_lucia,North America,185190,0,148
2020-11-12,saint_lucia,North America,185190,0,148
2020-11-13,saint_lucia,North America,185190,8,156
2020-11-14,saint_lucia,North America,185190,4,160
2020-11-15,saint_lucia,North America,185190,2,162
2020-11-16,saint_lucia,North America,185190,9,171
2020-11-17,saint_lucia,North America,185190,7,178
2020-11-18,saint_lucia,North America,185190,5,183
2020-11-19,saint_lucia,North America,185190,20,203
2020-11-20,saint_lucia,North America,185190,0,203
2020-11-21,saint_lucia,North America,185190,1,204
2020-11-22,saint_lucia,North America,185190,16,220
2020-11-23,saint_lucia,North America,185190,3,223
2020-11-24,saint_lucia,North America,185190,3,226
2020-11-25,saint_lucia,North America,185190,9,235
2020-11-26,saint_lucia,North America,185190,3,238
2020-11-27,saint_lucia,North America,185190,8,246
2020-11-28,saint_lucia,North America,185190,6,252
2020-11-29,saint_lucia,North America,185190,5,257
2020-11-30,saint_lucia,North America,185190,2,259
2020-12-01,saint_lucia,North America,185190,0,259
2020-12-02,saint_lucia,North America,185190,2,261
2020-12-03,saint_lucia,North America,185190,1,262
2020-12-04,saint_lucia,North America,185190,0,262
2020-12-05,saint_lucia,North America,185190,3,265
2020-12-06,saint_lucia,North America,185190,0,265
2020-12-07,saint_lucia,North America,185190,5,270
2020-12-08,saint_lucia,North America,185190,0,270
2020-12-09,saint_lucia,North America,185190,1,271
2020-12-10,saint_lucia,North America,185190,0,271
2020-12-11,saint_lucia,North America,185190,3,274
2020-12-12,saint_lucia,North America,185190,0,274
2020-12-13,saint_lucia,North America,185190,1,275
2020-12-14,saint_lucia,North America,185190,3,278
2020-12-15,saint_lucia,North America,185190,0,278
2020-12-16,saint_lucia,North America,185190,0,278
2020-12-17,saint_lucia,North America,185190,1,279
2020-12-18,saint_lucia,North America,185190,1,280
2020-12-19,saint_lucia,North America,185190,2,282
2020-12-20,saint_lucia,North America,185190,5,287
2020-12-21,saint_lucia,North America,185190,0,287
2020-12-22,saint_lucia,North America,185190,16,303
2020-12-23,saint_lucia,North America,185190,2,305
2020-12-24,saint_lucia,North America,185190,0,305
2020-12-25,saint_lucia,North America,185190,0,305
2020-12-26,saint_lucia,North America,185190,0,305
2020-12-27,saint_lucia,North America,185190,0,305
2020-12-28,saint_lucia,North America,185190,26,331
2020-12-29,saint_lucia,North America,185190,0,331
2020-12-30,saint_lucia,North America,185190,9,340
2020-12-31,saint_lucia,North America,185190,13,353
2021-01-01,saint_lucia,North America,185190,0,353
2021-01-02,saint_lucia,North America,185190,0,353
2021-01-03,saint_lucia,North America,185190,0,353
2021-01-04,saint_lucia,North America,185190,7,360
2021-01-05,saint_lucia,North America,185190,20,380
2021-01-06,saint_lucia,North America,185190,2,382
2021-01-07,saint_lucia,North America,185190,1,383
2021-01-08,saint_lucia,North America,185190,12,395
2021-01-09,saint_lucia,North America,185190,43,438
2021-01-10,saint_lucia,North America,185190,0,438
2021-01-11,saint_lucia,North America,185190,24,462
2021-01-12,saint_lucia,North America,185190,28,490
2021-01-13,saint_lucia,North America,185190,12,502
2021-01-14,saint_lucia,North America,185190,41,543
2021-01-15,saint_lucia,North America,185190,33,576
2021-01-16,saint_lucia,North America,185190,35,611
2021-01-17,saint_lucia,North America,185190,0,611
2021-01-18,saint_lucia,North America,185190,10,621
2021-01-19,saint_lucia,North America,185190,35,656
2021-01-20,saint_lucia,North America,185190,57,713
2021-01-21,saint_lucia,North America,185190,5,718
2021-01-22,saint_lucia,North America,185190,37,755
2021-01-23,saint_lucia,North America,185190,15,770
2021-01-24,saint_lucia,North America,185190,40,810
2021-01-25,saint_lucia,North America,185190,76,886
2021-01-26,saint_lucia,North America,185190,35,921
2021-01-27,saint_lucia,North America,185190,48,969
2021-01-28,saint_lucia,North America,185190,60,1029
2021-01-29,saint_lucia,North America,185190,77,1106
2021-01-30,saint_lucia,North America,185190,89,1195
2021-01-31,saint_lucia,North America,185190,0,1195
2021-02-01,saint_lucia,North America,185190,216,1411
2021-02-02,saint_lucia,North America,185190,59,1470
2021-02-03,saint_lucia,North America,185190,9,1479
2021-02-04,saint_lucia,North America,185190,77,1556
2021-02-05,saint_lucia,North America,185190,0,1556
2021-02-06,saint_lucia,North America,185190,257,1813
2021-02-07,saint_lucia,North America,185190,0,1813
2021-02-08,saint_lucia,North America,185190,214,2027
2021-02-09,saint_lucia,North America,185190,0,2027
2021-02-10,saint_lucia,North America,185190,110,2137
2021-02-11,saint_lucia,North America,185190,278,2415
2021-02-12,saint_lucia,North America,185190,72,2487
2021-02-13,saint_lucia,North America,185190,0,2487
2021-02-14,saint_lucia,North America,185190,32,2519
2021-02-15,saint_lucia,North America,185190,0,2519
2021-02-16,saint_lucia,North America,185190,30,2549
2021-02-17,saint_lucia,North America,185190,27,2576
2021-02-18,saint_lucia,North America,185190,44,2620
2021-02-19,saint_lucia,North America,185190,0,2620
2021-02-20,saint_lucia,North America,185190,240,2860
2021-02-21,saint_lucia,North America,185190,218,3078
2021-02-22,saint_lucia,North America,185190,57,3135
2021-02-23,saint_lucia,North America,185190,7,3142
2021-02-24,saint_lucia,North America,185190,7,3149
2021-02-25,saint_lucia,North America,185190,0,3149
2021-02-26,saint_lucia,North America,185190,207,3356
2021-02-27,saint_lucia,North America,185190,0,3356
2021-02-28,saint_lucia,North America,185190,34,3390
2021-03-01,saint_lucia,North America,185190,0,3390
2021-03-02,saint_lucia,North America,185190,389,3779
2021-03-03,saint_lucia,North America,185190,24,3803
2021-03-04,saint_lucia,North America,185190,11,3814
2021-03-05,saint_lucia,North America,185190,0,3814
2021-03-06,saint_lucia,North America,185190,29,3843
2021-03-07,saint_lucia,North America,185190,23,3866
2021-03-08,saint_lucia,North America,185190,5,3871
2021-03-09,saint_lucia,North America,185190,31,3902
2021-03-10,saint_lucia,North America,185190,39,3941
2021-03-11,saint_lucia,North America,185190,25,3966
2021-03-12,saint_lucia,North America,185190,23,3989
2021-03-13,saint_lucia,North America,185190,0,3989
2021-03-14,saint_lucia,North America,185190,42,4031
2021-03-15,saint_lucia,North America,185190,22,4053
2021-03-16,saint_lucia,North America,185190,16,4069
2021-03-17,saint_lucia,North America,185190,14,4083
2021-03-18,saint_lucia,North America,185190,14,4097
2021-03-19,saint_lucia,North America,185190,16,4113
2021-03-20,saint_lucia,North America,185190,0,4113
2021-03-21,saint_lucia,North America,185190,8,4121
2021-03-22,saint_lucia,North America,185190,11,4132
2021-03-23,saint_lucia,North America,185190,17,4149
2021-03-24,saint_lucia,North America,185190,12,4161
2021-03-25,saint_lucia,North America,185190,11,4172
2021-03-26,saint_lucia,North America,185190,19,4191
2021-03-27,saint_lucia,North America,185190,0,4191
2021-03-28,saint_lucia,North America,185190,0,4191
2021-03-29,saint_lucia,North America,185190,11,4202
2021-03-30,saint_lucia,North America,185190,26,4228
2021-03-31,saint_lucia,North America,185190,10,4238
2021-04-01,saint_lucia,North America,185190,7,4245
2021-04-02,saint_lucia,North America,185190,20,4265
2021-04-03,saint_lucia,North America,185190,8,4273
2021-04-04,saint_lucia,North America,185190,0,4273
2021-04-05,saint_lucia,North America,185190,0,4273
2021-04-06,saint_lucia,North America,185190,24,4297
2021-04-07,saint_lucia,North America,185190,7,4304
2021-04-08,saint_lucia,North America,185190,8,4312
2021-04-09,saint_lucia,North America,185190,17,4329
2021-04-10,saint_lucia,North America,185190,18,4347
2021-04-11,saint_lucia,North America,185190,1,4348
2021-04-12,saint_lucia,North America,185190,7,4355
2021-04-13,saint_lucia,North America,185190,0,4355
2021-04-14,saint_lucia,North America,185190,0,4355
2021-04-15,saint_lucia,North America,185190,0,4355
2021-04-16,saint_lucia,North America,185190,43,4398
2021-04-17,saint_lucia,North America,185190,3,4401
2021-04-18,saint_lucia,North America,185190,0,4401
2021-04-19,saint_lucia,North America,185190,18,4419
2021-04-20,saint_lucia,North America,185190,0,4419
2021-04-21,saint_lucia,North America,185190,25,4444
2021-04-22,saint_lucia,North America,185190,11,4455
2021-04-23,saint_lucia,North America,185190,0,4455
2021-04-24,saint_lucia,North America,185190,8,4463
2021-04-25,saint_lucia,North America,185190,23,4486
2021-04-26,saint_lucia,North America,185190,16,4502
2021-04-27,saint_lucia,North America,185190,6,4508
2021-04-28,saint_lucia,North America,185190,0,4508
2021-04-29,saint_lucia,North America,185190,26,4534
2021-04-30,saint_lucia,North America,185190,18,4552
2021-05-01,saint_lucia,North America,185190,8,4560
2021-05-02,saint_lucia,North America,185190,0,4560
2021-05-03,saint_lucia,North America,185190,0,4560
2021-05-04,saint_lucia,North America,185190,13,4573
2021-05-05,saint_lucia,North America,185190,12,4585
2021-05-06,saint_lucia,North America,185190,17,4602
2021-05-07,saint_lucia,North America,185190,5,4607
2021-05-08,saint_lucia,North America,185190,47,4654
2021-05-09,saint_lucia,North America,185190,0,4654
2021-05-10,saint_lucia,North America,185190,36,4690
2021-05-11,saint_lucia,North America,185190,10,4700
2021-05-12,saint_lucia,North America,185190,25,4725
2021-05-13,saint_lucia,North America,185190,0,4725
2021-05-14,saint_lucia,North America,185190,63,4788
2021-05-15,saint_lucia,North America,185190,30,4818
2021-05-16,saint_lucia,North America,185190,0,4818
2021-05-17,saint_lucia,North America,185190,0,4818
2021-05-18,saint_lucia,North America,185190,53,4871
2021-05-19,saint_lucia,North America,185190,35,4906
2021-05-20,saint_lucia,North America,185190,17,4923
2021-05-21,saint_lucia,North America,185190,12,4935
2021-05-22,saint_lucia,North America,185190,0,4935
2021-05-23,saint_lucia,North America,185190,10,4945
2021-05-24,saint_lucia,North America,185190,0,4945
2021-05-25,saint_lucia,North America,185190,23,4968
2021-05-26,saint_lucia,North America,185190,12,4980
2021-05-27,saint_lucia,North America,185190,22,5002
2021-05-28,saint_lucia,North America,185190,33,5035
2021-05-29,saint_lucia,North America,185190,0,5035
2021-05-30,saint_lucia,North America,185190,18,5053
2021-05-31,saint_lucia,North America,185190,14,5067
2021-06-01,saint_lucia,North America,185190,5,5072
2021-06-02,saint_lucia,North America,185190,0,5072
2021-06-03,saint_lucia,North America,185190,30,5102
2021-06-04,saint_lucia,North America,185190,6,5108
2021-06-05,saint_lucia,North America,185190,0,5108
2021-06-06,saint_lucia,North America,185190,25,5133
2021-06-07,saint_lucia,North America,185190,5,5138
2021-06-08,saint_lucia,North America,185190,10,5148
2021-06-09,saint_lucia,North America,185190,8,5156
2021-06-10,saint_lucia,North America,185190,4,5160
2021-06-11,saint_lucia,North America,185190,8,5168
2021-06-12,saint_lucia,North America,185190,11,5179
2021-06-13,saint_lucia,North America,185190,0,5179
2021-06-14,saint_lucia,North America,185190,1,5180
2021-06-15,saint_lucia,North America,185190,6,5186
2021-06-16,saint_lucia,North America,185190,2,5188
2021-06-17,saint_lucia,North America,185190,0,5188
2021-06-18,saint_lucia,North America,185190,18,5206
2021-06-19,saint_lucia,North America,185190,5,5211
2021-06-20,saint_lucia,North America,185190,5,5216
2021-06-21,saint_lucia,North America,185190,2,5218
2021-06-22,saint_lucia,North America,185190,9,5227
2021-06-23,saint_lucia,North America,185190,11,5238
2021-06-24,saint_lucia,North America,185190,0,5238
2021-06-25,saint_lucia,North America,185190,24,5262
2021-06-26,saint_lucia,North America,185190,7,5269
2021-06-27,saint_lucia,North America,185190,9,5278
2021-06-28,saint_lucia,North America,185190,6,5284
2021-06-29,saint_lucia,North America,185190,8,5292
2021-06-30,saint_lucia,North America,185190,4,5296
2021-07-01,saint_lucia,North America,185190,6,5302
2021-07-02,saint_lucia,North America,185190,0,5302
2021-07-03,saint_lucia,North America,185190,0,5302
2021-07-04,saint_lucia,North America,185190,24,5326
2021-07-05,saint_lucia,North America,185190,0,5326
2021-07-06,saint_lucia,North America,185190,26,5352
2021-07-07,saint_lucia,North America,185190,11,5363
2021-07-08,saint_lucia,North America,185190,11,5374
2021-07-09,saint_lucia,North America,185190,6,5380
2021-07-10,saint_lucia,North America,185190,19,5399
2021-07-11,saint_lucia,North America,185190,0,5399
2021-07-12,saint_lucia,North America,185190,17,5416
2021-07-13,saint_lucia,North America,185190,14,5430
2021-07-14,saint_lucia,North America,185190,9,5439
2021-07-15,saint_lucia,North America,185190,16,5455
2021-07-16,saint_lucia,North America,185190,7,5462
2021-07-17,saint_lucia,North America,185190,8,5470
2021-07-18,saint_lucia,North America,185190,10,5480
2021-07-19,saint_lucia,North America,185190,1,5481
2021-07-20,saint_lucia,North America,185190,3,5484
2021-07-21,saint_lucia,North America,185190,12,5496
2021-07-22,saint_lucia,North America,185190,0,5496
2021-07-23,saint_lucia,North America,185190,20,5516
2021-07-24,saint_lucia,North America,185190,0,5516
2021-07-25,saint_lucia,North America,185190,4,5520
2021-07-26,saint_lucia,North America,185190,9,5529
2021-07-27,saint_lucia,North America,185190,0,5529
2021-07-28,saint_lucia,North America,185190,8,5537
2021-07-29,saint_lucia,North America,185190,30,5567
2021-07-30,saint_lucia,North America,185190,14,5581
2021-07-31,saint_lucia,North America,185190,29,5610
2021-08-01,saint_lucia,North America,185190,0,5610
2021-08-02,saint_lucia,North America,185190,22,5632
2021-08-03,saint_lucia,North America,185190,20,5652
2021-08-04,saint_lucia,North America,185190,19,5671
2021-08-05,saint_lucia,North America,185190,17,5688
2021-08-06,saint_lucia,North America,185190,25,5713
2021-08-07,saint_lucia,North America,185190,66,5779
2021-08-08,saint_lucia,North America,185190,58,5837
2021-08-09,saint_lucia,North America,185190,76,5913
2021-08-10,saint_lucia,North America,185190,36,5949
2021-08-11,saint_lucia,North America,185190,33,5982
2021-08-12,saint_lucia,North America,185190,130,6112
2021-08-13,saint_lucia,North America,185190,82,6194
2021-08-14,saint_lucia,North America,185190,93,6287
2021-08-15,saint_lucia,North America,185190,79,6366
2021-08-16,saint_lucia,North America,185190,109,6475
2021-08-17,saint_lucia,North America,185190,103,6578
2021-08-18,saint_lucia,North America,185190,0,6578
2021-08-19,saint_lucia,North America,185190,279,6857
2021-08-20,saint_lucia,North America,185190,98,6955
2021-08-21,saint_lucia,North America,185190,0,6955
2021-08-22,saint_lucia,North America,185190,156,7111
2021-08-23,saint_lucia,North America,185190,121,7232
2021-08-24,saint_lucia,North America,185190,189,7421
2021-08-25,saint_lucia,North America,185190,115,7536
2021-08-26,saint_lucia,North America,185190,177,7713
2021-08-27,saint_lucia,North America,185190,0,7713
2021-08-28,saint_lucia,North America,185190,337,8050
2021-08-29,saint_lucia,North America,185190,61,8111
2021-08-30,saint_lucia,North America,185190,44,8155
2021-08-31,saint_lucia,North America,185190,64,8219
2021-09-01,saint_lucia,North America,185190,103,8322
2021-09-02,saint_lucia,North America,185190,220,8542
2021-09-03,saint_lucia,North America,185190,345,8887
2021-09-04,saint_lucia,North America,185190,138,9025
2021-09-05,saint_lucia,North America,185190,124,9149
2021-09-06,saint_lucia,North America,185190,42,9191
2021-09-07,saint_lucia,North America,185190,67,9258
2021-09-08,saint_lucia,North America,185190,69,9327
2021-09-09,saint_lucia,North America,185190,76,9403
2021-09-10,saint_lucia,North America,185190,0,9403
2021-09-11,saint_lucia,North America,185190,124,9527
2021-09-12,saint_lucia,North America,185190,296,9823
2021-09-13,saint_lucia,North America,185190,0,9823
2021-09-14,saint_lucia,North America,185190,148,9971
2021-09-15,saint_lucia,North America,185190,111,10082
2021-09-16,saint_lucia,North America,185190,135,10217
2021-09-17,saint_lucia,North America,185190,127,10344
2021-09-18,saint_lucia,North America,185190,55,10399
2021-09-19,saint_lucia,North America,185190,121,10520
2021-09-20,saint_lucia,North America,185190,85,10605
2021-09-21,saint_lucia,North America,185190,19,10624
2021-09-22,saint_lucia,North America,185190,103,10727
2021-09-23,saint_lucia,North America,185190,125,10852
2021-09-24,saint_lucia,North America,185190,109,10961
2021-09-25,saint_lucia,North America,185190,92,11053
2021-09-26,saint_lucia,North America,185190,91,11144
2021-09-27,saint_lucia,North America,185190,87,11231
2021-09-28,saint_lucia,North America,185190,89,11320
2021-09-29,saint_lucia,North America,185190,139,11459
2021-09-30,saint_lucia,North America,185190,0,11459
2021-10-01,saint_lucia,North America,185190,114,11573
2021-10-02,saint_lucia,North America,185190,63,11636
2021-10-03,saint_lucia,North America,185190,57,11693
2021-10-04,saint_lucia,North America,185190,0,11693
2021-10-05,saint_lucia,North America,185190,16,11709
2021-10-06,saint_lucia,North America,185190,18,11727
2021-10-07,saint_lucia,North America,185190,106,11833
2021-10-08,saint_lucia,North America,185190,109,11942
2021-10-09,saint_lucia,North America,185190,28,11970
2021-10-10,saint_lucia,North America,185190,0,11970
2021-10-11,saint_lucia,North America,185190,47,12017
2021-10-12,saint_lucia,North America,185190,37,12054
2021-10-13,saint_lucia,North America,185190,41,12095
2021-10-14,saint_lucia,North America,185190,34,12129
2021-10-15,saint_lucia,North America,185190,0,12129
2021-10-16,saint_lucia,North America,185190,77,12206
2021-10-17,saint_lucia,North America,185190,22,12228
2021-10-18,saint_lucia,North America,185190,6,12234
2021-10-19,saint_lucia,North America,185190,46,12280
2021-10-20,saint_lucia,North America,185190,33,12313
2021-10-21,saint_lucia,North America,185190,18,12331
2021-10-22,saint_lucia,North America,185190,54,12385
2021-10-23,saint_lucia,North America,185190,26,12411
2021-10-24,saint_lucia,North America,185190,15,12426
2021-10-25,saint_lucia,North America,185190,7,12433
2021-10-26,saint_lucia,North America,185190,32,12465
2021-10-27,saint_lucia,North America,185190,21,12486
2021-10-28,saint_lucia,North America,185190,31,12517
2021-10-29,saint_lucia,North America,185190,19,12536
2021-10-30,saint_lucia,North America,185190,23,12559
2021-10-31,saint_lucia,North America,185190,0,12559
2021-11-01,saint_lucia,North America,185190,14,12573
2021-11-02,saint_lucia,North America,185190,13,12586
2021-11-03,saint_lucia,North America,185190,24,12610
2021-11-04,saint_lucia,North America,185190,35,12645
2021-11-05,saint_lucia,North America,185190,28,12673
2021-11-06,saint_lucia,North America,185190,15,12688
2021-11-07,saint_lucia,North America,185190,0,12688
2021-11-08,saint_lucia,North America,185190,60,12748
2021-11-09,saint_lucia,North America,185190,0,12748
2021-11-10,saint_lucia,North America,185190,9,12757
2021-11-11,saint_lucia,North America,185190,28,12785
2021-11-12,saint_lucia,North America,185190,23,12808
2021-11-13,saint_lucia,North America,185190,19,12827
2021-11-14,saint_lucia,North America,185190,8,12835
2021-11-15,saint_lucia,North America,185190,2,12837
2021-11-16,saint_lucia,North America,185190,7,12844
2021-11-17,saint_lucia,North America,185190,7,12851
2021-11-18,saint_lucia,North America,185190,8,12859
2021-11-19,saint_lucia,North America,185190,13,12872
2021-11-20,saint_lucia,North America,185190,22,12894
2021-11-21,saint_lucia,North America,185190,8,12902
2021-11-22,saint_lucia,North America,185190,2,12904
2021-11-23,saint_lucia,North America,185190,5,12909
2021-11-24,saint_lucia,North America,185190,12,12921
2021-11-25,saint_lucia,North America,185190,6,12927
2021-11-26,saint_lucia,North America,185190,27,12954
2021-11-27,saint_lucia,North America,185190,0,12954
2021-11-28,saint_lucia,North America,185190,16,12970
2021-11-29,saint_lucia,North America,185190,19,12989
2021-11-30,saint_lucia,North America,185190,11,13000
2021-12-01,saint_lucia,North America,185190,17,13017
2021-12-02,saint_lucia,North America,185190,0,13017
2021-12-03,saint_lucia,North America,185190,10,13027
2021-12-04,saint_lucia,North America,185190,0,13027
2021-12-05,saint_lucia,North America,185190,7,13034
2021-12-06,saint_lucia,North America,185190,14,13048
2021-12-07,saint_lucia,North America,185190,4,13052
2021-12-08,saint_lucia,North America,185190,15,13067
2021-12-09,saint_lucia,North America,185190,0,13067
2021-12-10,saint_lucia,North America,185190,19,13086
2021-12-11,saint_lucia,North America,185190,12,13098
2021-12-12,saint_lucia,North America,185190,0,13098
2021-12-13,saint_lucia,North America,185190,2,13100
2021-12-14,saint_lucia,North America,185190,5,13105
2021-12-15,saint_lucia,North America,185190,10,13115
2021-12-16,saint_lucia,North America,185190,12,13127
2021-12-17,saint_lucia,North America,185190,9,13136
2021-12-18,saint_lucia,North America,185190,0,13136
2021-12-19,saint_lucia,North America,185190,13,13149
2021-12-20,saint_lucia,North America,185190,17,13166
2021-12-21,saint_lucia,North America,185190,11,13177
2021-12-22,saint_lucia,North America,185190,32,13209
2021-12-23,saint_lucia,North America,185190,16,13225
2021-12-24,saint_lucia,North America,185190,23,13248
2021-12-25,saint_lucia,North America,185190,27,13275
2021-12-26,saint_lucia,North America,185190,27,13302
2021-12-27,saint_lucia,North America,185190,17,13319
2021-12-28,saint_lucia,North America,185190,38,13357
2021-12-29,saint_lucia,North America,185190,53,13410
2021-12-30,saint_lucia,North America,185190,63,13473
2021-12-31,saint_lucia,North America,185190,97,13570
2022-01-01,saint_lucia,North America,185190,70,13640
2022-01-02,saint_lucia,North America,185190,92,13732
2022-01-03,saint_lucia,North America,185190,84,13816
2022-01-04,saint_lucia,North America,185190,65,13881
2022-01-05,saint_lucia,North America,185190,93,13974
2022-01-06,saint_lucia,North America,185190,258,14232
2022-01-07,saint_lucia,North America,185190,182,14414
2022-01-08,saint_lucia,North America,185190,240,14654
2022-01-09,saint_lucia,North America,185190,220,14874
2022-01-10,saint_lucia,North America,185190,227,15101
2022-01-11,saint_lucia,North America,185190,271,15372
2022-01-12,saint_lucia,North America,185190,565,15937
2022-01-13,saint_lucia,North America,185190,568,16505
2022-01-14,saint_lucia,North America,185190,464,16969
2022-01-15,saint_lucia,North America,185190,0,16969
2022-01-16,saint_lucia,North America,185190,281,17250
2022-01-17,saint_lucia,North America,185190,281,17531
2022-01-18,saint_lucia,North America,185190,135,17666
2022-01-19,saint_lucia,North America,185190,205,17871
2022-01-20,saint_lucia,North America,185190,451,18322
2022-01-21,saint_lucia,North America,185190,424,18746
2022-01-22,saint_lucia,North America,185190,722,19468
2022-01-23,saint_lucia,North America,185190,212,19680
2022-01-24,saint_lucia,North America,185190,75,19755
2022-01-25,saint_lucia,North America,185190,212,19967
2022-01-26,saint_lucia,North America,185190,225,20192
2022-01-27,saint_lucia,North America,185190,225,20417
2022-01-28,saint_lucia,North America,185190,0,20417
2022-01-29,saint_lucia,North America,185190,381,20798
2022-01-30,saint_lucia,North America,185190,111,20909
2022-01-31,saint_lucia,North America,185190,33,20942
2022-02-01,saint_lucia,North America,185190,0,20942
2022-02-02,saint_lucia,North America,185190,139,21081
2022-02-03,saint_lucia,North America,185190,318,21399
2022-02-04,saint_lucia,North America,185190,0,21399
2022-02-05,saint_lucia,North America,185190,114,21513
2022-02-06,saint_lucia,North America,185190,0,21513
2022-02-07,saint_lucia,North America,185190,22,21535
2022-02-08,saint_lucia,North America,185190,233,21768
2022-02-09,saint_lucia,North America,185190,63,21831
2022-02-10,saint_lucia,North America,185190,42,21873
2022-02-11,saint_lucia,North America,185190,59,21932
2022-02-12,saint_lucia,North America,185190,116,22048
2022-02-13,saint_lucia,North America,185190,0,22048
2022-02-14,saint_lucia,North America,185190,73,22121
2021-01-17,saint_vincent_and_the_grenadines,North America,111596,28,478
2021-01-18,saint_vincent_and_the_grenadines,North America,111596,16,494
2021-01-19,saint_vincent_and_the_grenadines,North America,111596,108,602
2021-01-20,saint_vincent_and_the_grenadines,North America,111596,53,655
2021-01-21,saint_vincent_and_the_grenadines,North America,111596,35,690
2021-01-22,saint_vincent_and_the_grenadines,North America,111596,0,690
2021-01-23,saint_vincent_and_the_grenadines,North America,111596,30,720
2021-01-24,saint_vincent_and_the_grenadines,North America,111596,18,738
2021-01-25,saint_vincent_and_the_grenadines,North America,111596,8,746
2021-01-26,saint_vincent_and_the_grenadines,North America,111596,17,763
2021-01-27,saint_vincent_and_the_grenadines,North America,111596,35,798
2021-01-28,saint_vincent_and_the_grenadines,North America,111596,29,827
2021-01-29,saint_vincent_and_the_grenadines,North America,111596,69,896
2021-01-30,saint_vincent_and_the_grenadines,North America,111596,0,896
2021-01-31,saint_vincent_and_the_grenadines,North America,111596,5,901
2021-02-01,saint_vincent_and_the_grenadines,North America,111596,50,951
2021-02-02,saint_vincent_and_the_grenadines,North America,111596,57,1008
2021-02-03,saint_vincent_and_the_grenadines,North America,111596,51,1059
2021-02-04,saint_vincent_and_the_grenadines,North America,111596,8,1067
2021-02-05,saint_vincent_and_the_grenadines,North America,111596,103,1170
2021-02-06,saint_vincent_and_the_grenadines,North America,111596,32,1202
2021-02-07,saint_vincent_and_the_grenadines,North America,111596,67,1269
2021-02-08,saint_vincent_and_the_grenadines,North America,111596,14,1283
2021-02-09,saint_vincent_and_the_grenadines,North America,111596,41,1324
2021-02-10,saint_vincent_and_the_grenadines,North America,111596,16,1340
2021-02-11,saint_vincent_and_the_grenadines,North America,111596,30,1370
2021-02-12,saint_vincent_and_the_grenadines,North America,111596,25,1395
2021-02-13,saint_vincent_and_the_grenadines,North America,111596,23,1418
2021-02-14,saint_vincent_and_the_grenadines,North America,111596,11,1429
2021-02-15,saint_vincent_and_the_grenadines,North America,111596,24,1453
2021-02-16,saint_vincent_and_the_grenadines,North America,111596,4,1457
2021-02-17,saint_vincent_and_the_grenadines,North America,111596,5,1462
2021-02-18,saint_vincent_and_the_grenadines,North America,111596,0,1462
2021-02-19,saint_vincent_and_the_grenadines,North America,111596,32,1494
2021-02-20,saint_vincent_and_the_grenadines,North America,111596,4,1498
2021-02-21,saint_vincent_and_the_grenadines,North America,111596,5,1503
2021-02-22,saint_vincent_and_the_grenadines,North America,111596,0,1503
2021-02-23,saint_vincent_and_the_grenadines,North America,111596,8,1511
2021-02-24,saint_vincent_and_the_grenadines,North America,111596,8,1519
2021-02-25,saint_vincent_and_the_grenadines,North America,111596,0,1519
2021-02-26,saint_vincent_and_the_grenadines,North America,111596,11,1530
2021-02-27,saint_vincent_and_the_grenadines,North America,111596,26,1556
2021-02-28,saint_vincent_and_the_grenadines,North America,111596,0,1556
2021-03-01,saint_vincent_and_the_grenadines,North America,111596,72,1628
2021-03-02,saint_vincent_and_the_grenadines,North America,111596,0,1628
2021-03-03,saint_vincent_and_the_grenadines,North America,111596,17,1645
2021-03-04,saint_vincent_and_the_grenadines,North America,111596,0,1645
2021-03-05,saint_vincent_and_the_grenadines,North America,111596,0,1645
2021-03-06,saint_vincent_and_the_grenadines,North America,111596,0,1645
2021-03-07,saint_vincent_and_the_grenadines,North America,111596,18,1663
2021-03-08,saint_vincent_and_the_grenadines,North America,111596,0,1663
2021-03-09,saint_vincent_and_the_grenadines,North America,111596,0,1663
2021-03-10,saint_vincent_and_the_grenadines,North America,111596,7,1670
2021-03-11,saint_vincent_and_the_grenadines,North America,111596,4,1674
2021-03-12,saint_vincent_and_the_grenadines,North America,111596,0,1674
2021-03-13,saint_vincent_and_the_grenadines,North America,111596,6,1680
2021-03-14,saint_vincent_and_the_grenadines,North America,111596,0,1680
2021-03-15,saint_vincent_and_the_grenadines,North America,111596,0,1680
2021-03-16,saint_vincent_and_the_grenadines,North America,111596,1,1681
2021-03-17,saint_vincent_and_the_grenadines,North America,111596,0,1681
2021-03-18,saint_vincent_and_the_grenadines,North America,111596,3,1684
2021-03-19,saint_vincent_and_the_grenadines,North America,111596,8,1692
2021-03-20,saint_vincent_and_the_grenadines,North America,111596,2,1694
2021-03-21,saint_vincent_and_the_grenadines,North America,111596,2,1696
2021-03-22,saint_vincent_and_the_grenadines,North America,111596,4,1700
2021-03-23,saint_vincent_and_the_grenadines,North America,111596,0,1700
2021-03-24,saint_vincent_and_the_grenadines,North America,111596,3,1703
2021-03-25,saint_vincent_and_the_grenadines,North America,111596,12,1715
2021-03-26,saint_vincent_and_the_grenadines,North America,111596,6,1721
2021-03-27,saint_vincent_and_the_grenadines,North America,111596,2,1723
2021-03-28,saint_vincent_and_the_grenadines,North America,111596,15,1738
2021-03-29,saint_vincent_and_the_grenadines,North America,111596,1,1739
2021-03-30,saint_vincent_and_the_grenadines,North America,111596,0,1739
2021-03-31,saint_vincent_and_the_grenadines,North America,111596,9,1748
2021-04-01,saint_vincent_and_the_grenadines,North America,111596,2,1750
2021-04-02,saint_vincent_and_the_grenadines,North America,111596,4,1754
2021-04-03,saint_vincent_and_the_grenadines,North America,111596,1,1755
2021-04-04,saint_vincent_and_the_grenadines,North America,111596,3,1758
2021-04-05,saint_vincent_and_the_grenadines,North America,111596,6,1764
2021-04-06,saint_vincent_and_the_grenadines,North America,111596,1,1765
2021-04-07,saint_vincent_and_the_grenadines,North America,111596,1,1766
2021-04-08,saint_vincent_and_the_grenadines,North America,111596,8,1774
2021-04-09,saint_vincent_and_the_grenadines,North America,111596,15,1789
2021-04-10,saint_vincent_and_the_grenadines,North America,111596,1,1790
2021-04-11,saint_vincent_and_the_grenadines,North America,111596,2,1792
2021-04-12,saint_vincent_and_the_grenadines,North America,111596,14,1806
2021-04-13,saint_vincent_and_the_grenadines,North America,111596,0,1806
2021-04-14,saint_vincent_and_the_grenadines,North America,111596,6,1812
2021-04-15,saint_vincent_and_the_grenadines,North America,111596,6,1818
2021-04-16,saint_vincent_and_the_grenadines,North America,111596,1,1819
2021-04-17,saint_vincent_and_the_grenadines,North America,111596,0,1819
2021-04-18,saint_vincent_and_the_grenadines,North America,111596,0,1819
2021-04-19,saint_vincent_and_the_grenadines,North America,111596,0,1819
2021-04-20,saint_vincent_and_the_grenadines,North America,111596,0,1819
2021-04-21,saint_vincent_and_the_grenadines,North America,111596,8,1827
2021-04-22,saint_vincent_and_the_grenadines,North America,111596,2,1829
2021-04-23,saint_vincent_and_the_grenadines,North America,111596,1,1830
2021-04-24,saint_vincent_and_the_grenadines,North America,111596,0,1830
2021-04-25,saint_vincent_and_the_grenadines,North America,111596,0,1830
2021-04-26,saint_vincent_and_the_grenadines,North America,111596,9,1839
2021-04-27,saint_vincent_and_the_grenadines,North America,111596,5,1844
2021-04-28,saint_vincent_and_the_grenadines,North America,111596,6,1850
2021-04-29,saint_vincent_and_the_grenadines,North America,111596,5,1855
2021-04-30,saint_vincent_and_the_grenadines,North America,111596,9,1864
2021-05-01,saint_vincent_and_the_grenadines,North America,111596,0,1864
2021-05-02,saint_vincent_and_the_grenadines,North America,111596,18,1882
2021-05-03,saint_vincent_and_the_grenadines,North America,111596,0,1882
2021-05-04,saint_vincent_and_the_grenadines,North America,111596,0,1882
2021-05-05,saint_vincent_and_the_grenadines,North America,111596,0,1882
2021-05-06,saint_vincent_and_the_grenadines,North America,111596,7,1889
2021-05-07,saint_vincent_and_the_grenadines,North America,111596,6,1895
2021-05-08,saint_vincent_and_the_grenadines,North America,111596,17,1912
2021-05-09,saint_vincent_and_the_grenadines,North America,111596,0,1912
2021-05-10,saint_vincent_and_the_grenadines,North America,111596,10,1922
2021-05-11,saint_vincent_and_the_grenadines,North America,111596,0,1922
2021-05-12,saint_vincent_and_the_grenadines,North America,111596,4,1926
2021-05-13,saint_vincent_and_the_grenadines,North America,111596,2,1928
2021-05-14,saint_vincent_and_the_grenadines,North America,111596,4,1932
2021-05-15,saint_vincent_and_the_grenadines,North America,111596,0,1932
2021-05-16,saint_vincent_and_the_grenadines,North America,111596,8,1940
2021-05-17,saint_vincent_and_the_grenadines,North America,111596,7,1947
2021-05-18,saint_vincent_and_the_grenadines,North America,111596,0,1947
2021-05-19,saint_vincent_and_the_grenadines,North America,111596,2,1949
2021-05-20,saint_vincent_and_the_grenadines,North America,111596,5,1954
2021-05-21,saint_vincent_and_the_grenadines,North America,111596,8,1962
2021-05-22,saint_vincent_and_the_grenadines,North America,111596,11,1973
2021-05-23,saint_vincent_and_the_grenadines,North America,111596,5,1978
2021-05-24,saint_vincent_and_the_grenadines,North America,111596,11,1989
2021-05-25,saint_vincent_and_the_grenadines,North America,111596,6,1995
2021-05-26,saint_vincent_and_the_grenadines,North America,111596,11,2006
2021-05-27,saint_vincent_and_the_grenadines,North America,111596,0,2006
2021-05-28,saint_vincent_and_the_grenadines,North America,111596,8,2014
2021-05-29,saint_vincent_and_the_grenadines,North America,111596,13,2027
2021-05-30,saint_vincent_and_the_grenadines,North America,111596,0,2027
2021-05-31,saint_vincent_and_the_grenadines,North America,111596,8,2035
2021-06-01,saint_vincent_and_the_grenadines,North America,111596,9,2044
2020-02-28,san_marino,Europe,34064,0,1
2020-02-29,san_marino,Europe,34064,0,1
2020-03-01,san_marino,Europe,34064,8,9
2020-03-02,san_marino,Europe,34064,0,9
2020-03-03,san_marino,Europe,34064,2,11
2020-03-04,san_marino,Europe,34064,6,17
2020-03-05,san_marino,Europe,34064,5,22
2020-03-06,san_marino,Europe,34064,2,24
2020-03-07,san_marino,Europe,34064,3,27
2020-03-08,san_marino,Europe,34064,10,37
2020-03-09,san_marino,Europe,34064,14,51
2020-03-10,san_marino,Europe,34064,11,62
2020-03-11,san_marino,Europe,34064,7,69
2020-03-12,san_marino,Europe,34064,3,72
2020-03-13,san_marino,Europe,34064,8,80
2020-03-14,san_marino,Europe,34064,21,101
2020-03-15,san_marino,Europe,34064,8,109
2020-03-16,san_marino,Europe,34064,0,109
2020-03-17,san_marino,Europe,34064,10,119
2020-03-18,san_marino,Europe,34064,21,140
2020-03-19,san_marino,Europe,34064,4,144
2020-03-20,san_marino,Europe,34064,7,151
2020-03-21,san_marino,Europe,34064,9,160
2020-03-22,san_marino,Europe,34064,15,175
2020-03-23,san_marino,Europe,34064,12,187
2020-03-24,san_marino,Europe,34064,0,187
2020-03-25,san_marino,Europe,34064,21,208
2020-03-26,san_marino,Europe,34064,0,208
2020-03-27,san_marino,Europe,34064,15,223
2020-03-28,san_marino,Europe,34064,1,224
2020-03-29,san_marino,Europe,34064,0,224
2020-03-30,san_marino,Europe,34064,6,230
2020-03-31,san_marino,Europe,34064,6,236
2020-04-01,san_marino,Europe,34064,0,236
2020-04-02,san_marino,Europe,34064,9,245
2020-04-03,san_marino,Europe,34064,6,251
2020-04-04,san_marino,Europe,34064,8,259
2020-04-05,san_marino,Europe,34064,7,266
2020-04-06,san_marino,Europe,34064,11,277
2020-04-07,san_marino,Europe,34064,2,279
2020-04-08,san_marino,Europe,34064,29,308
2020-04-09,san_marino,Europe,34064,25,333
2020-04-10,san_marino,Europe,34064,11,344
2020-04-11,san_marino,Europe,34064,12,356
2020-04-12,san_marino,Europe,34064,0,356
2020-04-13,san_marino,Europe,34064,15,371
2020-04-14,san_marino,Europe,34064,1,372
2020-04-15,san_marino,Europe,34064,21,393
2020-04-16,san_marino,Europe,34064,33,426
2020-04-17,san_marino,Europe,34064,9,435
2020-04-18,san_marino,Europe,34064,20,455
2020-04-19,san_marino,Europe,34064,6,461
2020-04-20,san_marino,Europe,34064,1,462
2020-04-21,san_marino,Europe,34064,14,476
2020-04-22,san_marino,Europe,34064,12,488
2020-04-23,san_marino,Europe,34064,13,501
2020-04-24,san_marino,Europe,34064,12,513
2020-04-25,san_marino,Europe,34064,0,513
2020-04-26,san_marino,Europe,34064,25,538
2020-04-27,san_marino,Europe,34064,0,538
2020-04-28,san_marino,Europe,34064,15,553
2020-04-29,san_marino,Europe,34064,10,563
2020-04-30,san_marino,Europe,34064,6,569
2020-05-01,san_marino,Europe,34064,11,580
2020-05-02,san_marino,Europe,34064,0,580
2020-05-03,san_marino,Europe,34064,2,582
2020-05-04,san_marino,Europe,34064,0,582
2020-05-05,san_marino,Europe,34064,7,589
2020-05-06,san_marino,Europe,34064,19,608
2020-05-07,san_marino,Europe,34064,14,622
2020-05-08,san_marino,Europe,34064,1,623
2020-05-09,san_marino,Europe,34064,5,628
2020-05-10,san_marino,Europe,34064,0,628
2020-05-11,san_marino,Europe,34064,0,628
2020-05-12,san_marino,Europe,34064,10,638
2020-05-13,san_marino,Europe,34064,5,643
2020-05-14,san_marino,Europe,34064,5,648
2020-05-15,san_marino,Europe,34064,4,652
2020-05-16,san_marino,Europe,34064,1,653
2020-05-17,san_marino,Europe,34064,1,654
2020-05-18,san_marino,Europe,34064,0,654
2020-05-19,san_marino,Europe,34064,1,655
2020-05-20,san_marino,Europe,34064,1,656
2020-05-21,san_marino,Europe,34064,2,658
2020-05-22,san_marino,Europe,34064,3,661
2020-05-23,san_marino,Europe,34064,4,665
2020-05-24,san_marino,Europe,34064,0,665
2020-05-25,san_marino,Europe,34064,1,666
2020-05-26,san_marino,Europe,34064,0,666
2020-05-27,san_marino,Europe,34064,1,667
2020-05-28,san_marino,Europe,34064,3,670
2020-05-29,san_marino,Europe,34064,1,671
2020-05-30,san_marino,Europe,34064,0,671
2020-05-31,san_marino,Europe,34064,0,671
2020-06-01,san_marino,Europe,34064,0,671
2020-06-02,san_marino,Europe,34064,1,672
2020-06-03,san_marino,Europe,34064,2,674
2020-06-04,san_marino,Europe,34064,4,678
2020-06-05,san_marino,Europe,34064,2,680
2020-06-06,san_marino,Europe,34064,0,680
2020-06-07,san_marino,Europe,34064,0,680
2020-06-08,san_marino,Europe,34064,7,687
2020-06-09,san_marino,Europe,34064,1,688
2020-06-10,san_marino,Europe,34064,3,691
2020-06-11,san_marino,Europe,34064,0,691
2020-06-12,san_marino,Europe,34064,3,694
2020-06-13,san_marino,Europe,34064,0,694
2020-06-14,san_marino,Europe,34064,0,694
2020-06-15,san_marino,Europe,34064,0,694
2020-06-16,san_marino,Europe,34064,0,694
2020-06-17,san_marino,Europe,34064,2,696
2020-06-18,san_marino,Europe,34064,0,696
2020-06-19,san_marino,Europe,34064,0,696
2020-06-20,san_marino,Europe,34064,0,696
2020-06-21,san_marino,Europe,34064,0,696
2020-06-22,san_marino,Europe,34064,1,697
2020-06-23,san_marino,Europe,34064,1,698
2020-06-24,san_marino,Europe,34064,0,698
2020-06-25,san_marino,Europe,34064,0,698
2020-06-26,san_marino,Europe,34064,0,698
2020-06-27,san_marino,Europe,34064,0,698
2020-06-28,san_marino,Europe,34064,0,698
2020-06-29,san_marino,Europe,34064,0,698
2020-06-30,san_marino,Europe,34064,0,698
2020-07-01,san_marino,Europe,34064,0,698
2020-07-02,san_marino,Europe,34064,0,698
2020-07-03,san_marino,Europe,34064,0,698
2020-07-04,san_marino,Europe,34064,0,698
2020-07-05,san_marino,Europe,34064,0,698
2020-07-06,san_marino,Europe,34064,0,698
2020-07-07,san_marino,Europe,34064,0,698
2020-07-08,san_marino,Europe,34064,0,698
2020-07-09,san_marino,Europe,34064,1,699
2020-07-10,san_marino,Europe,34064,0,699
2020-07-11,san_marino,Europe,34064,0,699
2020-07-12,san_marino,Europe,34064,0,699
2020-07-13,san_marino,Europe,34064,0,699
2020-07-14,san_marino,Europe,34064,0,699
2020-07-15,san_marino,Europe,34064,0,699
2020-07-16,san_marino,Europe,34064,0,699
2020-07-17,san_marino,Europe,34064,0,699
2020-07-18,san_marino,Europe,34064,0,699
2020-07-19,san_marino,Europe,34064,0,699
2020-07-20,san_marino,Europe,34064,0,699
2020-07-21,san_marino,Europe,34064,0,699
2020-07-22,san_marino,Europe,34064,0,699
2020-07-23,san_marino,Europe,34064,0,699
2020-07-24,san_marino,Europe,34064,0,699
2020-07-25,san_marino,Europe,34064,0,699
2020-07-26,san_marino,Europe,34064,0,699
2020-07-27,san_marino,Europe,34064,0,699
2020-07-28,san_marino,Europe,34064,0,699
2020-07-29,san_marino,Europe,34064,0,699
2020-07-30,san_marino,Europe,34064,0,699
2020-07-31,san_marino,Europe,34064,0,699
2020-08-01,san_marino,Europe,34064,0,699
2020-08-02,san_marino,Europe,34064,0,699
2020-08-03,san_marino,Europe,34064,0,699
2020-08-04,san_marino,Europe,34064,0,699
2020-08-05,san_marino,Europe,34064,0,699
2020-08-06,san_marino,Europe,34064,0,699
2020-08-07,san_marino,Europe,34064,0,699
2020-08-08,san_marino,Europe,34064,0,699
2020-08-09,san_marino,Europe,34064,0,699
2020-08-10,san_marino,Europe,34064,0,699
2020-08-11,san_marino,Europe,34064,0,699
2020-08-12,san_marino,Europe,34064,0,699
2020-08-13,san_marino,Europe,34064,0,699
2020-08-14,san_marino,Europe,34064,0,699
2020-08-15,san_marino,Europe,34064,0,699
2020-08-16,san_marino,Europe,34064,0,699
2020-08-17,san_marino,Europe,34064,0,699
2020-08-18,san_marino,Europe,34064,3,702
2020-08-19,san_marino,Europe,34064,2,704
2020-08-20,san_marino,Europe,34064,0,704
2020-08-21,san_marino,Europe,34064,0,704
2020-08-22,san_marino,Europe,34064,0,704
2020-08-23,san_marino,Europe,34064,0,704
2020-08-24,san_marino,Europe,34064,0,704
2020-08-25,san_marino,Europe,34064,6,710
2020-08-26,san_marino,Europe,34064,0,710
2020-08-27,san_marino,Europe,34064,0,710
2020-08-28,san_marino,Europe,34064,0,710
2020-08-29,san_marino,Europe,34064,0,710
2020-08-30,san_marino,Europe,34064,0,710
2020-08-31,san_marino,Europe,34064,5,715
2020-09-01,san_marino,Europe,34064,0,715
2020-09-02,san_marino,Europe,34064,0,715
2020-09-03,san_marino,Europe,34064,0,715
2020-09-04,san_marino,Europe,34064,0,715
2020-09-05,san_marino,Europe,34064,1,716
2020-09-06,san_marino,Europe,34064,0,716
2020-09-07,san_marino,Europe,34064,0,716
2020-09-08,san_marino,Europe,34064,0,716
2020-09-09,san_marino,Europe,34064,6,722
2020-09-10,san_marino,Europe,34064,0,722
2020-09-11,san_marino,Europe,34064,0,722
2020-09-12,san_marino,Europe,34064,0,722
2020-09-13,san_marino,Europe,34064,0,722
2020-09-14,san_marino,Europe,34064,0,722
2020-09-15,san_marino,Europe,34064,1,723
2020-09-16,san_marino,Europe,34064,0,723
2020-09-17,san_marino,Europe,34064,0,723
2020-09-18,san_marino,Europe,34064,0,723
2020-09-19,san_marino,Europe,34064,0,723
2020-09-20,san_marino,Europe,34064,0,723
2020-09-21,san_marino,Europe,34064,0,723
2020-09-22,san_marino,Europe,34064,0,723
2020-09-23,san_marino,Europe,34064,0,723
2020-09-24,san_marino,Europe,34064,4,727
2020-09-25,san_marino,Europe,34064,0,727
2020-09-26,san_marino,Europe,34064,0,727
2020-09-27,san_marino,Europe,34064,0,727
2020-09-28,san_marino,Europe,34064,0,727
2020-09-29,san_marino,Europe,34064,0,727
2020-09-30,san_marino,Europe,34064,5,732
2020-10-01,san_marino,Europe,34064,0,732
2020-10-02,san_marino,Europe,34064,0,732
2020-10-03,san_marino,Europe,34064,0,732
2020-10-04,san_marino,Europe,34064,0,732
2020-10-05,san_marino,Europe,34064,0,732
2020-10-06,san_marino,Europe,34064,0,732
2020-10-07,san_marino,Europe,34064,0,732
2020-10-08,san_marino,Europe,34064,9,741
2020-10-09,san_marino,Europe,34064,0,741
2020-10-10,san_marino,Europe,34064,0,741
2020-10-11,san_marino,Europe,34064,0,741
2020-10-12,san_marino,Europe,34064,0,741
2020-10-13,san_marino,Europe,34064,0,741
2020-10-14,san_marino,Europe,34064,0,741
2020-10-15,san_marino,Europe,34064,18,759
2020-10-16,san_marino,Europe,34064,0,759
2020-10-17,san_marino,Europe,34064,0,759
2020-10-18,san_marino,Europe,34064,0,759
2020-10-19,san_marino,Europe,34064,7,766
2020-10-20,san_marino,Europe,34064,0,766
2020-10-21,san_marino,Europe,34064,8,774
2020-10-22,san_marino,Europe,34064,28,802
2020-10-23,san_marino,Europe,34064,17,819
2020-10-24,san_marino,Europe,34064,0,819
2020-10-25,san_marino,Europe,34064,0,819
2020-10-26,san_marino,Europe,34064,33,852
2020-10-27,san_marino,Europe,34064,0,852
2020-10-28,san_marino,Europe,34064,0,852
2020-10-29,san_marino,Europe,34064,76,928
2020-10-30,san_marino,Europe,34064,0,928
2020-10-31,san_marino,Europe,34064,0,928
2020-11-01,san_marino,Europe,34064,0,928
2020-11-02,san_marino,Europe,34064,0,928
2020-11-03,san_marino,Europe,34064,66,994
2020-11-04,san_marino,Europe,34064,0,994
2020-11-05,san_marino,Europe,34064,49,1043
2020-11-06,san_marino,Europe,34064,0,1043
2020-11-07,san_marino,Europe,34064,0,1043
2020-11-08,san_marino,Europe,34064,0,1043
2020-11-09,san_marino,Europe,34064,71,1114
2020-11-10,san_marino,Europe,34064,0,1114
2020-11-11,san_marino,Europe,34064,76,1190
2020-11-12,san_marino,Europe,34064,0,1190
2020-11-13,san_marino,Europe,34064,63,1253
2020-11-14,san_marino,Europe,34064,0,1253
2020-11-15,san_marino,Europe,34064,0,1253
2020-11-16,san_marino,Europe,34064,37,1290
2020-11-17,san_marino,Europe,34064,0,1290
2020-11-18,san_marino,Europe,34064,68,1358
2020-11-19,san_marino,Europe,34064,0,1358
2020-11-20,san_marino,Europe,34064,37,1395
2020-11-21,san_marino,Europe,34064,0,1395
2020-11-22,san_marino,Europe,34064,0,1395
2020-11-23,san_marino,Europe,34064,33,1428
2020-11-24,san_marino,Europe,34064,0,1428
2020-11-25,san_marino,Europe,34064,64,1492
2020-11-26,san_marino,Europe,34064,22,1514
2020-11-27,san_marino,Europe,34064,40,1554
2020-11-28,san_marino,Europe,34064,32,1586
2020-11-29,san_marino,Europe,34064,0,1586
2020-11-30,san_marino,Europe,34064,26,1612
2020-12-01,san_marino,Europe,34064,38,1650
2020-12-02,san_marino,Europe,34064,37,1687
2020-12-03,san_marino,Europe,34064,27,1714
2020-12-04,san_marino,Europe,34064,42,1756
2020-12-05,san_marino,Europe,34064,33,1789
2020-12-06,san_marino,Europe,34064,0,1789
2020-12-07,san_marino,Europe,34064,11,1800
2020-12-08,san_marino,Europe,34064,0,1800
2020-12-09,san_marino,Europe,34064,34,1834
2020-12-10,san_marino,Europe,34064,34,1868
2020-12-11,san_marino,Europe,34064,40,1908
2020-12-12,san_marino,Europe,34064,24,1932
2020-12-13,san_marino,Europe,34064,0,1932
2020-12-14,san_marino,Europe,34064,2,1934
2020-12-15,san_marino,Europe,34064,48,1982
2020-12-16,san_marino,Europe,34064,43,2025
2020-12-17,san_marino,Europe,34064,24,2049
2020-12-18,san_marino,Europe,34064,23,2072
2020-12-19,san_marino,Europe,34064,35,2107
2020-12-20,san_marino,Europe,34064,0,2107
2020-12-21,san_marino,Europe,34064,29,2136
2020-12-22,san_marino,Europe,34064,39,2175
2020-12-23,san_marino,Europe,34064,33,2208
2020-12-24,san_marino,Europe,34064,23,2231
2020-12-25,san_marino,Europe,34064,0,2231
2020-12-26,san_marino,Europe,34064,0,2231
2020-12-27,san_marino,Europe,34064,0,2231
2020-12-28,san_marino,Europe,34064,44,2275
2020-12-29,san_marino,Europe,34064,58,2333
2020-12-30,san_marino,Europe,34064,51,2384
2020-12-31,san_marino,Europe,34064,44,2428
2021-01-01,san_marino,Europe,34064,0,2428
2021-01-02,san_marino,Europe,34064,0,2428
2021-01-03,san_marino,Europe,34064,0,2428
2021-01-04,san_marino,Europe,34064,65,2493
2021-01-05,san_marino,Europe,34064,56,2549
2021-01-06,san_marino,Europe,34064,0,2549
2021-01-07,san_marino,Europe,34064,34,2583
2021-01-08,san_marino,Europe,34064,45,2628
2021-01-09,san_marino,Europe,34064,0,2628
2021-01-10,san_marino,Europe,34064,0,2628
2021-01-11,san_marino,Europe,34064,39,2667
2021-01-12,san_marino,Europe,34064,39,2706
2021-01-13,san_marino,Europe,34064,17,2723
2021-01-14,san_marino,Europe,34064,15,2738
2021-01-15,san_marino,Europe,34064,29,2767
2021-01-16,san_marino,Europe,34064,11,2778
2021-01-17,san_marino,Europe,34064,0,2778
2021-01-18,san_marino,Europe,34064,10,2788
2021-01-19,san_marino,Europe,34064,15,2803
2021-01-20,san_marino,Europe,34064,13,2816
2021-01-21,san_marino,Europe,34064,21,2837
2021-01-22,san_marino,Europe,34064,24,2861
2021-01-23,san_marino,Europe,34064,13,2874
2021-01-24,san_marino,Europe,34064,0,2874
2021-01-25,san_marino,Europe,34064,15,2889
2021-01-26,san_marino,Europe,34064,26,2915
2021-01-27,san_marino,Europe,34064,28,2943
2021-01-28,san_marino,Europe,34064,26,2969
2021-01-29,san_marino,Europe,34064,27,2996
2021-01-30,san_marino,Europe,34064,0,2996
2021-01-31,san_marino,Europe,34064,29,3025
2021-02-01,san_marino,Europe,34064,0,3025
2021-02-02,san_marino,Europe,34064,41,3066
2021-02-03,san_marino,Europe,34064,28,3094
2021-02-04,san_marino,Europe,34064,17,3111
2021-02-05,san_marino,Europe,34064,0,3111
2021-02-06,san_marino,Europe,34064,16,3127
2021-02-07,san_marino,Europe,34064,0,3127
2021-02-08,san_marino,Europe,34064,10,3137
2021-02-09,san_marino,Europe,34064,50,3187
2021-02-10,san_marino,Europe,34064,26,3213
2021-02-11,san_marino,Europe,34064,34,3247
2021-02-12,san_marino,Europe,34064,31,3278
2021-02-13,san_marino,Europe,34064,0,3278
2021-02-14,san_marino,Europe,34064,0,3278
2021-02-15,san_marino,Europe,34064,39,3317
2021-02-16,san_marino,Europe,34064,35,3352
2021-02-17,san_marino,Europe,34064,42,3394
2021-02-18,san_marino,Europe,34064,26,3420
2021-02-19,san_marino,Europe,34064,20,3440
2021-02-20,san_marino,Europe,34064,32,3472
2021-02-21,san_marino,Europe,34064,0,3472
2021-02-22,san_marino,Europe,34064,22,3494
2021-02-23,san_marino,Europe,34064,44,3538
2021-02-24,san_marino,Europe,34064,48,3586
2021-02-25,san_marino,Europe,34064,38,3624
2021-02-26,san_marino,Europe,34064,52,3676
2021-02-27,san_marino,Europe,34064,40,3716
2021-02-28,san_marino,Europe,34064,0,3716
2021-03-01,san_marino,Europe,34064,30,3746
2021-03-02,san_marino,Europe,34064,45,3791
2021-03-03,san_marino,Europe,34064,38,3829
2021-03-04,san_marino,Europe,34064,38,3867
2021-03-05,san_marino,Europe,34064,29,3896
2021-03-06,san_marino,Europe,34064,26,3922
2021-03-07,san_marino,Europe,34064,0,3922
2021-03-08,san_marino,Europe,34064,16,3938
2021-03-09,san_marino,Europe,34064,46,3984
2021-03-10,san_marino,Europe,34064,46,4030
2021-03-11,san_marino,Europe,34064,33,4063
2021-03-12,san_marino,Europe,34064,33,4096
2021-03-13,san_marino,Europe,34064,53,4149
2021-03-14,san_marino,Europe,34064,1,4150
2021-03-15,san_marino,Europe,34064,4,4154
2021-03-16,san_marino,Europe,34064,50,4204
2021-03-17,san_marino,Europe,34064,47,4251
2021-03-18,san_marino,Europe,34064,41,4292
2021-03-19,san_marino,Europe,34064,39,4331
2021-03-20,san_marino,Europe,34064,27,4358
2021-03-21,san_marino,Europe,34064,27,4385
2021-03-22,san_marino,Europe,34064,5,4390
2021-03-23,san_marino,Europe,34064,46,4436
2021-03-24,san_marino,Europe,34064,48,4484
2021-03-25,san_marino,Europe,34064,0,4484
2021-03-26,san_marino,Europe,34064,64,4548
2021-03-27,san_marino,Europe,34064,55,4603
2021-03-28,san_marino,Europe,34064,22,4625
2021-03-29,san_marino,Europe,34064,6,4631
2021-03-30,san_marino,Europe,34064,50,4681
2021-03-31,san_marino,Europe,34064,50,4731
2021-04-01,san_marino,Europe,34064,57,4788
2021-04-02,san_marino,Europe,34064,6,4794
2021-04-03,san_marino,Europe,34064,48,4842
2021-04-04,san_marino,Europe,34064,16,4858
2021-04-05,san_marino,Europe,34064,3,4861
2021-04-06,san_marino,Europe,34064,4,4865
2021-04-07,san_marino,Europe,34064,41,4906
2021-04-08,san_marino,Europe,34064,27,4933
2021-04-09,san_marino,Europe,34064,11,4944
2021-04-10,san_marino,Europe,34064,15,4959
2021-04-11,san_marino,Europe,34064,6,4965
2021-04-12,san_marino,Europe,34064,0,4965
2021-04-13,san_marino,Europe,34064,21,4986
2021-04-14,san_marino,Europe,34064,19,5005
2021-04-15,san_marino,Europe,34064,7,5012
2021-04-16,san_marino,Europe,34064,6,5018
2021-04-17,san_marino,Europe,34064,8,5026
2021-04-18,san_marino,Europe,34064,4,5030
2021-04-19,san_marino,Europe,34064,2,5032
2021-04-20,san_marino,Europe,34064,9,5041
2021-04-21,san_marino,Europe,34064,3,5044
2021-04-22,san_marino,Europe,34064,2,5046
2021-04-23,san_marino,Europe,34064,1,5047
2021-04-24,san_marino,Europe,34064,5,5052
2021-04-25,san_marino,Europe,34064,3,5055
2021-04-26,san_marino,Europe,34064,0,5055
2021-04-27,san_marino,Europe,34064,3,5058
2021-04-28,san_marino,Europe,34064,1,5059
2021-04-29,san_marino,Europe,34064,1,5060
2021-04-30,san_marino,Europe,34064,6,5066
2021-05-01,san_marino,Europe,34064,1,5067
2021-05-02,san_marino,Europe,34064,0,5067
2021-05-03,san_marino,Europe,34064,0,5067
2021-05-04,san_marino,Europe,34064,0,5067
2021-05-05,san_marino,Europe,34064,0,5067
2021-05-06,san_marino,Europe,34064,0,5067
2021-05-07,san_marino,Europe,34064,0,5067
2021-05-08,san_marino,Europe,34064,0,5067
2021-05-09,san_marino,Europe,34064,0,5067
2021-05-10,san_marino,Europe,34064,16,5083
2021-05-11,san_marino,Europe,34064,0,5083
2021-05-12,san_marino,Europe,34064,0,5083
2021-05-13,san_marino,Europe,34064,0,5083
2021-05-14,san_marino,Europe,34064,0,5083
2021-05-15,san_marino,Europe,34064,0,5083
2021-05-16,san_marino,Europe,34064,0,5083
2021-05-17,san_marino,Europe,34064,4,5087
2021-05-18,san_marino,Europe,34064,0,5087
2021-05-19,san_marino,Europe,34064,0,5087
2021-05-20,san_marino,Europe,34064,0,5087
2021-05-21,san_marino,Europe,34064,0,5087
2021-05-22,san_marino,Europe,34064,0,5087
2021-05-23,san_marino,Europe,34064,0,5087
2021-05-24,san_marino,Europe,34064,2,5089
2021-05-25,san_marino,Europe,34064,0,5089
2021-05-26,san_marino,Europe,34064,0,5089
2021-05-27,san_marino,Europe,34064,0,5089
2021-05-28,san_marino,Europe,34064,0,5089
2021-05-29,san_marino,Europe,34064,0,5089
2021-05-30,san_marino,Europe,34064,0,5089
2021-05-31,san_marino,Europe,34064,1,5090
2021-06-01,san_marino,Europe,34064,0,5090
2021-06-02,san_marino,Europe,34064,0,5090
2021-06-03,san_marino,Europe,34064,0,5090
2021-06-04,san_marino,Europe,34064,0,5090
2021-06-05,san_marino,Europe,34064,0,5090
2021-06-06,san_marino,Europe,34064,0,5090
2021-06-07,san_marino,Europe,34064,0,5090
2021-06-08,san_marino,Europe,34064,0,5090
2021-06-09,san_marino,Europe,34064,0,5090
2021-06-10,san_marino,Europe,34064,0,5090
2021-06-11,san_marino,Europe,34064,0,5090
2021-06-12,san_marino,Europe,34064,0,5090
2021-06-13,san_marino,Europe,34064,0,5090
2021-06-14,san_marino,Europe,34064,0,5090
2021-06-15,san_marino,Europe,34064,0,5090
2021-06-16,san_marino,Europe,34064,0,5090
2021-06-17,san_marino,Europe,34064,0,5090
2021-06-18,san_marino,Europe,34064,0,5090
2021-06-19,san_marino,Europe,34064,0,5090
2021-06-20,san_marino,Europe,34064,0,5090
2021-06-21,san_marino,Europe,34064,0,5090
2021-06-22,san_marino,Europe,34064,0,5090
2021-06-23,san_marino,Europe,34064,0,5090
2021-06-24,san_marino,Europe,34064,0,5090
2021-06-25,san_marino,Europe,34064,0,5090
2021-06-26,san_marino,Europe,34064,0,5090
2021-06-27,san_marino,Europe,34064,0,5090
2021-06-28,san_marino,Europe,34064,1,5091
2021-06-29,san_marino,Europe,34064,0,5091
2021-06-30,san_marino,Europe,34064,0,5091
2021-07-01,san_marino,Europe,34064,0,5091
2021-07-02,san_marino,Europe,34064,0,5091
2021-07-03,san_marino,Europe,34064,0,5091
2021-07-04,san_marino,Europe,34064,0,5091
2021-07-05,san_marino,Europe,34064,1,5092
2021-07-06,san_marino,Europe,34064,0,5092
2021-07-07,san_marino,Europe,34064,0,5092
2021-07-08,san_marino,Europe,34064,0,5092
2021-07-09,san_marino,Europe,34064,0,5092
2021-07-10,san_marino,Europe,34064,0,5092
2021-07-11,san_marino,Europe,34064,0,5092
2021-07-12,san_marino,Europe,34064,0,5092
2021-07-13,san_marino,Europe,34064,2,5094
2021-07-14,san_marino,Europe,34064,0,5094
2021-07-15,san_marino,Europe,34064,0,5094
2021-07-16,san_marino,Europe,34064,0,5094
2021-07-17,san_marino,Europe,34064,0,5094
2021-07-18,san_marino,Europe,34064,0,5094
2021-07-19,san_marino,Europe,34064,5,5099
2021-07-20,san_marino,Europe,34064,0,5099
2021-07-21,san_marino,Europe,34064,0,5099
2021-07-22,san_marino,Europe,34064,0,5099
2021-07-23,san_marino,Europe,34064,0,5099
2021-07-24,san_marino,Europe,34064,0,5099
2021-07-25,san_marino,Europe,34064,0,5099
2021-07-26,san_marino,Europe,34064,31,5130
2021-07-27,san_marino,Europe,34064,0,5130
2021-07-28,san_marino,Europe,34064,0,5130
2021-07-29,san_marino,Europe,34064,0,5130
2021-07-30,san_marino,Europe,34064,0,5130
2021-07-31,san_marino,Europe,34064,0,5130
2021-08-01,san_marino,Europe,34064,21,5151
2021-08-02,san_marino,Europe,34064,19,5170
2021-08-03,san_marino,Europe,34064,10,5180
2021-08-04,san_marino,Europe,34064,1,5181
2021-08-05,san_marino,Europe,34064,3,5184
2021-08-06,san_marino,Europe,34064,8,5192
2021-08-07,san_marino,Europe,34064,2,5194
2021-08-08,san_marino,Europe,34064,2,5196
2021-08-09,san_marino,Europe,34064,13,5209
2021-08-10,san_marino,Europe,34064,3,5212
2021-08-11,san_marino,Europe,34064,6,5218
2021-08-12,san_marino,Europe,34064,6,5224
2021-08-13,san_marino,Europe,34064,6,5230
2021-08-14,san_marino,Europe,34064,1,5231
2021-08-15,san_marino,Europe,34064,0,5231
2021-08-16,san_marino,Europe,34064,2,5233
2021-08-17,san_marino,Europe,34064,7,5240
2021-08-18,san_marino,Europe,34064,5,5245
2021-08-19,san_marino,Europe,34064,5,5250
2021-08-20,san_marino,Europe,34064,5,5255
2021-08-21,san_marino,Europe,34064,4,5259
2021-08-22,san_marino,Europe,34064,1,5260
2021-08-23,san_marino,Europe,34064,6,5266
2021-08-24,san_marino,Europe,34064,17,5283
2021-08-25,san_marino,Europe,34064,10,5293
2021-08-26,san_marino,Europe,34064,12,5305
2021-08-27,san_marino,Europe,34064,9,5314
2021-08-28,san_marino,Europe,34064,7,5321
2021-08-29,san_marino,Europe,34064,0,5321
2021-08-30,san_marino,Europe,34064,0,5321
2021-08-31,san_marino,Europe,34064,0,5321
2021-09-01,san_marino,Europe,34064,0,5321
2021-09-02,san_marino,Europe,34064,0,5321
2021-09-03,san_marino,Europe,34064,0,5321
2021-09-04,san_marino,Europe,34064,0,5321
2021-09-05,san_marino,Europe,34064,2,5323
2021-09-06,san_marino,Europe,34064,28,5351
2021-09-07,san_marino,Europe,34064,0,5351
2021-09-08,san_marino,Europe,34064,0,5351
2021-09-09,san_marino,Europe,34064,0,5351
2021-09-10,san_marino,Europe,34064,0,5351
2021-09-11,san_marino,Europe,34064,0,5351
2021-09-12,san_marino,Europe,34064,0,5351
2021-09-13,san_marino,Europe,34064,37,5388
2021-09-14,san_marino,Europe,34064,2,5390
2021-09-15,san_marino,Europe,34064,0,5390
2021-09-16,san_marino,Europe,34064,0,5390
2021-09-17,san_marino,Europe,34064,0,5390
2021-09-18,san_marino,Europe,34064,0,5390
2021-09-19,san_marino,Europe,34064,0,5390
2021-09-20,san_marino,Europe,34064,29,5419
2021-09-21,san_marino,Europe,34064,0,5419
2021-09-22,san_marino,Europe,34064,0,5419
2021-09-23,san_marino,Europe,34064,0,5419
2021-09-24,san_marino,Europe,34064,0,5419
2021-09-25,san_marino,Europe,34064,0,5419
2021-09-26,san_marino,Europe,34064,0,5419
2021-09-27,san_marino,Europe,34064,12,5431
2021-09-28,san_marino,Europe,34064,0,5431
2021-09-29,san_marino,Europe,34064,0,5431
2021-09-30,san_marino,Europe,34064,0,5431
2021-10-01,san_marino,Europe,34064,0,5431
2021-10-02,san_marino,Europe,34064,0,5431
2021-10-03,san_marino,Europe,34064,0,5431
2021-10-04,san_marino,Europe,34064,13,5444
2021-10-05,san_marino,Europe,34064,0,5444
2021-10-06,san_marino,Europe,34064,0,5444
2021-10-07,san_marino,Europe,34064,0,5444
2021-10-08,san_marino,Europe,34064,0,5444
2021-10-09,san_marino,Europe,34064,0,5444
2021-10-10,san_marino,Europe,34064,0,5444
2021-10-11,san_marino,Europe,34064,26,5470
2021-10-12,san_marino,Europe,34064,0,5470
2021-10-13,san_marino,Europe,34064,0,5470
2021-10-14,san_marino,Europe,34064,0,5470
2021-10-15,san_marino,Europe,34064,0,5470
2021-10-16,san_marino,Europe,34064,0,5470
2021-10-17,san_marino,Europe,34064,0,5470
2021-10-18,san_marino,Europe,34064,5,5475
2021-10-19,san_marino,Europe,34064,0,5475
2021-10-20,san_marino,Europe,34064,0,5475
2021-10-21,san_marino,Europe,34064,0,5475
2021-10-22,san_marino,Europe,34064,0,5475
2021-10-23,san_marino,Europe,34064,0,5475
2021-10-24,san_marino,Europe,34064,0,5475
2021-10-25,san_marino,Europe,34064,34,5509
2021-10-26,san_marino,Europe,34064,0,5509
2021-10-27,san_marino,Europe,34064,0,5509
2021-10-28,san_marino,Europe,34064,0,5509
2020-03-03,saudi_arabia,Asia,35823522,0,1
2020-03-04,saudi_arabia,Asia,35823522,1,2
2020-03-05,saudi_arabia,Asia,35823522,3,5
2020-03-06,saudi_arabia,Asia,35823522,0,5
2020-03-07,saudi_arabia,Asia,35823522,2,7
2020-03-08,saudi_arabia,Asia,35823522,4,11
2020-03-09,saudi_arabia,Asia,35823522,9,20
2020-03-10,saudi_arabia,Asia,35823522,0,20
2020-03-11,saudi_arabia,Asia,35823522,25,45
2020-03-12,saudi_arabia,Asia,35823522,0,45
2020-03-13,saudi_arabia,Asia,35823522,41,86
2020-03-14,saudi_arabia,Asia,35823522,17,103
2020-03-15,saudi_arabia,Asia,35823522,15,118
2020-03-16,saudi_arabia,Asia,35823522,15,133
2020-03-17,saudi_arabia,Asia,35823522,38,171
2020-03-18,saudi_arabia,Asia,35823522,67,238
2020-03-19,saudi_arabia,Asia,35823522,36,274
2020-03-20,saudi_arabia,Asia,35823522,70,344
2020-03-21,saudi_arabia,Asia,35823522,48,392
2020-03-22,saudi_arabia,Asia,35823522,119,511
2020-03-23,saudi_arabia,Asia,35823522,51,562
2020-03-24,saudi_arabia,Asia,35823522,205,767
2020-03-25,saudi_arabia,Asia,35823522,133,900
2020-03-26,saudi_arabia,Asia,35823522,112,1012
2020-03-27,saudi_arabia,Asia,35823522,92,1104
2020-03-28,saudi_arabia,Asia,35823522,99,1203
2020-03-29,saudi_arabia,Asia,35823522,96,1299
2020-03-30,saudi_arabia,Asia,35823522,154,1453
2020-03-31,saudi_arabia,Asia,35823522,110,1563
2020-04-01,saudi_arabia,Asia,35823522,157,1720
2020-04-02,saudi_arabia,Asia,35823522,165,1885
2020-04-03,saudi_arabia,Asia,35823522,154,2039
2020-04-04,saudi_arabia,Asia,35823522,140,2179
2020-04-05,saudi_arabia,Asia,35823522,223,2402
2020-04-06,saudi_arabia,Asia,35823522,203,2605
2020-04-07,saudi_arabia,Asia,35823522,190,2795
2020-04-08,saudi_arabia,Asia,35823522,137,2932
2020-04-09,saudi_arabia,Asia,35823522,355,3287
2020-04-10,saudi_arabia,Asia,35823522,364,3651
2020-04-11,saudi_arabia,Asia,35823522,382,4033
2020-04-12,saudi_arabia,Asia,35823522,429,4462
2020-04-13,saudi_arabia,Asia,35823522,472,4934
2020-04-14,saudi_arabia,Asia,35823522,435,5369
2020-04-15,saudi_arabia,Asia,35823522,493,5862
2020-04-16,saudi_arabia,Asia,35823522,518,6380
2020-04-17,saudi_arabia,Asia,35823522,762,7142
2020-04-18,saudi_arabia,Asia,35823522,1132,8274
2020-04-19,saudi_arabia,Asia,35823522,1088,9362
2020-04-20,saudi_arabia,Asia,35823522,1122,10484
2020-04-21,saudi_arabia,Asia,35823522,1147,11631
2020-04-22,saudi_arabia,Asia,35823522,1141,12772
2020-04-23,saudi_arabia,Asia,35823522,1158,13930
2020-04-24,saudi_arabia,Asia,35823522,1172,15102
2020-04-25,saudi_arabia,Asia,35823522,1197,16299
2020-04-26,saudi_arabia,Asia,35823522,1223,17522
2020-04-27,saudi_arabia,Asia,35823522,1289,18811
2020-04-28,saudi_arabia,Asia,35823522,1266,20077
2020-04-29,saudi_arabia,Asia,35823522,1325,21402
2020-04-30,saudi_arabia,Asia,35823522,1351,22753
2020-03-03,senegal,Africa,17565349,1,2
2020-03-04,senegal,Africa,17565349,2,4
2020-03-05,senegal,Africa,17565349,0,4
2020-03-06,senegal,Africa,17565349,0,4
2020-03-07,senegal,Africa,17565349,0,4
2020-03-08,senegal,Africa,17565349,0,4
2020-03-09,senegal,Africa,17565349,0,4
2020-03-10,senegal,Africa,17565349,0,4
2020-03-11,senegal,Africa,17565349,0,4
2020-03-12,senegal,Africa,17565349,6,10
2020-03-13,senegal,Africa,17565349,11,21
2020-03-14,senegal,Africa,17565349,3,24
2020-03-15,senegal,Africa,17565349,0,24
2020-03-16,senegal,Africa,17565349,3,27
2020-03-17,senegal,Africa,17565349,0,27
2020-03-18,senegal,Africa,17565349,9,36
2020-03-19,senegal,Africa,17565349,0,36
2020-03-20,senegal,Africa,17565349,11,47
2020-03-21,senegal,Africa,17565349,9,56
2020-03-22,senegal,Africa,17565349,11,67
2020-03-23,senegal,Africa,17565349,12,79
2020-03-24,senegal,Africa,17565349,7,86
2020-03-25,senegal,Africa,17565349,13,99
2020-03-26,senegal,Africa,17565349,6,105
2020-03-27,senegal,Africa,17565349,14,119
2020-03-28,senegal,Africa,17565349,11,130
2020-03-29,senegal,Africa,17565349,12,142
2020-03-30,senegal,Africa,17565349,20,162
2020-03-31,senegal,Africa,17565349,13,175
2020-04-01,senegal,Africa,17565349,15,190
2020-04-02,senegal,Africa,17565349,5,195
2020-04-03,senegal,Africa,17565349,12,207
2020-04-04,senegal,Africa,17565349,12,219
2020-04-05,senegal,Africa,17565349,3,222
2020-04-06,senegal,Africa,17565349,4,226
2020-04-07,senegal,Africa,17565349,11,237
2020-04-08,senegal,Africa,17565349,7,244
2020-04-09,senegal,Africa,17565349,6,250
2020-04-10,senegal,Africa,17565349,15,265
2020-04-11,senegal,Africa,17565349,13,278
2020-04-12,senegal,Africa,17565349,2,280
2020-04-13,senegal,Africa,17565349,11,291
2020-04-14,senegal,Africa,17565349,8,299
2020-04-15,senegal,Africa,17565349,15,314
2020-04-16,senegal,Africa,17565349,21,335
2020-04-17,senegal,Africa,17565349,7,342
2020-04-18,senegal,Africa,17565349,8,350
2020-04-19,senegal,Africa,17565349,17,367
2020-04-20,senegal,Africa,17565349,10,377
2020-04-21,senegal,Africa,17565349,35,412
2020-04-22,senegal,Africa,17565349,30,442
2020-04-23,senegal,Africa,17565349,37,479
2020-04-24,senegal,Africa,17565349,66,545
2020-04-25,senegal,Africa,17565349,69,614
2020-04-26,senegal,Africa,17565349,57,671
2020-04-27,senegal,Africa,17565349,65,736
2020-04-28,senegal,Africa,17565349,87,823
2020-04-29,senegal,Africa,17565349,59,882
2020-04-30,senegal,Africa,17565349,51,933
2020-05-01,senegal,Africa,17565349,91,1024
2020-05-02,senegal,Africa,17565349,91,1115
2020-05-03,senegal,Africa,17565349,67,1182
2020-05-04,senegal,Africa,17565349,89,1271
2020-05-05,senegal,Africa,17565349,58,1329
2020-05-06,senegal,Africa,17565349,104,1433
2020-05-07,senegal,Africa,17565349,59,1492
2020-05-08,senegal,Africa,17565349,59,1551
2020-05-09,senegal,Africa,17565349,83,1634
2020-05-10,senegal,Africa,17565349,75,1709
2020-05-11,senegal,Africa,17565349,177,1886
2020-05-12,senegal,Africa,17565349,109,1995
2020-05-13,senegal,Africa,17565349,110,2105
2020-05-14,senegal,Africa,17565349,84,2189
2020-05-15,senegal,Africa,17565349,121,2310
2020-05-16,senegal,Africa,17565349,119,2429
2020-05-17,senegal,Africa,17565349,51,2480
2020-05-18,senegal,Africa,17565349,64,2544
2020-05-19,senegal,Africa,17565349,73,2617
2020-05-20,senegal,Africa,17565349,97,2714
2020-05-21,senegal,Africa,17565349,98,2812
2020-05-22,senegal,Africa,17565349,97,2909
2020-05-23,senegal,Africa,17565349,67,2976
2020-05-24,senegal,Africa,17565349,71,3047
2020-05-25,senegal,Africa,17565349,83,3130
2020-05-26,senegal,Africa,17565349,31,3161
2020-05-27,senegal,Africa,17565349,92,3253
2020-05-28,senegal,Africa,17565349,95,3348
2020-05-29,senegal,Africa,17565349,81,3429
2020-05-30,senegal,Africa,17565349,106,3535
2020-05-31,senegal,Africa,17565349,110,3645
2020-06-01,senegal,Africa,17565349,94,3739
2020-06-02,senegal,Africa,17565349,97,3836
2020-06-03,senegal,Africa,17565349,96,3932
2020-06-04,senegal,Africa,17565349,89,4021
2020-06-05,senegal,Africa,17565349,134,4155
2020-06-06,senegal,Africa,17565349,94,4249
2020-06-07,senegal,Africa,17565349,79,4328
2020-06-08,senegal,Africa,17565349,99,4427
2020-06-09,senegal,Africa,17565349,89,4516
2020-06-10,senegal,Africa,17565349,124,4640
2020-06-11,senegal,Africa,17565349,119,4759
2020-06-12,senegal,Africa,17565349,92,4851
2020-06-13,senegal,Africa,17565349,145,4996
2020-06-14,senegal,Africa,17565349,94,5090
2020-06-15,senegal,Africa,17565349,83,5173
2020-06-16,senegal,Africa,17565349,74,5247
2020-06-17,senegal,Africa,17565349,122,5369
2020-06-18,senegal,Africa,17565349,106,5475
2020-06-19,senegal,Africa,17565349,164,5639
2020-06-20,senegal,Africa,17565349,144,5783
2020-06-21,senegal,Africa,17565349,105,5888
2020-06-22,senegal,Africa,17565349,82,5970
2020-06-23,senegal,Africa,17565349,64,6034
2020-06-24,senegal,Africa,17565349,95,6129
2020-06-25,senegal,Africa,17565349,104,6233
2020-06-26,senegal,Africa,17565349,121,6354
2020-06-27,senegal,Africa,17565349,105,6459
2020-06-28,senegal,Africa,17565349,127,6586
2020-06-29,senegal,Africa,17565349,112,6698
2020-06-30,senegal,Africa,17565349,95,6793
2020-07-01,senegal,Africa,17565349,132,6925
2020-07-02,senegal,Africa,17565349,129,7054
2020-07-03,senegal,Africa,17565349,110,7164
2020-07-04,senegal,Africa,17565349,108,7272
2020-07-05,senegal,Africa,17565349,128,7400
2020-07-06,senegal,Africa,17565349,78,7478
2020-07-07,senegal,Africa,17565349,69,7547
2020-07-08,senegal,Africa,17565349,110,7657
2020-07-09,senegal,Africa,17565349,127,7784
2020-07-10,senegal,Africa,17565349,98,7882
2020-07-11,senegal,Africa,17565349,132,8014
2020-07-12,senegal,Africa,17565349,121,8135
2020-07-13,senegal,Africa,17565349,63,8198
2020-07-14,senegal,Africa,17565349,45,8243
2020-07-15,senegal,Africa,17565349,126,8369
2020-07-16,senegal,Africa,17565349,112,8481
2020-07-17,senegal,Africa,17565349,63,8544
2020-07-18,senegal,Africa,17565349,125,8669
2020-07-19,senegal,Africa,17565349,141,8810
2020-07-20,senegal,Africa,17565349,138,8948
2020-07-21,senegal,Africa,17565349,37,8985
2020-07-22,senegal,Africa,17565349,136,9121
2020-07-23,senegal,Africa,17565349,145,9266
2020-07-24,senegal,Africa,17565349,156,9422
2020-07-25,senegal,Africa,17565349,130,9552
2020-07-26,senegal,Africa,17565349,129,9681
2020-07-27,senegal,Africa,17565349,83,9764
2020-07-28,senegal,Africa,17565349,41,9805
2020-07-29,senegal,Africa,17565349,156,9961
2020-07-30,senegal,Africa,17565349,145,10106
2020-07-31,senegal,Africa,17565349,126,10232
2020-08-01,senegal,Africa,17565349,52,10284
2020-08-02,senegal,Africa,17565349,60,10344
2020-08-03,senegal,Africa,17565349,42,10386
2020-08-04,senegal,Africa,17565349,46,10432
2020-08-05,senegal,Africa,17565349,106,10538
2020-08-06,senegal,Africa,17565349,177,10715
2020-08-07,senegal,Africa,17565349,172,10887
2020-08-08,senegal,Africa,17565349,116,11003
2020-08-09,senegal,Africa,17565349,172,11175
2020-08-10,senegal,Africa,17565349,137,11312
2020-08-11,senegal,Africa,17565349,68,11380
2020-08-12,senegal,Africa,17565349,207,11587
2020-08-13,senegal,Africa,17565349,153,11740
2020-08-14,senegal,Africa,17565349,132,11872
2020-08-15,senegal,Africa,17565349,160,12032
2020-08-16,senegal,Africa,17565349,130,12162
2020-08-17,senegal,Africa,17565349,75,12237
2020-08-18,senegal,Africa,17565349,68,12305
2020-08-19,senegal,Africa,17565349,141,12446
2020-08-20,senegal,Africa,17565349,113,12559
2020-08-21,senegal,Africa,17565349,130,12689
2020-08-22,senegal,Africa,17565349,161,12850
2020-08-23,senegal,Africa,17565349,99,12949
2020-08-24,senegal,Africa,17565349,64,13013
2020-08-25,senegal,Africa,17565349,43,13056
2020-08-26,senegal,Africa,17565349,130,13186
2020-08-27,senegal,Africa,17565349,108,13294
2020-08-28,senegal,Africa,17565349,90,13384
2020-08-29,senegal,Africa,17565349,72,13456
2020-08-30,senegal,Africa,17565349,100,13556
2020-08-31,senegal,Africa,17565349,55,13611
2020-09-01,senegal,Africa,17565349,44,13655
2020-09-02,senegal,Africa,17565349,88,13743
2020-09-03,senegal,Africa,17565349,83,13826
2020-09-04,senegal,Africa,17565349,55,13881
2020-09-05,senegal,Africa,17565349,67,13948
2020-09-06,senegal,Africa,17565349,39,13987
2020-09-07,senegal,Africa,17565349,27,14014
2020-09-08,senegal,Africa,17565349,30,14044
2020-09-09,senegal,Africa,17565349,58,14102
2020-09-10,senegal,Africa,17565349,48,14150
2020-09-11,senegal,Africa,17565349,43,14193
2020-09-12,senegal,Africa,17565349,44,14237
2020-09-13,senegal,Africa,17565349,43,14280
2020-09-14,senegal,Africa,17565349,26,14306
2020-09-15,senegal,Africa,17565349,223,14529
2020-09-16,senegal,Africa,17565349,39,14568
2020-09-17,senegal,Africa,17565349,50,14618
2020-09-18,senegal,Africa,17565349,27,14645
2020-09-19,senegal,Africa,17565349,43,14688
2020-09-20,senegal,Africa,17565349,26,14714
2020-09-21,senegal,Africa,17565349,24,14738
2020-09-22,senegal,Africa,17565349,21,14759
2020-09-23,senegal,Africa,17565349,36,14795
2020-09-24,senegal,Africa,17565349,21,14816
2020-09-25,senegal,Africa,17565349,23,14839
2020-09-26,senegal,Africa,17565349,30,14869
2020-09-27,senegal,Africa,17565349,40,14909
2020-09-28,senegal,Africa,17565349,10,14919
2020-09-29,senegal,Africa,17565349,26,14945
2020-09-30,senegal,Africa,17565349,37,14982
2020-10-01,senegal,Africa,17565349,37,15019
2020-10-02,senegal,Africa,17565349,32,15051
2020-10-03,senegal,Africa,17565349,17,15068
2020-10-04,senegal,Africa,17565349,26,15094
2020-10-05,senegal,Africa,17565349,28,15122
2020-10-06,senegal,Africa,17565349,19,15141
2020-10-07,senegal,Africa,17565349,33,15174
2020-10-08,senegal,Africa,17565349,16,15190
2020-10-09,senegal,Africa,17565349,23,15213
2020-10-10,senegal,Africa,17565349,31,15244
2020-10-11,senegal,Africa,17565349,24,15268
2020-10-12,senegal,Africa,17565349,24,15292
2020-10-13,senegal,Africa,17565349,15,15307
2020-10-14,senegal,Africa,17565349,24,15331
2020-10-15,senegal,Africa,17565349,17,15348
2020-10-16,senegal,Africa,17565349,20,15368
2020-10-17,senegal,Africa,17565349,24,15392
2020-10-18,senegal,Africa,17565349,26,15418
2020-10-19,senegal,Africa,17565349,14,15432
2020-10-20,senegal,Africa,17565349,27,15459
2020-10-21,senegal,Africa,17565349,25,15484
2020-10-22,senegal,Africa,17565349,24,15508
2020-10-23,senegal,Africa,17565349,17,15525
2020-10-24,senegal,Africa,17565349,18,15543
2020-10-25,senegal,Africa,17565349,8,15551
2020-10-26,senegal,Africa,17565349,14,15565
2020-10-27,senegal,Africa,17565349,6,15571
2020-10-28,senegal,Africa,17565349,11,15582
2020-10-29,senegal,Africa,17565349,11,15593
2020-10-30,senegal,Africa,17565349,12,15605
2020-10-31,senegal,Africa,17565349,11,15616
2020-11-01,senegal,Africa,17565349,14,15630
2020-11-02,senegal,Africa,17565349,7,15637
2020-11-03,senegal,Africa,17565349,3,15640
2020-11-04,senegal,Africa,17565349,10,15650
2020-11-05,senegal,Africa,17565349,18,15668
2020-11-06,senegal,Africa,17565349,8,15676
2020-11-07,senegal,Africa,17565349,17,15693
2020-11-08,senegal,Africa,17565349,15,15708
2020-11-09,senegal,Africa,17565349,3,15711
2020-11-10,senegal,Africa,17565349,9,15720
2020-11-11,senegal,Africa,17565349,15,15735
2020-11-12,senegal,Africa,17565349,9,15744
2020-11-13,senegal,Africa,17565349,11,15755
2020-03-21,serbia,Europe,8671838,36,171
2020-03-22,serbia,Europe,8671838,51,222
2020-03-23,serbia,Europe,8671838,27,249
2020-03-24,serbia,Europe,8671838,54,303
2020-03-25,serbia,Europe,8671838,81,384
2020-03-26,serbia,Europe,8671838,73,457
2020-03-27,serbia,Europe,8671838,71,528
2020-03-28,serbia,Europe,8671838,131,659
2020-03-29,serbia,Europe,8671838,82,741
2020-03-30,serbia,Europe,8671838,44,785
2020-03-31,serbia,Europe,8671838,115,900
2020-04-01,serbia,Europe,8671838,160,1060
2020-04-02,serbia,Europe,8671838,111,1171
2020-04-03,serbia,Europe,8671838,305,1476
2020-04-04,serbia,Europe,8671838,148,1624
2020-04-05,serbia,Europe,8671838,284,1908
2020-04-06,serbia,Europe,8671838,292,2200
2020-04-07,serbia,Europe,8671838,247,2447
2020-04-08,serbia,Europe,8671838,219,2666
2020-04-09,serbia,Europe,8671838,201,2867
2020-04-10,serbia,Europe,8671838,238,3105
2020-04-11,serbia,Europe,8671838,275,3380
2020-04-12,serbia,Europe,8671838,250,3630
2020-04-13,serbia,Europe,8671838,424,4054
2020-04-14,serbia,Europe,8671838,411,4465
2020-04-15,serbia,Europe,8671838,408,4873
2020-04-16,serbia,Europe,8671838,445,5318
2020-04-17,serbia,Europe,8671838,372,5690
2020-04-18,serbia,Europe,8671838,304,5994
2020-04-19,serbia,Europe,8671838,324,6318
2020-04-20,serbia,Europe,8671838,312,6630
2020-04-21,serbia,Europe,8671838,260,6890
2020-04-22,serbia,Europe,8671838,224,7114
2020-04-23,serbia,Europe,8671838,162,7276
2020-04-24,serbia,Europe,8671838,207,7483
2020-04-25,serbia,Europe,8671838,296,7779
2020-04-26,serbia,Europe,8671838,263,8042
2020-04-27,serbia,Europe,8671838,233,8275
2020-04-28,serbia,Europe,8671838,222,8497
2020-04-29,serbia,Europe,8671838,227,8724
2020-04-30,serbia,Europe,8671838,285,9009
2020-05-01,serbia,Europe,8671838,196,9205
2020-05-02,serbia,Europe,8671838,157,9362
2020-05-03,serbia,Europe,8671838,102,9464
2020-05-04,serbia,Europe,8671838,93,9557
2020-05-05,serbia,Europe,8671838,120,9677
2020-05-06,serbia,Europe,8671838,114,9791
2020-05-07,serbia,Europe,8671838,57,9848
2020-05-08,serbia,Europe,8671838,95,9943
2020-05-09,serbia,Europe,8671838,89,10032
2020-05-10,serbia,Europe,8671838,82,10114
2020-05-11,serbia,Europe,8671838,62,10176
2020-05-12,serbia,Europe,8671838,67,10243
2020-05-13,serbia,Europe,8671838,52,10295
2020-05-14,serbia,Europe,8671838,79,10374
2020-05-15,serbia,Europe,8671838,64,10438
2020-05-16,serbia,Europe,8671838,58,10496
2020-05-17,serbia,Europe,8671838,114,10610
2020-05-18,serbia,Europe,8671838,89,10699
2020-05-19,serbia,Europe,8671838,34,10733
2020-05-20,serbia,Europe,8671838,100,10833
2020-05-21,serbia,Europe,8671838,86,10919
2020-05-22,serbia,Europe,8671838,105,11024
2020-05-23,serbia,Europe,8671838,68,11092
2020-05-24,serbia,Europe,8671838,67,11159
2020-05-25,serbia,Europe,8671838,34,11193
2020-05-26,serbia,Europe,8671838,34,11227
2020-05-27,serbia,Europe,8671838,48,11275
2020-05-28,serbia,Europe,8671838,25,11300
2020-05-29,serbia,Europe,8671838,54,11354
2020-05-30,serbia,Europe,8671838,27,11381
2020-05-31,serbia,Europe,8671838,31,11412
2020-06-01,serbia,Europe,8671838,18,11430
2020-06-02,serbia,Europe,8671838,24,11454
2020-06-03,serbia,Europe,8671838,69,11523
2020-06-04,serbia,Europe,8671838,48,11571
2020-06-05,serbia,Europe,8671838,96,11667
2020-06-06,serbia,Europe,8671838,74,11741
2020-06-07,serbia,Europe,8671838,82,11823
2020-06-08,serbia,Europe,8671838,73,11896
2020-06-09,serbia,Europe,8671838,69,11965
2020-06-10,serbia,Europe,8671838,66,12031
2020-06-11,serbia,Europe,8671838,71,12102
2020-06-12,serbia,Europe,8671838,73,12175
2020-06-13,serbia,Europe,8671838,76,12251
2020-06-14,serbia,Europe,8671838,59,12310
2020-06-15,serbia,Europe,8671838,57,12367
2020-06-16,serbia,Europe,8671838,59,12426
2020-06-17,serbia,Europe,8671838,96,12522
2020-06-18,serbia,Europe,8671838,94,12616
2020-06-19,serbia,Europe,8671838,93,12709
2020-06-20,serbia,Europe,8671838,94,12803
2020-06-21,serbia,Europe,8671838,91,12894
2020-06-22,serbia,Europe,8671838,96,12990
2020-06-23,serbia,Europe,8671838,102,13092
2020-06-24,serbia,Europe,8671838,143,13235
2020-06-25,serbia,Europe,8671838,137,13372
2020-06-26,serbia,Europe,8671838,193,13565
2020-06-27,serbia,Europe,8671838,227,13792
2020-06-28,serbia,Europe,8671838,254,14046
2020-06-29,serbia,Europe,8671838,242,14288
2020-06-30,serbia,Europe,8671838,276,14564
2020-07-01,serbia,Europe,8671838,272,14836
2020-07-02,serbia,Europe,8671838,359,15195
2020-07-03,serbia,Europe,8671838,309,15504
2020-07-04,serbia,Europe,8671838,325,15829
2020-07-05,serbia,Europe,8671838,302,16131
2020-07-06,serbia,Europe,8671838,289,16420
2020-07-07,serbia,Europe,8671838,299,16719
2020-07-08,serbia,Europe,8671838,357,17076
2020-07-09,serbia,Europe,8671838,266,17342
2020-07-10,serbia,Europe,8671838,386,17728
2020-07-11,serbia,Europe,8671838,345,18073
2020-07-12,serbia,Europe,8671838,287,18360
2020-07-13,serbia,Europe,8671838,279,18639
2020-07-14,serbia,Europe,8671838,344,18983
2020-07-15,serbia,Europe,8671838,351,19334
2020-07-16,serbia,Europe,8671838,383,19717
2020-07-17,serbia,Europe,8671838,392,20109
2020-07-18,serbia,Europe,8671838,389,20498
2020-07-19,serbia,Europe,8671838,396,20894
2020-07-20,serbia,Europe,8671838,359,21253
2020-07-21,serbia,Europe,8671838,352,21605
2020-07-22,serbia,Europe,8671838,426,22031
2020-07-23,serbia,Europe,8671838,412,22443
2020-07-24,serbia,Europe,8671838,409,22852
2020-07-25,serbia,Europe,8671838,411,23263
2020-07-26,serbia,Europe,8671838,467,23730
2020-07-27,serbia,Europe,8671838,411,24141
2020-07-28,serbia,Europe,8671838,379,24520
2020-07-29,serbia,Europe,8671838,372,24892
2020-07-30,serbia,Europe,8671838,321,25213
2020-07-31,serbia,Europe,8671838,339,25552
2020-08-01,serbia,Europe,8671838,330,25882
2020-08-02,serbia,Europe,8671838,311,26193
2020-08-03,serbia,Europe,8671838,258,26451
2020-08-04,serbia,Europe,8671838,287,26738
2020-08-05,serbia,Europe,8671838,295,27033
2020-08-06,serbia,Europe,8671838,299,27332
2020-08-07,serbia,Europe,8671838,276,27608
2020-08-08,serbia,Europe,8671838,255,27863
2020-08-09,serbia,Europe,8671838,236,28099
2020-08-10,serbia,Europe,8671838,163,28262
2020-08-11,serbia,Europe,8671838,235,28497
2020-08-12,serbia,Europe,8671838,254,28751
2020-08-13,serbia,Europe,8671838,247,28998
2020-08-14,serbia,Europe,8671838,235,29233
2020-08-15,serbia,Europe,8671838,238,29471
2020-08-16,serbia,Europe,8671838,211,29682
2020-08-17,serbia,Europe,8671838,100,29782
2020-08-18,serbia,Europe,8671838,108,29890
2020-08-19,serbia,Europe,8671838,158,30048
2020-08-20,serbia,Europe,8671838,161,30209
2020-08-21,serbia,Europe,8671838,169,30378
2020-08-22,serbia,Europe,8671838,170,30548
2020-08-23,serbia,Europe,8671838,109,30657
2020-08-24,serbia,Europe,8671838,57,30714
2020-08-25,serbia,Europe,8671838,106,30820
2020-08-26,serbia,Europe,8671838,154,30974
2020-08-27,serbia,Europe,8671838,125,31099
2020-08-28,serbia,Europe,8671838,108,31207
2020-08-29,serbia,Europe,8671838,75,31282
2020-08-30,serbia,Europe,8671838,83,31365
2020-08-31,serbia,Europe,8671838,41,31406
2020-09-01,serbia,Europe,8671838,76,31482
2020-09-02,serbia,Europe,8671838,99,31581
2020-09-03,serbia,Europe,8671838,95,31676
2020-09-04,serbia,Europe,8671838,96,31772
2020-09-05,serbia,Europe,8671838,77,31849
2020-09-06,serbia,Europe,8671838,56,31905
2020-09-07,serbia,Europe,8671838,36,31941
2020-09-08,serbia,Europe,8671838,53,31994
2020-09-09,serbia,Europe,8671838,84,32078
2020-09-10,serbia,Europe,8671838,58,32136
2020-09-11,serbia,Europe,8671838,92,32228
2020-09-12,serbia,Europe,8671838,72,32300
2020-09-13,serbia,Europe,8671838,108,32408
2020-09-14,serbia,Europe,8671838,29,32437
2020-09-15,serbia,Europe,8671838,74,32511
2020-09-16,serbia,Europe,8671838,102,32613
2020-09-17,serbia,Europe,8671838,82,32695
2020-09-18,serbia,Europe,8671838,62,32757
2020-09-19,serbia,Europe,8671838,83,32840
2020-09-20,serbia,Europe,8671838,68,32908
2020-09-21,serbia,Europe,8671838,30,32938
2020-09-22,serbia,Europe,8671838,61,32999
2020-09-23,serbia,Europe,8671838,81,33080
2020-09-24,serbia,Europe,8671838,83,33163
2020-09-25,serbia,Europe,8671838,75,33238
2020-09-26,serbia,Europe,8671838,74,33312
2020-09-27,serbia,Europe,8671838,72,33384
2020-09-28,serbia,Europe,8671838,30,33414
2020-09-29,serbia,Europe,8671838,65,33479
2020-09-30,serbia,Europe,8671838,72,33551
2020-10-01,serbia,Europe,8671838,111,33662
2020-10-02,serbia,Europe,8671838,73,33735
2020-10-03,serbia,Europe,8671838,107,33842
2020-10-04,serbia,Europe,8671838,59,33901
2020-10-05,serbia,Europe,8671838,51,33952
2020-10-06,serbia,Europe,8671838,120,34072
2020-10-07,serbia,Europe,8671838,121,34193
2020-10-08,serbia,Europe,8671838,151,34344
2020-10-09,serbia,Europe,8671838,173,34517
2020-10-10,serbia,Europe,8671838,168,34685
2020-10-11,serbia,Europe,8671838,102,34787
2020-10-12,serbia,Europe,8671838,67,34854
2020-10-13,serbia,Europe,8671838,152,35006
2020-10-14,serbia,Europe,8671838,245,35251
2020-10-15,serbia,Europe,8671838,203,35454
2020-10-16,serbia,Europe,8671838,265,35719
2020-10-17,serbia,Europe,8671838,227,35946
2020-10-18,serbia,Europe,8671838,214,36160
2020-10-19,serbia,Europe,8671838,122,36282
2020-10-20,serbia,Europe,8671838,326,36608
2020-10-21,serbia,Europe,8671838,512,37120
2020-10-22,serbia,Europe,8671838,416,37536
2020-10-23,serbia,Europe,8671838,579,38115
2020-10-24,serbia,Europe,8671838,757,38872
2020-10-25,serbia,Europe,8671838,614,39486
2020-10-26,serbia,Europe,8671838,341,39827
2020-10-27,serbia,Europe,8671838,1053,40880
2020-10-28,serbia,Europe,8671838,1328,42208
2020-10-29,serbia,Europe,8671838,1384,43592
2020-10-30,serbia,Europe,8671838,1545,45137
2020-10-31,serbia,Europe,8671838,1817,46954
2020-11-01,serbia,Europe,8671838,1449,48403
2020-11-02,serbia,Europe,8671838,802,49205
2020-11-03,serbia,Europe,8671838,1878,51083
2020-11-04,serbia,Europe,8671838,2412,53495
2020-11-05,serbia,Europe,8671838,2181,55676
2020-11-06,serbia,Europe,8671838,2282,57958
2020-11-07,serbia,Europe,8671838,2677,60635
2020-11-08,serbia,Europe,8671838,2112,62747
2020-11-09,serbia,Europe,8671838,1318,64065
2020-11-10,serbia,Europe,8671838,2823,66888
2020-11-11,serbia,Europe,8671838,3536,70424
2020-11-12,serbia,Europe,8671838,3341,73765
2020-11-13,serbia,Europe,8671838,3499,77264
2020-11-14,serbia,Europe,8671838,3822,81086
2020-11-15,serbia,Europe,8671838,3482,84568
2020-11-16,serbia,Europe,8671838,2813,87381
2020-11-17,serbia,Europe,8671838,4994,92375
2020-11-18,serbia,Europe,8671838,5613,97988
2020-11-19,serbia,Europe,8671838,6109,104097
2020-11-20,serbia,Europe,8671838,6254,110351
2020-11-21,serbia,Europe,8671838,5774,116125
2020-11-22,serbia,Europe,8671838,4995,121120
2020-11-23,serbia,Europe,8671838,5067,126187
2020-11-24,serbia,Europe,8671838,6842,133029
2020-11-25,serbia,Europe,8671838,7579,140608
2020-11-26,serbia,Europe,8671838,7606,148214
2020-11-27,serbia,Europe,8671838,7780,155994
2020-11-28,serbia,Europe,8671838,7041,163035
2020-11-29,serbia,Europe,8671838,6179,169214
2020-11-30,serbia,Europe,8671838,6224,175438
2020-12-01,serbia,Europe,8671838,7999,183437
2020-12-02,serbia,Europe,8671838,7919,191356
2020-12-03,serbia,Europe,8671838,7802,199158
2020-12-04,serbia,Europe,8671838,7782,206940
2020-12-05,serbia,Europe,8671838,6903,213843
2020-12-06,serbia,Europe,8671838,5809,219652
2020-12-07,serbia,Europe,8671838,6557,226209
2020-12-08,serbia,Europe,8671838,7818,234027
2020-12-09,serbia,Europe,8671838,7804,241831
2020-12-10,serbia,Europe,8671838,7393,249224
2020-12-11,serbia,Europe,8671838,6534,255758
2020-12-12,serbia,Europe,8671838,5679,261437
2020-12-13,serbia,Europe,8671838,4995,266432
2020-12-14,serbia,Europe,8671838,4932,271364
2020-12-15,serbia,Europe,8671838,5884,277248
2020-12-16,serbia,Europe,8671838,5353,282601
2020-12-17,serbia,Europe,8671838,5129,287730
2020-12-18,serbia,Europe,8671838,4910,292640
2020-12-19,serbia,Europe,8671838,3888,296528
2020-12-20,serbia,Europe,8671838,3534,300062
2020-12-21,serbia,Europe,8671838,3685,303747
2020-12-22,serbia,Europe,8671838,4080,307827
2020-12-23,serbia,Europe,8671838,4426,312253
2020-12-24,serbia,Europe,8671838,4091,316344
2020-12-25,serbia,Europe,8671838,3823,320167
2020-12-26,serbia,Europe,8671838,3200,323367
2020-12-27,serbia,Europe,8671838,2693,326060
2020-12-28,serbia,Europe,8671838,2559,328619
2020-12-29,serbia,Europe,8671838,3136,331755
2020-12-30,serbia,Europe,8671838,3236,334991
2020-12-31,serbia,Europe,8671838,2932,337923
2021-01-01,serbia,Europe,8671838,2074,339997
2021-01-02,serbia,Europe,8671838,1907,341904
2021-01-03,serbia,Europe,8671838,1966,343870
2021-01-04,serbia,Europe,8671838,2715,346585
2021-01-05,serbia,Europe,8671838,2653,349238
2021-01-06,serbia,Europe,8671838,2882,352120
2021-01-07,serbia,Europe,8671838,1787,353907
2021-01-08,serbia,Europe,8671838,2218,356125
2021-01-09,serbia,Europe,8671838,1769,357894
2021-01-10,serbia,Europe,8671838,1795,359689
2021-01-11,serbia,Europe,8671838,2093,361782
2021-01-12,serbia,Europe,8671838,2142,363924
2021-01-13,serbia,Europe,8671838,2267,366191
2021-01-14,serbia,Europe,8671838,1881,368072
2021-01-15,serbia,Europe,8671838,1751,369823
2021-01-16,serbia,Europe,8671838,1393,371216
2021-01-17,serbia,Europe,8671838,1317,372533
2021-01-18,serbia,Europe,8671838,1578,374111
2021-01-19,serbia,Europe,8671838,1688,375799
2021-01-20,serbia,Europe,8671838,1646,377445
2021-01-21,serbia,Europe,8671838,1648,379093
2021-01-22,serbia,Europe,8671838,1709,380802
2021-01-23,serbia,Europe,8671838,1483,382285
2021-01-24,serbia,Europe,8671838,1318,383603
2021-01-25,serbia,Europe,8671838,1523,385126
2021-01-26,serbia,Europe,8671838,2080,387206
2021-01-27,serbia,Europe,8671838,1839,389045
2021-01-28,serbia,Europe,8671838,1592,390637
2021-01-29,serbia,Europe,8671838,1717,392354
2021-01-30,serbia,Europe,8671838,1543,393897
2021-01-31,serbia,Europe,8671838,1366,395263
2021-02-01,serbia,Europe,8671838,1739,397002
2021-02-02,serbia,Europe,8671838,1903,398905
2021-02-03,serbia,Europe,8671838,1932,400837
2021-02-04,serbia,Europe,8671838,1863,402700
2021-02-05,serbia,Europe,8671838,1968,404668
2021-02-06,serbia,Europe,8671838,1684,406352
2021-02-07,serbia,Europe,8671838,1529,407881
2021-02-08,serbia,Europe,8671838,1960,409841
2021-02-09,serbia,Europe,8671838,2014,411855
2021-02-10,serbia,Europe,8671838,2088,413943
2021-02-11,serbia,Europe,8671838,2000,415943
2021-02-12,serbia,Europe,8671838,1928,417871
2021-02-13,serbia,Europe,8671838,1622,419493
2021-02-14,serbia,Europe,8671838,1386,420879
2021-02-15,serbia,Europe,8671838,1331,422210
2021-02-16,serbia,Europe,8671838,1810,424020
2021-02-17,serbia,Europe,8671838,2467,426487
2021-02-18,serbia,Europe,8671838,2561,429048
2021-02-19,serbia,Europe,8671838,2632,431680
2021-02-20,serbia,Europe,8671838,2442,434122
2021-02-21,serbia,Europe,8671838,2518,436640
2021-02-22,serbia,Europe,8671838,2956,439596
2021-02-23,serbia,Europe,8671838,3257,442853
2021-02-24,serbia,Europe,8671838,3460,446313
2021-02-25,serbia,Europe,8671838,3588,449901
2021-02-26,serbia,Europe,8671838,3339,453240
2021-02-27,serbia,Europe,8671838,3210,456450
2021-02-28,serbia,Europe,8671838,2809,459259
2021-03-01,serbia,Europe,8671838,3469,462728
2021-03-02,serbia,Europe,8671838,4157,466885
2021-03-03,serbia,Europe,8671838,4056,470941
2021-03-04,serbia,Europe,8671838,3866,474807
2021-03-05,serbia,Europe,8671838,4071,478878
2021-03-06,serbia,Europe,8671838,3519,482397
2021-03-07,serbia,Europe,8671838,3042,485439
2021-03-08,serbia,Europe,8671838,4091,489530
2021-03-09,serbia,Europe,8671838,4576,494106
2021-03-10,serbia,Europe,8671838,4590,498696
2021-03-11,serbia,Europe,8671838,4595,503291
2021-03-12,serbia,Europe,8671838,4668,507959
2021-03-13,serbia,Europe,8671838,4092,512051
2021-03-14,serbia,Europe,8671838,4226,516277
2021-03-15,serbia,Europe,8671838,4634,520911
2021-03-16,serbia,Europe,8671838,5201,526112
2021-03-17,serbia,Europe,8671838,5446,531558
2021-03-18,serbia,Europe,8671838,5346,536904
2021-03-19,serbia,Europe,8671838,5305,542209
2021-03-20,serbia,Europe,8671838,4687,546896
2021-03-21,serbia,Europe,8671838,4232,551128
2021-03-22,serbia,Europe,8671838,4769,555897
2021-03-23,serbia,Europe,8671838,5475,561372
2021-03-24,serbia,Europe,8671838,5297,566669
2021-03-25,serbia,Europe,8671838,5226,571895
2021-03-26,serbia,Europe,8671838,5225,577120
2021-03-27,serbia,Europe,8671838,4497,581617
2021-03-28,serbia,Europe,8671838,3889,585506
2021-03-29,serbia,Europe,8671838,4512,590018
2021-03-30,serbia,Europe,8671838,5471,595489
2021-03-31,serbia,Europe,8671838,5107,600596
2021-04-01,serbia,Europe,8671838,4810,605406
2021-04-02,serbia,Europe,8671838,4826,610232
2021-04-03,serbia,Europe,8671838,4133,614365
2021-04-04,serbia,Europe,8671838,3304,617669
2021-04-05,serbia,Europe,8671838,3706,621375
2021-04-06,serbia,Europe,8671838,4398,625773
2021-04-07,serbia,Europe,8671838,3615,629388
2021-04-08,serbia,Europe,8671838,3625,633013
2021-04-09,serbia,Europe,8671838,3405,636418
2021-04-10,serbia,Europe,8671838,3058,639476
2021-04-11,serbia,Europe,8671838,2732,642208
2021-04-12,serbia,Europe,8671838,2965,645173
2021-04-13,serbia,Europe,8671838,3572,648745
2021-04-14,serbia,Europe,8671838,3154,651899
2021-04-15,serbia,Europe,8671838,2971,654870
2021-04-16,serbia,Europe,8671838,2846,657716
2021-04-17,serbia,Europe,8671838,2583,660299
2021-04-18,serbia,Europe,8671838,2069,662368
2021-04-19,serbia,Europe,8671838,2604,664972
2021-04-20,serbia,Europe,8671838,2965,667937
2021-04-21,serbia,Europe,8671838,2864,670801
2021-04-22,serbia,Europe,8671838,2719,673520
2021-04-23,serbia,Europe,8671838,2384,675904
2021-04-24,serbia,Europe,8671838,2068,677972
2021-04-25,serbia,Europe,8671838,1695,679667
2021-04-26,serbia,Europe,8671838,1987,681654
2021-04-27,serbia,Europe,8671838,2145,683799
2021-04-28,serbia,Europe,8671838,2138,685937
2021-04-29,serbia,Europe,8671838,2007,687944
2021-04-30,serbia,Europe,8671838,1613,689557
2021-05-01,serbia,Europe,8671838,1374,690931
2021-05-02,serbia,Europe,8671838,989,691920
2021-05-03,serbia,Europe,8671838,1249,693169
2021-05-04,serbia,Europe,8671838,1304,694473
2021-05-05,serbia,Europe,8671838,1402,695875
2021-05-06,serbia,Europe,8671838,1366,697241
2021-05-07,serbia,Europe,8671838,1277,698518
2021-05-08,serbia,Europe,8671838,1056,699574
2021-05-09,serbia,Europe,8671838,834,700408
2021-05-10,serbia,Europe,8671838,918,701326
2021-05-11,serbia,Europe,8671838,1125,702451
2021-05-12,serbia,Europe,8671838,1046,703497
2021-05-13,serbia,Europe,8671838,901,704398
2021-05-14,serbia,Europe,8671838,787,705185
2021-05-15,serbia,Europe,8671838,705,705890
2021-05-16,serbia,Europe,8671838,568,706458
2021-05-17,serbia,Europe,8671838,575,707033
2021-05-18,serbia,Europe,8671838,686,707719
2021-05-19,serbia,Europe,8671838,609,708328
2021-05-20,serbia,Europe,8671838,550,708878
2021-05-21,serbia,Europe,8671838,391,709269
2021-05-22,serbia,Europe,8671838,404,709673
2021-05-23,serbia,Europe,8671838,266,709939
2021-05-24,serbia,Europe,8671838,376,710315
2021-05-25,serbia,Europe,8671838,414,710729
2021-05-26,serbia,Europe,8671838,387,711116
2021-05-27,serbia,Europe,8671838,326,711442
2021-05-28,serbia,Europe,8671838,330,711772
2021-05-29,serbia,Europe,8671838,274,712046
2021-05-30,serbia,Europe,8671838,178,712224
2021-05-31,serbia,Europe,8671838,248,712472
2021-06-01,serbia,Europe,8671838,230,712702
2021-06-02,serbia,Europe,8671838,287,712989
2021-06-03,serbia,Europe,8671838,218,713207
2021-06-04,serbia,Europe,8671838,210,713417
2021-06-05,serbia,Europe,8671838,145,713562
2021-06-06,serbia,Europe,8671838,116,713678
2021-06-07,serbia,Europe,8671838,162,713840
2021-06-08,serbia,Europe,8671838,214,714054
2021-06-09,serbia,Europe,8671838,198,714252
2021-06-10,serbia,Europe,8671838,210,714462
2021-06-11,serbia,Europe,8671838,172,714634
2021-06-12,serbia,Europe,8671838,119,714753
2021-06-13,serbia,Europe,8671838,138,714891
2021-06-14,serbia,Europe,8671838,124,715015
2021-06-15,serbia,Europe,8671838,132,715147
2021-06-16,serbia,Europe,8671838,160,715307
2020-02-20,singapore,Asia,5936034,1,85
2020-02-21,singapore,Asia,5936034,1,86
2020-02-22,singapore,Asia,5936034,3,89
2020-02-23,singapore,Asia,5936034,0,89
2020-02-24,singapore,Asia,5936034,1,90
2020-02-25,singapore,Asia,5936034,1,91
2020-02-26,singapore,Asia,5936034,2,93
2020-02-27,singapore,Asia,5936034,3,96
2020-02-28,singapore,Asia,5936034,2,98
2020-02-29,singapore,Asia,5936034,4,102
2020-03-01,singapore,Asia,5936034,4,106
2020-03-02,singapore,Asia,5936034,2,108
2020-03-03,singapore,Asia,5936034,2,110
2020-03-04,singapore,Asia,5936034,2,112
2020-03-05,singapore,Asia,5936034,5,117
2020-03-06,singapore,Asia,5936034,13,130
2020-03-07,singapore,Asia,5936034,8,138
2020-03-08,singapore,Asia,5936034,12,150
2020-03-09,singapore,Asia,5936034,10,160
2020-03-10,singapore,Asia,5936034,6,166
2020-03-11,singapore,Asia,5936034,12,178
2020-03-12,singapore,Asia,5936034,9,187
2020-03-13,singapore,Asia,5936034,13,200
2020-03-14,singapore,Asia,5936034,12,212
2020-03-15,singapore,Asia,5936034,14,226
2020-03-16,singapore,Asia,5936034,17,243
2020-03-17,singapore,Asia,5936034,23,266
2020-03-18,singapore,Asia,5936034,47,313
2020-03-19,singapore,Asia,5936034,32,345
2020-03-20,singapore,Asia,5936034,40,385
2020-03-21,singapore,Asia,5936034,47,432
2020-03-22,singapore,Asia,5936034,23,455
2020-03-23,singapore,Asia,5936034,54,509
2020-03-24,singapore,Asia,5936034,49,558
2020-03-25,singapore,Asia,5936034,73,631
2020-03-26,singapore,Asia,5936034,52,683
2020-03-27,singapore,Asia,5936034,49,732
2020-03-28,singapore,Asia,5936034,70,802
2020-03-29,singapore,Asia,5936034,42,844
2020-03-30,singapore,Asia,5936034,35,879
2020-03-31,singapore,Asia,5936034,47,926
2020-04-01,singapore,Asia,5936034,74,1000
2020-04-02,singapore,Asia,5936034,49,1049
2020-04-03,singapore,Asia,5936034,65,1114
2020-04-04,singapore,Asia,5936034,75,1189
2020-04-05,singapore,Asia,5936034,120,1309
2020-04-06,singapore,Asia,5936034,66,1375
2020-04-07,singapore,Asia,5936034,106,1481
2020-04-08,singapore,Asia,5936034,142,1623
2020-04-09,singapore,Asia,5936034,287,1910
2020-04-10,singapore,Asia,5936034,198,2108
2020-04-11,singapore,Asia,5936034,191,2299
2020-04-12,singapore,Asia,5936034,233,2532
2020-04-13,singapore,Asia,5936034,386,2918
2020-04-14,singapore,Asia,5936034,334,3252
2020-04-15,singapore,Asia,5936034,447,3699
2020-04-16,singapore,Asia,5936034,728,4427
2020-04-17,singapore,Asia,5936034,623,5050
2020-04-18,singapore,Asia,5936034,942,5992
2020-04-19,singapore,Asia,5936034,596,6588
2020-04-20,singapore,Asia,5936034,1426,8014
2020-04-21,singapore,Asia,5936034,1111,9125
2020-04-22,singapore,Asia,5936034,1016,10141
2020-04-23,singapore,Asia,5936034,1037,11178
2020-04-24,singapore,Asia,5936034,897,12075
2020-04-25,singapore,Asia,5936034,618,12693
2020-04-26,singapore,Asia,5936034,931,13624
2020-04-27,singapore,Asia,5936034,799,14423
2020-04-28,singapore,Asia,5936034,528,14951
2020-04-29,singapore,Asia,5936034,690,15641
2020-04-30,singapore,Asia,5936034,528,16169
2020-05-01,singapore,Asia,5936034,932,17101
2020-05-02,singapore,Asia,5936034,447,17548
2020-05-03,singapore,Asia,5936034,657,18205
2020-05-04,singapore,Asia,5936034,573,18778
2020-05-05,singapore,Asia,5936034,632,19410
2020-05-06,singapore,Asia,5936034,788,20198
2020-05-07,singapore,Asia,5936034,741,20939
2020-05-08,singapore,Asia,5936034,768,21707
2020-05-09,singapore,Asia,5936034,753,22460
2020-05-10,singapore,Asia,5936034,876,23336
2020-05-11,singapore,Asia,5936034,451,23787
2020-05-12,singapore,Asia,5936034,884,24671
2020-05-13,singapore,Asia,5936034,675,25346
2020-05-14,singapore,Asia,5936034,752,26098
2020-05-15,singapore,Asia,5936034,793,26891
2020-05-16,singapore,Asia,5936034,465,27356
2020-05-17,singapore,Asia,5936034,682,28038
2020-05-18,singapore,Asia,5936034,305,28343
2020-05-19,singapore,Asia,5936034,451,28794
2020-05-20,singapore,Asia,5936034,570,29364
2020-05-21,singapore,Asia,5936034,448,29812
2020-05-22,singapore,Asia,5936034,614,30426
2020-05-23,singapore,Asia,5936034,642,31068
2020-05-24,singapore,Asia,5936034,548,31616
2020-05-25,singapore,Asia,5936034,344,31960
2020-05-26,singapore,Asia,5936034,383,32343
2020-05-27,singapore,Asia,5936034,533,32876
2020-05-28,singapore,Asia,5936034,373,33249
2020-05-29,singapore,Asia,5936034,611,33860
2020-05-30,singapore,Asia,5936034,506,34366
2020-05-31,singapore,Asia,5936034,518,34884
2020-06-01,singapore,Asia,5936034,408,35292
2020-06-02,singapore,Asia,5936034,544,35836
2020-06-03,singapore,Asia,5936034,569,36405
2020-06-04,singapore,Asia,5936034,517,36922
2020-06-05,singapore,Asia,5936034,261,37183
2020-06-06,singapore,Asia,5936034,344,37527
2020-06-07,singapore,Asia,5936034,383,37910
2020-06-08,singapore,Asia,5936034,386,38296
2020-06-09,singapore,Asia,5936034,218,38514
2020-06-10,singapore,Asia,5936034,451,38965
2020-06-11,singapore,Asia,5936034,422,39387
2020-06-12,singapore,Asia,5936034,463,39850
2020-06-13,singapore,Asia,5936034,347,40197
2020-06-14,singapore,Asia,5936034,407,40604
2020-06-15,singapore,Asia,5936034,214,40818
2020-06-16,singapore,Asia,5936034,151,40969
2020-06-17,singapore,Asia,5936034,247,41216
2020-06-18,singapore,Asia,5936034,257,41473
2020-06-19,singapore,Asia,5936034,142,41615
2020-06-20,singapore,Asia,5936034,218,41833
2020-06-21,singapore,Asia,5936034,262,42095
2020-06-22,singapore,Asia,5936034,218,42313
2020-06-23,singapore,Asia,5936034,119,42432
2020-06-24,singapore,Asia,5936034,191,42623
2020-06-25,singapore,Asia,5936034,113,42736
2020-06-26,singapore,Asia,5936034,219,42955
2020-06-27,singapore,Asia,5936034,291,43246
2020-06-28,singapore,Asia,5936034,213,43459
2020-06-29,singapore,Asia,5936034,202,43661
2020-06-30,singapore,Asia,5936034,246,43907
2020-07-01,singapore,Asia,5936034,215,44122
2020-07-02,singapore,Asia,5936034,188,44310
2020-07-03,singapore,Asia,5936034,169,44479
2020-07-04,singapore,Asia,5936034,185,44664
2020-07-05,singapore,Asia,5936034,136,44800
2020-07-06,singapore,Asia,5936034,183,44983
2020-07-07,singapore,Asia,5936034,156,45139
2020-07-08,singapore,Asia,5936034,158,45297
2020-07-09,singapore,Asia,5936034,125,45422
2020-07-10,singapore,Asia,5936034,191,45613
2020-07-11,singapore,Asia,5936034,170,45783
2020-07-12,singapore,Asia,5936034,178,45961
2020-07-13,singapore,Asia,5936034,322,46283
2020-07-14,singapore,Asia,5936034,346,46629
2020-07-15,singapore,Asia,5936034,249,46878
2020-07-16,singapore,Asia,5936034,248,47126
2020-07-17,singapore,Asia,5936034,327,47453
2020-07-18,singapore,Asia,5936034,202,47655
2020-07-19,singapore,Asia,5936034,257,47912
2020-07-20,singapore,Asia,5936034,123,48035
2020-07-21,singapore,Asia,5936034,399,48434
2020-07-22,singapore,Asia,5936034,310,48744
2020-07-23,singapore,Asia,5936034,354,49098
2020-07-24,singapore,Asia,5936034,277,49375
2020-07-25,singapore,Asia,5936034,513,49888
2020-07-26,singapore,Asia,5936034,481,50369
2020-07-27,singapore,Asia,5936034,469,50838
2020-07-28,singapore,Asia,5936034,359,51197
2020-07-29,singapore,Asia,5936034,334,51531
2020-07-30,singapore,Asia,5936034,278,51809
2020-07-31,singapore,Asia,5936034,396,52205
2020-08-01,singapore,Asia,5936034,307,52512
2020-08-02,singapore,Asia,5936034,313,52825
2020-08-03,singapore,Asia,5936034,226,53051
2020-08-04,singapore,Asia,5936034,295,53346
2020-08-05,singapore,Asia,5936034,908,54254
2020-08-06,singapore,Asia,5936034,301,54555
2020-08-07,singapore,Asia,5936034,242,54797
2020-08-08,singapore,Asia,5936034,132,54929
2020-08-09,singapore,Asia,5936034,175,55104
2020-08-10,singapore,Asia,5936034,188,55292
2020-04-02,sint_maarten,North America,43783,2,18
2020-04-03,sint_maarten,North America,43783,5,23
2020-04-04,sint_maarten,North America,43783,0,23
2020-04-05,sint_maarten,North America,43783,2,25
2020-04-06,sint_maarten,North America,43783,12,37
2020-04-07,sint_maarten,North America,43783,3,40
2020-04-08,sint_maarten,North America,43783,0,40
2020-04-09,sint_maarten,North America,43783,3,43
2020-04-10,sint_maarten,North America,43783,7,50
2020-04-11,sint_maarten,North America,43783,0,50
2020-04-12,sint_maarten,North America,43783,0,50
2020-04-13,sint_maarten,North America,43783,0,50
2020-04-14,sint_maarten,North America,43783,2,52
2020-04-15,sint_maarten,North America,43783,1,53
2020-04-16,sint_maarten,North America,43783,4,57
2020-04-17,sint_maarten,North America,43783,0,57
2020-04-18,sint_maarten,North America,43783,7,64
2020-04-19,sint_maarten,North America,43783,3,67
2020-04-20,sint_maarten,North America,43783,0,67
2020-04-21,sint_maarten,North America,43783,1,68
2020-04-22,sint_maarten,North America,43783,3,71
2020-04-23,sint_maarten,North America,43783,2,73
2020-04-24,sint_maarten,North America,43783,0,73
2020-04-25,sint_maarten,North America,43783,0,73
2020-04-26,sint_maarten,North America,43783,1,74
2020-04-27,sint_maarten,North America,43783,0,74
2020-04-28,sint_maarten,North America,43783,1,75
2020-04-29,sint_maarten,North America,43783,0,75
2020-04-30,sint_maarten,North America,43783,0,75
2020-05-01,sint_maarten,North America,43783,1,76
2020-05-02,sint_maarten,North America,43783,0,76
2020-05-03,sint_maarten,North America,43783,0,76
2020-05-04,sint_maarten,North America,43783,0,76
2020-05-05,sint_maarten,North America,43783,0,76
2020-05-06,sint_maarten,North America,43783,0,76
2020-05-07,sint_maarten,North America,43783,0,76
2020-05-08,sint_maarten,North America,43783,0,76
2020-05-09,sint_maarten,North America,43783,0,76
2020-05-10,sint_maarten,North America,43783,0,76
2020-05-11,sint_maarten,North America,43783,0,76
2020-05-12,sint_maarten,North America,43783,0,76
2020-05-13,sint_maarten,North America,43783,0,76
2020-05-14,sint_maarten,North America,43783,0,76
2020-05-15,sint_maarten,North America,43783,1,77
2020-05-16,sint_maarten,North America,43783,0,77
2020-05-17,sint_maarten,North America,43783,0,77
2020-05-18,sint_maarten,North America,43783,0,77
2020-05-19,sint_maarten,North America,43783,0,77
2020-05-20,sint_maarten,North America,43783,0,77
2020-05-21,sint_maarten,North America,43783,0,77
2020-05-22,sint_maarten,North America,43783,0,77
2020-05-23,sint_maarten,North America,43783,0,77
2020-05-24,sint_maarten,North America,43783,0,77
2020-05-25,sint_maarten,North America,43783,0,77
2020-05-26,sint_maarten,North America,43783,0,77
2020-05-27,sint_maarten,North America,43783,0,77
2020-05-28,sint_maarten,North America,43783,0,77
2020-05-29,sint_maarten,North America,43783,0,77
2020-05-30,sint_maarten,North America,43783,0,77
2020-05-31,sint_maarten,North America,43783,0,77
2020-06-01,sint_maarten,North America,43783,0,77
2020-06-02,sint_maarten,North America,43783,0,77
2020-06-03,sint_maarten,North America,43783,0,77
2020-06-04,sint_maarten,North America,43783,0,77
2020-06-05,sint_maarten,North America,43783,0,77
2020-06-06,sint_maarten,North America,43783,0,77
2020-06-07,sint_maarten,North America,43783,0,77
2020-06-08,sint_maarten,North America,43783,0,77
2020-06-09,sint_maarten,North America,43783,0,77
2020-06-10,sint_maarten,North America,43783,0,77
2020-06-11,sint_maarten,North America,43783,0,77
2020-06-12,sint_maarten,North America,43783,0,77
2020-06-13,sint_maarten,North America,43783,0,77
2020-06-14,sint_maarten,North America,43783,0,77
2020-06-15,sint_maarten,North America,43783,0,77
2020-06-16,sint_maarten,North America,43783,0,77
2020-06-17,sint_maarten,North America,43783,0,77
2020-06-18,sint_maarten,North America,43783,0,77
2020-06-19,sint_maarten,North America,43783,0,77
2020-06-20,sint_maarten,North America,43783,0,77
2020-06-21,sint_maarten,North America,43783,0,77
2020-06-22,sint_maarten,North America,43783,0,77
2020-06-23,sint_maarten,North America,43783,0,77
2020-06-24,sint_maarten,North America,43783,0,77
2020-06-25,sint_maarten,North America,43783,0,77
2020-06-26,sint_maarten,North America,43783,0,77
2020-06-27,sint_maarten,North America,43783,0,77
2020-06-28,sint_maarten,North America,43783,0,77
2020-06-29,sint_maarten,North America,43783,0,77
2020-06-30,sint_maarten,North America,43783,0,77
2020-07-01,sint_maarten,North America,43783,0,77
2020-07-02,sint_maarten,North America,43783,0,77
2020-07-03,sint_maarten,North America,43783,0,77
2020-07-04,sint_maarten,North America,43783,1,78
2020-07-05,sint_maarten,North America,43783,0,78
2020-07-06,sint_maarten,North America,43783,0,78
2020-07-07,sint_maarten,North America,43783,0,78
2020-07-08,sint_maarten,North America,43783,0,78
2020-07-09,sint_maarten,North America,43783,0,78
2020-07-10,sint_maarten,North America,43783,0,78
2020-07-11,sint_maarten,North America,43783,0,78
2020-07-12,sint_maarten,North America,43783,0,78
2020-07-13,sint_maarten,North America,43783,0,78
2020-07-14,sint_maarten,North America,43783,0,78
2020-07-15,sint_maarten,North America,43783,0,78
2020-07-16,sint_maarten,North America,43783,0,78
2020-07-17,sint_maarten,North America,43783,1,79
2020-07-18,sint_maarten,North America,43783,0,79
2020-07-19,sint_maarten,North America,43783,0,79
2020-07-20,sint_maarten,North America,43783,0,79
2020-07-21,sint_maarten,North America,43783,0,79
2020-07-22,sint_maarten,North America,43783,0,79
2020-07-23,sint_maarten,North America,43783,2,81
2020-07-24,sint_maarten,North America,43783,3,84
2020-07-25,sint_maarten,North America,43783,25,109
2020-07-26,sint_maarten,North America,43783,5,114
2020-07-27,sint_maarten,North America,43783,0,114
2020-07-28,sint_maarten,North America,43783,0,114
2020-07-29,sint_maarten,North America,43783,1,115
2020-07-30,sint_maarten,North America,43783,11,126
2020-07-31,sint_maarten,North America,43783,2,128
2020-08-01,sint_maarten,North America,43783,0,128
2020-08-02,sint_maarten,North America,43783,18,146
2020-08-03,sint_maarten,North America,43783,0,146
2020-08-04,sint_maarten,North America,43783,4,150
2020-08-05,sint_maarten,North America,43783,6,156
2020-08-06,sint_maarten,North America,43783,4,160
2020-08-07,sint_maarten,North America,43783,16,176
2020-08-08,sint_maarten,North America,43783,1,177
2020-08-09,sint_maarten,North America,43783,12,189
2020-08-10,sint_maarten,North America,43783,0,189
2020-08-11,sint_maarten,North America,43783,16,205
2020-08-12,sint_maarten,North America,43783,14,219
2020-08-13,sint_maarten,North America,43783,29,248
2020-08-14,sint_maarten,North America,43783,15,263
2020-08-15,sint_maarten,North America,43783,6,269
2020-08-16,sint_maarten,North America,43783,31,300
2020-08-17,sint_maarten,North America,43783,17,317
2020-08-18,sint_maarten,North America,43783,9,326
2020-08-19,sint_maarten,North America,43783,7,333
2020-08-20,sint_maarten,North America,43783,15,348
2020-08-21,sint_maarten,North America,43783,5,353
2020-08-22,sint_maarten,North America,43783,15,368
2020-08-23,sint_maarten,North America,43783,28,396
2020-08-24,sint_maarten,North America,43783,12,408
2020-08-25,sint_maarten,North America,43783,0,408
2020-08-26,sint_maarten,North America,43783,10,418
2020-08-27,sint_maarten,North America,43783,24,442
2020-08-28,sint_maarten,North America,43783,2,444
2020-08-29,sint_maarten,North America,43783,0,444
2020-08-30,sint_maarten,North America,43783,16,460
2020-08-31,sint_maarten,North America,43783,3,463
2020-09-01,sint_maarten,North America,43783,13,476
2020-09-02,sint_maarten,North America,43783,6,482
2020-09-03,sint_maarten,North America,43783,22,504
2020-09-04,sint_maarten,North America,43783,7,511
2020-09-05,sint_maarten,North America,43783,0,511
2020-09-06,sint_maarten,North America,43783,0,511
2020-09-07,sint_maarten,North America,43783,5,516
2020-09-08,sint_maarten,North America,43783,0,516
2020-09-09,sint_maarten,North America,43783,11,527
2020-09-10,sint_maarten,North America,43783,3,530
2020-09-11,sint_maarten,North America,43783,0,530
2020-09-12,sint_maarten,North America,43783,1,531
2020-09-13,sint_maarten,North America,43783,2,533
2020-09-14,sint_maarten,North America,43783,16,549
2020-09-15,sint_maarten,North America,43783,0,549
2020-09-16,sint_maarten,North America,43783,0,549
2020-09-17,sint_maarten,North America,43783,8,557
2020-09-18,sint_maarten,North America,43783,8,565
2020-09-19,sint_maarten,North America,43783,9,574
2020-09-20,sint_maarten,North America,43783,10,584
2020-09-21,sint_maarten,North America,43783,0,584
2020-09-22,sint_maarten,North America,43783,7,591
2020-09-23,sint_maarten,North America,43783,3,594
2020-09-24,sint_maarten,North America,43783,22,616
2020-09-25,sint_maarten,North America,43783,2,618
2020-09-26,sint_maarten,North America,43783,9,627
2020-09-27,sint_maarten,North America,43783,6,633
2020-09-28,sint_maarten,North America,43783,11,644
2020-09-29,sint_maarten,North America,43783,1,645
2020-09-30,sint_maarten,North America,43783,14,659
2020-10-01,sint_maarten,North America,43783,8,667
2020-10-02,sint_maarten,North America,43783,1,668
2020-10-03,sint_maarten,North America,43783,6,674
2020-10-04,sint_maarten,North America,43783,4,678
2020-10-05,sint_maarten,North America,43783,1,679
2020-10-06,sint_maarten,North America,43783,7,686
2020-10-07,sint_maarten,North America,43783,3,689
2020-10-08,sint_maarten,North America,43783,9,698
2020-10-09,sint_maarten,North America,43783,1,699
2020-10-10,sint_maarten,North America,43783,4,703
2020-10-11,sint_maarten,North America,43783,4,707
2020-10-12,sint_maarten,North America,43783,3,710
2020-10-13,sint_maarten,North America,43783,9,719
2020-10-14,sint_maarten,North America,43783,10,729
2020-10-15,sint_maarten,North America,43783,8,737
2020-10-16,sint_maarten,North America,43783,9,746
2020-10-17,sint_maarten,North America,43783,3,749
2020-10-18,sint_maarten,North America,43783,4,753
2020-10-19,sint_maarten,North America,43783,3,756
2020-10-20,sint_maarten,North America,43783,0,756
2020-10-21,sint_maarten,North America,43783,6,762
2020-10-22,sint_maarten,North America,43783,7,769
2020-10-23,sint_maarten,North America,43783,7,776
2020-10-24,sint_maarten,North America,43783,4,780
2020-10-25,sint_maarten,North America,43783,4,784
2020-10-26,sint_maarten,North America,43783,5,789
2020-10-27,sint_maarten,North America,43783,3,792
2020-10-28,sint_maarten,North America,43783,13,805
2020-10-29,sint_maarten,North America,43783,0,805
2020-10-30,sint_maarten,North America,43783,17,822
2020-10-31,sint_maarten,North America,43783,4,826
2020-11-01,sint_maarten,North America,43783,5,831
2020-11-02,sint_maarten,North America,43783,13,844
2020-11-03,sint_maarten,North America,43783,15,859
2020-11-04,sint_maarten,North America,43783,11,870
2020-11-05,sint_maarten,North America,43783,7,877
2020-11-06,sint_maarten,North America,43783,0,877
2020-11-07,sint_maarten,North America,43783,9,886
2020-11-08,sint_maarten,North America,43783,4,890
2020-11-09,sint_maarten,North America,43783,6,896
2020-11-10,sint_maarten,North America,43783,12,908
2020-11-11,sint_maarten,North America,43783,2,910
2020-11-12,sint_maarten,North America,43783,4,914
2020-11-13,sint_maarten,North America,43783,9,923
2020-11-14,sint_maarten,North America,43783,0,923
2020-11-15,sint_maarten,North America,43783,10,933
2020-11-16,sint_maarten,North America,43783,6,939
2020-11-17,sint_maarten,North America,43783,15,954
2020-11-18,sint_maarten,North America,43783,10,964
2020-11-19,sint_maarten,North America,43783,9,973
2020-11-20,sint_maarten,North America,43783,10,983
2020-11-21,sint_maarten,North America,43783,13,996
2020-11-22,sint_maarten,North America,43783,11,1007
2020-11-23,sint_maarten,North America,43783,5,1012
2020-11-24,sint_maarten,North America,43783,8,1020
2020-11-25,sint_maarten,North America,43783,16,1036
2020-11-26,sint_maarten,North America,43783,5,1041
2020-11-27,sint_maarten,North America,43783,12,1053
2020-11-28,sint_maarten,North America,43783,9,1062
2020-11-29,sint_maarten,North America,43783,0,1062
2020-11-30,sint_maarten,North America,43783,4,1066
2020-12-01,sint_maarten,North America,43783,3,1069
2020-12-02,sint_maarten,North America,43783,3,1072
2020-12-03,sint_maarten,North America,43783,20,1092
2020-12-04,sint_maarten,North America,43783,13,1105
2020-12-05,sint_maarten,North America,43783,15,1120
2020-12-06,sint_maarten,North America,43783,19,1139
2020-12-07,sint_maarten,North America,43783,2,1141
2020-12-08,sint_maarten,North America,43783,14,1155
2020-12-09,sint_maarten,North America,43783,6,1161
2020-12-10,sint_maarten,North America,43783,24,1185
2020-12-11,sint_maarten,North America,43783,16,1201
2020-12-12,sint_maarten,North America,43783,24,1225
2020-12-13,sint_maarten,North America,43783,7,1232
2020-12-14,sint_maarten,North America,43783,17,1249
2020-12-15,sint_maarten,North America,43783,20,1269
2020-12-16,sint_maarten,North America,43783,7,1276
2020-12-17,sint_maarten,North America,43783,18,1294
2020-12-18,sint_maarten,North America,43783,21,1315
2020-12-19,sint_maarten,North America,43783,8,1323
2020-12-20,sint_maarten,North America,43783,5,1328
2020-12-21,sint_maarten,North America,43783,10,1338
2020-12-22,sint_maarten,North America,43783,24,1362
2020-12-23,sint_maarten,North America,43783,8,1370
2020-12-24,sint_maarten,North America,43783,15,1385
2020-12-25,sint_maarten,North America,43783,8,1393
2020-12-26,sint_maarten,North America,43783,0,1393
2020-12-27,sint_maarten,North America,43783,0,1393
2020-12-28,sint_maarten,North America,43783,18,1411
2020-12-29,sint_maarten,North America,43783,12,1423
2020-12-30,sint_maarten,North America,43783,11,1434
2020-12-31,sint_maarten,North America,43783,22,1456
2021-01-01,sint_maarten,North America,43783,2,1458
2021-01-02,sint_maarten,North America,43783,4,1462
2021-01-03,sint_maarten,North America,43783,0,1462
2021-01-04,sint_maarten,North America,43783,3,1465
2021-01-05,sint_maarten,North America,43783,39,1504
2021-01-06,sint_maarten,North America,43783,8,1512
2021-01-07,sint_maarten,North America,43783,19,1531
2021-01-08,sint_maarten,North America,43783,23,1554
2021-01-09,sint_maarten,North America,43783,0,1554
2021-01-10,sint_maarten,North America,43783,1,1555
2021-01-11,sint_maarten,North America,43783,20,1575
2021-01-12,sint_maarten,North America,43783,14,1589
2021-01-13,sint_maarten,North America,43783,18,1607
2021-01-14,sint_maarten,North America,43783,22,1629
2021-01-15,sint_maarten,North America,43783,12,1641
2021-01-16,sint_maarten,North America,43783,0,1641
2021-01-17,sint_maarten,North America,43783,15,1656
2021-01-18,sint_maarten,North America,43783,13,1669
2021-01-19,sint_maarten,North America,43783,8,1677
2021-01-20,sint_maarten,North America,43783,26,1703
2021-01-21,sint_maarten,North America,43783,5,1708
2021-01-22,sint_maarten,North America,43783,16,1724
2021-01-23,sint_maarten,North America,43783,0,1724
2021-01-24,sint_maarten,North America,43783,29,1753
2021-01-25,sint_maarten,North America,43783,5,1758
2021-01-26,sint_maarten,North America,43783,9,1767
2021-01-27,sint_maarten,North America,43783,40,1807
2021-01-28,sint_maarten,North America,43783,15,1822
2021-01-29,sint_maarten,North America,43783,25,1847
2021-01-30,sint_maarten,North America,43783,6,1853
2021-01-31,sint_maarten,North America,43783,9,1862
2021-02-01,sint_maarten,North America,43783,8,1870
2021-02-02,sint_maarten,North America,43783,15,1885
2021-02-03,sint_maarten,North America,43783,14,1899
2021-02-04,sint_maarten,North America,43783,12,1911
2021-02-05,sint_maarten,North America,43783,10,1921
2021-02-06,sint_maarten,North America,43783,7,1928
2021-02-07,sint_maarten,North America,43783,0,1928
2021-02-08,sint_maarten,North America,43783,10,1938
2021-02-09,sint_maarten,North America,43783,14,1952
2021-02-10,sint_maarten,North America,43783,20,1972
2021-02-11,sint_maarten,North America,43783,13,1985
2021-02-12,sint_maarten,North America,43783,6,1991
2021-02-13,sint_maarten,North America,43783,3,1994
2021-02-14,sint_maarten,North America,43783,4,1998
2021-02-15,sint_maarten,North America,43783,3,2001
2021-02-16,sint_maarten,North America,43783,12,2013
2021-02-17,sint_maarten,North America,43783,8,2021
2021-02-18,sint_maarten,North America,43783,6,2027
2021-02-19,sint_maarten,North America,43783,6,2033
2021-02-20,sint_maarten,North America,43783,0,2033
2021-02-21,sint_maarten,North America,43783,0,2033
2021-02-22,sint_maarten,North America,43783,9,2042
2021-02-23,sint_maarten,North America,43783,5,2047
2021-02-24,sint_maarten,North America,43783,3,2050
2021-02-25,sint_maarten,North America,43783,1,2051
2021-02-26,sint_maarten,North America,43783,2,2053
2021-02-27,sint_maarten,North America,43783,2,2055
2021-02-28,sint_maarten,North America,43783,2,2057
2021-03-01,sint_maarten,North America,43783,3,2060
2021-03-02,sint_maarten,North America,43783,1,2061
2021-03-03,sint_maarten,North America,43783,4,2065
2021-03-04,sint_maarten,North America,43783,1,2066
2021-03-05,sint_maarten,North America,43783,1,2067
2021-03-06,sint_maarten,North America,43783,3,2070
2021-03-07,sint_maarten,North America,43783,0,2070
2021-03-08,sint_maarten,North America,43783,4,2074
2021-03-09,sint_maarten,North America,43783,2,2076
2021-03-10,sint_maarten,North America,43783,1,2077
2021-03-11,sint_maarten,North America,43783,1,2078
2021-03-12,sint_maarten,North America,43783,4,2082
2021-03-13,sint_maarten,North America,43783,0,2082
2021-03-14,sint_maarten,North America,43783,0,2082
2021-03-15,sint_maarten,North America,43783,3,2085
2021-03-16,sint_maarten,North America,43783,3,2088
2021-03-17,sint_maarten,North America,43783,5,2093
2021-03-18,sint_maarten,North America,43783,0,2093
2021-03-19,sint_maarten,North America,43783,6,2099
2021-03-20,sint_maarten,North America,43783,2,2101
2021-03-21,sint_maarten,North America,43783,0,2101
2021-03-22,sint_maarten,North America,43783,3,2104
2021-03-23,sint_maarten,North America,43783,4,2108
2021-03-24,sint_maarten,North America,43783,6,2114
2021-03-25,sint_maarten,North America,43783,4,2118
2020-03-20,slovakia,Europe,5464567,13,137
2020-03-21,slovakia,Europe,5464567,41,178
2020-03-22,slovakia,Europe,5464567,7,185
2020-03-23,slovakia,Europe,5464567,1,186
2020-03-24,slovakia,Europe,5464567,18,204
2020-03-25,slovakia,Europe,5464567,12,216
2020-03-26,slovakia,Europe,5464567,10,226
2020-03-27,slovakia,Europe,5464567,43,269
2020-03-28,slovakia,Europe,5464567,23,292
2020-03-29,slovakia,Europe,5464567,22,314
2020-03-30,slovakia,Europe,5464567,22,336
2020-03-31,slovakia,Europe,5464567,27,363
2020-04-01,slovakia,Europe,5464567,37,400
2020-04-02,slovakia,Europe,5464567,26,426
2020-04-03,slovakia,Europe,5464567,24,450
2020-04-04,slovakia,Europe,5464567,21,471
2020-04-05,slovakia,Europe,5464567,14,485
2020-04-06,slovakia,Europe,5464567,49,534
2020-04-07,slovakia,Europe,5464567,47,581
2020-04-08,slovakia,Europe,5464567,101,682
2020-04-09,slovakia,Europe,5464567,19,701
2020-04-10,slovakia,Europe,5464567,14,715
2020-04-11,slovakia,Europe,5464567,13,728
2020-04-12,slovakia,Europe,5464567,14,742
2020-04-13,slovakia,Europe,5464567,27,769
2020-04-14,slovakia,Europe,5464567,66,835
2020-04-15,slovakia,Europe,5464567,28,863
2020-04-16,slovakia,Europe,5464567,114,977
2020-04-17,slovakia,Europe,5464567,72,1049
2020-04-18,slovakia,Europe,5464567,40,1089
2020-04-19,slovakia,Europe,5464567,72,1161
2020-04-20,slovakia,Europe,5464567,12,1173
2020-04-21,slovakia,Europe,5464567,26,1199
2020-04-22,slovakia,Europe,5464567,45,1244
2020-04-23,slovakia,Europe,5464567,81,1325
2020-04-24,slovakia,Europe,5464567,35,1360
2020-04-25,slovakia,Europe,5464567,13,1373
2020-04-26,slovakia,Europe,5464567,6,1379
2020-04-27,slovakia,Europe,5464567,2,1381
2020-04-28,slovakia,Europe,5464567,3,1384
2020-04-29,slovakia,Europe,5464567,7,1391
2020-04-30,slovakia,Europe,5464567,5,1396
2020-05-01,slovakia,Europe,5464567,7,1403
2020-05-02,slovakia,Europe,5464567,4,1407
2020-05-03,slovakia,Europe,5464567,1,1408
2020-05-04,slovakia,Europe,5464567,5,1413
2020-05-05,slovakia,Europe,5464567,8,1421
2020-05-06,slovakia,Europe,5464567,8,1429
2020-05-07,slovakia,Europe,5464567,16,1445
2020-05-08,slovakia,Europe,5464567,10,1455
2020-05-09,slovakia,Europe,5464567,0,1455
2020-05-10,slovakia,Europe,5464567,2,1457
2020-05-11,slovakia,Europe,5464567,0,1457
2020-05-12,slovakia,Europe,5464567,8,1465
2020-05-13,slovakia,Europe,5464567,4,1469
2020-05-14,slovakia,Europe,5464567,8,1477
2020-05-15,slovakia,Europe,5464567,3,1480
2020-05-16,slovakia,Europe,5464567,13,1493
2020-05-17,slovakia,Europe,5464567,1,1494
2020-05-18,slovakia,Europe,5464567,1,1495
2020-05-19,slovakia,Europe,5464567,0,1495
2020-05-20,slovakia,Europe,5464567,1,1496
2020-05-21,slovakia,Europe,5464567,6,1502
2020-05-22,slovakia,Europe,5464567,1,1503
2020-05-23,slovakia,Europe,5464567,1,1504
2020-05-24,slovakia,Europe,5464567,5,1509
2020-05-25,slovakia,Europe,5464567,2,1511
2020-05-26,slovakia,Europe,5464567,2,1513
2020-05-27,slovakia,Europe,5464567,2,1515
2020-05-28,slovakia,Europe,5464567,5,1520
2020-05-29,slovakia,Europe,5464567,0,1520
2020-05-30,slovakia,Europe,5464567,1,1521
2020-05-31,slovakia,Europe,5464567,0,1521
2020-06-01,slovakia,Europe,5464567,1,1522
2020-06-02,slovakia,Europe,5464567,0,1522
2020-06-03,slovakia,Europe,5464567,3,1525
2020-06-04,slovakia,Europe,5464567,1,1526
2020-06-05,slovakia,Europe,5464567,0,1526
2020-06-06,slovakia,Europe,5464567,2,1528
2020-06-07,slovakia,Europe,5464567,0,1528
2020-06-08,slovakia,Europe,5464567,2,1530
2020-06-09,slovakia,Europe,5464567,1,1531
2020-06-10,slovakia,Europe,5464567,2,1533
2020-06-11,slovakia,Europe,5464567,8,1541
2020-06-12,slovakia,Europe,5464567,1,1542
2020-06-13,slovakia,Europe,5464567,3,1545
2020-06-14,slovakia,Europe,5464567,3,1548
2020-06-15,slovakia,Europe,5464567,4,1552
2020-06-16,slovakia,Europe,5464567,0,1552
2020-06-17,slovakia,Europe,5464567,9,1561
2020-06-18,slovakia,Europe,5464567,1,1562
2020-06-19,slovakia,Europe,5464567,14,1576
2020-06-20,slovakia,Europe,5464567,10,1586
2020-06-21,slovakia,Europe,5464567,1,1587
2020-06-22,slovakia,Europe,5464567,1,1588
2020-06-23,slovakia,Europe,5464567,1,1589
2020-06-24,slovakia,Europe,5464567,18,1607
2020-06-25,slovakia,Europe,5464567,23,1630
2020-06-26,slovakia,Europe,5464567,13,1643
2020-06-27,slovakia,Europe,5464567,14,1657
2020-06-28,slovakia,Europe,5464567,7,1664
2020-06-29,slovakia,Europe,5464567,1,1665
2020-06-30,slovakia,Europe,5464567,2,1667
2020-07-01,slovakia,Europe,5464567,20,1687
2020-07-02,slovakia,Europe,5464567,13,1700
2020-07-03,slovakia,Europe,5464567,20,1720
2020-07-04,slovakia,Europe,5464567,29,1749
2020-07-05,slovakia,Europe,5464567,15,1764
2020-07-06,slovakia,Europe,5464567,1,1765
2020-07-07,slovakia,Europe,5464567,2,1767
2020-07-08,slovakia,Europe,5464567,31,1798
2020-07-09,slovakia,Europe,5464567,53,1851
2020-07-10,slovakia,Europe,5464567,19,1870
2020-07-11,slovakia,Europe,5464567,23,1893
2020-07-12,slovakia,Europe,5464567,8,1901
2020-07-13,slovakia,Europe,5464567,1,1902
2020-07-14,slovakia,Europe,5464567,6,1908
2020-07-15,slovakia,Europe,5464567,19,1927
2020-07-16,slovakia,Europe,5464567,24,1951
2020-07-17,slovakia,Europe,5464567,14,1965
2020-07-18,slovakia,Europe,5464567,11,1976
2020-07-19,slovakia,Europe,5464567,3,1979
2020-07-20,slovakia,Europe,5464567,1,1980
2020-07-21,slovakia,Europe,5464567,41,2021
2020-07-22,slovakia,Europe,5464567,37,2058
2020-07-23,slovakia,Europe,5464567,31,2089
2020-07-24,slovakia,Europe,5464567,29,2118
2020-07-25,slovakia,Europe,5464567,23,2141
2020-07-26,slovakia,Europe,5464567,38,2179
2020-07-27,slovakia,Europe,5464567,2,2181
2020-07-28,slovakia,Europe,5464567,23,2204
2020-07-29,slovakia,Europe,5464567,41,2245
2020-07-30,slovakia,Europe,5464567,20,2265
2020-07-31,slovakia,Europe,5464567,27,2292
2020-08-01,slovakia,Europe,5464567,45,2337
2020-08-02,slovakia,Europe,5464567,7,2344
2020-08-03,slovakia,Europe,5464567,10,2354
2020-08-04,slovakia,Europe,5464567,14,2368
2020-08-05,slovakia,Europe,5464567,49,2417
2020-08-06,slovakia,Europe,5464567,63,2480
2020-08-07,slovakia,Europe,5464567,43,2523
2020-08-08,slovakia,Europe,5464567,43,2566
2020-08-09,slovakia,Europe,5464567,30,2596
2020-08-10,slovakia,Europe,5464567,3,2599
2020-08-11,slovakia,Europe,5464567,16,2615
2020-08-12,slovakia,Europe,5464567,75,2690
2020-08-13,slovakia,Europe,5464567,49,2739
2020-08-14,slovakia,Europe,5464567,62,2801
2020-08-15,slovakia,Europe,5464567,54,2855
2020-08-16,slovakia,Europe,5464567,47,2902
2020-08-17,slovakia,Europe,5464567,5,2907
2020-08-18,slovakia,Europe,5464567,15,2922
2020-08-19,slovakia,Europe,5464567,100,3022
2020-08-20,slovakia,Europe,5464567,80,3102
2020-08-21,slovakia,Europe,5464567,123,3225
2020-08-22,slovakia,Europe,5464567,91,3316
2020-08-23,slovakia,Europe,5464567,40,3356
2020-08-24,slovakia,Europe,5464567,68,3424
2020-08-25,slovakia,Europe,5464567,28,3452
2020-08-26,slovakia,Europe,5464567,84,3536
2020-08-27,slovakia,Europe,5464567,90,3626
2020-08-28,slovakia,Europe,5464567,102,3728
2020-08-29,slovakia,Europe,5464567,114,3842
2020-08-30,slovakia,Europe,5464567,34,3876
2020-08-31,slovakia,Europe,5464567,41,3917
2020-09-01,slovakia,Europe,5464567,72,3989
2020-09-02,slovakia,Europe,5464567,53,4042
2020-09-03,slovakia,Europe,5464567,121,4163
2020-09-04,slovakia,Europe,5464567,137,4300
2020-09-05,slovakia,Europe,5464567,226,4526
2020-09-06,slovakia,Europe,5464567,88,4614
2020-09-07,slovakia,Europe,5464567,22,4636
2020-09-08,slovakia,Europe,5464567,91,4727
2020-09-09,slovakia,Europe,5464567,161,4888
2020-09-10,slovakia,Europe,5464567,178,5066
2020-09-11,slovakia,Europe,5464567,186,5252
2020-09-12,slovakia,Europe,5464567,201,5453
2020-09-13,slovakia,Europe,5464567,79,5532
2020-09-14,slovakia,Europe,5464567,48,5580
2020-09-15,slovakia,Europe,5464567,188,5768
2020-09-16,slovakia,Europe,5464567,92,5860
2020-09-17,slovakia,Europe,5464567,161,6021
2020-09-18,slovakia,Europe,5464567,235,6256
2020-09-19,slovakia,Europe,5464567,290,6546
2020-09-20,slovakia,Europe,5464567,131,6677
2020-09-21,slovakia,Europe,5464567,79,6756
2020-09-22,slovakia,Europe,5464567,175,6931
2020-09-23,slovakia,Europe,5464567,338,7269
2020-09-24,slovakia,Europe,5464567,360,7629
2020-09-25,slovakia,Europe,5464567,419,8048
2020-09-26,slovakia,Europe,5464567,552,8600
2020-09-27,slovakia,Europe,5464567,478,9078
2020-09-28,slovakia,Europe,5464567,265,9343
2020-09-29,slovakia,Europe,5464567,231,9574
2020-09-30,slovakia,Europe,5464567,567,10141
2020-10-01,slovakia,Europe,5464567,797,10938
2020-10-02,slovakia,Europe,5464567,679,11617
2020-10-03,slovakia,Europe,5464567,704,12321
2020-10-04,slovakia,Europe,5464567,818,13139
2020-10-05,slovakia,Europe,5464567,353,13492
2020-10-06,slovakia,Europe,5464567,320,13812
2020-10-07,slovakia,Europe,5464567,877,14689
2020-10-08,slovakia,Europe,5464567,1037,15726
2020-10-09,slovakia,Europe,5464567,1184,16910
2020-10-10,slovakia,Europe,5464567,1887,18797
2020-10-11,slovakia,Europe,5464567,1054,19851
2020-10-12,slovakia,Europe,5464567,504,20355
2020-10-13,slovakia,Europe,5464567,531,20886
2020-10-14,slovakia,Europe,5464567,1410,22296
2020-10-15,slovakia,Europe,5464567,1929,24225
2020-10-16,slovakia,Europe,5464567,2075,26300
2020-10-17,slovakia,Europe,5464567,1968,28268
2020-10-18,slovakia,Europe,5464567,1567,29835
2020-10-19,slovakia,Europe,5464567,860,30695
2020-10-20,slovakia,Europe,5464567,705,31400
2020-10-21,slovakia,Europe,5464567,2202,33602
2020-10-22,slovakia,Europe,5464567,1728,35330
2020-10-23,slovakia,Europe,5464567,2581,37911
2020-10-24,slovakia,Europe,5464567,2890,40801
2020-10-25,slovakia,Europe,5464567,3042,43843
2020-10-26,slovakia,Europe,5464567,1312,45155
2020-10-27,slovakia,Europe,5464567,901,46056
2020-10-28,slovakia,Europe,5464567,2887,48943
2020-10-29,slovakia,Europe,5464567,2785,51728
2020-10-30,slovakia,Europe,5464567,3363,55091
2020-10-31,slovakia,Europe,5464567,2573,57664
2020-11-01,slovakia,Europe,5464567,2282,59946
2020-11-02,slovakia,Europe,5464567,1883,61829
2020-11-03,slovakia,Europe,5464567,1727,63556
2020-11-04,slovakia,Europe,5464567,3216,66772
2020-11-05,slovakia,Europe,5464567,1962,68734
2020-11-06,slovakia,Europe,5464567,2354,71088
2020-11-07,slovakia,Europe,5464567,2579,73667
2020-11-08,slovakia,Europe,5464567,1828,75495
2020-11-09,slovakia,Europe,5464567,577,76072
2020-11-10,slovakia,Europe,5464567,1051,77123
2020-11-11,slovakia,Europe,5464567,2058,79181
2020-11-12,slovakia,Europe,5464567,2591,81772
2020-11-13,slovakia,Europe,5464567,2024,83796
2020-11-14,slovakia,Europe,5464567,1771,85567
2020-11-15,slovakia,Europe,5464567,1200,86767
2020-11-16,slovakia,Europe,5464567,509,87276
2020-11-17,slovakia,Europe,5464567,1326,88602
2020-11-18,slovakia,Europe,5464567,1311,89913
2020-11-19,slovakia,Europe,5464567,1665,91578
2020-11-20,slovakia,Europe,5464567,1818,93396
2020-11-21,slovakia,Europe,5464567,1861,95257
2020-11-22,slovakia,Europe,5464567,984,96241
2020-11-23,slovakia,Europe,5464567,231,96472
2020-11-24,slovakia,Europe,5464567,1021,97493
2020-11-25,slovakia,Europe,5464567,1811,99304
2020-11-26,slovakia,Europe,5464567,1953,101257
2020-11-27,slovakia,Europe,5464567,1849,103106
2020-11-28,slovakia,Europe,5464567,1527,104633
2020-11-29,slovakia,Europe,5464567,1100,105733
2020-11-30,slovakia,Europe,5464567,196,105929
2020-12-01,slovakia,Europe,5464567,1254,107183
2020-12-02,slovakia,Europe,5464567,2043,109226
2020-12-03,slovakia,Europe,5464567,1982,111208
2020-12-04,slovakia,Europe,5464567,2184,113392
2020-12-05,slovakia,Europe,5464567,2070,115462
2020-12-06,slovakia,Europe,5464567,1269,116731
2020-12-07,slovakia,Europe,5464567,552,117283
2020-12-08,slovakia,Europe,5464567,1949,119232
2020-12-09,slovakia,Europe,5464567,2564,121796
2020-12-10,slovakia,Europe,5464567,3125,124921
2020-12-11,slovakia,Europe,5464567,2166,127087
2020-12-12,slovakia,Europe,5464567,3707,130794
2020-12-13,slovakia,Europe,5464567,2190,132984
2020-12-14,slovakia,Europe,5464567,505,133489
2020-12-15,slovakia,Europe,5464567,2034,135523
2020-12-16,slovakia,Europe,5464567,3565,139088
2020-12-17,slovakia,Europe,5464567,3045,142133
2020-12-18,slovakia,Europe,5464567,3991,146124
2020-12-19,slovakia,Europe,5464567,3151,149275
2020-12-20,slovakia,Europe,5464567,2061,151336
2020-12-21,slovakia,Europe,5464567,1219,152555
2020-12-22,slovakia,Europe,5464567,2663,155218
2020-12-23,slovakia,Europe,5464567,3687,158905
2020-12-24,slovakia,Europe,5464567,2657,161562
2020-12-25,slovakia,Europe,5464567,4046,165608
2020-12-26,slovakia,Europe,5464567,1041,166649
2020-12-27,slovakia,Europe,5464567,874,167523
2020-12-28,slovakia,Europe,5464567,569,168092
2020-12-29,slovakia,Europe,5464567,2095,170187
2020-12-30,slovakia,Europe,5464567,3041,173228
2020-12-31,slovakia,Europe,5464567,6315,179543
2021-01-01,slovakia,Europe,5464567,4965,184508
2021-01-02,slovakia,Europe,5464567,1736,186244
2021-01-03,slovakia,Europe,5464567,1219,187463
2021-01-04,slovakia,Europe,5464567,636,188099
2021-01-05,slovakia,Europe,5464567,2989,191088
2021-01-06,slovakia,Europe,5464567,4959,196047
2021-01-07,slovakia,Europe,5464567,2137,198184
2021-01-08,slovakia,Europe,5464567,2980,201164
2021-01-09,slovakia,Europe,5464567,4072,205236
2021-01-10,slovakia,Europe,5464567,2973,208209
2021-01-11,slovakia,Europe,5464567,860,209069
2021-01-12,slovakia,Europe,5464567,2410,211479
2021-01-13,slovakia,Europe,5464567,3576,215055
2021-01-14,slovakia,Europe,5464567,2923,217978
2021-01-15,slovakia,Europe,5464567,2729,220707
2021-01-16,slovakia,Europe,5464567,2045,222752
2021-01-17,slovakia,Europe,5464567,573,223325
2021-01-18,slovakia,Europe,5464567,1060,224385
2021-01-19,slovakia,Europe,5464567,1909,226294
2021-01-20,slovakia,Europe,5464567,2484,228778
2021-01-21,slovakia,Europe,5464567,2464,231242
2021-01-22,slovakia,Europe,5464567,1785,233027
2021-01-23,slovakia,Europe,5464567,1544,234571
2021-01-24,slovakia,Europe,5464567,1905,236476
2021-01-25,slovakia,Europe,5464567,551,237027
2021-01-26,slovakia,Europe,5464567,1590,238617
2021-01-27,slovakia,Europe,5464567,2775,241392
2021-01-28,slovakia,Europe,5464567,2035,243427
2021-01-29,slovakia,Europe,5464567,2581,246008
2021-01-30,slovakia,Europe,5464567,2182,248190
2021-01-31,slovakia,Europe,5464567,1723,249913
2021-02-01,slovakia,Europe,5464567,444,250357
2021-02-02,slovakia,Europe,5464567,1737,252094
2021-02-03,slovakia,Europe,5464567,2732,254826
2021-02-04,slovakia,Europe,5464567,2077,256903
2021-02-05,slovakia,Europe,5464567,2630,259533
2021-02-06,slovakia,Europe,5464567,2241,261774
2021-02-07,slovakia,Europe,5464567,1552,263326
2021-02-08,slovakia,Europe,5464567,757,264083
2021-02-09,slovakia,Europe,5464567,1724,265807
2021-02-10,slovakia,Europe,5464567,3179,268986
2021-02-11,slovakia,Europe,5464567,2487,271473
2021-02-12,slovakia,Europe,5464567,2431,273904
2021-02-13,slovakia,Europe,5464567,2330,276234
2021-02-14,slovakia,Europe,5464567,1448,277682
2021-02-15,slovakia,Europe,5464567,572,278254
2021-02-16,slovakia,Europe,5464567,1442,279696
2021-02-17,slovakia,Europe,5464567,3168,282864
2021-02-18,slovakia,Europe,5464567,2555,285419
2021-02-19,slovakia,Europe,5464567,2333,287752
2021-02-20,slovakia,Europe,5464567,2705,290457
2021-02-21,slovakia,Europe,5464567,1686,292143
2021-02-22,slovakia,Europe,5464567,649,292792
2021-02-23,slovakia,Europe,5464567,1998,294790
2021-02-24,slovakia,Europe,5464567,3547,298337
2021-02-25,slovakia,Europe,5464567,2438,300775
2021-02-26,slovakia,Europe,5464567,2645,303420
2021-02-27,slovakia,Europe,5464567,2848,306268
2021-02-28,slovakia,Europe,5464567,1815,308083
2021-03-01,slovakia,Europe,5464567,842,308925
2021-03-02,slovakia,Europe,5464567,2077,311002
2021-03-03,slovakia,Europe,5464567,3357,314359
2021-03-04,slovakia,Europe,5464567,2800,317159
2021-03-05,slovakia,Europe,5464567,2423,319582
2021-03-06,slovakia,Europe,5464567,2522,322104
2021-03-07,slovakia,Europe,5464567,1286,323390
2021-03-08,slovakia,Europe,5464567,396,323786
2021-03-09,slovakia,Europe,5464567,2207,325993
2021-03-10,slovakia,Europe,5464567,3600,329593
2021-03-11,slovakia,Europe,5464567,1978,331571
2021-03-12,slovakia,Europe,5464567,2301,333872
2021-03-13,slovakia,Europe,5464567,2363,336235
2021-03-14,slovakia,Europe,5464567,1268,337503
2021-03-15,slovakia,Europe,5464567,457,337960
2021-03-16,slovakia,Europe,5464567,1578,339538
2021-03-17,slovakia,Europe,5464567,2892,342430
2021-03-18,slovakia,Europe,5464567,2040,344470
2021-03-19,slovakia,Europe,5464567,1679,346149
2021-03-20,slovakia,Europe,5464567,1795,347944
2021-03-21,slovakia,Europe,5464567,925,348869
2021-03-22,slovakia,Europe,5464567,401,349270
2021-03-23,slovakia,Europe,5464567,1281,350551
2021-03-24,slovakia,Europe,5464567,1977,352528
2021-03-25,slovakia,Europe,5464567,1654,354182
2021-03-26,slovakia,Europe,5464567,1272,355454
2021-03-27,slovakia,Europe,5464567,1531,356985
2021-03-28,slovakia,Europe,5464567,925,357910
2021-03-29,slovakia,Europe,5464567,205,358115
2021-03-30,slovakia,Europe,5464567,1215,359330
2021-03-31,slovakia,Europe,5464567,1855,361185
2021-04-01,slovakia,Europe,5464567,1304,362489
2021-04-02,slovakia,Europe,5464567,1385,363874
2021-04-03,slovakia,Europe,5464567,748,364622
2021-04-04,slovakia,Europe,5464567,620,365242
2021-04-05,slovakia,Europe,5464567,158,365400
2021-04-06,slovakia,Europe,5464567,333,365733
2021-04-07,slovakia,Europe,5464567,1161,366894
2021-04-08,slovakia,Europe,5464567,1576,368470
2021-04-09,slovakia,Europe,5464567,923,369393
2021-04-10,slovakia,Europe,5464567,1080,370473
2021-04-11,slovakia,Europe,5464567,589,371062
2021-04-12,slovakia,Europe,5464567,106,371168
2021-04-13,slovakia,Europe,5464567,870,372038
2021-04-14,slovakia,Europe,5464567,1069,373107
2021-04-15,slovakia,Europe,5464567,843,373950
2021-04-16,slovakia,Europe,5464567,636,374586
2021-04-17,slovakia,Europe,5464567,750,375336
2021-04-18,slovakia,Europe,5464567,638,375974
2021-04-19,slovakia,Europe,5464567,93,376067
2021-04-20,slovakia,Europe,5464567,642,376709
2021-04-21,slovakia,Europe,5464567,764,377473
2021-04-22,slovakia,Europe,5464567,677,378150
2021-04-23,slovakia,Europe,5464567,485,378635
2021-04-24,slovakia,Europe,5464567,841,379476
2021-04-25,slovakia,Europe,5464567,435,379911
2021-04-26,slovakia,Europe,5464567,99,380010
2021-04-27,slovakia,Europe,5464567,488,380498
2021-04-28,slovakia,Europe,5464567,682,381180
2021-04-29,slovakia,Europe,5464567,564,381744
2021-04-30,slovakia,Europe,5464567,467,382211
2021-05-01,slovakia,Europe,5464567,509,382720
2021-05-02,slovakia,Europe,5464567,378,383098
2021-05-03,slovakia,Europe,5464567,130,383228
2021-05-04,slovakia,Europe,5464567,381,383609
2021-05-05,slovakia,Europe,5464567,708,384317
2021-05-06,slovakia,Europe,5464567,343,384660
2021-05-07,slovakia,Europe,5464567,362,385022
2021-05-08,slovakia,Europe,5464567,373,385395
2021-05-09,slovakia,Europe,5464567,80,385475
2021-05-10,slovakia,Europe,5464567,311,385786
2021-05-11,slovakia,Europe,5464567,350,386136
2021-05-12,slovakia,Europe,5464567,404,386540
2021-05-13,slovakia,Europe,5464567,328,386868
2021-05-14,slovakia,Europe,5464567,294,387162
2021-05-15,slovakia,Europe,5464567,258,387420
2021-05-16,slovakia,Europe,5464567,103,387523
2021-05-17,slovakia,Europe,5464567,136,387659
2021-05-18,slovakia,Europe,5464567,233,387892
2021-05-19,slovakia,Europe,5464567,246,388138
2021-05-20,slovakia,Europe,5464567,253,388391
2021-05-21,slovakia,Europe,5464567,138,388529
2021-05-22,slovakia,Europe,5464567,190,388719
2021-05-23,slovakia,Europe,5464567,116,388835
2021-05-24,slovakia,Europe,5464567,19,388854
2021-05-25,slovakia,Europe,5464567,132,388986
2021-05-26,slovakia,Europe,5464567,190,389176
2021-05-27,slovakia,Europe,5464567,168,389344
2021-05-28,slovakia,Europe,5464567,96,389440
2021-05-29,slovakia,Europe,5464567,148,389588
2021-05-30,slovakia,Europe,5464567,102,389690
2021-05-31,slovakia,Europe,5464567,31,389721
2021-06-01,slovakia,Europe,5464567,145,389866
2021-06-02,slovakia,Europe,5464567,124,389990
2021-06-03,slovakia,Europe,5464567,139,390129
2021-06-04,slovakia,Europe,5464567,94,390223
2021-06-05,slovakia,Europe,5464567,117,390340
2021-06-06,slovakia,Europe,5464567,96,390436
2021-06-07,slovakia,Europe,5464567,15,390451
2021-06-08,slovakia,Europe,5464567,95,390546
2021-06-09,slovakia,Europe,5464567,147,390693
2021-06-10,slovakia,Europe,5464567,116,390809
2021-06-11,slovakia,Europe,5464567,84,390893
2021-06-12,slovakia,Europe,5464567,91,390984
2021-06-13,slovakia,Europe,5464567,42,391026
2021-06-14,slovakia,Europe,5464567,12,391038
2021-06-15,slovakia,Europe,5464567,49,391087
2021-06-16,slovakia,Europe,5464567,62,391149
2021-06-17,slovakia,Europe,5464567,61,391210
2021-06-18,slovakia,Europe,5464567,38,391248
2021-06-19,slovakia,Europe,5464567,49,391297
2021-06-20,slovakia,Europe,5464567,28,391325
2021-06-21,slovakia,Europe,5464567,1,391326
2021-06-22,slovakia,Europe,5464567,59,391385
2021-06-23,slovakia,Europe,5464567,35,391420
2021-06-24,slovakia,Europe,5464567,36,391456
2021-06-25,slovakia,Europe,5464567,34,391490
2021-06-26,slovakia,Europe,5464567,41,391531
2021-06-27,slovakia,Europe,5464567,20,391551
2021-06-28,slovakia,Europe,5464567,15,391566
2021-06-29,slovakia,Europe,5464567,43,391609
2021-06-30,slovakia,Europe,5464567,33,391642
2021-07-01,slovakia,Europe,5464567,17,391659
2021-07-02,slovakia,Europe,5464567,17,391676
2021-07-03,slovakia,Europe,5464567,20,391696
2021-07-04,slovakia,Europe,5464567,21,391717
2021-07-05,slovakia,Europe,5464567,3,391720
2021-07-06,slovakia,Europe,5464567,15,391735
2021-07-07,slovakia,Europe,5464567,45,391780
2021-07-08,slovakia,Europe,5464567,33,391813
2021-07-09,slovakia,Europe,5464567,39,391852
2021-07-10,slovakia,Europe,5464567,41,391893
2021-07-11,slovakia,Europe,5464567,25,391918
2021-07-12,slovakia,Europe,5464567,7,391925
2021-07-13,slovakia,Europe,5464567,28,391953
2021-07-14,slovakia,Europe,5464567,18,391971
2021-07-15,slovakia,Europe,5464567,29,392000
2021-07-16,slovakia,Europe,5464567,34,392034
2021-07-17,slovakia,Europe,5464567,37,392071
2021-07-18,slovakia,Europe,5464567,29,392100
2021-07-19,slovakia,Europe,5464567,4,392104
2021-07-20,slovakia,Europe,5464567,35,392139
2021-07-21,slovakia,Europe,5464567,46,392185
2021-07-22,slovakia,Europe,5464567,34,392219
2021-07-23,slovakia,Europe,5464567,40,392259
2021-07-24,slovakia,Europe,5464567,43,392302
2021-07-25,slovakia,Europe,5464567,46,392348
2021-07-26,slovakia,Europe,5464567,7,392355
2021-07-27,slovakia,Europe,5464567,51,392406
2021-07-28,slovakia,Europe,5464567,82,392488
2021-07-29,slovakia,Europe,5464567,49,392537
2021-07-30,slovakia,Europe,5464567,44,392581
2021-07-31,slovakia,Europe,5464567,66,392647
2021-08-01,slovakia,Europe,5464567,57,392704
2021-08-02,slovakia,Europe,5464567,6,392710
2021-08-03,slovakia,Europe,5464567,41,392751
2021-08-04,slovakia,Europe,5464567,94,392845
2021-08-05,slovakia,Europe,5464567,53,392898
2021-08-06,slovakia,Europe,5464567,65,392963
2021-08-07,slovakia,Europe,5464567,44,393007
2021-08-08,slovakia,Europe,5464567,33,393040
2021-08-09,slovakia,Europe,5464567,19,393059
2021-08-10,slovakia,Europe,5464567,101,393160
2021-08-11,slovakia,Europe,5464567,68,393228
2021-08-12,slovakia,Europe,5464567,74,393302
2021-08-13,slovakia,Europe,5464567,59,393361
2021-08-14,slovakia,Europe,5464567,94,393455
2021-08-15,slovakia,Europe,5464567,74,393529
2021-08-16,slovakia,Europe,5464567,7,393536
2021-08-17,slovakia,Europe,5464567,74,393610
2021-08-18,slovakia,Europe,5464567,112,393722
2021-08-19,slovakia,Europe,5464567,77,393799
2021-08-20,slovakia,Europe,5464567,84,393883
2021-08-21,slovakia,Europe,5464567,94,393977
2021-08-22,slovakia,Europe,5464567,105,394082
2021-08-23,slovakia,Europe,5464567,11,394093
2021-08-24,slovakia,Europe,5464567,111,394204
2021-08-25,slovakia,Europe,5464567,81,394285
2021-08-26,slovakia,Europe,5464567,161,394446
2021-08-27,slovakia,Europe,5464567,89,394535
2021-08-28,slovakia,Europe,5464567,122,394657
2021-08-29,slovakia,Europe,5464567,85,394742
2021-08-30,slovakia,Europe,5464567,49,394791
2021-08-31,slovakia,Europe,5464567,132,394923
2021-09-01,slovakia,Europe,5464567,199,395122
2021-09-02,slovakia,Europe,5464567,178,395300
2021-09-03,slovakia,Europe,5464567,232,395532
2021-09-04,slovakia,Europe,5464567,329,395861
2021-09-05,slovakia,Europe,5464567,219,396080
2021-09-06,slovakia,Europe,5464567,101,396181
2021-09-07,slovakia,Europe,5464567,306,396487
2021-09-08,slovakia,Europe,5464567,417,396904
2021-09-09,slovakia,Europe,5464567,478,397382
2021-09-10,slovakia,Europe,5464567,377,397759
2021-09-11,slovakia,Europe,5464567,519,398278
2021-09-12,slovakia,Europe,5464567,412,398690
2021-09-13,slovakia,Europe,5464567,54,398744
2021-09-14,slovakia,Europe,5464567,474,399218
2021-09-15,slovakia,Europe,5464567,760,399978
2021-09-16,slovakia,Europe,5464567,370,400348
2021-09-17,slovakia,Europe,5464567,902,401250
2021-09-18,slovakia,Europe,5464567,816,402066
2021-09-19,slovakia,Europe,5464567,742,402808
2021-09-20,slovakia,Europe,5464567,114,402922
2021-09-21,slovakia,Europe,5464567,880,403802
2021-09-22,slovakia,Europe,5464567,1180,404982
2021-09-23,slovakia,Europe,5464567,949,405931
2021-09-24,slovakia,Europe,5464567,829,406760
2021-09-25,slovakia,Europe,5464567,1039,407799
2021-09-26,slovakia,Europe,5464567,689,408488
2021-09-27,slovakia,Europe,5464567,121,408609
2021-09-28,slovakia,Europe,5464567,1012,409621
2021-09-29,slovakia,Europe,5464567,1459,411080
2021-09-30,slovakia,Europe,5464567,1427,412507
2021-10-01,slovakia,Europe,5464567,1216,413723
2021-10-02,slovakia,Europe,5464567,1293,415016
2021-10-03,slovakia,Europe,5464567,977,415993
2021-10-04,slovakia,Europe,5464567,267,416260
2021-10-05,slovakia,Europe,5464567,1242,417502
2021-10-06,slovakia,Europe,5464567,1971,419473
2021-10-07,slovakia,Europe,5464567,1451,420924
2021-10-08,slovakia,Europe,5464567,1690,422614
2021-10-09,slovakia,Europe,5464567,1793,424407
2021-10-10,slovakia,Europe,5464567,1162,425569
2021-10-11,slovakia,Europe,5464567,402,425971
2021-10-12,slovakia,Europe,5464567,1509,427480
2021-10-13,slovakia,Europe,5464567,2406,429886
2021-10-14,slovakia,Europe,5464567,1871,431757
2021-10-15,slovakia,Europe,5464567,1952,433709
2021-10-16,slovakia,Europe,5464567,1941,435650
2021-10-17,slovakia,Europe,5464567,1735,437385
2021-10-18,slovakia,Europe,5464567,553,437938
2021-10-19,slovakia,Europe,5464567,1796,439734
2021-10-20,slovakia,Europe,5464567,3480,443214
2021-10-21,slovakia,Europe,5464567,3091,446305
2021-10-22,slovakia,Europe,5464567,3470,449775
2021-10-23,slovakia,Europe,5464567,3456,453231
2021-10-24,slovakia,Europe,5464567,3207,456438
2021-10-25,slovakia,Europe,5464567,993,457431
2022-01-26,solomon_islands,Australia/Oceania,718243,0,651
2022-01-27,solomon_islands,Australia/Oceania,718243,104,755
2022-01-28,solomon_islands,Australia/Oceania,718243,143,898
2022-01-29,solomon_islands,Australia/Oceania,718243,0,898
2022-01-30,solomon_islands,Australia/Oceania,718243,285,1183
2022-01-31,solomon_islands,Australia/Oceania,718243,303,1486
2022-02-01,solomon_islands,Australia/Oceania,718243,366,1852
2022-02-02,solomon_islands,Australia/Oceania,718243,315,2167
2020-03-28,south_africa,Africa,60701292,17,1192
2020-03-29,south_africa,Africa,60701292,94,1286
2020-03-30,south_africa,Africa,60701292,46,1332
2020-03-31,south_africa,Africa,60701292,27,1359
2020-04-01,south_africa,Africa,60701292,27,1386
2020-04-02,south_africa,Africa,60701292,82,1468
2020-04-03,south_africa,Africa,60701292,43,1511
2020-04-04,south_africa,Africa,60701292,80,1591
2020-04-05,south_africa,Africa,60701292,70,1661
2020-04-06,south_africa,Africa,60701292,31,1692
2020-04-07,south_africa,Africa,60701292,63,1755
2020-04-08,south_africa,Africa,60701292,97,1852
2020-04-09,south_africa,Africa,60701292,90,1942
2020-04-10,south_africa,Africa,60701292,69,2011
2020-04-11,south_africa,Africa,60701292,25,2036
2020-04-12,south_africa,Africa,60701292,146,2182
2020-04-13,south_africa,Africa,60701292,100,2282
2020-04-14,south_africa,Africa,60701292,144,2426
2020-04-15,south_africa,Africa,60701292,92,2518
2020-04-16,south_africa,Africa,60701292,100,2618
2020-04-17,south_africa,Africa,60701292,179,2797
2020-04-18,south_africa,Africa,60701292,253,3050
2020-04-19,south_africa,Africa,60701292,125,3175
2020-04-20,south_africa,Africa,60701292,143,3318
2020-04-21,south_africa,Africa,60701292,166,3484
2020-04-22,south_africa,Africa,60701292,171,3655
2020-04-23,south_africa,Africa,60701292,320,3975
2020-04-24,south_africa,Africa,60701292,269,4244
2020-04-25,south_africa,Africa,60701292,142,4386
2020-04-26,south_africa,Africa,60701292,186,4572
2020-04-27,south_africa,Africa,60701292,248,4820
2020-04-28,south_africa,Africa,60701292,204,5024
2020-04-29,south_africa,Africa,60701292,356,5380
2020-04-30,south_africa,Africa,60701292,299,5679
2020-05-01,south_africa,Africa,60701292,306,5985
2020-05-02,south_africa,Africa,60701292,387,6372
2020-05-03,south_africa,Africa,60701292,450,6822
2020-05-04,south_africa,Africa,60701292,440,7262
2020-05-05,south_africa,Africa,60701292,354,7616
2020-05-06,south_africa,Africa,60701292,237,7853
2020-05-07,south_africa,Africa,60701292,427,8280
2020-05-08,south_africa,Africa,60701292,667,8947
2020-05-09,south_africa,Africa,60701292,528,9475
2020-05-10,south_africa,Africa,60701292,599,10074
2020-05-11,south_africa,Africa,60701292,641,10715
2020-05-12,south_africa,Africa,60701292,702,11417
2020-05-13,south_africa,Africa,60701292,728,12145
2020-05-14,south_africa,Africa,60701292,669,12814
2020-05-15,south_africa,Africa,60701292,790,13604
2020-05-16,south_africa,Africa,60701292,836,14440
2020-05-17,south_africa,Africa,60701292,1167,15607
2020-05-18,south_africa,Africa,60701292,924,16531
2020-05-19,south_africa,Africa,60701292,772,17303
2020-05-20,south_africa,Africa,60701292,808,18111
2020-05-21,south_africa,Africa,60701292,1141,19252
2020-05-22,south_africa,Africa,60701292,994,20246
2020-05-23,south_africa,Africa,60701292,1225,21471
2020-05-24,south_africa,Africa,60701292,1247,22718
2020-05-25,south_africa,Africa,60701292,1038,23756
2020-05-26,south_africa,Africa,60701292,653,24409
2020-05-27,south_africa,Africa,60701292,1683,26092
2020-05-28,south_africa,Africa,60701292,1475,27567
2020-05-29,south_africa,Africa,60701292,1848,29415
2020-05-30,south_africa,Africa,60701292,1737,31152
2020-05-31,south_africa,Africa,60701292,1726,32878
2020-06-01,south_africa,Africa,60701292,1684,34562
2020-06-02,south_africa,Africa,60701292,1464,36026
2020-06-03,south_africa,Africa,60701292,1723,37749
2020-06-04,south_africa,Africa,60701292,3287,41036
2020-06-05,south_africa,Africa,60701292,2658,43694
2020-06-06,south_africa,Africa,60701292,2554,46248
2020-06-07,south_africa,Africa,60701292,2326,48574
2020-06-08,south_africa,Africa,60701292,2610,51184
2020-06-09,south_africa,Africa,60701292,2125,53309
2020-06-10,south_africa,Africa,60701292,2445,55754
2020-06-11,south_africa,Africa,60701292,3166,58920
2020-06-12,south_africa,Africa,60701292,3379,62299
2020-06-13,south_africa,Africa,60701292,3832,66131
2020-06-14,south_africa,Africa,60701292,4328,70459
2020-06-15,south_africa,Africa,60701292,3516,73975
2020-06-16,south_africa,Africa,60701292,2818,76793
2020-06-17,south_africa,Africa,60701292,4103,80896
2020-06-18,south_africa,Africa,60701292,3499,84395
2020-06-19,south_africa,Africa,60701292,3848,88243
2020-06-20,south_africa,Africa,60701292,4996,93239
2020-06-21,south_africa,Africa,60701292,4649,97888
2020-06-22,south_africa,Africa,60701292,4314,102202
2020-06-23,south_africa,Africa,60701292,4545,106747
2020-06-24,south_africa,Africa,60701292,5722,112469
2020-06-25,south_africa,Africa,60701292,6619,119088
2020-06-26,south_africa,Africa,60701292,6253,125341
2020-06-27,south_africa,Africa,60701292,7254,132595
2020-06-28,south_africa,Africa,60701292,6372,138967
2020-06-29,south_africa,Africa,60701292,6167,145134
2020-06-30,south_africa,Africa,60701292,6987,152121
2020-07-01,south_africa,Africa,60701292,8173,160294
2020-07-02,south_africa,Africa,60701292,8781,169075
2020-07-03,south_africa,Africa,60701292,9118,178193
2020-07-04,south_africa,Africa,60701292,10919,189112
2020-07-05,south_africa,Africa,60701292,8826,197938
2020-07-06,south_africa,Africa,60701292,9025,206963
2020-07-07,south_africa,Africa,60701292,10195,217158
2020-07-08,south_africa,Africa,60701292,8863,226021
2020-07-09,south_africa,Africa,60701292,13757,239778
2020-07-10,south_africa,Africa,60701292,12423,252201
2020-07-11,south_africa,Africa,60701292,13579,265780
2020-07-12,south_africa,Africa,60701292,12131,277911
2020-07-13,south_africa,Africa,60701292,11624,289535
2020-07-14,south_africa,Africa,60701292,10559,300094
2020-07-15,south_africa,Africa,60701292,12834,312928
2020-07-16,south_africa,Africa,60701292,13252,326180
2020-07-17,south_africa,Africa,60701292,13454,339634
2020-07-18,south_africa,Africa,60701292,13365,352999
2020-07-19,south_africa,Africa,60701292,13530,366529
2020-07-20,south_africa,Africa,60701292,9356,375885
2020-07-21,south_africa,Africa,60701292,8219,384104
2020-07-22,south_africa,Africa,60701292,13229,397333
2020-07-23,south_africa,Africa,60701292,13183,410516
2020-07-24,south_africa,Africa,60701292,14028,424544
2020-07-25,south_africa,Africa,60701292,12278,436822
2020-07-26,south_africa,Africa,60701292,11301,448123
2020-07-27,south_africa,Africa,60701292,7139,455262
2020-07-28,south_africa,Africa,60701292,7276,462538
2020-07-29,south_africa,Africa,60701292,11431,473969
2020-07-30,south_africa,Africa,60701292,11113,485082
2020-07-31,south_africa,Africa,60701292,11081,496163
2020-08-01,south_africa,Africa,60701292,10168,506331
2020-08-02,south_africa,Africa,60701292,8245,514576
2020-08-03,south_africa,Africa,60701292,5409,519985
2020-08-04,south_africa,Africa,60701292,4483,524468
2020-08-05,south_africa,Africa,60701292,8611,533079
2020-08-06,south_africa,Africa,60701292,8357,541436
2020-08-07,south_africa,Africa,60701292,7336,548772
2020-05-16,south_sudan,Africa,11438136,0,236
2020-05-17,south_sudan,Africa,11438136,54,290
2020-05-18,south_sudan,Africa,11438136,0,290
2020-05-19,south_sudan,Africa,11438136,0,290
2020-05-20,south_sudan,Africa,11438136,0,290
2020-05-21,south_sudan,Africa,11438136,191,481
2020-05-22,south_sudan,Africa,11438136,82,563
2020-05-23,south_sudan,Africa,11438136,92,655
2020-05-24,south_sudan,Africa,11438136,0,655
2020-05-25,south_sudan,Africa,11438136,151,806
2020-05-26,south_sudan,Africa,11438136,0,806
2020-05-27,south_sudan,Africa,11438136,188,994
2020-05-28,south_sudan,Africa,11438136,0,994
2020-05-29,south_sudan,Africa,11438136,0,994
2020-05-30,south_sudan,Africa,11438136,0,994
2020-05-31,south_sudan,Africa,11438136,0,994
2020-06-01,south_sudan,Africa,11438136,0,994
2020-06-02,south_sudan,Africa,11438136,0,994
2020-06-03,south_sudan,Africa,11438136,0,994
2020-06-04,south_sudan,Africa,11438136,0,994
2020-06-05,south_sudan,Africa,11438136,0,994
2020-06-06,south_sudan,Africa,11438136,0,994
2020-06-07,south_sudan,Africa,11438136,323,1317
2020-06-08,south_sudan,Africa,11438136,287,1604
2020-06-09,south_sudan,Africa,11438136,0,1604
2020-06-10,south_sudan,Africa,11438136,0,1604
2020-06-11,south_sudan,Africa,11438136,66,1670
2020-06-12,south_sudan,Africa,11438136,0,1670
2020-06-13,south_sudan,Africa,11438136,23,1693
2020-06-14,south_sudan,Africa,11438136,0,1693
2020-06-15,south_sudan,Africa,11438136,0,1693
2020-06-16,south_sudan,Africa,11438136,83,1776
2020-06-17,south_sudan,Africa,11438136,37,1813
2020-06-18,south_sudan,Africa,11438136,17,1830
2020-06-19,south_sudan,Africa,11438136,34,1864
2020-06-20,south_sudan,Africa,11438136,18,1882
2020-06-21,south_sudan,Africa,11438136,10,1892
2020-06-22,south_sudan,Africa,11438136,24,1916
2020-06-23,south_sudan,Africa,11438136,14,1930
2020-06-24,south_sudan,Africa,11438136,12,1942
2020-06-25,south_sudan,Africa,11438136,0,1942
2020-06-26,south_sudan,Africa,11438136,0,1942
2020-06-27,south_sudan,Africa,11438136,0,1942
2020-06-28,south_sudan,Africa,11438136,47,1989
2020-06-29,south_sudan,Africa,11438136,0,1989
2020-06-30,south_sudan,Africa,11438136,18,2007
2020-07-01,south_sudan,Africa,11438136,14,2021
2020-07-02,south_sudan,Africa,11438136,0,2021
2020-07-03,south_sudan,Africa,11438136,0,2021
2020-07-04,south_sudan,Africa,11438136,0,2021
2020-07-05,south_sudan,Africa,11438136,0,2021
2020-07-06,south_sudan,Africa,11438136,0,2021
2020-07-07,south_sudan,Africa,11438136,0,2021
2020-07-08,south_sudan,Africa,11438136,0,2021
2020-07-09,south_sudan,Africa,11438136,0,2021
2020-07-10,south_sudan,Africa,11438136,0,2021
2020-07-11,south_sudan,Africa,11438136,0,2021
2020-07-12,south_sudan,Africa,11438136,0,2021
2020-07-13,south_sudan,Africa,11438136,127,2148
2020-07-14,south_sudan,Africa,11438136,0,2148
2020-07-15,south_sudan,Africa,11438136,5,2153
2020-07-16,south_sudan,Africa,11438136,18,2171
2020-07-17,south_sudan,Africa,11438136,20,2191
2020-07-18,south_sudan,Africa,11438136,0,2191
2020-07-19,south_sudan,Africa,11438136,9,2200
2020-07-20,south_sudan,Africa,11438136,11,2211
2020-07-21,south_sudan,Africa,11438136,0,2211
2020-07-22,south_sudan,Africa,11438136,0,2211
2020-07-23,south_sudan,Africa,11438136,28,2239
2020-07-24,south_sudan,Africa,11438136,19,2258
2020-07-25,south_sudan,Africa,11438136,0,2258
2020-07-26,south_sudan,Africa,11438136,4,2262
2020-07-27,south_sudan,Africa,11438136,43,2305
2020-07-28,south_sudan,Africa,11438136,0,2305
2020-07-29,south_sudan,Africa,11438136,17,2322
2020-07-30,south_sudan,Africa,11438136,0,2322
2020-07-31,south_sudan,Africa,11438136,0,2322
2020-08-01,south_sudan,Africa,11438136,30,2352
2020-08-02,south_sudan,Africa,11438136,77,2429
2020-08-03,south_sudan,Africa,11438136,0,2429
2020-08-04,south_sudan,Africa,11438136,8,2437
2020-08-05,south_sudan,Africa,11438136,0,2437
2020-08-06,south_sudan,Africa,11438136,13,2450
2020-08-07,south_sudan,Africa,11438136,0,2450
2020-08-08,south_sudan,Africa,11438136,13,2463
2020-08-09,south_sudan,Africa,11438136,7,2470
2020-08-10,south_sudan,Africa,11438136,0,2470
2020-08-11,south_sudan,Africa,11438136,2,2472
2020-08-12,south_sudan,Africa,11438136,5,2477
2020-08-13,south_sudan,Africa,11438136,1,2478
2020-08-14,south_sudan,Africa,11438136,4,2482
2020-08-15,south_sudan,Africa,11438136,6,2488
2020-08-16,south_sudan,Africa,11438136,1,2489
2020-08-17,south_sudan,Africa,11438136,1,2490
2020-08-18,south_sudan,Africa,11438136,0,2490
2020-08-19,south_sudan,Africa,11438136,4,2494
2020-08-20,south_sudan,Africa,11438136,0,2494
2020-08-21,south_sudan,Africa,11438136,3,2497
2020-08-22,south_sudan,Africa,11438136,0,2497
2020-08-23,south_sudan,Africa,11438136,2,2499
2020-08-24,south_sudan,Africa,11438136,5,2504
2020-08-25,south_sudan,Africa,11438136,3,2507
2020-08-26,south_sudan,Africa,11438136,3,2510
2020-08-27,south_sudan,Africa,11438136,4,2514
2020-08-28,south_sudan,Africa,11438136,4,2518
2020-08-29,south_sudan,Africa,11438136,1,2519
2020-08-30,south_sudan,Africa,11438136,0,2519
2020-08-31,south_sudan,Africa,11438136,8,2527
2020-09-01,south_sudan,Africa,11438136,0,2527
2020-09-02,south_sudan,Africa,11438136,5,2532
2020-09-03,south_sudan,Africa,11438136,1,2533
2020-09-04,south_sudan,Africa,11438136,3,2536
2020-09-05,south_sudan,Africa,11438136,8,2544
2020-09-06,south_sudan,Africa,11438136,0,2544
2020-09-07,south_sudan,Africa,11438136,1,2545
2020-09-08,south_sudan,Africa,11438136,7,2552
2020-09-09,south_sudan,Africa,11438136,3,2555
2020-09-10,south_sudan,Africa,11438136,0,2555
2020-09-11,south_sudan,Africa,11438136,13,2568
2020-09-12,south_sudan,Africa,11438136,10,2578
2020-09-13,south_sudan,Africa,11438136,0,2578
2020-09-14,south_sudan,Africa,11438136,9,2587
2020-09-15,south_sudan,Africa,11438136,5,2592
2020-09-16,south_sudan,Africa,11438136,2,2594
2020-09-17,south_sudan,Africa,11438136,5,2599
2020-09-18,south_sudan,Africa,11438136,10,2609
2020-09-19,south_sudan,Africa,11438136,33,2642
2020-09-20,south_sudan,Africa,11438136,0,2642
2020-09-21,south_sudan,Africa,11438136,7,2649
2020-09-22,south_sudan,Africa,11438136,11,2660
2020-09-23,south_sudan,Africa,11438136,4,2664
2020-09-24,south_sudan,Africa,11438136,5,2669
2020-09-25,south_sudan,Africa,11438136,7,2676
2020-09-26,south_sudan,Africa,11438136,0,2676
2020-09-27,south_sudan,Africa,11438136,10,2686
2020-09-28,south_sudan,Africa,11438136,6,2692
2020-09-29,south_sudan,Africa,11438136,8,2700
2020-09-30,south_sudan,Africa,11438136,4,2704
2020-10-01,south_sudan,Africa,11438136,0,2704
2020-10-02,south_sudan,Africa,11438136,11,2715
2020-10-03,south_sudan,Africa,11438136,0,2715
2020-10-04,south_sudan,Africa,11438136,11,2726
2020-10-05,south_sudan,Africa,11438136,0,2726
2020-10-06,south_sudan,Africa,11438136,8,2734
2020-10-07,south_sudan,Africa,11438136,14,2748
2020-10-08,south_sudan,Africa,11438136,1,2749
2020-10-09,south_sudan,Africa,11438136,12,2761
2020-10-10,south_sudan,Africa,11438136,0,2761
2020-10-11,south_sudan,Africa,11438136,16,2777
2020-10-12,south_sudan,Africa,11438136,10,2787
2020-10-13,south_sudan,Africa,11438136,11,2798
2020-10-14,south_sudan,Africa,11438136,0,2798
2020-10-15,south_sudan,Africa,11438136,9,2807
2020-10-16,south_sudan,Africa,11438136,10,2817
2020-10-17,south_sudan,Africa,11438136,0,2817
2020-10-18,south_sudan,Africa,11438136,25,2842
2020-10-19,south_sudan,Africa,11438136,5,2847
2020-10-20,south_sudan,Africa,11438136,0,2847
2020-10-21,south_sudan,Africa,11438136,23,2870
2020-10-22,south_sudan,Africa,11438136,2,2872
2020-10-23,south_sudan,Africa,11438136,4,2876
2020-10-24,south_sudan,Africa,11438136,2,2878
2020-10-25,south_sudan,Africa,11438136,5,2883
2020-10-26,south_sudan,Africa,11438136,0,2883
2020-10-27,south_sudan,Africa,11438136,7,2890
2020-10-28,south_sudan,Africa,11438136,0,2890
2020-10-29,south_sudan,Africa,11438136,13,2903
2020-10-30,south_sudan,Africa,11438136,0,2903
2020-10-31,south_sudan,Africa,11438136,2,2905
2020-11-01,south_sudan,Africa,11438136,21,2926
2020-11-02,south_sudan,Africa,11438136,0,2926
2020-11-03,south_sudan,Africa,11438136,14,2940
2020-11-04,south_sudan,Africa,11438136,3,2943
2020-11-05,south_sudan,Africa,11438136,0,2943
2020-11-06,south_sudan,Africa,11438136,0,2943
2020-11-07,south_sudan,Africa,11438136,0,2943
2020-11-08,south_sudan,Africa,11438136,0,2943
2020-11-09,south_sudan,Africa,11438136,17,2960
2020-11-10,south_sudan,Africa,11438136,0,2960
2020-11-11,south_sudan,Africa,11438136,0,2960
2020-11-12,south_sudan,Africa,11438136,0,2960
2020-11-13,south_sudan,Africa,11438136,20,2980
2020-11-14,south_sudan,Africa,11438136,23,3003
2020-11-15,south_sudan,Africa,11438136,0,3003
2020-11-16,south_sudan,Africa,11438136,9,3012
2020-11-17,south_sudan,Africa,11438136,4,3016
2020-11-18,south_sudan,Africa,11438136,0,3016
2020-11-19,south_sudan,Africa,11438136,0,3016
2020-11-20,south_sudan,Africa,11438136,0,3016
2020-11-21,south_sudan,Africa,11438136,31,3047
2020-11-22,south_sudan,Africa,11438136,0,3047
2020-11-23,south_sudan,Africa,11438136,17,3064
2020-11-24,south_sudan,Africa,11438136,5,3069
2020-11-25,south_sudan,Africa,11438136,4,3073
2020-11-26,south_sudan,Africa,11438136,19,3092
2020-11-27,south_sudan,Africa,11438136,12,3104
2020-11-28,south_sudan,Africa,11438136,3,3107
2020-11-29,south_sudan,Africa,11438136,2,3109
2020-11-30,south_sudan,Africa,11438136,0,3109
2020-12-01,south_sudan,Africa,11438136,2,3111
2020-12-02,south_sudan,Africa,11438136,7,3118
2020-12-03,south_sudan,Africa,11438136,36,3154
2020-12-04,south_sudan,Africa,11438136,0,3154
2020-12-05,south_sudan,Africa,11438136,12,3166
2020-12-06,south_sudan,Africa,11438136,15,3181
2020-12-07,south_sudan,Africa,11438136,0,3181
2020-12-08,south_sudan,Africa,11438136,0,3181
2020-12-09,south_sudan,Africa,11438136,0,3181
2020-12-10,south_sudan,Africa,11438136,0,3181
2020-12-11,south_sudan,Africa,11438136,0,3181
2020-12-12,south_sudan,Africa,11438136,25,3206
2020-12-13,south_sudan,Africa,11438136,0,3206
2020-12-14,south_sudan,Africa,11438136,0,3206
2020-12-15,south_sudan,Africa,11438136,16,3222
2020-12-16,south_sudan,Africa,11438136,0,3222
2020-12-17,south_sudan,Africa,11438136,0,3222
2020-12-18,south_sudan,Africa,11438136,6,3228
2020-12-19,south_sudan,Africa,11438136,0,3228
2020-12-20,south_sudan,Africa,11438136,0,3228
2020-12-21,south_sudan,Africa,11438136,6,3234
2020-12-22,south_sudan,Africa,11438136,221,3455
2020-12-23,south_sudan,Africa,11438136,0,3455
2020-12-24,south_sudan,Africa,11438136,0,3455
2020-12-25,south_sudan,Africa,11438136,0,3455
2020-12-26,south_sudan,Africa,11438136,0,3455
2020-12-27,south_sudan,Africa,11438136,35,3490
2020-12-28,south_sudan,Africa,11438136,1,3491
2020-12-29,south_sudan,Africa,11438136,20,3511
2020-12-30,south_sudan,Africa,11438136,29,3540
2020-12-31,south_sudan,Africa,11438136,18,3558
2021-01-01,south_sudan,Africa,11438136,0,3558
2021-01-02,south_sudan,Africa,11438136,0,3558
2021-01-03,south_sudan,Africa,11438136,18,3576
2021-01-04,south_sudan,Africa,11438136,13,3589
2021-01-05,south_sudan,Africa,11438136,4,3593
2021-01-06,south_sudan,Africa,11438136,11,3604
2021-01-07,south_sudan,Africa,11438136,8,3612
2021-01-08,south_sudan,Africa,11438136,8,3620
2021-01-09,south_sudan,Africa,11438136,20,3640
2021-01-10,south_sudan,Africa,11438136,9,3649
2021-01-11,south_sudan,Africa,11438136,13,3662
2021-01-12,south_sudan,Africa,11438136,8,3670
2021-01-13,south_sudan,Africa,11438136,0,3670
2021-01-14,south_sudan,Africa,11438136,0,3670
2021-01-15,south_sudan,Africa,11438136,0,3670
2021-01-16,south_sudan,Africa,11438136,0,3670
2021-01-17,south_sudan,Africa,11438136,23,3693
2021-01-18,south_sudan,Africa,11438136,10,3703
2021-01-19,south_sudan,Africa,11438136,59,3762
2021-01-20,south_sudan,Africa,11438136,11,3773
2021-01-21,south_sudan,Africa,11438136,34,3807
2021-01-22,south_sudan,Africa,11438136,20,3827
2021-01-23,south_sudan,Africa,11438136,16,3843
2021-01-24,south_sudan,Africa,11438136,22,3865
2021-01-25,south_sudan,Africa,11438136,17,3882
2021-01-26,south_sudan,Africa,11438136,31,3913
2021-01-27,south_sudan,Africa,11438136,16,3929
2021-01-28,south_sudan,Africa,11438136,0,3929
2021-01-29,south_sudan,Africa,11438136,0,3929
2021-01-30,south_sudan,Africa,11438136,0,3929
2021-01-31,south_sudan,Africa,11438136,0,3929
2021-02-01,south_sudan,Africa,11438136,0,3929
2021-02-02,south_sudan,Africa,11438136,0,3929
2021-02-03,south_sudan,Africa,11438136,0,3929
2021-02-04,south_sudan,Africa,11438136,338,4267
2021-02-05,south_sudan,Africa,11438136,88,4355
2021-02-06,south_sudan,Africa,11438136,0,4355
2021-02-07,south_sudan,Africa,11438136,0,4355
2021-02-08,south_sudan,Africa,11438136,254,4609
2021-02-09,south_sudan,Africa,11438136,195,4804
2021-02-10,south_sudan,Africa,11438136,156,4960
2021-02-11,south_sudan,Africa,11438136,174,5134
2021-02-12,south_sudan,Africa,11438136,0,5134
2021-02-13,south_sudan,Africa,11438136,176,5310
2021-02-14,south_sudan,Africa,11438136,103,5413
2021-02-15,south_sudan,Africa,11438136,149,5562
2021-02-16,south_sudan,Africa,11438136,148,5710
2021-02-17,south_sudan,Africa,11438136,212,5922
2021-02-18,south_sudan,Africa,11438136,162,6084
2021-02-19,south_sudan,Africa,11438136,183,6267
2021-02-20,south_sudan,Africa,11438136,150,6417
2021-02-21,south_sudan,Africa,11438136,166,6583
2021-02-22,south_sudan,Africa,11438136,348,6931
2021-02-23,south_sudan,Africa,11438136,167,7098
2021-02-24,south_sudan,Africa,11438136,126,7224
2021-02-25,south_sudan,Africa,11438136,125,7349
2021-02-26,south_sudan,Africa,11438136,248,7597
2021-02-27,south_sudan,Africa,11438136,174,7771
2021-02-28,south_sudan,Africa,11438136,155,7926
2021-03-01,south_sudan,Africa,11438136,84,8010
2021-03-02,south_sudan,Africa,11438136,134,8144
2021-03-03,south_sudan,Africa,11438136,161,8305
2021-03-04,south_sudan,Africa,11438136,109,8414
2021-03-05,south_sudan,Africa,11438136,113,8527
2021-03-06,south_sudan,Africa,11438136,150,8677
2021-03-07,south_sudan,Africa,11438136,89,8766
2021-03-08,south_sudan,Africa,11438136,104,8870
2021-03-09,south_sudan,Africa,11438136,89,8959
2021-03-10,south_sudan,Africa,11438136,133,9092
2021-03-11,south_sudan,Africa,11438136,113,9205
2021-03-12,south_sudan,Africa,11438136,129,9334
2021-03-13,south_sudan,Africa,11438136,95,9429
2021-03-14,south_sudan,Africa,11438136,61,9490
2021-03-15,south_sudan,Africa,11438136,64,9554
2021-03-16,south_sudan,Africa,11438136,59,9613
2021-03-17,south_sudan,Africa,11438136,81,9694
2021-03-18,south_sudan,Africa,11438136,74,9768
2021-03-19,south_sudan,Africa,11438136,41,9809
2021-03-20,south_sudan,Africa,11438136,40,9849
2021-03-21,south_sudan,Africa,11438136,30,9879
2021-03-22,south_sudan,Africa,11438136,11,9890
2021-03-23,south_sudan,Africa,11438136,29,9919
2021-03-24,south_sudan,Africa,11438136,50,9969
2021-03-25,south_sudan,Africa,11438136,79,10048
2021-03-26,south_sudan,Africa,11438136,0,10048
2021-03-27,south_sudan,Africa,11438136,31,10079
2021-03-28,south_sudan,Africa,11438136,19,10098
2021-03-29,south_sudan,Africa,11438136,21,10119
2021-03-30,south_sudan,Africa,11438136,1,10120
2021-03-31,south_sudan,Africa,11438136,48,10168
2021-04-01,south_sudan,Africa,11438136,29,10197
2021-04-02,south_sudan,Africa,11438136,22,10219
2021-04-03,south_sudan,Africa,11438136,36,10255
2021-04-04,south_sudan,Africa,11438136,12,10267
2021-04-05,south_sudan,Africa,11438136,14,10281
2021-04-06,south_sudan,Africa,11438136,5,10286
2021-04-07,south_sudan,Africa,11438136,11,10297
2021-04-08,south_sudan,Africa,11438136,27,10324
2021-04-09,south_sudan,Africa,11438136,16,10340
2021-04-10,south_sudan,Africa,11438136,19,10359
2021-04-11,south_sudan,Africa,11438136,13,10372
2021-04-12,south_sudan,Africa,11438136,9,10381
2021-04-13,south_sudan,Africa,11438136,6,10387
2021-04-14,south_sudan,Africa,11438136,18,10405
2021-04-15,south_sudan,Africa,11438136,11,10416
2021-04-16,south_sudan,Africa,11438136,16,10432
2021-04-17,south_sudan,Africa,11438136,20,10452
2021-04-18,south_sudan,Africa,11438136,21,10473
2021-04-19,south_sudan,Africa,11438136,2,10475
2021-04-20,south_sudan,Africa,11438136,3,10478
2021-04-21,south_sudan,Africa,11438136,8,10486
2021-04-22,south_sudan,Africa,11438136,18,10504
2021-04-23,south_sudan,Africa,11438136,11,10515
2021-04-24,south_sudan,Africa,11438136,0,10515
2021-04-25,south_sudan,Africa,11438136,18,10533
2021-04-26,south_sudan,Africa,11438136,5,10538
2021-04-27,south_sudan,Africa,11438136,15,10553
2021-04-28,south_sudan,Africa,11438136,0,10553
2021-04-29,south_sudan,Africa,11438136,14,10567
2021-04-30,south_sudan,Africa,11438136,16,10583
2021-05-01,south_sudan,Africa,11438136,0,10583
2021-05-02,south_sudan,Africa,11438136,15,10598
2021-05-03,south_sudan,Africa,11438136,4,10602
2021-05-04,south_sudan,Africa,11438136,11,10613
2021-05-05,south_sudan,Africa,11438136,0,10613
2020-02-20,spain,Europe,46788503,57,867
2020-02-21,spain,Europe,46788503,62,929
2020-02-22,spain,Europe,46788503,60,989
2020-02-23,spain,Europe,46788503,75,1064
2020-02-24,spain,Europe,46788503,108,1172
2020-02-25,spain,Europe,46788503,129,1301
2020-02-26,spain,Europe,46788503,147,1448
2020-02-27,spain,Europe,46788503,180,1628
2020-02-28,spain,Europe,46788503,317,1945
2020-02-29,spain,Europe,46788503,238,2183
2020-03-01,spain,Europe,46788503,676,2859
2020-03-02,spain,Europe,46788503,785,3644
2020-03-03,spain,Europe,46788503,776,4420
2020-03-04,spain,Europe,46788503,934,5354
2020-03-05,spain,Europe,46788503,1256,6610
2020-03-06,spain,Europe,46788503,1587,8197
2020-03-07,spain,Europe,46788503,1814,10011
2020-03-08,spain,Europe,46788503,2143,12154
2020-03-09,spain,Europe,46788503,3328,15482
2020-03-10,spain,Europe,46788503,4568,20050
2020-03-11,spain,Europe,46788503,4620,24670
2020-03-12,spain,Europe,46788503,5801,30471
2020-03-13,spain,Europe,46788503,7627,38098
2020-03-14,spain,Europe,46788503,7276,45374
2020-03-15,spain,Europe,46788503,7746,53120
2020-03-16,spain,Europe,46788503,9250,62370
2020-03-17,spain,Europe,46788503,8617,70987
2020-03-18,spain,Europe,46788503,8749,79736
2020-03-19,spain,Europe,46788503,8444,88180
2020-03-20,spain,Europe,46788503,10401,98581
2020-03-21,spain,Europe,46788503,7251,105832
2020-03-22,spain,Europe,46788503,6609,112441
2020-03-23,spain,Europe,46788503,8078,120519
2020-03-24,spain,Europe,46788503,6952,127471
2020-03-25,spain,Europe,46788503,6777,134248
2020-03-26,spain,Europe,46788503,6203,140451
2020-03-27,spain,Europe,46788503,5918,146369
2020-03-28,spain,Europe,46788503,5233,151602
2020-03-29,spain,Europe,46788503,4144,155746
2020-03-30,spain,Europe,46788503,5026,160772
2020-03-31,spain,Europe,46788503,4312,165084
2020-04-01,spain,Europe,46788503,5353,170437
2020-04-02,spain,Europe,46788503,4349,174786
2020-04-03,spain,Europe,46788503,4363,179149
2020-04-04,spain,Europe,46788503,3584,182733
2020-04-05,spain,Europe,46788503,3137,185870
2020-04-06,spain,Europe,46788503,3455,189325
2020-04-07,spain,Europe,46788503,3119,192444
2020-04-08,spain,Europe,46788503,3394,195838
2020-04-09,spain,Europe,46788503,3208,199046
2020-04-10,spain,Europe,46788503,3100,202146
2020-04-11,spain,Europe,46788503,2818,204964
2020-04-12,spain,Europe,46788503,2216,207180
2020-04-13,spain,Europe,46788503,2146,209326
2020-04-14,spain,Europe,46788503,2208,211534
2020-04-15,spain,Europe,46788503,2335,213869
2020-04-16,spain,Europe,46788503,2242,216111
2020-04-17,spain,Europe,46788503,1871,217982
2020-04-18,spain,Europe,46788503,1636,219618
2020-04-19,spain,Europe,46788503,1122,220740
2020-04-20,spain,Europe,46788503,1453,222193
2020-04-21,spain,Europe,46788503,1305,223498
2020-04-22,spain,Europe,46788503,1449,224947
2020-04-23,spain,Europe,46788503,1167,226114
2020-04-24,spain,Europe,46788503,1101,227215
2020-04-25,spain,Europe,46788503,751,227966
2020-04-26,spain,Europe,46788503,551,228517
2020-04-27,spain,Europe,46788503,699,229216
2020-04-28,spain,Europe,46788503,838,230054
2020-04-29,spain,Europe,46788503,742,230796
2020-04-30,spain,Europe,46788503,735,231531
2020-05-01,spain,Europe,46788503,741,232272
2020-05-02,spain,Europe,46788503,649,232921
2020-05-03,spain,Europe,46788503,448,233369
2020-05-04,spain,Europe,46788503,520,233889
2020-05-05,spain,Europe,46788503,324,234213
2020-05-06,spain,Europe,46788503,309,234522
2020-05-07,spain,Europe,46788503,325,234847
2020-05-08,spain,Europe,46788503,317,235164
2020-05-09,spain,Europe,46788503,249,235413
2020-05-10,spain,Europe,46788503,290,235703
2020-05-11,spain,Europe,46788503,579,236282
2020-05-12,spain,Europe,46788503,538,236820
2020-05-13,spain,Europe,46788503,634,237454
2020-05-14,spain,Europe,46788503,562,238016
2020-05-15,spain,Europe,46788503,612,238628
2020-05-16,spain,Europe,46788503,347,238975
2020-05-17,spain,Europe,46788503,312,239287
2020-05-18,spain,Europe,46788503,580,239867
2020-05-19,spain,Europe,46788503,618,240485
2020-05-20,spain,Europe,46788503,515,241000
2020-05-21,spain,Europe,46788503,548,241548
2020-05-22,spain,Europe,46788503,621,242169
2020-05-23,spain,Europe,46788503,353,242522
2020-05-24,spain,Europe,46788503,327,242849
2020-05-25,spain,Europe,46788503,589,243438
2020-05-26,spain,Europe,46788503,585,244023
2020-05-27,spain,Europe,46788503,448,244471
2020-05-28,spain,Europe,46788503,545,245016
2020-05-29,spain,Europe,46788503,511,245527
2020-05-30,spain,Europe,46788503,314,245841
2020-05-31,spain,Europe,46788503,237,246078
2020-06-01,spain,Europe,46788503,424,246502
2020-06-02,spain,Europe,46788503,405,246907
2020-06-03,spain,Europe,46788503,445,247352
2020-06-04,spain,Europe,46788503,387,247739
2020-06-05,spain,Europe,46788503,493,248232
2020-06-06,spain,Europe,46788503,259,248491
2020-06-07,spain,Europe,46788503,217,248708
2020-06-08,spain,Europe,46788503,424,249132
2020-06-09,spain,Europe,46788503,356,249488
2020-06-10,spain,Europe,46788503,364,249852
2020-06-11,spain,Europe,46788503,325,250177
2020-06-12,spain,Europe,46788503,367,250544
2020-06-13,spain,Europe,46788503,150,250694
2020-06-14,spain,Europe,46788503,164,250858
2020-06-15,spain,Europe,46788503,325,251183
2020-06-16,spain,Europe,46788503,290,251473
2020-06-17,spain,Europe,46788503,308,251781
2020-06-18,spain,Europe,46788503,311,252092
2020-06-19,spain,Europe,46788503,284,252376
2020-06-20,spain,Europe,46788503,261,252637
2020-06-21,spain,Europe,46788503,241,252878
2020-06-22,spain,Europe,46788503,319,253197
2020-06-23,spain,Europe,46788503,360,253557
2020-06-24,spain,Europe,46788503,399,253956
2020-06-25,spain,Europe,46788503,367,254323
2020-06-26,spain,Europe,46788503,417,254740
2020-06-27,spain,Europe,46788503,313,255053
2020-06-28,spain,Europe,46788503,267,255320
2020-06-29,spain,Europe,46788503,421,255741
2020-06-30,spain,Europe,46788503,455,256196
2020-07-01,spain,Europe,46788503,576,256772
2020-07-02,spain,Europe,46788503,441,257213
2020-07-03,spain,Europe,46788503,562,257775
2020-07-04,spain,Europe,46788503,444,258219
2020-07-05,spain,Europe,46788503,447,258666
2020-07-06,spain,Europe,46788503,739,259405
2020-07-07,spain,Europe,46788503,828,260233
2020-07-08,spain,Europe,46788503,954,261187
2020-07-09,spain,Europe,46788503,976,262163
2020-07-10,spain,Europe,46788503,1182,263345
2020-07-11,spain,Europe,46788503,911,264256
2020-07-12,spain,Europe,46788503,896,265152
2020-07-13,spain,Europe,46788503,1428,266580
2020-07-14,spain,Europe,46788503,1577,268157
2020-07-15,spain,Europe,46788503,1910,270067
2020-07-16,spain,Europe,46788503,1756,271823
2020-07-17,spain,Europe,46788503,2088,273911
2020-07-18,spain,Europe,46788503,1848,275759
2020-07-19,spain,Europe,46788503,1624,277383
2020-07-20,spain,Europe,46788503,2414,279797
2020-07-21,spain,Europe,46788503,2408,282205
2020-07-22,spain,Europe,46788503,2444,284649
2020-07-23,spain,Europe,46788503,2318,286967
2020-07-24,spain,Europe,46788503,2594,289561
2020-07-25,spain,Europe,46788503,2106,291667
2020-07-26,spain,Europe,46788503,1913,293580
2020-07-27,spain,Europe,46788503,3035,296615
2020-07-28,spain,Europe,46788503,3186,299801
2020-07-29,spain,Europe,46788503,3285,303086
2020-07-30,spain,Europe,46788503,3180,306266
2020-07-31,spain,Europe,46788503,3677,309943
2020-08-01,spain,Europe,46788503,3600,313543
2020-08-02,spain,Europe,46788503,2763,316306
2020-08-03,spain,Europe,46788503,4110,320416
2020-08-04,spain,Europe,46788503,4630,325046
2020-08-05,spain,Europe,46788503,4613,329659
2020-08-06,spain,Europe,46788503,4543,334202
2020-08-07,spain,Europe,46788503,5317,339519
2020-08-08,spain,Europe,46788503,4184,343703
2020-08-09,spain,Europe,46788503,3973,347676
2020-08-10,spain,Europe,46788503,5994,353670
2020-08-11,spain,Europe,46788503,6324,359994
2020-08-12,spain,Europe,46788503,6491,366485
2020-08-13,spain,Europe,46788503,6247,372732
2020-08-14,spain,Europe,46788503,7045,379777
2020-08-15,spain,Europe,46788503,5525,385302
2020-08-16,spain,Europe,46788503,4844,390146
2020-08-17,spain,Europe,46788503,6996,397142
2020-08-18,spain,Europe,46788503,8280,405422
2020-08-19,spain,Europe,46788503,8297,413719
2020-08-20,spain,Europe,46788503,8315,422034
2020-08-21,spain,Europe,46788503,9528,431562
2020-08-22,spain,Europe,46788503,6533,438095
2020-08-23,spain,Europe,46788503,5807,443902
2020-08-24,spain,Europe,46788503,8035,451937
2020-08-25,spain,Europe,46788503,10023,461960
2020-08-26,spain,Europe,46788503,9672,471632
2020-08-27,spain,Europe,46788503,9358,480990
2020-08-28,spain,Europe,46788503,10769,491759
2020-08-29,spain,Europe,46788503,7143,498902
2020-08-30,spain,Europe,46788503,6290,505192
2020-08-31,spain,Europe,46788503,8288,513480
2020-09-01,spain,Europe,46788503,11198,524678
2020-09-02,spain,Europe,46788503,10388,535066
2020-09-03,spain,Europe,46788503,10242,545308
2020-09-04,spain,Europe,46788503,11369,556677
2020-09-05,spain,Europe,46788503,8560,565237
2020-09-06,spain,Europe,46788503,7295,572532
2020-09-07,spain,Europe,46788503,9244,581776
2020-09-08,spain,Europe,46788503,11230,593006
2020-09-09,spain,Europe,46788503,11646,604652
2020-09-10,spain,Europe,46788503,11479,616131
2020-09-11,spain,Europe,46788503,11952,628083
2020-09-12,spain,Europe,46788503,9213,637296
2020-09-13,spain,Europe,46788503,7912,645208
2020-09-14,spain,Europe,46788503,10470,655678
2020-09-15,spain,Europe,46788503,12049,667727
2020-09-16,spain,Europe,46788503,12035,679762
2020-09-17,spain,Europe,46788503,11515,691277
2020-09-18,spain,Europe,46788503,14181,705458
2020-09-19,spain,Europe,46788503,8364,713822
2020-09-20,spain,Europe,46788503,7127,720949
2020-09-21,spain,Europe,46788503,9930,730879
2020-09-22,spain,Europe,46788503,12198,743077
2020-09-23,spain,Europe,46788503,11609,754686
2020-09-24,spain,Europe,46788503,10981,765667
2020-09-25,spain,Europe,46788503,11634,777301
2020-09-26,spain,Europe,46788503,7653,784954
2020-09-27,spain,Europe,46788503,6296,791250
2020-09-28,spain,Europe,46788503,9098,800348
2020-09-29,spain,Europe,46788503,10531,810879
2020-09-30,spain,Europe,46788503,9973,820852
2020-10-01,spain,Europe,46788503,10548,831400
2020-10-02,spain,Europe,46788503,10885,842285
2020-10-03,spain,Europe,46788503,7917,850202
2020-10-04,spain,Europe,46788503,7265,857467
2020-10-05,spain,Europe,46788503,11101,868568
2020-10-06,spain,Europe,46788503,12414,880982
2020-10-07,spain,Europe,46788503,12252,893234
2020-10-08,spain,Europe,46788503,12429,905663
2020-10-09,spain,Europe,46788503,13309,918972
2020-10-10,spain,Europe,46788503,10686,929658
2020-10-11,spain,Europe,46788503,8810,938468
2020-10-12,spain,Europe,46788503,10653,949121
2020-10-13,spain,Europe,46788503,14099,963220
2020-10-14,spain,Europe,46788503,15977,979197
2020-10-15,spain,Europe,46788503,16071,995268
2020-10-16,spain,Europe,46788503,17078,1012346
2020-10-17,spain,Europe,46788503,13936,1026282
2020-10-18,spain,Europe,46788503,12662,1038944
2020-10-19,spain,Europe,46788503,20263,1059207
2020-10-20,spain,Europe,46788503,22315,1081522
2020-10-21,spain,Europe,46788503,21886,1103408
2020-10-22,spain,Europe,46788503,20990,1124398
2020-10-23,spain,Europe,46788503,21881,1146279
2020-10-24,spain,Europe,46788503,16897,1163176
2020-10-25,spain,Europe,46788503,15009,1178185
2020-10-26,spain,Europe,46788503,21921,1200106
2020-10-27,spain,Europe,46788503,22766,1222872
2020-10-28,spain,Europe,46788503,21722,1244594
2020-10-29,spain,Europe,46788503,20260,1264854
2020-10-30,spain,Europe,46788503,21195,1286049
2020-10-31,spain,Europe,46788503,16502,1302551
2020-11-01,spain,Europe,46788503,15638,1318189
2020-11-02,spain,Europe,46788503,18907,1337096
2020-11-03,spain,Europe,46788503,20954,1358050
2020-11-04,spain,Europe,46788503,20085,1378135
2020-11-05,spain,Europe,46788503,19210,1397345
2020-11-06,spain,Europe,46788503,18955,1416300
2020-11-07,spain,Europe,46788503,15050,1431350
2020-11-08,spain,Europe,46788503,12093,1443443
2020-11-09,spain,Europe,46788503,16819,1460262
2020-11-10,spain,Europe,46788503,17347,1477609
2020-11-11,spain,Europe,46788503,15947,1493556
2020-11-12,spain,Europe,46788503,14302,1507858
2020-11-13,spain,Europe,46788503,14324,1522182
2020-11-14,spain,Europe,46788503,11532,1533714
2020-11-15,spain,Europe,46788503,9070,1542784
2020-11-16,spain,Europe,46788503,13061,1555845
2020-11-17,spain,Europe,46788503,13122,1568967
2020-11-18,spain,Europe,46788503,11703,1580670
2020-11-19,spain,Europe,46788503,9797,1590467
2020-11-20,spain,Europe,46788503,10278,1600745
2020-11-21,spain,Europe,46788503,7876,1608621
2020-11-22,spain,Europe,46788503,6257,1614878
2020-11-23,spain,Europe,46788503,8929,1623807
2020-11-24,spain,Europe,46788503,8950,1632757
2020-11-25,spain,Europe,46788503,8316,1641073
2020-11-26,spain,Europe,46788503,7608,1648681
2020-11-27,spain,Europe,46788503,8388,1657069
2020-11-28,spain,Europe,46788503,6301,1663370
2020-11-29,spain,Europe,46788503,4975,1668345
2020-11-30,spain,Europe,46788503,7457,1675802
2020-12-01,spain,Europe,46788503,8358,1684160
2020-12-02,spain,Europe,46788503,7779,1691939
2020-12-03,spain,Europe,46788503,6761,1698700
2020-12-04,spain,Europe,46788503,7181,1705881
2020-12-05,spain,Europe,46788503,5699,1711580
2020-12-06,spain,Europe,46788503,4695,1716275
2020-12-07,spain,Europe,46788503,6771,1723046
2020-12-08,spain,Europe,46788503,6162,1729208
2020-12-09,spain,Europe,46788503,8745,1737953
2020-12-10,spain,Europe,46788503,9364,1747317
2020-12-11,spain,Europe,46788503,9830,1757147
2020-12-12,spain,Europe,46788503,8036,1765183
2020-12-13,spain,Europe,46788503,6495,1771678
2020-12-14,spain,Europe,46788503,10297,1781975
2020-12-15,spain,Europe,46788503,10967,1792942
2020-12-16,spain,Europe,46788503,10446,1803388
2020-12-17,spain,Europe,46788503,9565,1812953
2020-12-18,spain,Europe,46788503,10530,1823483
2020-12-19,spain,Europe,46788503,8319,1831802
2020-12-20,spain,Europe,46788503,7149,1838951
2020-12-21,spain,Europe,46788503,10825,1849776
2020-12-22,spain,Europe,46788503,11606,1861382
2020-12-23,spain,Europe,46788503,11656,1873038
2020-12-24,spain,Europe,46788503,10182,1883220
2020-12-25,spain,Europe,46788503,7641,1890861
2020-12-26,spain,Europe,46788503,9495,1900356
2020-12-27,spain,Europe,46788503,9752,1910108
2020-12-28,spain,Europe,46788503,15642,1925750
2020-12-29,spain,Europe,46788503,16063,1941813
2020-12-30,spain,Europe,46788503,16217,1958030
2020-12-31,spain,Europe,46788503,12973,1971003
2021-01-01,spain,Europe,46788503,11539,1982542
2021-01-02,spain,Europe,46788503,13643,1996185
2021-01-03,spain,Europe,46788503,13946,2010131
2021-01-04,spain,Europe,46788503,22561,2032692
2021-01-05,spain,Europe,46788503,27293,2059985
2021-01-06,spain,Europe,46788503,17944,2077929
2021-01-07,spain,Europe,46788503,25294,2103223
2021-01-08,spain,Europe,46788503,30718,2133941
2021-01-09,spain,Europe,46788503,24259,2158200
2021-01-10,spain,Europe,46788503,21107,2179307
2021-01-11,spain,Europe,46788503,31635,2210942
2021-01-12,spain,Europe,46788503,33167,2244109
2021-01-13,spain,Europe,46788503,32755,2276864
2021-01-14,spain,Europe,46788503,30804,2307668
2021-01-15,spain,Europe,46788503,34378,2342046
2021-01-16,spain,Europe,46788503,24894,2366940
2021-01-17,spain,Europe,46788503,20348,2387288
2021-01-18,spain,Europe,46788503,29612,2416900
2021-01-19,spain,Europe,46788503,31688,2448588
2021-01-20,spain,Europe,46788503,28602,2477190
2021-01-21,spain,Europe,46788503,25840,2503030
2021-01-22,spain,Europe,46788503,21442,2524472
2021-01-23,spain,Europe,46788503,22027,2546499
2021-01-24,spain,Europe,46788503,18841,2565340
2021-01-25,spain,Europe,46788503,28764,2594104
2021-01-26,spain,Europe,46788503,27069,2621173
2021-01-27,spain,Europe,46788503,29906,2651079
2021-01-28,spain,Europe,46788503,25920,2676999
2021-01-29,spain,Europe,46788503,28292,2705291
2021-01-30,spain,Europe,46788503,19665,2724956
2021-01-31,spain,Europe,46788503,16072,2741028
2021-02-01,spain,Europe,46788503,23381,2764409
2021-02-02,spain,Europe,46788503,26235,2790644
2021-02-03,spain,Europe,46788503,28498,2819142
2021-02-04,spain,Europe,46788503,27021,2846163
2021-02-05,spain,Europe,46788503,25760,2871923
2021-02-06,spain,Europe,46788503,14516,2886439
2021-02-07,spain,Europe,46788503,12626,2899065
2021-02-08,spain,Europe,46788503,18912,2917977
2021-02-09,spain,Europe,46788503,16066,2934043
2021-02-10,spain,Europe,46788503,17721,2951764
2021-02-11,spain,Europe,46788503,17467,2969231
2021-02-12,spain,Europe,46788503,14275,2983506
2021-02-13,spain,Europe,46788503,9848,2993354
2021-02-14,spain,Europe,46788503,8047,3001401
2021-02-15,spain,Europe,46788503,11720,3013121
2021-02-16,spain,Europe,46788503,9877,3022998
2021-02-17,spain,Europe,46788503,10621,3033619
2021-02-18,spain,Europe,46788503,14214,3047833
2021-02-19,spain,Europe,46788503,11204,3059037
2021-02-20,spain,Europe,46788503,6794,3065831
2021-02-21,spain,Europe,46788503,5552,3071383
2021-02-22,spain,Europe,46788503,8096,3079479
2021-02-23,spain,Europe,46788503,7334,3086813
2021-02-24,spain,Europe,46788503,9038,3095851
2021-02-25,spain,Europe,46788503,9379,3105230
2021-02-26,spain,Europe,46788503,8182,3113412
2021-02-27,spain,Europe,46788503,5209,3118621
2021-02-28,spain,Europe,46788503,4258,3122879
2021-03-01,spain,Europe,46788503,6214,3129093
2021-03-02,spain,Europe,46788503,6536,3135629
2021-03-03,spain,Europe,46788503,6186,3141815
2021-03-04,spain,Europe,46788503,6080,3147895
2021-03-05,spain,Europe,46788503,6699,3154594
2021-03-06,spain,Europe,46788503,4003,3158597
2021-03-07,spain,Europe,46788503,3272,3161869
2021-03-08,spain,Europe,46788503,4774,3166643
2021-03-09,spain,Europe,46788503,4059,3170702
2021-03-10,spain,Europe,46788503,7163,3177865
2021-03-11,spain,Europe,46788503,6298,3184163
2021-03-12,spain,Europe,46788503,5393,3189556
2021-03-13,spain,Europe,46788503,3802,3193358
2021-03-14,spain,Europe,46788503,3108,3196466
2021-03-15,spain,Europe,46788503,4545,3201011
2021-03-16,spain,Europe,46788503,5013,3206024
2021-03-17,spain,Europe,46788503,6141,3212165
2021-03-18,spain,Europe,46788503,6266,3218431
2021-03-19,spain,Europe,46788503,5320,3223751
2021-03-20,spain,Europe,46788503,3751,3227502
2021-03-21,spain,Europe,46788503,3070,3230572
2021-03-22,spain,Europe,46788503,4486,3235058
2021-03-23,spain,Europe,46788503,5578,3240636
2021-03-24,spain,Europe,46788503,7089,3247725
2021-03-25,spain,Europe,46788503,6452,3254177
2021-03-26,spain,Europe,46788503,7647,3261824
2021-03-27,spain,Europe,46788503,5191,3267015
2021-03-28,spain,Europe,46788503,4244,3271259
2021-03-29,spain,Europe,46788503,6195,3277454
2021-03-30,spain,Europe,46788503,5058,3282512
2021-03-31,spain,Europe,46788503,8597,3291109
2021-04-01,spain,Europe,46788503,7098,3298207
2021-04-02,spain,Europe,46788503,5721,3303928
2021-04-03,spain,Europe,46788503,3909,3307837
2021-04-04,spain,Europe,46788503,5731,3313568
2021-04-05,spain,Europe,46788503,4692,3318260
2021-04-06,spain,Europe,46788503,6715,3324975
2021-04-07,spain,Europe,46788503,8863,3333838
2021-04-08,spain,Europe,46788503,9975,3343813
2021-04-09,spain,Europe,46788503,10944,3354757
2021-04-10,spain,Europe,46788503,6221,3360978
2021-04-11,spain,Europe,46788503,9132,3370110
2021-04-12,spain,Europe,46788503,7529,3377639
2021-04-13,spain,Europe,46788503,6359,3383998
2021-04-14,spain,Europe,46788503,10542,3394540
2021-04-15,spain,Europe,46788503,9726,3404266
2021-04-16,spain,Europe,46788503,10664,3414930
2021-04-17,spain,Europe,46788503,5766,3420696
2021-04-18,spain,Europe,46788503,8462,3429158
2021-04-19,spain,Europe,46788503,6973,3436131
2021-04-20,spain,Europe,46788503,7562,3443693
2021-04-21,spain,Europe,46788503,10300,3453993
2021-04-22,spain,Europe,46788503,10877,3464870
2021-04-23,spain,Europe,46788503,11796,3476666
2021-04-24,spain,Europe,46788503,5437,3482103
2021-04-25,spain,Europe,46788503,7976,3490079
2021-04-26,spain,Europe,46788503,6577,3496656
2021-04-27,spain,Europe,46788503,7734,3504390
2021-04-28,spain,Europe,46788503,8728,3513118
2021-04-29,spain,Europe,46788503,10202,3523320
2021-04-30,spain,Europe,46788503,9192,3532512
2021-05-01,spain,Europe,46788503,4474,3536986
2021-05-02,spain,Europe,46788503,6570,3543556
2021-05-03,spain,Europe,46788503,5416,3548972
2021-05-04,spain,Europe,46788503,4570,3553542
2021-05-05,spain,Europe,46788503,6364,3559906
2021-05-06,spain,Europe,46788503,8004,3567910
2021-05-07,spain,Europe,46788503,8228,3576138
2021-05-08,spain,Europe,46788503,3824,3579962
2021-05-09,spain,Europe,46788503,5613,3585575
2021-05-10,spain,Europe,46788503,4620,3590195
2021-05-11,spain,Europe,46788503,4975,3595170
2021-05-12,spain,Europe,46788503,6450,3601620
2021-05-13,spain,Europe,46788503,5728,3607348
2021-05-14,spain,Europe,46788503,6373,3613721
2021-05-15,spain,Europe,46788503,3023,3616744
2021-05-16,spain,Europe,46788503,4440,3621184
2021-05-17,spain,Europe,46788503,3655,3624839
2021-05-18,spain,Europe,46788503,4017,3628856
2021-05-19,spain,Europe,46788503,6107,3634963
2021-05-20,spain,Europe,46788503,5760,3640723
2021-05-21,spain,Europe,46788503,4816,3645539
2021-05-22,spain,Europe,46788503,3022,3648561
2021-05-23,spain,Europe,46788503,4441,3653002
2021-05-24,spain,Europe,46788503,3647,3656649
2021-05-25,spain,Europe,46788503,5390,3662039
2021-05-26,spain,Europe,46788503,5034,3667073
2021-05-27,spain,Europe,46788503,5315,3672388
2021-05-28,spain,Europe,46788503,5506,3677894
2021-05-29,spain,Europe,46788503,2659,3680553
2021-05-30,spain,Europe,46788503,3906,3684459
2021-05-31,spain,Europe,46788503,3213,3687672
2021-06-01,spain,Europe,46788503,4410,3692082
2021-06-02,spain,Europe,46788503,5005,3697087
2021-06-03,spain,Europe,46788503,5270,3702357
2021-06-04,spain,Europe,46788503,4995,3707352
2021-06-05,spain,Europe,46788503,2606,3709958
2021-06-06,spain,Europe,46788503,3824,3713782
2021-06-07,spain,Europe,46788503,3122,3716904
2021-06-08,spain,Europe,46788503,3504,3720408
2021-06-09,spain,Europe,46788503,4427,3724835
2021-06-10,spain,Europe,46788503,4623,3729458
2021-06-11,spain,Europe,46788503,4142,3733600
2021-06-12,spain,Europe,46788503,2223,3735823
2021-06-13,spain,Europe,46788503,3270,3739093
2021-06-14,spain,Europe,46788503,2674,3741767
2021-06-15,spain,Europe,46788503,3432,3745199
2021-06-16,spain,Europe,46788503,3832,3749031
2021-06-17,spain,Europe,46788503,4197,3753228
2021-06-18,spain,Europe,46788503,4214,3757442
2021-06-19,spain,Europe,46788503,1962,3759404
2021-06-20,spain,Europe,46788503,2887,3762291
2021-06-21,spain,Europe,46788503,2360,3764651
2021-06-22,spain,Europe,46788503,4040,3768691
2021-06-23,spain,Europe,46788503,4341,3773032
2021-06-24,spain,Europe,46788503,4507,3777539
2021-06-25,spain,Europe,46788503,4924,3782463
2021-06-26,spain,Europe,46788503,2771,3785234
2021-06-27,spain,Europe,46788503,4076,3789310
2021-06-28,spain,Europe,46788503,3332,3792642
2021-06-29,spain,Europe,46788503,7091,3799733
2021-06-30,spain,Europe,46788503,9227,3808960
2021-07-01,spain,Europe,46788503,12345,3821305
2021-07-02,spain,Europe,46788503,12563,3833868
2021-07-03,spain,Europe,46788503,8876,3842744
2021-07-04,spain,Europe,46788503,13056,3855800
2021-07-05,spain,Europe,46788503,10675,3866475
2021-07-06,spain,Europe,46788503,14137,3880612
2021-07-07,spain,Europe,46788503,17384,3897996
2021-07-08,spain,Europe,46788503,17317,3915313
2021-07-09,spain,Europe,46788503,21879,3937192
2021-07-10,spain,Europe,46788503,11311,3948503
2021-07-11,spain,Europe,46788503,11311,3959814
2021-07-12,spain,Europe,46788503,11310,3971124
2021-07-13,spain,Europe,46788503,43960,4015084
2021-07-14,spain,Europe,46788503,26390,4041474
2021-07-15,spain,Europe,46788503,27688,4069162
2021-07-16,spain,Europe,46788503,31060,4100222
2021-07-17,spain,Europe,46788503,20543,4120765
2021-07-18,spain,Europe,46788503,20543,4141308
2021-07-19,spain,Europe,46788503,20542,4161850
2021-07-20,spain,Europe,46788503,27286,4189136
2021-07-21,spain,Europe,46788503,30587,4219723
2021-07-22,spain,Europe,46788503,29535,4249258
2021-07-23,spain,Europe,46788503,31171,4280429
2021-07-24,spain,Europe,46788503,20542,4300971
2021-07-25,spain,Europe,46788503,20542,4321513
2021-07-26,spain,Europe,46788503,20541,4342054
2021-07-27,spain,Europe,46788503,26399,4368453
2021-07-28,spain,Europe,46788503,27149,4395602
2021-07-29,spain,Europe,46788503,26689,4422291
2021-07-30,spain,Europe,46788503,24753,4447044
2021-07-31,spain,Europe,46788503,18646,4465690
2021-08-01,spain,Europe,46788503,18646,4484336
2021-08-02,spain,Europe,46788503,18647,4502983
2021-08-03,spain,Europe,46788503,20327,4523310
2021-08-04,spain,Europe,46788503,21874,4545184
2021-08-05,spain,Europe,46788503,21387,4566571
2021-08-06,spain,Europe,46788503,21561,4588132
2021-08-07,spain,Europe,46788503,13213,4601345
2021-08-08,spain,Europe,46788503,13213,4614558
2021-08-09,spain,Europe,46788503,13212,4627770
2021-08-10,spain,Europe,46788503,15680,4643450
2021-08-11,spain,Europe,46788503,17023,4660473
2021-08-12,spain,Europe,46788503,17410,4677883
2021-08-13,spain,Europe,46788503,15657,4693540
2021-08-14,spain,Europe,46788503,8575,4702115
2021-08-15,spain,Europe,46788503,8575,4710690
2021-08-16,spain,Europe,46788503,8576,4719266
2021-08-17,spain,Europe,46788503,14336,4733602
2021-08-18,spain,Europe,46788503,11956,4745558
2021-08-19,spain,Europe,46788503,12445,4758003
2021-08-20,spain,Europe,46788503,12450,4770453
2021-08-21,spain,Europe,46788503,7966,4778419
2021-08-22,spain,Europe,46788503,7966,4786385
2021-08-23,spain,Europe,46788503,7967,4794352
2021-08-24,spain,Europe,46788503,10072,4804424
2021-08-25,spain,Europe,46788503,10781,4815205
2021-08-26,spain,Europe,46788503,7115,4822320
2021-08-27,spain,Europe,46788503,9489,4831809
2021-08-28,spain,Europe,46788503,5163,4836972
2021-08-29,spain,Europe,46788503,5163,4842135
2021-08-30,spain,Europe,46788503,5163,4847298
2021-08-31,spain,Europe,46788503,7767,4855065
2021-09-01,spain,Europe,46788503,6818,4861883
2021-09-02,spain,Europe,46788503,9561,4871444
2021-09-03,spain,Europe,46788503,6311,4877755
2021-09-04,spain,Europe,46788503,3213,4880968
2021-09-05,spain,Europe,46788503,3213,4884181
2021-09-06,spain,Europe,46788503,3213,4887394
2021-09-07,spain,Europe,46788503,5246,4892640
2021-09-08,spain,Europe,46788503,5618,4898258
2021-09-09,spain,Europe,46788503,4763,4903021
2021-09-10,spain,Europe,46788503,4440,4907461
2021-09-11,spain,Europe,46788503,2601,4910062
2021-09-12,spain,Europe,46788503,2601,4912663
2021-09-13,spain,Europe,46788503,2602,4915265
2021-09-14,spain,Europe,46788503,3261,4918526
2021-09-15,spain,Europe,46788503,3723,4922249
2021-09-16,spain,Europe,46788503,4075,4926324
2021-09-17,spain,Europe,46788503,3222,4929546
2021-09-18,spain,Europe,46788503,1996,4931542
2021-09-19,spain,Europe,46788503,1996,4933538
2021-09-20,spain,Europe,46788503,1996,4935534
2021-09-21,spain,Europe,46788503,2450,4937984
2021-09-22,spain,Europe,46788503,2840,4940824
2021-09-23,spain,Europe,46788503,3031,4943855
2021-09-24,spain,Europe,46788503,2746,4946601
2021-09-25,spain,Europe,46788503,1680,4948281
2021-09-26,spain,Europe,46788503,1680,4949961
2021-09-27,spain,Europe,46788503,1679,4951640
2021-09-28,spain,Europe,46788503,2290,4953930
2021-09-29,spain,Europe,46788503,2761,4956691
2021-09-30,spain,Europe,46788503,2400,4959091
2021-10-01,spain,Europe,46788503,2037,4961128
2021-10-02,spain,Europe,46788503,1424,4962552
2021-10-03,spain,Europe,46788503,1424,4963976
2021-10-04,spain,Europe,46788503,1423,4965399
2021-10-05,spain,Europe,46788503,1801,4967200
2021-10-06,spain,Europe,46788503,2303,4969503
2021-10-07,spain,Europe,46788503,1807,4971310
2021-10-08,spain,Europe,46788503,2309,4973619
2021-10-09,spain,Europe,46788503,1276,4974895
2021-10-10,spain,Europe,46788503,1276,4976171
2021-10-11,spain,Europe,46788503,1277,4977448
2021-10-12,spain,Europe,46788503,0,4977448
2021-10-13,spain,Europe,46788503,2758,4980206
2021-10-14,spain,Europe,46788503,1932,4982138
2021-10-15,spain,Europe,46788503,2248,4984386
2021-10-16,spain,Europe,46788503,1497,4985883
2021-10-17,spain,Europe,46788503,1497,4987380
2021-10-18,spain,Europe,46788503,1498,4988878
2021-10-19,spain,Europe,46788503,1889,4990767
2021-10-20,spain,Europe,46788503,2528,4993295
2021-10-21,spain,Europe,46788503,1881,4995176
2021-10-22,spain,Europe,46788503,2556,4997732
2021-10-23,spain,Europe,46788503,1495,4999227
2021-10-24,spain,Europe,46788503,1495,5000722
2021-10-25,spain,Europe,46788503,1495,5002217
2021-10-26,spain,Europe,46788503,1926,5004143
2021-10-27,spain,Europe,46788503,2532,5006675
2021-10-28,spain,Europe,46788503,2212,5008887
2021-10-29,spain,Europe,46788503,2261,5011148
2021-10-30,spain,Europe,46788503,1455,5012603
2021-10-31,spain,Europe,46788503,1455,5014058
2021-11-01,spain,Europe,46788503,1455,5015513
2021-11-02,spain,Europe,46788503,1455,5016968
2021-11-03,spain,Europe,46788503,2287,5019255
2021-11-04,spain,Europe,46788503,3291,5022546
2021-11-05,spain,Europe,46788503,3093,5025639
2021-11-06,spain,Europe,46788503,2139,5027778
2020-02-20,sri_lanka,Asia,21580463,0,1
2020-02-21,sri_lanka,Asia,21580463,0,1
2020-02-22,sri_lanka,Asia,21580463,0,1
2020-02-23,sri_lanka,Asia,21580463,0,1
2020-02-24,sri_lanka,Asia,21580463,0,1
2020-02-25,sri_lanka,Asia,21580463,0,1
2020-02-26,sri_lanka,Asia,21580463,0,1
2020-02-27,sri_lanka,Asia,21580463,0,1
2020-02-28,sri_lanka,Asia,21580463,0,1
2020-02-29,sri_lanka,Asia,21580463,0,1
2020-03-01,sri_lanka,Asia,21580463,0,1
2020-03-02,sri_lanka,Asia,21580463,0,1
2020-03-03,sri_lanka,Asia,21580463,0,1
2020-03-04,sri_lanka,Asia,21580463,0,1
2020-03-05,sri_lanka,Asia,21580463,0,1
2020-03-06,sri_lanka,Asia,21580463,0,1
2020-03-07,sri_lanka,Asia,21580463,0,1
2020-03-08,sri_lanka,Asia,21580463,0,1
2020-03-09,sri_lanka,Asia,21580463,0,1
2020-03-10,sri_lanka,Asia,21580463,0,1
2020-03-11,sri_lanka,Asia,21580463,1,2
2020-03-12,sri_lanka,Asia,21580463,1,3
2020-03-13,sri_lanka,Asia,21580463,3,6
2020-03-14,sri_lanka,Asia,21580463,4,10
2020-03-15,sri_lanka,Asia,21580463,8,18
2020-03-16,sri_lanka,Asia,21580463,10,28
2020-03-17,sri_lanka,Asia,21580463,16,44
2020-03-18,sri_lanka,Asia,21580463,7,51
2020-03-19,sri_lanka,Asia,21580463,9,60
2020-03-20,sri_lanka,Asia,21580463,13,73
2020-03-21,sri_lanka,Asia,21580463,4,77
2020-03-22,sri_lanka,Asia,21580463,5,82
2020-03-23,sri_lanka,Asia,21580463,15,97
2020-03-24,sri_lanka,Asia,21580463,5,102
2020-03-25,sri_lanka,Asia,21580463,0,102
2020-03-26,sri_lanka,Asia,21580463,4,106
2020-03-27,sri_lanka,Asia,21580463,0,106
2020-03-28,sri_lanka,Asia,21580463,7,113
2020-03-29,sri_lanka,Asia,21580463,4,117
2020-03-30,sri_lanka,Asia,21580463,5,122
2020-03-31,sri_lanka,Asia,21580463,21,143
2020-04-01,sri_lanka,Asia,21580463,3,146
2020-04-02,sri_lanka,Asia,21580463,5,151
2020-04-03,sri_lanka,Asia,21580463,8,159
2020-04-04,sri_lanka,Asia,21580463,7,166
2020-04-05,sri_lanka,Asia,21580463,10,176
2020-04-06,sri_lanka,Asia,21580463,2,178
2020-04-07,sri_lanka,Asia,21580463,7,185
2020-04-08,sri_lanka,Asia,21580463,4,189
2020-04-09,sri_lanka,Asia,21580463,1,190
2020-04-10,sri_lanka,Asia,21580463,0,190
2020-04-11,sri_lanka,Asia,21580463,8,198
2020-04-12,sri_lanka,Asia,21580463,12,210
2020-04-13,sri_lanka,Asia,21580463,7,217
2020-04-14,sri_lanka,Asia,21580463,16,233
2020-04-15,sri_lanka,Asia,21580463,5,238
2020-04-16,sri_lanka,Asia,21580463,0,238
2020-04-17,sri_lanka,Asia,21580463,6,244
2020-04-18,sri_lanka,Asia,21580463,10,254
2020-04-19,sri_lanka,Asia,21580463,17,271
2020-04-20,sri_lanka,Asia,21580463,33,304
2020-04-21,sri_lanka,Asia,21580463,6,310
2020-04-22,sri_lanka,Asia,21580463,20,330
2020-04-23,sri_lanka,Asia,21580463,38,368
2020-04-24,sri_lanka,Asia,21580463,49,417
2020-04-25,sri_lanka,Asia,21580463,35,452
2020-04-26,sri_lanka,Asia,21580463,71,523
2020-04-27,sri_lanka,Asia,21580463,65,588
2020-04-28,sri_lanka,Asia,21580463,31,619
2020-04-29,sri_lanka,Asia,21580463,30,649
2020-04-30,sri_lanka,Asia,21580463,14,663
2020-05-01,sri_lanka,Asia,21580463,27,690
2020-05-02,sri_lanka,Asia,21580463,12,702
2020-05-03,sri_lanka,Asia,21580463,16,718
2020-05-04,sri_lanka,Asia,21580463,33,751
2020-05-05,sri_lanka,Asia,21580463,20,771
2020-05-06,sri_lanka,Asia,21580463,26,797
2020-05-07,sri_lanka,Asia,21580463,26,823
2020-05-08,sri_lanka,Asia,21580463,12,835
2020-05-09,sri_lanka,Asia,21580463,12,847
2020-05-10,sri_lanka,Asia,21580463,9,856
2020-05-11,sri_lanka,Asia,21580463,7,863
2020-05-12,sri_lanka,Asia,21580463,26,889
2020-05-13,sri_lanka,Asia,21580463,4,893
2020-05-14,sri_lanka,Asia,21580463,32,925
2020-05-15,sri_lanka,Asia,21580463,10,935
2020-05-16,sri_lanka,Asia,21580463,22,957
2020-05-17,sri_lanka,Asia,21580463,24,981
2020-05-18,sri_lanka,Asia,21580463,11,992
2020-05-19,sri_lanka,Asia,21580463,31,1023
2020-05-20,sri_lanka,Asia,21580463,5,1028
2020-05-21,sri_lanka,Asia,21580463,20,1048
2020-05-22,sri_lanka,Asia,21580463,20,1068
2020-05-23,sri_lanka,Asia,21580463,21,1089
2020-05-24,sri_lanka,Asia,21580463,52,1141
2020-05-25,sri_lanka,Asia,21580463,41,1182
2020-05-26,sri_lanka,Asia,21580463,137,1319
2020-05-27,sri_lanka,Asia,21580463,150,1469
2020-05-28,sri_lanka,Asia,21580463,61,1530
2020-05-29,sri_lanka,Asia,21580463,28,1558
2020-05-30,sri_lanka,Asia,21580463,55,1613
2020-05-31,sri_lanka,Asia,21580463,20,1633
2020-06-01,sri_lanka,Asia,21580463,10,1643
2020-06-02,sri_lanka,Asia,21580463,40,1683
2020-06-03,sri_lanka,Asia,21580463,52,1735
2020-06-04,sri_lanka,Asia,21580463,62,1797
2020-06-05,sri_lanka,Asia,21580463,4,1801
2020-06-06,sri_lanka,Asia,21580463,13,1814
2020-06-07,sri_lanka,Asia,21580463,21,1835
2020-06-08,sri_lanka,Asia,21580463,22,1857
2020-06-09,sri_lanka,Asia,21580463,2,1859
2020-06-10,sri_lanka,Asia,21580463,10,1869
2020-06-11,sri_lanka,Asia,21580463,8,1877
2020-06-12,sri_lanka,Asia,21580463,3,1880
2020-06-13,sri_lanka,Asia,21580463,4,1884
2020-06-14,sri_lanka,Asia,21580463,5,1889
2020-06-15,sri_lanka,Asia,21580463,16,1905
2020-06-16,sri_lanka,Asia,21580463,10,1915
2020-06-17,sri_lanka,Asia,21580463,9,1924
2020-06-18,sri_lanka,Asia,21580463,22,1946
2020-06-19,sri_lanka,Asia,21580463,4,1950
2020-06-20,sri_lanka,Asia,21580463,0,1950
2020-06-21,sri_lanka,Asia,21580463,0,1950
2020-06-22,sri_lanka,Asia,21580463,1,1951
2020-06-23,sri_lanka,Asia,21580463,40,1991
2020-06-24,sri_lanka,Asia,21580463,10,2001
2020-06-25,sri_lanka,Asia,21580463,9,2010
2020-06-26,sri_lanka,Asia,21580463,4,2014
2020-06-27,sri_lanka,Asia,21580463,19,2033
2020-06-28,sri_lanka,Asia,21580463,4,2037
2020-06-29,sri_lanka,Asia,21580463,2,2039
2020-06-30,sri_lanka,Asia,21580463,8,2047
2020-07-01,sri_lanka,Asia,21580463,7,2054
2020-07-02,sri_lanka,Asia,21580463,12,2066
2020-07-03,sri_lanka,Asia,21580463,3,2069
2020-07-04,sri_lanka,Asia,21580463,5,2074
2020-07-05,sri_lanka,Asia,21580463,2,2076
2020-07-06,sri_lanka,Asia,21580463,1,2077
2020-07-07,sri_lanka,Asia,21580463,4,2081
2020-07-08,sri_lanka,Asia,21580463,13,2094
2020-07-09,sri_lanka,Asia,21580463,60,2154
2020-07-10,sri_lanka,Asia,21580463,300,2454
2020-07-11,sri_lanka,Asia,21580463,57,2511
2020-07-12,sri_lanka,Asia,21580463,106,2617
2020-07-13,sri_lanka,Asia,21580463,29,2646
2020-07-14,sri_lanka,Asia,21580463,19,2665
2020-07-15,sri_lanka,Asia,21580463,6,2671
2020-07-16,sri_lanka,Asia,21580463,16,2687
2020-07-17,sri_lanka,Asia,21580463,10,2697
2020-07-18,sri_lanka,Asia,21580463,7,2704
2020-07-19,sri_lanka,Asia,21580463,20,2724
2020-07-20,sri_lanka,Asia,21580463,6,2730
2020-07-21,sri_lanka,Asia,21580463,0,2730
2020-07-22,sri_lanka,Asia,21580463,22,2752
2020-07-23,sri_lanka,Asia,21580463,1,2753
2020-07-24,sri_lanka,Asia,21580463,11,2764
2020-07-25,sri_lanka,Asia,21580463,6,2770
2020-07-26,sri_lanka,Asia,21580463,12,2782
2020-07-27,sri_lanka,Asia,21580463,23,2805
2020-07-28,sri_lanka,Asia,21580463,5,2810
2020-07-29,sri_lanka,Asia,21580463,0,2810
2020-07-30,sri_lanka,Asia,21580463,4,2814
2020-07-31,sri_lanka,Asia,21580463,1,2815
2020-08-01,sri_lanka,Asia,21580463,0,2815
2020-08-02,sri_lanka,Asia,21580463,8,2823
2020-08-03,sri_lanka,Asia,21580463,5,2828
2020-08-04,sri_lanka,Asia,21580463,6,2834
2020-08-05,sri_lanka,Asia,21580463,5,2839
2020-08-06,sri_lanka,Asia,21580463,0,2839
2020-08-07,sri_lanka,Asia,21580463,0,2839
2020-08-08,sri_lanka,Asia,21580463,2,2841
2020-08-09,sri_lanka,Asia,21580463,3,2844
2020-08-10,sri_lanka,Asia,21580463,27,2871
2020-08-11,sri_lanka,Asia,21580463,9,2880
2020-08-12,sri_lanka,Asia,21580463,1,2881
2020-08-13,sri_lanka,Asia,21580463,1,2882
2020-08-14,sri_lanka,Asia,21580463,4,2886
2020-08-15,sri_lanka,Asia,21580463,4,2890
2020-08-16,sri_lanka,Asia,21580463,3,2893
2020-08-17,sri_lanka,Asia,21580463,7,2900
2020-08-18,sri_lanka,Asia,21580463,2,2902
2020-08-19,sri_lanka,Asia,21580463,0,2902
2020-08-20,sri_lanka,Asia,21580463,16,2918
2020-08-21,sri_lanka,Asia,21580463,23,2941
2020-08-22,sri_lanka,Asia,21580463,6,2947
2020-08-23,sri_lanka,Asia,21580463,6,2953
2020-08-24,sri_lanka,Asia,21580463,6,2959
2020-08-25,sri_lanka,Asia,21580463,12,2971
2020-08-26,sri_lanka,Asia,21580463,13,2984
2020-08-27,sri_lanka,Asia,21580463,2,2986
2020-08-28,sri_lanka,Asia,21580463,3,2989
2020-08-29,sri_lanka,Asia,21580463,6,2995
2020-08-30,sri_lanka,Asia,21580463,17,3012
2020-08-31,sri_lanka,Asia,21580463,37,3049
2020-09-01,sri_lanka,Asia,21580463,43,3092
2020-09-02,sri_lanka,Asia,21580463,9,3101
2020-09-03,sri_lanka,Asia,21580463,10,3111
2020-09-04,sri_lanka,Asia,21580463,4,3115
2020-09-05,sri_lanka,Asia,21580463,6,3121
2020-09-06,sri_lanka,Asia,21580463,2,3123
2020-09-07,sri_lanka,Asia,21580463,0,3123
2020-09-08,sri_lanka,Asia,21580463,17,3140
2020-09-09,sri_lanka,Asia,21580463,7,3147
2020-09-10,sri_lanka,Asia,21580463,8,3155
2020-09-11,sri_lanka,Asia,21580463,14,3169
2020-09-12,sri_lanka,Asia,21580463,26,3195
2020-09-13,sri_lanka,Asia,21580463,39,3234
2020-09-14,sri_lanka,Asia,21580463,28,3262
2020-09-15,sri_lanka,Asia,21580463,9,3271
2020-09-16,sri_lanka,Asia,21580463,0,3271
2020-09-17,sri_lanka,Asia,21580463,5,3276
2020-09-18,sri_lanka,Asia,21580463,5,3281
2020-09-19,sri_lanka,Asia,21580463,2,3283
2020-09-20,sri_lanka,Asia,21580463,4,3287
2020-09-21,sri_lanka,Asia,21580463,12,3299
2020-09-22,sri_lanka,Asia,21580463,14,3313
2020-09-23,sri_lanka,Asia,21580463,11,3324
2020-09-24,sri_lanka,Asia,21580463,9,3333
2020-09-25,sri_lanka,Asia,21580463,12,3345
2020-09-26,sri_lanka,Asia,21580463,4,3349
2020-09-27,sri_lanka,Asia,21580463,11,3360
2020-09-28,sri_lanka,Asia,21580463,3,3363
2020-09-29,sri_lanka,Asia,21580463,11,3374
2020-09-30,sri_lanka,Asia,21580463,6,3380
2020-10-01,sri_lanka,Asia,21580463,2,3382
2020-10-02,sri_lanka,Asia,21580463,6,3388
2020-10-03,sri_lanka,Asia,21580463,7,3395
2020-10-04,sri_lanka,Asia,21580463,7,3402
2020-10-05,sri_lanka,Asia,21580463,111,3513
2020-10-06,sri_lanka,Asia,21580463,739,4252
2020-10-07,sri_lanka,Asia,21580463,207,4459
2020-10-08,sri_lanka,Asia,21580463,29,4488
2020-10-09,sri_lanka,Asia,21580463,35,4523
2020-10-10,sri_lanka,Asia,21580463,105,4628
2020-10-11,sri_lanka,Asia,21580463,124,4752
2020-10-12,sri_lanka,Asia,21580463,92,4844
2020-10-13,sri_lanka,Asia,21580463,194,5038
2020-10-14,sri_lanka,Asia,21580463,132,5170
2020-10-15,sri_lanka,Asia,21580463,74,5244
2020-10-16,sri_lanka,Asia,21580463,110,5354
2020-10-17,sri_lanka,Asia,21580463,121,5475
2020-10-18,sri_lanka,Asia,21580463,63,5538
2020-10-19,sri_lanka,Asia,21580463,87,5625
2020-10-20,sri_lanka,Asia,21580463,186,5811
2020-10-21,sri_lanka,Asia,21580463,167,5978
2020-10-22,sri_lanka,Asia,21580463,309,6287
2020-10-23,sri_lanka,Asia,21580463,866,7153
2020-10-24,sri_lanka,Asia,21580463,368,7521
2020-10-25,sri_lanka,Asia,21580463,351,7872
2020-10-26,sri_lanka,Asia,21580463,541,8413
2020-10-27,sri_lanka,Asia,21580463,457,8870
2020-10-28,sri_lanka,Asia,21580463,335,9205
2020-10-29,sri_lanka,Asia,21580463,586,9791
2020-10-30,sri_lanka,Asia,21580463,633,10424
2020-10-31,sri_lanka,Asia,21580463,239,10663
2020-11-01,sri_lanka,Asia,21580463,397,11060
2020-11-02,sri_lanka,Asia,21580463,275,11335
2020-11-03,sri_lanka,Asia,21580463,409,11744
2020-11-04,sri_lanka,Asia,21580463,443,12187
2020-11-05,sri_lanka,Asia,21580463,383,12570
2020-11-06,sri_lanka,Asia,21580463,400,12970
2020-11-07,sri_lanka,Asia,21580463,449,13419
2020-11-08,sri_lanka,Asia,21580463,510,13929
2020-11-09,sri_lanka,Asia,21580463,356,14285
2020-11-10,sri_lanka,Asia,21580463,430,14715
2020-11-11,sri_lanka,Asia,21580463,635,15350
2020-11-12,sri_lanka,Asia,21580463,373,15723
2020-11-13,sri_lanka,Asia,21580463,468,16191
2020-11-14,sri_lanka,Asia,21580463,392,16583
2020-11-15,sri_lanka,Asia,21580463,704,17287
2020-11-16,sri_lanka,Asia,21580463,387,17674
2020-11-17,sri_lanka,Asia,21580463,401,18075
2020-11-18,sri_lanka,Asia,21580463,327,18402
2020-11-19,sri_lanka,Asia,21580463,439,18841
2020-11-20,sri_lanka,Asia,21580463,439,19280
2020-11-21,sri_lanka,Asia,21580463,491,19771
2020-11-22,sri_lanka,Asia,21580463,400,20171
2020-11-23,sri_lanka,Asia,21580463,337,20508
2020-11-24,sri_lanka,Asia,21580463,459,20967
2020-11-25,sri_lanka,Asia,21580463,502,21469
2020-11-26,sri_lanka,Asia,21580463,559,22028
2020-11-27,sri_lanka,Asia,21580463,473,22501
2020-11-28,sri_lanka,Asia,21580463,487,22988
2020-11-29,sri_lanka,Asia,21580463,496,23484
2020-11-30,sri_lanka,Asia,21580463,503,23987
2020-12-01,sri_lanka,Asia,21580463,545,24532
2020-12-02,sri_lanka,Asia,21580463,878,25410
2020-12-03,sri_lanka,Asia,21580463,628,26038
2020-12-04,sri_lanka,Asia,21580463,521,26559
2020-12-05,sri_lanka,Asia,21580463,669,27228
2020-12-06,sri_lanka,Asia,21580463,649,27877
2020-12-07,sri_lanka,Asia,21580463,703,28580
2020-12-08,sri_lanka,Asia,21580463,798,29378
2020-12-09,sri_lanka,Asia,21580463,694,30072
2020-12-10,sri_lanka,Asia,21580463,541,30613
2020-12-11,sri_lanka,Asia,21580463,762,31375
2020-12-12,sri_lanka,Asia,21580463,760,32135
2020-12-13,sri_lanka,Asia,21580463,655,32790
2020-12-14,sri_lanka,Asia,21580463,688,33478
2020-12-15,sri_lanka,Asia,21580463,643,34121
2020-12-16,sri_lanka,Asia,21580463,616,34737
2020-12-17,sri_lanka,Asia,21580463,650,35387
2020-12-18,sri_lanka,Asia,21580463,662,36049
2020-12-19,sri_lanka,Asia,21580463,618,36667
2020-12-20,sri_lanka,Asia,21580463,594,37261
2020-12-21,sri_lanka,Asia,21580463,370,37631
2020-12-22,sri_lanka,Asia,21580463,428,38059
2020-12-23,sri_lanka,Asia,21580463,580,38639
2020-12-24,sri_lanka,Asia,21580463,592,39231
2020-12-25,sri_lanka,Asia,21580463,551,39782
2020-12-26,sri_lanka,Asia,21580463,598,40380
2020-12-27,sri_lanka,Asia,21580463,674,41054
2020-12-28,sri_lanka,Asia,21580463,549,41603
2020-12-29,sri_lanka,Asia,21580463,453,42056
2020-12-30,sri_lanka,Asia,21580463,646,42702
2020-12-31,sri_lanka,Asia,21580463,597,43299
2021-01-01,sri_lanka,Asia,21580463,557,43856
2021-01-02,sri_lanka,Asia,21580463,515,44371
2021-01-03,sri_lanka,Asia,21580463,403,44774
2021-01-04,sri_lanka,Asia,21580463,468,45242
2021-01-05,sri_lanka,Asia,21580463,484,45726
2021-01-06,sri_lanka,Asia,21580463,522,46248
2021-01-07,sri_lanka,Asia,21580463,532,46780
2021-01-08,sri_lanka,Asia,21580463,525,47305
2021-01-09,sri_lanka,Asia,21580463,535,47840
2021-01-10,sri_lanka,Asia,21580463,540,48380
2021-01-11,sri_lanka,Asia,21580463,569,48949
2021-01-12,sri_lanka,Asia,21580463,588,49537
2021-01-13,sri_lanka,Asia,21580463,692,50229
2021-01-14,sri_lanka,Asia,21580463,670,50899
2021-01-15,sri_lanka,Asia,21580463,695,51594
2021-01-16,sri_lanka,Asia,21580463,719,52313
2021-01-17,sri_lanka,Asia,21580463,749,53062
2021-01-18,sri_lanka,Asia,21580463,688,53750
2021-01-19,sri_lanka,Asia,21580463,670,54420
2021-01-20,sri_lanka,Asia,21580463,769,55189
2021-01-21,sri_lanka,Asia,21580463,887,56076
2021-01-22,sri_lanka,Asia,21580463,787,56863
2021-01-23,sri_lanka,Asia,21580463,724,57587
2021-01-24,sri_lanka,Asia,21580463,843,58430
2021-01-25,sri_lanka,Asia,21580463,737,59167
2021-01-26,sri_lanka,Asia,21580463,755,59922
2021-01-27,sri_lanka,Asia,21580463,772,60694
2021-01-28,sri_lanka,Asia,21580463,892,61586
2021-01-29,sri_lanka,Asia,21580463,859,62445
2021-01-30,sri_lanka,Asia,21580463,848,63293
2021-01-31,sri_lanka,Asia,21580463,864,64157
2021-02-01,sri_lanka,Asia,21580463,826,64983
2021-02-02,sri_lanka,Asia,21580463,715,65698
2021-02-03,sri_lanka,Asia,21580463,711,66409
2021-02-04,sri_lanka,Asia,21580463,706,67115
2021-02-05,sri_lanka,Asia,21580463,735,67850
2021-02-06,sri_lanka,Asia,21580463,726,68576
2021-02-07,sri_lanka,Asia,21580463,772,69348
2021-02-08,sri_lanka,Asia,21580463,887,70235
2021-02-09,sri_lanka,Asia,21580463,976,71211
2021-02-10,sri_lanka,Asia,21580463,963,72174
2021-02-11,sri_lanka,Asia,21580463,942,73116
2021-02-12,sri_lanka,Asia,21580463,940,74056
2021-02-13,sri_lanka,Asia,21580463,796,74852
2021-02-14,sri_lanka,Asia,21580463,802,75654
2021-02-15,sri_lanka,Asia,21580463,774,76428
2021-02-16,sri_lanka,Asia,21580463,756,77184
2021-02-17,sri_lanka,Asia,21580463,722,77906
2021-02-18,sri_lanka,Asia,21580463,514,78420
2021-02-19,sri_lanka,Asia,21580463,517,78937
2021-02-20,sri_lanka,Asia,21580463,543,79480
2021-02-21,sri_lanka,Asia,21580463,519,79999
2021-02-22,sri_lanka,Asia,21580463,518,80517
2021-02-23,sri_lanka,Asia,21580463,492,81009
2021-02-24,sri_lanka,Asia,21580463,458,81467
2021-02-25,sri_lanka,Asia,21580463,466,81933
2021-02-26,sri_lanka,Asia,21580463,497,82430
2021-02-27,sri_lanka,Asia,21580463,460,82890
2021-02-28,sri_lanka,Asia,21580463,352,83242
2021-03-01,sri_lanka,Asia,21580463,310,83552
2021-03-02,sri_lanka,Asia,21580463,318,83870
2021-03-03,sri_lanka,Asia,21580463,356,84226
2021-03-04,sri_lanka,Asia,21580463,384,84610
2021-03-05,sri_lanka,Asia,21580463,350,84960
2021-03-06,sri_lanka,Asia,21580463,190,85150
2021-03-07,sri_lanka,Asia,21580463,545,85695
2021-03-08,sri_lanka,Asia,21580463,344,86039
2021-03-09,sri_lanka,Asia,21580463,304,86343
2021-03-10,sri_lanka,Asia,21580463,342,86685
2021-03-11,sri_lanka,Asia,21580463,304,86989
2021-03-12,sri_lanka,Asia,21580463,297,87286
2021-03-13,sri_lanka,Asia,21580463,314,87600
2021-03-14,sri_lanka,Asia,21580463,307,87907
2021-03-15,sri_lanka,Asia,21580463,331,88238
2021-03-16,sri_lanka,Asia,21580463,154,88392
2021-03-17,sri_lanka,Asia,21580463,470,88862
2021-03-18,sri_lanka,Asia,21580463,162,89024
2021-03-19,sri_lanka,Asia,21580463,473,89497
2021-03-20,sri_lanka,Asia,21580463,349,89846
2021-03-21,sri_lanka,Asia,21580463,354,90200
2021-03-22,sri_lanka,Asia,21580463,314,90514
2021-03-23,sri_lanka,Asia,21580463,251,90765
2021-03-24,sri_lanka,Asia,21580463,253,91018
2021-03-25,sri_lanka,Asia,21580463,271,91289
2021-03-26,sri_lanka,Asia,21580463,272,91561
2021-03-27,sri_lanka,Asia,21580463,278,91839
2021-03-28,sri_lanka,Asia,21580463,249,92088
2021-03-29,sri_lanka,Asia,21580463,215,92303
2021-03-30,sri_lanka,Asia,21580463,139,92442
2021-03-31,sri_lanka,Asia,21580463,264,92706
2021-04-01,sri_lanka,Asia,21580463,211,92917
2021-04-02,sri_lanka,Asia,21580463,211,93128
2021-04-03,sri_lanka,Asia,21580463,167,93295
2021-04-04,sri_lanka,Asia,21580463,141,93436
2021-04-05,sri_lanka,Asia,21580463,159,93595
2021-04-06,sri_lanka,Asia,21580463,177,93772
2021-04-07,sri_lanka,Asia,21580463,221,93993
2021-04-08,sri_lanka,Asia,21580463,343,94336
2021-04-09,sri_lanka,Asia,21580463,228,94564
2021-04-10,sri_lanka,Asia,21580463,284,94848
2021-04-11,sri_lanka,Asia,21580463,283,95131
2021-04-12,sri_lanka,Asia,21580463,263,95394
2021-04-13,sri_lanka,Asia,21580463,226,95620
2021-04-14,sri_lanka,Asia,21580463,117,95737
2021-04-15,sri_lanka,Asia,21580463,212,95949
2021-04-16,sri_lanka,Asia,21580463,237,96186
2021-04-17,sri_lanka,Asia,21580463,253,96439
2021-04-18,sri_lanka,Asia,21580463,357,96796
2021-04-19,sri_lanka,Asia,21580463,309,97105
2021-04-20,sri_lanka,Asia,21580463,367,97472
2021-04-21,sri_lanka,Asia,21580463,578,98050
2021-04-22,sri_lanka,Asia,21580463,672,98722
2021-04-23,sri_lanka,Asia,21580463,969,99691
2021-04-24,sri_lanka,Asia,21580463,895,100586
2021-04-25,sri_lanka,Asia,21580463,793,101379
2021-04-26,sri_lanka,Asia,21580463,997,102376
2021-04-27,sri_lanka,Asia,21580463,1111,103487
2021-04-28,sri_lanka,Asia,21580463,1466,104953
2021-04-29,sri_lanka,Asia,21580463,1531,106484
2021-04-30,sri_lanka,Asia,21580463,1662,108146
2021-05-01,sri_lanka,Asia,21580463,1716,109862
2021-05-02,sri_lanka,Asia,21580463,1891,111753
2021-05-03,sri_lanka,Asia,21580463,1923,113676
2021-05-04,sri_lanka,Asia,21580463,1914,115590
2021-05-05,sri_lanka,Asia,21580463,1939,117529
2021-05-06,sri_lanka,Asia,21580463,1895,119424
2021-05-07,sri_lanka,Asia,21580463,1914,121338
2021-05-08,sri_lanka,Asia,21580463,1896,123234
2021-05-09,sri_lanka,Asia,21580463,2672,125906
2021-05-10,sri_lanka,Asia,21580463,2624,128530
2021-05-11,sri_lanka,Asia,21580463,2568,131098
2021-05-12,sri_lanka,Asia,21580463,2429,133527
2021-05-13,sri_lanka,Asia,21580463,2269,135796
2021-05-14,sri_lanka,Asia,21580463,2289,138085
2021-05-15,sri_lanka,Asia,21580463,2386,140471
2021-05-16,sri_lanka,Asia,21580463,2275,142746
2021-05-17,sri_lanka,Asia,21580463,2456,145202
2021-05-18,sri_lanka,Asia,21580463,2518,147720
2021-05-19,sri_lanka,Asia,21580463,3623,151343
2021-05-20,sri_lanka,Asia,21580463,3443,154786
2021-05-21,sri_lanka,Asia,21580463,3547,158333
2021-05-22,sri_lanka,Asia,21580463,2909,161242
2021-05-23,sri_lanka,Asia,21580463,2959,164201
2021-05-24,sri_lanka,Asia,21580463,2971,167172
2021-05-25,sri_lanka,Asia,21580463,2728,169900
2021-05-26,sri_lanka,Asia,21580463,2377,172277
2021-05-27,sri_lanka,Asia,21580463,2584,174861
2021-05-28,sri_lanka,Asia,21580463,2850,177711
2021-05-29,sri_lanka,Asia,21580463,2882,180593
2021-05-30,sri_lanka,Asia,21580463,2859,183452
2021-05-31,sri_lanka,Asia,21580463,2912,186364
2021-06-01,sri_lanka,Asia,21580463,2877,189241
2021-06-02,sri_lanka,Asia,21580463,3306,192547
2021-06-03,sri_lanka,Asia,21580463,3297,195844
2021-06-04,sri_lanka,Asia,21580463,3410,199254
2021-06-05,sri_lanka,Asia,21580463,3103,202357
2021-06-06,sri_lanka,Asia,21580463,2976,205333
2021-06-07,sri_lanka,Asia,21580463,2646,207979
2021-06-08,sri_lanka,Asia,21580463,2682,210661
2021-06-09,sri_lanka,Asia,21580463,2735,213396
2021-06-10,sri_lanka,Asia,21580463,2738,216134
2021-06-11,sri_lanka,Asia,21580463,2789,218923
2021-06-12,sri_lanka,Asia,21580463,2354,221277
2021-06-13,sri_lanka,Asia,21580463,2361,223638
2021-06-14,sri_lanka,Asia,21580463,2284,225922
2021-06-15,sri_lanka,Asia,21580463,2334,228256
2021-06-16,sri_lanka,Asia,21580463,2436,230692
2021-06-17,sri_lanka,Asia,21580463,2372,233064
2021-06-18,sri_lanka,Asia,21580463,2349,235413
2021-06-19,sri_lanka,Asia,21580463,2248,237661
2021-06-20,sri_lanka,Asia,21580463,2028,239689
2021-06-21,sri_lanka,Asia,21580463,2131,241820
2021-06-22,sri_lanka,Asia,21580463,2093,243913
2021-06-23,sri_lanka,Asia,21580463,2196,246109
2021-06-24,sri_lanka,Asia,21580463,1941,248050
2021-06-25,sri_lanka,Asia,21580463,1876,249926
2021-06-26,sri_lanka,Asia,21580463,1825,251751
2021-06-27,sri_lanka,Asia,21580463,1867,253618
2021-06-28,sri_lanka,Asia,21580463,1890,255508
2021-06-29,sri_lanka,Asia,21580463,1717,257225
2021-06-30,sri_lanka,Asia,21580463,1864,259089
2021-07-01,sri_lanka,Asia,21580463,1883,260972
2021-07-02,sri_lanka,Asia,21580463,1823,262795
2021-07-03,sri_lanka,Asia,21580463,1262,264057
2021-07-04,sri_lanka,Asia,21580463,1573,265630
2021-07-05,sri_lanka,Asia,21580463,869,266499
2021-07-06,sri_lanka,Asia,21580463,934,267433
2021-07-07,sri_lanka,Asia,21580463,1243,268676
2021-07-08,sri_lanka,Asia,21580463,1270,269946
2021-07-09,sri_lanka,Asia,21580463,1537,271483
2021-07-10,sri_lanka,Asia,21580463,1548,273031
2021-07-11,sri_lanka,Asia,21580463,1507,274538
2021-07-12,sri_lanka,Asia,21580463,1568,276106
2021-07-13,sri_lanka,Asia,21580463,1413,277519
2021-07-14,sri_lanka,Asia,21580463,1540,279059
2021-07-15,sri_lanka,Asia,21580463,1484,280543
2021-07-16,sri_lanka,Asia,21580463,1517,282060
2021-07-17,sri_lanka,Asia,21580463,1452,283512
2021-07-18,sri_lanka,Asia,21580463,1420,284932
2021-07-19,sri_lanka,Asia,21580463,1487,286419
2021-07-20,sri_lanka,Asia,21580463,1554,287973
2021-07-21,sri_lanka,Asia,21580463,1604,289577
2021-07-22,sri_lanka,Asia,21580463,1721,291298
2021-07-23,sri_lanka,Asia,21580463,1815,293113
2021-07-24,sri_lanka,Asia,21580463,1737,294850
2021-07-25,sri_lanka,Asia,21580463,1666,296516
2021-07-26,sri_lanka,Asia,21580463,1665,298181
2021-07-27,sri_lanka,Asia,21580463,1711,299892
2021-07-28,sri_lanka,Asia,21580463,1940,301832
2021-07-29,sri_lanka,Asia,21580463,2370,304202
2021-07-30,sri_lanka,Asia,21580463,2460,306662
2021-07-31,sri_lanka,Asia,21580463,2150,308812
2021-08-01,sri_lanka,Asia,21580463,2537,311349
2021-08-02,sri_lanka,Asia,21580463,2420,313769
2021-08-03,sri_lanka,Asia,21580463,2913,316682
2021-08-04,sri_lanka,Asia,21580463,3019,319701
2021-08-05,sri_lanka,Asia,21580463,3117,322818
2021-08-06,sri_lanka,Asia,21580463,3257,326075
2021-08-07,sri_lanka,Asia,21580463,3278,329353
2021-08-08,sri_lanka,Asia,21580463,3419,332772
2021-08-09,sri_lanka,Asia,21580463,3416,336188
2021-08-10,sri_lanka,Asia,21580463,2904,339092
2021-08-11,sri_lanka,Asia,21580463,2987,342079
2021-08-12,sri_lanka,Asia,21580463,4425,346504
2021-08-13,sri_lanka,Asia,21580463,3152,349656
2021-08-14,sri_lanka,Asia,21580463,3956,353612
2021-08-15,sri_lanka,Asia,21580463,4128,357740
2021-08-16,sri_lanka,Asia,21580463,5544,363284
2021-08-17,sri_lanka,Asia,21580463,4819,368103
2021-08-18,sri_lanka,Asia,21580463,4886,372989
2021-08-19,sri_lanka,Asia,21580463,5016,378005
2021-08-20,sri_lanka,Asia,21580463,3807,381812
2021-08-21,sri_lanka,Asia,21580463,5005,386817
2021-08-22,sri_lanka,Asia,21580463,5425,392242
2021-08-23,sri_lanka,Asia,21580463,5476,397718
2021-08-24,sri_lanka,Asia,21580463,5567,403285
2021-08-25,sri_lanka,Asia,21580463,6265,409550
2021-08-26,sri_lanka,Asia,21580463,6384,415934
2021-08-27,sri_lanka,Asia,21580463,6373,422307
2021-08-28,sri_lanka,Asia,21580463,4596,426903
2021-08-29,sri_lanka,Asia,21580463,5796,432699
2021-08-30,sri_lanka,Asia,21580463,5742,438441
2021-08-31,sri_lanka,Asia,21580463,5401,443842
2021-09-01,sri_lanka,Asia,21580463,5008,448850
2021-09-02,sri_lanka,Asia,21580463,3627,452477
2021-09-03,sri_lanka,Asia,21580463,3649,456126
2021-09-04,sri_lanka,Asia,21580463,3333,459459
2021-09-05,sri_lanka,Asia,21580463,3308,462767
2021-09-06,sri_lanka,Asia,21580463,3182,465949
2021-09-07,sri_lanka,Asia,21580463,5914,471863
2021-09-08,sri_lanka,Asia,21580463,2917,474780
2021-09-09,sri_lanka,Asia,21580463,2856,477636
2021-09-10,sri_lanka,Asia,21580463,2842,480478
2021-09-11,sri_lanka,Asia,21580463,2802,483280
2021-09-12,sri_lanka,Asia,21580463,2642,485922
2021-09-13,sri_lanka,Asia,21580463,2560,488482
2021-09-14,sri_lanka,Asia,21580463,2475,490957
2021-09-15,sri_lanka,Asia,21580463,5466,496423
2021-09-16,sri_lanka,Asia,21580463,2271,498694
2021-09-17,sri_lanka,Asia,21580463,2078,500772
2021-09-18,sri_lanka,Asia,21580463,1986,502758
2021-09-19,sri_lanka,Asia,21580463,1733,504491
2021-09-20,sri_lanka,Asia,21580463,1518,506009
2021-09-21,sri_lanka,Asia,21580463,1321,507330
2021-09-22,sri_lanka,Asia,21580463,1342,508672
2021-09-23,sri_lanka,Asia,21580463,1368,510040
2021-09-24,sri_lanka,Asia,21580463,1332,511372
2021-09-25,sri_lanka,Asia,21580463,1159,512531
2021-09-26,sri_lanka,Asia,21580463,1078,513609
2021-09-27,sri_lanka,Asia,21580463,983,514592
2021-09-28,sri_lanka,Asia,21580463,932,515524
2021-09-29,sri_lanka,Asia,21580463,941,516465
2021-09-30,sri_lanka,Asia,21580463,912,517377
2021-10-01,sri_lanka,Asia,21580463,1398,518775
2021-10-02,sri_lanka,Asia,21580463,855,519630
2021-10-03,sri_lanka,Asia,21580463,802,520432
2021-10-04,sri_lanka,Asia,21580463,786,521218
2021-10-05,sri_lanka,Asia,21580463,784,522002
2021-10-06,sri_lanka,Asia,21580463,776,522778
2021-10-07,sri_lanka,Asia,21580463,772,523550
2021-10-08,sri_lanka,Asia,21580463,1387,524937
2021-10-09,sri_lanka,Asia,21580463,726,525663
2021-10-10,sri_lanka,Asia,21580463,720,526383
2021-10-11,sri_lanka,Asia,21580463,681,527064
2021-10-12,sri_lanka,Asia,21580463,671,527735
2021-10-13,sri_lanka,Asia,21580463,680,528415
2021-10-14,sri_lanka,Asia,21580463,1340,529755
2021-10-15,sri_lanka,Asia,21580463,666,530421
2021-10-16,sri_lanka,Asia,21580463,649,531070
2021-10-17,sri_lanka,Asia,21580463,578,531648
2021-10-18,sri_lanka,Asia,21580463,570,532218
2021-10-19,sri_lanka,Asia,21580463,442,532660
2021-10-20,sri_lanka,Asia,21580463,645,533305
2021-10-21,sri_lanka,Asia,21580463,555,533860
2021-10-22,sri_lanka,Asia,21580463,1115,534975
2021-10-23,sri_lanka,Asia,21580463,554,535529
2021-10-24,sri_lanka,Asia,21580463,555,536084
2021-10-25,sri_lanka,Asia,21580463,561,536645
2021-10-26,sri_lanka,Asia,21580463,985,537630
2021-10-27,sri_lanka,Asia,21580463,690,538320
2021-10-28,sri_lanka,Asia,21580463,540,538860
2021-10-29,sri_lanka,Asia,21580463,556,539416
2021-10-30,sri_lanka,Asia,21580463,565,539981
2021-10-31,sri_lanka,Asia,21580463,1092,541073
2021-11-01,sri_lanka,Asia,21580463,566,541639
2021-11-02,sri_lanka,Asia,21580463,573,542212
2021-11-03,sri_lanka,Asia,21580463,581,542793
2021-11-04,sri_lanka,Asia,21580463,592,543385
2021-11-05,sri_lanka,Asia,21580463,628,544013
2021-11-06,sri_lanka,Asia,21580463,617,544630
2021-11-07,sri_lanka,Asia,21580463,626,545256
2021-11-08,sri_lanka,Asia,21580463,679,545935
2021-11-09,sri_lanka,Asia,21580463,718,546653
2021-11-10,sri_lanka,Asia,21580463,693,547346
2021-11-11,sri_lanka,Asia,21580463,715,548061
2021-11-12,sri_lanka,Asia,21580463,723,548784
2021-11-13,sri_lanka,Asia,21580463,716,549500
2021-11-14,sri_lanka,Asia,21580463,1843,551343
2021-11-15,sri_lanka,Asia,21580463,931,552274
2021-11-16,sri_lanka,Asia,21580463,720,552994
2021-11-17,sri_lanka,Asia,21580463,728,553722
2021-11-18,sri_lanka,Asia,21580463,737,554459
2021-11-19,sri_lanka,Asia,21580463,745,555204
2021-11-20,sri_lanka,Asia,21580463,725,555929
2021-11-21,sri_lanka,Asia,21580463,697,556626
2021-11-22,sri_lanka,Asia,21580463,735,557361
2021-11-23,sri_lanka,Asia,21580463,1499,558860
2021-11-24,sri_lanka,Asia,21580463,745,559605
2021-11-25,sri_lanka,Asia,21580463,740,560345
2021-11-26,sri_lanka,Asia,21580463,714,561059
2021-11-27,sri_lanka,Asia,21580463,719,561778
2021-11-28,sri_lanka,Asia,21580463,742,562520
2021-11-29,sri_lanka,Asia,21580463,747,563267
2021-11-30,sri_lanka,Asia,21580463,722,563989
2021-12-01,sri_lanka,Asia,21580463,744,564733
2021-12-02,sri_lanka,Asia,21580463,738,565471
2021-12-03,sri_lanka,Asia,21580463,725,566196
2021-12-04,sri_lanka,Asia,21580463,740,566936
2021-12-05,sri_lanka,Asia,21580463,746,567682
2021-12-06,sri_lanka,Asia,21580463,741,568423
2021-12-07,sri_lanka,Asia,21580463,748,569171
2021-12-08,sri_lanka,Asia,21580463,757,569928
2021-12-09,sri_lanka,Asia,21580463,744,570672
2021-12-10,sri_lanka,Asia,21580463,754,571426
2021-12-11,sri_lanka,Asia,21580463,762,572188
2021-12-12,sri_lanka,Asia,21580463,714,572902
2021-12-13,sri_lanka,Asia,21580463,747,573649
2021-12-14,sri_lanka,Asia,21580463,2545,576194
2021-12-15,sri_lanka,Asia,21580463,772,576966
2021-12-16,sri_lanka,Asia,21580463,758,577724
2021-12-17,sri_lanka,Asia,21580463,715,578439
2021-12-18,sri_lanka,Asia,21580463,695,579134
2021-12-19,sri_lanka,Asia,21580463,551,579685
2021-12-20,sri_lanka,Asia,21580463,524,580209
2021-12-21,sri_lanka,Asia,21580463,713,580922
2021-12-22,sri_lanka,Asia,21580463,673,581595
2021-12-23,sri_lanka,Asia,21580463,554,582149
2021-12-24,sri_lanka,Asia,21580463,573,582722
2021-12-25,sri_lanka,Asia,21580463,529,583251
2021-12-26,sri_lanka,Asia,21580463,398,583649
2021-12-27,sri_lanka,Asia,21580463,458,584107
2021-12-28,sri_lanka,Asia,21580463,479,584586
2021-12-29,sri_lanka,Asia,21580463,1597,586183
2021-12-30,sri_lanka,Asia,21580463,563,586746
2021-12-31,sri_lanka,Asia,21580463,499,587245
2022-01-01,sri_lanka,Asia,21580463,351,587596
2022-01-02,sri_lanka,Asia,21580463,339,587935
2022-01-03,sri_lanka,Asia,21580463,365,588300
2022-01-04,sri_lanka,Asia,21580463,629,588929
2022-01-05,sri_lanka,Asia,21580463,550,589479
2022-01-06,sri_lanka,Asia,21580463,584,590063
2022-01-07,sri_lanka,Asia,21580463,588,590651
2022-01-08,sri_lanka,Asia,21580463,580,591231
2022-01-09,sri_lanka,Asia,21580463,436,591667
2022-01-10,sri_lanka,Asia,21580463,461,592128
2022-01-11,sri_lanka,Asia,21580463,944,593072
2022-01-12,sri_lanka,Asia,21580463,653,593725
2022-01-13,sri_lanka,Asia,21580463,594,594319
2022-01-14,sri_lanka,Asia,21580463,677,594996
2022-01-15,sri_lanka,Asia,21580463,661,595657
2022-01-16,sri_lanka,Asia,21580463,690,596347
2022-01-17,sri_lanka,Asia,21580463,688,597035
2022-01-18,sri_lanka,Asia,21580463,672,597707
2022-01-19,sri_lanka,Asia,21580463,829,598536
2022-01-20,sri_lanka,Asia,21580463,827,599363
2022-01-21,sri_lanka,Asia,21580463,840,600203
2022-01-22,sri_lanka,Asia,21580463,845,601048
2022-01-23,sri_lanka,Asia,21580463,838,601886
2022-01-24,sri_lanka,Asia,21580463,877,602763
2022-01-25,sri_lanka,Asia,21580463,891,603654
2022-01-26,sri_lanka,Asia,21580463,927,604581
2022-01-27,sri_lanka,Asia,21580463,2523,607104
2022-01-28,sri_lanka,Asia,21580463,961,608065
2022-01-29,sri_lanka,Asia,21580463,982,609047
2022-01-30,sri_lanka,Asia,21580463,1056,610103
2022-01-31,sri_lanka,Asia,21580463,1082,611185
2022-02-01,sri_lanka,Asia,21580463,1241,612426
2022-02-02,sri_lanka,Asia,21580463,1260,613686
2022-02-03,sri_lanka,Asia,21580463,1285,614971
2022-02-04,sri_lanka,Asia,21580463,1347,616318
2022-02-05,sri_lanka,Asia,21580463,1391,617709
2022-02-06,sri_lanka,Asia,21580463,1435,619144
2022-02-07,sri_lanka,Asia,21580463,2316,621460
2022-02-08,sri_lanka,Asia,21580463,1357,622817
2022-02-09,sri_lanka,Asia,21580463,1367,624184
2022-02-10,sri_lanka,Asia,21580463,1401,625585
2022-02-11,sri_lanka,Asia,21580463,1364,626949
2022-02-12,sri_lanka,Asia,21580463,1267,628216
2022-02-13,sri_lanka,Asia,21580463,1255,629471
2022-02-14,sri_lanka,Asia,21580463,1336,630807
2022-02-15,sri_lanka,Asia,21580463,1357,632164
2022-02-16,sri_lanka,Asia,21580463,1217,633381
2022-02-17,sri_lanka,Asia,21580463,1235,634616
2022-02-18,sri_lanka,Asia,21580463,1282,635898
2022-02-19,sri_lanka,Asia,21580463,1273,637171
2022-02-20,sri_lanka,Asia,21580463,1231,638402
2022-02-21,sri_lanka,Asia,21580463,1206,639608
2022-02-22,sri_lanka,Asia,21580463,1254,640862
2022-02-23,sri_lanka,Asia,21580463,1281,642143
2022-02-24,sri_lanka,Asia,21580463,1208,643351
2022-02-25,sri_lanka,Asia,21580463,1286,644637
2022-02-26,sri_lanka,Asia,21580463,988,645625
2022-02-27,sri_lanka,Asia,21580463,977,646602
2022-02-28,sri_lanka,Asia,21580463,997,647599
2022-03-01,sri_lanka,Asia,21580463,914,648513
2022-03-02,sri_lanka,Asia,21580463,751,649264
2022-03-03,sri_lanka,Asia,21580463,711,649975
2022-03-04,sri_lanka,Asia,21580463,583,650558
2022-03-05,sri_lanka,Asia,21580463,639,651197
2022-03-06,sri_lanka,Asia,21580463,508,651705
2022-03-07,sri_lanka,Asia,21580463,662,652367
2022-03-08,sri_lanka,Asia,21580463,662,653029
2022-03-09,sri_lanka,Asia,21580463,1307,654336
2022-03-10,sri_lanka,Asia,21580463,580,654916
2022-03-11,sri_lanka,Asia,21580463,467,655383
2022-03-12,sri_lanka,Asia,21580463,347,655730
2022-03-13,sri_lanka,Asia,21580463,311,656041
2022-03-14,sri_lanka,Asia,21580463,345,656386
2022-03-15,sri_lanka,Asia,21580463,428,656814
2022-03-16,sri_lanka,Asia,21580463,320,657134
2022-03-17,sri_lanka,Asia,21580463,301,657435
2022-03-18,sri_lanka,Asia,21580463,288,657723
2022-03-19,sri_lanka,Asia,21580463,238,657961
2022-03-20,sri_lanka,Asia,21580463,236,658197
2022-03-21,sri_lanka,Asia,21580463,296,658493
2022-03-22,sri_lanka,Asia,21580463,1366,659859
2022-03-23,sri_lanka,Asia,21580463,292,660151
2022-03-24,sri_lanka,Asia,21580463,248,660399
2022-03-25,sri_lanka,Asia,21580463,234,660633
2022-03-26,sri_lanka,Asia,21580463,164,660797
2022-03-27,sri_lanka,Asia,21580463,93,660890
2022-03-28,sri_lanka,Asia,21580463,163,661053
2022-03-29,sri_lanka,Asia,21580463,232,661285
2022-03-30,sri_lanka,Asia,21580463,168,661453
2022-03-31,sri_lanka,Asia,21580463,178,661631
2022-04-01,sri_lanka,Asia,21580463,150,661781
2022-04-02,sri_lanka,Asia,21580463,104,661885
2022-04-03,sri_lanka,Asia,21580463,106,661991
2022-04-04,sri_lanka,Asia,21580463,112,662103
2022-04-05,sri_lanka,Asia,21580463,113,662216
2022-04-06,sri_lanka,Asia,21580463,126,662342
2022-04-07,sri_lanka,Asia,21580463,83,662425
2022-04-08,sri_lanka,Asia,21580463,80,662505
2022-04-09,sri_lanka,Asia,21580463,54,662559
2022-04-10,sri_lanka,Asia,21580463,33,662592
2022-04-11,sri_lanka,Asia,21580463,65,662657
2022-04-12,sri_lanka,Asia,21580463,60,662717
2022-04-13,sri_lanka,Asia,21580463,31,662748
2022-04-14,sri_lanka,Asia,21580463,27,662775
2022-04-15,sri_lanka,Asia,21580463,19,662794
2022-04-16,sri_lanka,Asia,21580463,33,662827
2022-04-17,sri_lanka,Asia,21580463,0,662827
2022-04-18,sri_lanka,Asia,21580463,85,662912
2022-04-19,sri_lanka,Asia,21580463,33,662945
2022-04-20,sri_lanka,Asia,21580463,61,663006
2022-04-21,sri_lanka,Asia,21580463,35,663041
2022-04-22,sri_lanka,Asia,21580463,50,663091
2022-04-23,sri_lanka,Asia,21580463,40,663131
2022-04-24,sri_lanka,Asia,21580463,0,663131
2022-04-25,sri_lanka,Asia,21580463,64,663195
2022-04-26,sri_lanka,Asia,21580463,44,663239
2022-04-27,sri_lanka,Asia,21580463,0,663239
2022-04-28,sri_lanka,Asia,21580463,62,663301
2022-04-29,sri_lanka,Asia,21580463,28,663329
2022-04-30,sri_lanka,Asia,21580463,33,663362
2022-05-01,sri_lanka,Asia,21580463,11,663373
2022-05-02,sri_lanka,Asia,21580463,35,663408
2022-05-03,sri_lanka,Asia,21580463,18,663426
2022-05-04,sri_lanka,Asia,21580463,43,663469
2022-05-05,sri_lanka,Asia,21580463,34,663503
2022-05-06,sri_lanka,Asia,21580463,17,663520
2022-05-07,sri_lanka,Asia,21580463,13,663533
2022-05-08,sri_lanka,Asia,21580463,28,663561
2022-05-09,sri_lanka,Asia,21580463,19,663580
2022-05-10,sri_lanka,Asia,21580463,17,663597
2020-04-04,suriname,South America,596421,0,10
2020-04-05,suriname,South America,596421,0,10
2020-04-06,suriname,South America,596421,0,10
2020-04-07,suriname,South America,596421,0,10
2020-04-08,suriname,South America,596421,0,10
2020-04-09,suriname,South America,596421,0,10
2020-04-10,suriname,South America,596421,0,10
2020-04-11,suriname,South America,596421,0,10
2020-04-12,suriname,South America,596421,0,10
2020-04-13,suriname,South America,596421,0,10
2020-04-14,suriname,South America,596421,0,10
2020-04-15,suriname,South America,596421,0,10
2020-04-16,suriname,South America,596421,0,10
2020-04-17,suriname,South America,596421,0,10
2020-04-18,suriname,South America,596421,0,10
2020-04-19,suriname,South America,596421,0,10
2020-04-20,suriname,South America,596421,0,10
2020-04-21,suriname,South America,596421,0,10
2020-04-22,suriname,South America,596421,0,10
2020-04-23,suriname,South America,596421,0,10
2020-04-24,suriname,South America,596421,0,10
2020-04-25,suriname,South America,596421,0,10
2020-04-26,suriname,South America,596421,0,10
2020-04-27,suriname,South America,596421,0,10
2020-04-28,suriname,South America,596421,0,10
2020-04-29,suriname,South America,596421,0,10
2020-04-30,suriname,South America,596421,0,10
2020-05-01,suriname,South America,596421,0,10
2020-05-02,suriname,South America,596421,0,10
2020-05-03,suriname,South America,596421,0,10
2020-05-04,suriname,South America,596421,0,10
2020-05-05,suriname,South America,596421,0,10
2020-05-06,suriname,South America,596421,0,10
2020-05-07,suriname,South America,596421,0,10
2020-05-08,suriname,South America,596421,0,10
2020-05-09,suriname,South America,596421,0,10
2020-05-10,suriname,South America,596421,0,10
2020-05-11,suriname,South America,596421,0,10
2020-05-12,suriname,South America,596421,0,10
2020-05-13,suriname,South America,596421,0,10
2020-05-14,suriname,South America,596421,0,10
2020-05-15,suriname,South America,596421,0,10
2020-05-16,suriname,South America,596421,0,10
2020-05-17,suriname,South America,596421,0,10
2020-05-18,suriname,South America,596421,1,11
2020-05-19,suriname,South America,596421,0,11
2020-05-20,suriname,South America,596421,0,11
2020-05-21,suriname,South America,596421,0,11
2020-05-22,suriname,South America,596421,0,11
2020-05-23,suriname,South America,596421,0,11
2020-05-24,suriname,South America,596421,0,11
2020-05-25,suriname,South America,596421,0,11
2020-05-26,suriname,South America,596421,0,11
2020-05-27,suriname,South America,596421,1,12
2020-05-28,suriname,South America,596421,0,12
2020-05-29,suriname,South America,596421,0,12
2020-05-30,suriname,South America,596421,0,12
2020-05-31,suriname,South America,596421,11,23
2020-06-01,suriname,South America,596421,21,44
2020-06-02,suriname,South America,596421,10,54
2020-06-03,suriname,South America,596421,20,74
2020-06-04,suriname,South America,596421,8,82
2020-06-05,suriname,South America,596421,8,90
2020-06-06,suriname,South America,596421,10,100
2020-06-07,suriname,South America,596421,22,122
2020-06-08,suriname,South America,596421,6,128
2020-06-09,suriname,South America,596421,9,137
2020-06-10,suriname,South America,596421,7,144
2020-06-11,suriname,South America,596421,24,168
2020-06-12,suriname,South America,596421,19,187
2020-06-13,suriname,South America,596421,9,196
2020-06-14,suriname,South America,596421,12,208
2020-06-15,suriname,South America,596421,21,229
2020-06-16,suriname,South America,596421,7,236
2020-06-17,suriname,South America,596421,25,261
2020-06-18,suriname,South America,596421,16,277
2020-06-19,suriname,South America,596421,16,293
2020-06-20,suriname,South America,596421,9,302
2020-06-21,suriname,South America,596421,12,314
2020-06-22,suriname,South America,596421,5,319
2020-06-23,suriname,South America,596421,0,319
2020-06-24,suriname,South America,596421,38,357
2020-06-25,suriname,South America,596421,16,373
2020-06-26,suriname,South America,596421,16,389
2020-06-27,suriname,South America,596421,44,433
2020-06-28,suriname,South America,596421,57,490
2020-06-29,suriname,South America,596421,11,501
2020-06-30,suriname,South America,596421,14,515
2020-07-01,suriname,South America,596421,20,535
2020-07-02,suriname,South America,596421,12,547
2020-07-03,suriname,South America,596421,14,561
2020-07-04,suriname,South America,596421,4,565
2020-07-05,suriname,South America,596421,29,594
2020-07-06,suriname,South America,596421,20,614
2020-07-07,suriname,South America,596421,20,634
2020-07-08,suriname,South America,596421,31,665
2020-07-09,suriname,South America,596421,29,694
2020-07-10,suriname,South America,596421,32,726
2020-07-11,suriname,South America,596421,15,741
2020-07-12,suriname,South America,596421,0,741
2020-07-13,suriname,South America,596421,39,780
2020-07-14,suriname,South America,596421,21,801
2020-07-15,suriname,South America,596421,36,837
2020-07-16,suriname,South America,596421,67,904
2020-07-17,suriname,South America,596421,39,943
2020-07-18,suriname,South America,596421,58,1001
2020-07-19,suriname,South America,596421,28,1029
2020-07-20,suriname,South America,596421,50,1079
2020-07-21,suriname,South America,596421,52,1131
2020-07-22,suriname,South America,596421,45,1176
2020-07-23,suriname,South America,596421,58,1234
2020-07-24,suriname,South America,596421,71,1305
2020-07-25,suriname,South America,596421,76,1381
2020-07-26,suriname,South America,596421,58,1439
2020-07-27,suriname,South America,596421,44,1483
2020-07-28,suriname,South America,596421,27,1510
2020-07-29,suriname,South America,596421,97,1607
2020-07-30,suriname,South America,596421,0,1607
2020-07-31,suriname,South America,596421,43,1650
2020-08-01,suriname,South America,596421,110,1760
2020-08-02,suriname,South America,596421,89,1849
2020-08-03,suriname,South America,596421,44,1893
2020-08-04,suriname,South America,596421,88,1981
2020-08-05,suriname,South America,596421,69,2050
2020-08-06,suriname,South America,596421,46,2096
2020-08-07,suriname,South America,596421,107,2203
2020-08-08,suriname,South America,596421,103,2306
2020-08-09,suriname,South America,596421,85,2391
2020-08-10,suriname,South America,596421,98,2489
2020-08-11,suriname,South America,596421,70,2559
2020-08-12,suriname,South America,596421,94,2653
2020-08-13,suriname,South America,596421,108,2761
2020-08-14,suriname,South America,596421,77,2838
2020-08-15,suriname,South America,596421,123,2961
2020-08-16,suriname,South America,596421,55,3016
2020-08-17,suriname,South America,596421,61,3077
2020-08-18,suriname,South America,596421,139,3216
2020-08-19,suriname,South America,596421,79,3295
2020-08-20,suriname,South America,596421,71,3366
2020-08-21,suriname,South America,596421,94,3460
2020-08-22,suriname,South America,596421,109,3569
2020-08-23,suriname,South America,596421,38,3607
2020-08-24,suriname,South America,596421,25,3632
2020-08-25,suriname,South America,596421,66,3698
2020-08-26,suriname,South America,596421,26,3724
2020-08-27,suriname,South America,596421,69,3793
2020-08-28,suriname,South America,596421,55,3848
2020-08-29,suriname,South America,596421,106,3954
2020-08-30,suriname,South America,596421,55,4009
2020-08-31,suriname,South America,596421,25,4034
2020-09-01,suriname,South America,596421,55,4089
2020-09-02,suriname,South America,596421,60,4149
2020-09-03,suriname,South America,596421,66,4215
2020-09-04,suriname,South America,596421,37,4252
2020-09-05,suriname,South America,596421,68,4320
2020-09-06,suriname,South America,596421,26,4346
2020-09-07,suriname,South America,596421,14,4360
2020-09-08,suriname,South America,596421,59,4419
2020-09-09,suriname,South America,596421,28,4447
2020-09-10,suriname,South America,596421,30,4477
2020-09-11,suriname,South America,596421,52,4529
2020-09-12,suriname,South America,596421,50,4579
2020-09-13,suriname,South America,596421,3,4582
2020-09-14,suriname,South America,596421,29,4611
2020-09-15,suriname,South America,596421,14,4625
2020-09-16,suriname,South America,596421,20,4645
2020-09-17,suriname,South America,596421,26,4671
2020-09-18,suriname,South America,596421,20,4691
2020-09-19,suriname,South America,596421,18,4709
2020-09-20,suriname,South America,596421,14,4723
2020-09-21,suriname,South America,596421,17,4740
2020-09-22,suriname,South America,596421,19,4759
2020-09-23,suriname,South America,596421,20,4779
2020-09-24,suriname,South America,596421,10,4789
2020-09-25,suriname,South America,596421,28,4817
2020-09-26,suriname,South America,596421,14,4831
2020-09-27,suriname,South America,596421,4,4835
2020-09-28,suriname,South America,596421,1,4836
2020-09-29,suriname,South America,596421,27,4863
2020-09-30,suriname,South America,596421,14,4877
2020-10-01,suriname,South America,596421,14,4891
2020-10-02,suriname,South America,596421,8,4899
2020-10-03,suriname,South America,596421,25,4924
2020-10-04,suriname,South America,596421,17,4941
2020-10-05,suriname,South America,596421,13,4954
2020-10-06,suriname,South America,596421,11,4965
2020-10-07,suriname,South America,596421,14,4979
2020-10-08,suriname,South America,596421,25,5004
2020-10-09,suriname,South America,596421,14,5018
2020-10-10,suriname,South America,596421,17,5035
2020-10-11,suriname,South America,596421,16,5051
2020-10-12,suriname,South America,596421,7,5058
2020-10-13,suriname,South America,596421,14,5072
2020-10-14,suriname,South America,596421,11,5083
2020-10-15,suriname,South America,596421,11,5094
2020-10-16,suriname,South America,596421,19,5113
2020-10-17,suriname,South America,596421,10,5123
2020-10-18,suriname,South America,596421,7,5130
2020-10-19,suriname,South America,596421,3,5133
2020-10-20,suriname,South America,596421,11,5144
2020-10-21,suriname,South America,596421,6,5150
2020-10-22,suriname,South America,596421,4,5154
2020-10-23,suriname,South America,596421,1,5155
2020-10-24,suriname,South America,596421,11,5166
2020-10-25,suriname,South America,596421,4,5170
2020-10-26,suriname,South America,596421,10,5180
2020-10-27,suriname,South America,596421,7,5187
2020-10-28,suriname,South America,596421,5,5192
2020-10-29,suriname,South America,596421,5,5197
2020-10-30,suriname,South America,596421,4,5201
2020-10-31,suriname,South America,596421,2,5203
2020-11-01,suriname,South America,596421,7,5210
2020-11-02,suriname,South America,596421,2,5212
2020-11-03,suriname,South America,596421,6,5218
2020-11-04,suriname,South America,596421,2,5220
2020-11-05,suriname,South America,596421,5,5225
2020-04-17,swaziland,Africa,1182536,0,16
2020-04-18,swaziland,Africa,1182536,6,22
2020-04-19,swaziland,Africa,1182536,0,22
2020-04-20,swaziland,Africa,1182536,2,24
2020-04-21,swaziland,Africa,1182536,7,31
2020-04-22,swaziland,Africa,1182536,0,31
2020-04-23,swaziland,Africa,1182536,0,31
2020-04-24,swaziland,Africa,1182536,5,36
2020-04-25,swaziland,Africa,1182536,21,57
2020-04-26,swaziland,Africa,1182536,3,60
2020-04-27,swaziland,Africa,1182536,6,66
2020-04-28,swaziland,Africa,1182536,6,72
2020-04-29,swaziland,Africa,1182536,21,93
2020-04-30,swaziland,Africa,1182536,10,103
2020-05-01,swaziland,Africa,1182536,6,109
2020-05-02,swaziland,Africa,1182536,2,111
2020-05-03,swaziland,Africa,1182536,4,115
2020-05-04,swaziland,Africa,1182536,4,119
2020-05-05,swaziland,Africa,1182536,3,122
2020-05-06,swaziland,Africa,1182536,4,126
2020-05-07,swaziland,Africa,1182536,32,158
2020-05-08,swaziland,Africa,1182536,6,164
2020-05-09,swaziland,Africa,1182536,4,168
2020-05-10,swaziland,Africa,1182536,10,178
2020-05-11,swaziland,Africa,1182536,3,181
2020-05-12,swaziland,Africa,1182536,10,191
2020-05-13,swaziland,Africa,1182536,3,194
2020-05-14,swaziland,Africa,1182536,0,194
2020-05-15,swaziland,Africa,1182536,3,197
2020-05-16,swaziland,Africa,1182536,13,210
2020-05-17,swaziland,Africa,1182536,1,211
2020-05-18,swaziland,Africa,1182536,2,213
2020-05-19,swaziland,Africa,1182536,3,216
2020-05-20,swaziland,Africa,1182536,10,226
2020-05-21,swaziland,Africa,1182536,3,229
2020-05-22,swaziland,Africa,1182536,5,234
2020-05-23,swaziland,Africa,1182536,14,248
2020-05-24,swaziland,Africa,1182536,13,261
2020-05-25,swaziland,Africa,1182536,6,267
2020-05-26,swaziland,Africa,1182536,5,272
2020-05-27,swaziland,Africa,1182536,12,284
2020-05-28,swaziland,Africa,1182536,7,291
2020-05-29,swaziland,Africa,1182536,0,291
2020-05-30,swaziland,Africa,1182536,4,295
2020-05-31,swaziland,Africa,1182536,2,297
2020-06-01,swaziland,Africa,1182536,8,305
2020-06-02,swaziland,Africa,1182536,1,306
2020-06-03,swaziland,Africa,1182536,1,307
2020-06-04,swaziland,Africa,1182536,5,312
2020-06-05,swaziland,Africa,1182536,5,317
2020-06-06,swaziland,Africa,1182536,18,335
2020-06-07,swaziland,Africa,1182536,12,347
2020-06-08,swaziland,Africa,1182536,7,354
2020-06-09,swaziland,Africa,1182536,33,387
2020-06-10,swaziland,Africa,1182536,29,416
2020-06-11,swaziland,Africa,1182536,54,470
2020-06-12,swaziland,Africa,1182536,24,494
2020-06-13,swaziland,Africa,1182536,15,509
2020-06-14,swaziland,Africa,1182536,4,513
2020-06-15,swaziland,Africa,1182536,17,530
2020-06-16,swaziland,Africa,1182536,15,545
2020-06-17,swaziland,Africa,1182536,46,591
2020-06-18,swaziland,Africa,1182536,24,615
2020-06-19,swaziland,Africa,1182536,39,654
2020-06-20,swaziland,Africa,1182536,4,658
2020-06-21,swaziland,Africa,1182536,8,666
2020-06-22,swaziland,Africa,1182536,8,674
2020-06-23,swaziland,Africa,1182536,33,707
2020-06-24,swaziland,Africa,1182536,17,724
2020-06-25,swaziland,Africa,1182536,17,741
2020-06-26,swaziland,Africa,1182536,23,764
2020-06-27,swaziland,Africa,1182536,18,782
2020-06-28,swaziland,Africa,1182536,38,820
2020-06-29,swaziland,Africa,1182536,15,835
2020-06-30,swaziland,Africa,1182536,18,853
2020-07-01,swaziland,Africa,1182536,30,883
2020-07-02,swaziland,Africa,1182536,35,918
2020-07-03,swaziland,Africa,1182536,38,956
2020-07-04,swaziland,Africa,1182536,48,1004
2020-07-05,swaziland,Africa,1182536,36,1040
2020-07-06,swaziland,Africa,1182536,24,1064
2020-07-07,swaziland,Africa,1182536,48,1112
2020-07-08,swaziland,Africa,1182536,87,1199
2020-07-09,swaziland,Africa,1182536,79,1278
2020-07-10,swaziland,Africa,1182536,47,1325
2020-07-11,swaziland,Africa,1182536,57,1382
2020-07-12,swaziland,Africa,1182536,42,1424
2020-07-13,swaziland,Africa,1182536,40,1464
2020-07-14,swaziland,Africa,1182536,48,1512
2020-07-15,swaziland,Africa,1182536,58,1570
2020-07-16,swaziland,Africa,1182536,67,1637
2020-07-17,swaziland,Africa,1182536,71,1708
2020-07-18,swaziland,Africa,1182536,116,1824
2020-07-19,swaziland,Africa,1182536,68,1892
2020-07-20,swaziland,Africa,1182536,35,1927
2020-07-21,swaziland,Africa,1182536,72,1999
2020-07-22,swaziland,Africa,1182536,47,2046
2020-07-23,swaziland,Africa,1182536,88,2134
2020-07-24,swaziland,Africa,1182536,55,2189
2020-07-25,swaziland,Africa,1182536,73,2262
2020-07-26,swaziland,Africa,1182536,69,2331
2020-07-27,swaziland,Africa,1182536,115,2446
2020-07-28,swaziland,Africa,1182536,93,2539
2020-07-29,swaziland,Africa,1182536,156,2695
2020-07-30,swaziland,Africa,1182536,28,2723
2020-07-31,swaziland,Africa,1182536,75,2798
2020-08-01,swaziland,Africa,1182536,61,2859
2020-08-02,swaziland,Africa,1182536,73,2932
2020-08-03,swaziland,Africa,1182536,67,2999
2020-08-04,swaziland,Africa,1182536,19,3018
2020-08-05,swaziland,Africa,1182536,56,3074
2020-08-06,swaziland,Africa,1182536,62,3136
2020-08-07,swaziland,Africa,1182536,72,3208
2020-08-08,swaziland,Africa,1182536,97,3305
2020-08-09,swaziland,Africa,1182536,114,3419
2020-08-10,swaziland,Africa,1182536,77,3496
2020-08-11,swaziland,Africa,1182536,107,3603
2020-08-12,swaziland,Africa,1182536,122,3725
2020-08-13,swaziland,Africa,1182536,78,3803
2020-08-14,swaziland,Africa,1182536,75,3878
2020-08-15,swaziland,Africa,1182536,79,3957
2020-08-16,swaziland,Africa,1182536,100,4057
2020-08-17,swaziland,Africa,1182536,58,4115
2020-08-18,swaziland,Africa,1182536,101,4216
2020-08-19,swaziland,Africa,1182536,73,4289
2020-08-20,swaziland,Africa,1182536,55,4344
2020-08-21,swaziland,Africa,1182536,19,4363
2020-08-22,swaziland,Africa,1182536,65,4428
2020-08-23,swaziland,Africa,1182536,38,4466
2020-08-24,swaziland,Africa,1182536,84,4550
2020-08-25,swaziland,Africa,1182536,24,4574
2020-08-26,swaziland,Africa,1182536,64,4638
2020-08-27,swaziland,Africa,1182536,49,4687
2020-08-28,swaziland,Africa,1182536,30,4717
2020-08-29,swaziland,Africa,1182536,52,4769
2020-08-30,swaziland,Africa,1182536,54,4823
2020-08-31,swaziland,Africa,1182536,17,4840
2020-09-01,swaziland,Africa,1182536,43,4883
2020-09-02,swaziland,Africa,1182536,53,4936
2020-09-03,swaziland,Africa,1182536,55,4991
2020-09-04,swaziland,Africa,1182536,64,5055
2020-09-05,swaziland,Africa,1182536,41,5096
2020-09-06,swaziland,Africa,1182536,36,5132
2020-09-07,swaziland,Africa,1182536,33,5165
2020-09-08,swaziland,Africa,1182536,21,5186
2020-09-09,swaziland,Africa,1182536,34,5220
2020-09-10,swaziland,Africa,1182536,61,5281
2020-09-11,swaziland,Africa,1182536,33,5314
2020-09-12,swaziland,Africa,1182536,26,5340
2020-09-13,swaziland,Africa,1182536,26,5366
2020-09-14,swaziland,Africa,1182536,31,5397
2020-09-15,swaziland,Africa,1182536,25,5422
2020-09-16,swaziland,Africa,1182536,29,5451
2020-09-17,swaziland,Africa,1182536,38,5489
2020-09-18,swaziland,Africa,1182536,25,5514
2020-09-19,swaziland,Africa,1182536,32,5546
2020-09-20,swaziland,Africa,1182536,25,5571
2020-09-21,swaziland,Africa,1182536,14,5585
2020-09-22,swaziland,Africa,1182536,26,5611
2020-09-23,swaziland,Africa,1182536,38,5649
2020-09-24,swaziland,Africa,1182536,34,5683
2020-09-25,swaziland,Africa,1182536,25,5708
2020-09-26,swaziland,Africa,1182536,21,5729
2020-09-27,swaziland,Africa,1182536,13,5742
2020-09-28,swaziland,Africa,1182536,22,5764
2020-09-29,swaziland,Africa,1182536,11,5775
2020-09-30,swaziland,Africa,1182536,21,5796
2020-10-01,swaziland,Africa,1182536,19,5815
2020-10-02,swaziland,Africa,1182536,22,5837
2020-10-03,swaziland,Africa,1182536,10,5847
2020-10-04,swaziland,Africa,1182536,41,5888
2020-10-05,swaziland,Africa,1182536,11,5899
2020-10-06,swaziland,Africa,1182536,20,5919
2020-10-07,swaziland,Africa,1182536,20,5939
2020-10-08,swaziland,Africa,1182536,16,5955
2020-10-09,swaziland,Africa,1182536,13,5968
2020-10-10,swaziland,Africa,1182536,17,5985
2020-10-11,swaziland,Africa,1182536,10,5995
2020-10-12,swaziland,Africa,1182536,15,6010
2020-10-13,swaziland,Africa,1182536,14,6024
2020-10-14,swaziland,Africa,1182536,20,6044
2020-10-15,swaziland,Africa,1182536,19,6063
2020-10-16,swaziland,Africa,1182536,14,6077
2020-10-17,swaziland,Africa,1182536,20,6097
2020-10-18,swaziland,Africa,1182536,16,6113
2020-10-19,swaziland,Africa,1182536,8,6121
2020-10-20,swaziland,Africa,1182536,13,6134
2020-10-21,swaziland,Africa,1182536,5,6139
2020-10-22,swaziland,Africa,1182536,10,6149
2020-10-23,swaziland,Africa,1182536,18,6167
2020-10-24,swaziland,Africa,1182536,17,6184
2020-10-25,swaziland,Africa,1182536,7,6191
2020-10-26,swaziland,Africa,1182536,10,6201
2020-10-27,swaziland,Africa,1182536,13,6214
2020-10-28,swaziland,Africa,1182536,12,6226
2020-10-29,swaziland,Africa,1182536,14,6240
2020-10-30,swaziland,Africa,1182536,11,6251
2020-10-31,swaziland,Africa,1182536,8,6259
2020-11-01,swaziland,Africa,1182536,8,6267
2020-11-02,swaziland,Africa,1182536,4,6271
2020-11-03,swaziland,Africa,1182536,14,6285
2020-11-04,swaziland,Africa,1182536,14,6299
2020-11-05,swaziland,Africa,1182536,13,6312
2020-11-06,swaziland,Africa,1182536,10,6322
2020-11-07,swaziland,Africa,1182536,14,6336
2020-11-08,swaziland,Africa,1182536,15,6351
2020-11-09,swaziland,Africa,1182536,11,6362
2020-11-10,swaziland,Africa,1182536,12,6374
2020-11-11,swaziland,Africa,1182536,21,6395
2020-11-12,swaziland,Africa,1182536,17,6412
2020-11-13,swaziland,Africa,1182536,17,6429
2020-11-14,swaziland,Africa,1182536,18,6447
2020-11-15,swaziland,Africa,1182536,2,6449
2020-11-16,swaziland,Africa,1182536,11,6460
2020-11-17,swaziland,Africa,1182536,20,6480
2020-11-18,swaziland,Africa,1182536,21,6501
2020-11-19,swaziland,Africa,1182536,13,6514
2020-11-20,swaziland,Africa,1182536,31,6545
2020-11-21,swaziland,Africa,1182536,21,6566
2020-11-22,swaziland,Africa,1182536,15,6581
2020-11-23,swaziland,Africa,1182536,15,6596
2020-11-24,swaziland,Africa,1182536,15,6611
2020-11-25,swaziland,Africa,1182536,26,6637
2020-11-26,swaziland,Africa,1182536,60,6697
2020-11-27,swaziland,Africa,1182536,35,6732
2020-11-28,swaziland,Africa,1182536,47,6779
2020-11-29,swaziland,Africa,1182536,4,6783
2020-11-30,swaziland,Africa,1182536,10,6793
2020-12-01,swaziland,Africa,1182536,24,6817
2020-12-02,swaziland,Africa,1182536,14,6831
2020-12-03,swaziland,Africa,1182536,20,6851
2020-12-04,swaziland,Africa,1182536,6,6857
2020-12-05,swaziland,Africa,1182536,16,6873
2020-12-06,swaziland,Africa,1182536,6,6879
2020-12-07,swaziland,Africa,1182536,30,6909
2020-12-08,swaziland,Africa,1182536,36,6945
2020-12-09,swaziland,Africa,1182536,52,6997
2020-12-10,swaziland,Africa,1182536,22,7019
2020-12-11,swaziland,Africa,1182536,55,7074
2020-12-12,swaziland,Africa,1182536,31,7105
2020-12-13,swaziland,Africa,1182536,57,7162
2020-12-14,swaziland,Africa,1182536,60,7222
2020-12-15,swaziland,Africa,1182536,92,7314
2020-12-16,swaziland,Africa,1182536,121,7435
2020-12-17,swaziland,Africa,1182536,71,7506
2020-12-18,swaziland,Africa,1182536,115,7621
2020-12-19,swaziland,Africa,1182536,109,7730
2020-12-20,swaziland,Africa,1182536,129,7859
2020-12-21,swaziland,Africa,1182536,143,8002
2020-12-22,swaziland,Africa,1182536,162,8164
2020-12-23,swaziland,Africa,1182536,162,8326
2020-12-24,swaziland,Africa,1182536,174,8500
2020-12-25,swaziland,Africa,1182536,146,8646
2020-12-26,swaziland,Africa,1182536,209,8855
2020-12-27,swaziland,Africa,1182536,124,8979
2020-12-28,swaziland,Africa,1182536,215,9194
2020-12-29,swaziland,Africa,1182536,262,9456
2020-12-30,swaziland,Africa,1182536,224,9680
2020-12-31,swaziland,Africa,1182536,224,9904
2021-01-01,swaziland,Africa,1182536,131,10035
2021-01-02,swaziland,Africa,1182536,242,10277
2021-01-03,swaziland,Africa,1182536,246,10523
2021-01-04,swaziland,Africa,1182536,206,10729
2021-01-05,swaziland,Africa,1182536,212,10941
2021-01-06,swaziland,Africa,1182536,213,11154
2021-01-07,swaziland,Africa,1182536,248,11402
2021-01-08,swaziland,Africa,1182536,214,11616
2021-01-09,swaziland,Africa,1182536,217,11833
2021-01-10,swaziland,Africa,1182536,270,12103
2021-01-11,swaziland,Africa,1182536,292,12395
2021-01-12,swaziland,Africa,1182536,220,12615
2021-01-13,swaziland,Africa,1182536,217,12832
2021-01-14,swaziland,Africa,1182536,215,13047
2021-01-15,swaziland,Africa,1182536,217,13264
2021-01-16,swaziland,Africa,1182536,216,13480
2021-01-17,swaziland,Africa,1182536,220,13700
2021-01-18,swaziland,Africa,1182536,257,13957
2021-01-19,swaziland,Africa,1182536,271,14228
2021-01-20,swaziland,Africa,1182536,366,14594
2021-01-21,swaziland,Africa,1182536,241,14835
2021-01-22,swaziland,Africa,1182536,214,15049
2021-01-23,swaziland,Africa,1182536,118,15167
2021-01-24,swaziland,Africa,1182536,163,15330
2021-01-25,swaziland,Africa,1182536,146,15476
2021-01-26,swaziland,Africa,1182536,220,15696
2021-01-27,swaziland,Africa,1182536,234,15930
2021-01-28,swaziland,Africa,1182536,246,16176
2021-01-29,swaziland,Africa,1182536,199,16375
2021-01-30,swaziland,Africa,1182536,206,16581
2021-01-31,swaziland,Africa,1182536,48,16629
2021-02-01,swaziland,Africa,1182536,98,16727
2021-02-02,swaziland,Africa,1182536,78,16805
2021-02-03,swaziland,Africa,1182536,102,16907
2021-02-04,swaziland,Africa,1182536,75,16982
2021-02-05,swaziland,Africa,1182536,97,17079
2021-02-06,swaziland,Africa,1182536,47,17126
2021-02-07,swaziland,Africa,1182536,24,17150
2021-02-08,swaziland,Africa,1182536,32,17182
2021-02-09,swaziland,Africa,1182536,57,17239
2021-02-10,swaziland,Africa,1182536,56,17295
2021-02-11,swaziland,Africa,1182536,58,17353
2021-02-12,swaziland,Africa,1182536,62,17415
2021-02-13,swaziland,Africa,1182536,35,17450
2021-02-14,swaziland,Africa,1182536,50,17500
2021-02-15,swaziland,Africa,1182536,43,17543
2021-02-16,swaziland,Africa,1182536,32,17575
2021-02-17,swaziland,Africa,1182536,71,17646
2021-02-18,swaziland,Africa,1182536,38,17684
2021-02-19,swaziland,Africa,1182536,35,17719
2021-02-20,swaziland,Africa,1182536,23,17742
2021-02-21,swaziland,Africa,1182536,26,17768
2021-02-22,swaziland,Africa,1182536,19,17787
2021-02-23,swaziland,Africa,1182536,34,17821
2021-02-24,swaziland,Africa,1182536,61,17882
2021-02-25,swaziland,Africa,1182536,52,17934
2021-02-26,swaziland,Africa,1182536,28,17962
2021-02-27,swaziland,Africa,1182536,32,17994
2021-02-28,swaziland,Africa,1182536,13,18007
2021-03-01,swaziland,Africa,1182536,12,18019
2021-03-02,swaziland,Africa,1182536,65,18084
2021-03-03,swaziland,Africa,1182536,18,18102
2021-03-04,swaziland,Africa,1182536,28,18130
2021-03-05,swaziland,Africa,1182536,28,18158
2021-03-06,swaziland,Africa,1182536,19,18177
2021-03-07,swaziland,Africa,1182536,12,18189
2021-03-08,swaziland,Africa,1182536,4,18193
2021-03-09,swaziland,Africa,1182536,3,18196
2021-03-10,swaziland,Africa,1182536,13,18209
2021-03-11,swaziland,Africa,1182536,13,18222
2021-03-12,swaziland,Africa,1182536,11,18233
2021-03-13,swaziland,Africa,1182536,10,18243
2021-03-14,swaziland,Africa,1182536,3,18246
2021-03-15,swaziland,Africa,1182536,2,18248
2021-03-16,swaziland,Africa,1182536,4,18252
2021-03-17,swaziland,Africa,1182536,15,18267
2021-03-18,swaziland,Africa,1182536,11,18278
2021-03-19,swaziland,Africa,1182536,7,18285
2021-03-20,swaziland,Africa,1182536,10,18295
2021-03-21,swaziland,Africa,1182536,3,18298
2021-03-22,swaziland,Africa,1182536,4,18302
2021-03-23,swaziland,Africa,1182536,6,18308
2021-03-24,swaziland,Africa,1182536,5,18313
2021-03-25,swaziland,Africa,1182536,5,18318
2021-03-26,swaziland,Africa,1182536,6,18324
2021-03-27,swaziland,Africa,1182536,6,18330
2021-03-28,swaziland,Africa,1182536,3,18333
2021-03-29,swaziland,Africa,1182536,5,18338
2021-03-30,swaziland,Africa,1182536,7,18345
2021-03-31,swaziland,Africa,1182536,4,18349
2021-04-01,swaziland,Africa,1182536,7,18356
2021-04-02,swaziland,Africa,1182536,3,18359
2021-04-03,swaziland,Africa,1182536,2,18361
2021-04-04,swaziland,Africa,1182536,3,18364
2021-04-05,swaziland,Africa,1182536,2,18366
2021-04-06,swaziland,Africa,1182536,4,18370
2021-04-07,swaziland,Africa,1182536,7,18377
2021-04-08,swaziland,Africa,1182536,2,18379
2021-04-09,swaziland,Africa,1182536,3,18382
2021-04-10,swaziland,Africa,1182536,3,18385
2021-04-11,swaziland,Africa,1182536,3,18388
2021-04-12,swaziland,Africa,1182536,5,18393
2021-04-13,swaziland,Africa,1182536,9,18402
2021-04-14,swaziland,Africa,1182536,5,18407
2021-04-15,swaziland,Africa,1182536,5,18412
2021-04-16,swaziland,Africa,1182536,2,18414
2021-04-17,swaziland,Africa,1182536,1,18415
2021-04-18,swaziland,Africa,1182536,2,18417
2021-04-19,swaziland,Africa,1182536,0,18417
2021-04-20,swaziland,Africa,1182536,0,18417
2021-04-21,swaziland,Africa,1182536,6,18423
2021-04-22,swaziland,Africa,1182536,3,18426
2021-04-23,swaziland,Africa,1182536,8,18434
2021-04-24,swaziland,Africa,1182536,6,18440
2021-04-25,swaziland,Africa,1182536,2,18442
2021-04-26,swaziland,Africa,1182536,1,18443
2021-04-27,swaziland,Africa,1182536,5,18448
2021-04-28,swaziland,Africa,1182536,4,18452
2021-04-29,swaziland,Africa,1182536,6,18458
2021-04-30,swaziland,Africa,1182536,0,18458
2021-05-01,swaziland,Africa,1182536,0,18458
2021-05-02,swaziland,Africa,1182536,0,18458
2021-05-03,swaziland,Africa,1182536,2,18460
2021-05-04,swaziland,Africa,1182536,1,18461
2021-05-05,swaziland,Africa,1182536,6,18467
2021-05-06,swaziland,Africa,1182536,6,18473
2021-05-07,swaziland,Africa,1182536,1,18474
2021-05-08,swaziland,Africa,1182536,3,18477
2021-05-09,swaziland,Africa,1182536,3,18480
2021-05-10,swaziland,Africa,1182536,2,18482
2021-05-11,swaziland,Africa,1182536,5,18487
2021-05-12,swaziland,Africa,1182536,5,18492
2021-05-13,swaziland,Africa,1182536,5,18497
2021-05-14,swaziland,Africa,1182536,14,18511
2021-05-15,swaziland,Africa,1182536,8,18519
2021-05-16,swaziland,Africa,1182536,1,18520
2021-05-17,swaziland,Africa,1182536,3,18523
2021-05-18,swaziland,Africa,1182536,2,18525
2021-05-19,swaziland,Africa,1182536,5,18530
2021-05-20,swaziland,Africa,1182536,9,18539
2021-05-21,swaziland,Africa,1182536,7,18546
2021-05-22,swaziland,Africa,1182536,4,18550
2021-05-23,swaziland,Africa,1182536,1,18551
2021-05-24,swaziland,Africa,1182536,6,18557
2021-05-25,swaziland,Africa,1182536,13,18570
2021-05-26,swaziland,Africa,1182536,2,18572
2021-05-27,swaziland,Africa,1182536,10,18582
2021-05-28,swaziland,Africa,1182536,5,18587
2021-05-29,swaziland,Africa,1182536,2,18589
2021-05-30,swaziland,Africa,1182536,2,18591
2021-05-31,swaziland,Africa,1182536,4,18595
2021-06-01,swaziland,Africa,1182536,6,18601
2021-06-02,swaziland,Africa,1182536,17,18618
2021-06-03,swaziland,Africa,1182536,5,18623
2021-06-04,swaziland,Africa,1182536,9,18632
2021-06-05,swaziland,Africa,1182536,4,18636
2021-06-06,swaziland,Africa,1182536,17,18653
2021-06-07,swaziland,Africa,1182536,11,18664
2021-06-08,swaziland,Africa,1182536,16,18680
2021-06-09,swaziland,Africa,1182536,14,18694
2021-06-10,swaziland,Africa,1182536,11,18705
2021-06-11,swaziland,Africa,1182536,18,18723
2021-06-12,swaziland,Africa,1182536,9,18732
2021-06-13,swaziland,Africa,1182536,4,18736
2021-06-14,swaziland,Africa,1182536,10,18746
2021-06-15,swaziland,Africa,1182536,8,18754
2021-06-16,swaziland,Africa,1182536,14,18768
2021-06-17,swaziland,Africa,1182536,16,18784
2021-06-18,swaziland,Africa,1182536,16,18800
2021-06-19,swaziland,Africa,1182536,11,18811
2021-06-20,swaziland,Africa,1182536,2,18813
2021-06-21,swaziland,Africa,1182536,18,18831
2021-06-22,swaziland,Africa,1182536,23,18854
2021-06-23,swaziland,Africa,1182536,44,18898
2021-06-24,swaziland,Africa,1182536,49,18947
2021-06-25,swaziland,Africa,1182536,42,18989
2021-06-26,swaziland,Africa,1182536,29,19018
2021-06-27,swaziland,Africa,1182536,17,19035
2021-06-28,swaziland,Africa,1182536,49,19084
2021-06-29,swaziland,Africa,1182536,0,19084
2021-06-30,swaziland,Africa,1182536,0,19084
2021-07-01,swaziland,Africa,1182536,0,19084
2021-07-02,swaziland,Africa,1182536,0,19084
2021-07-03,swaziland,Africa,1182536,0,19084
2021-07-04,swaziland,Africa,1182536,0,19084
2021-07-05,swaziland,Africa,1182536,230,19314
2020-02-16,sweden,Europe,10216549,0,1
2020-02-17,sweden,Europe,10216549,0,1
2020-02-18,sweden,Europe,10216549,0,1
2020-02-19,sweden,Europe,10216549,0,1
2020-02-20,sweden,Europe,10216549,0,1
2020-02-21,sweden,Europe,10216549,0,1
2020-02-22,sweden,Europe,10216549,0,1
2020-02-23,sweden,Europe,10216549,0,1
2020-02-24,sweden,Europe,10216549,0,1
2020-02-25,sweden,Europe,10216549,0,1
2020-02-26,sweden,Europe,10216549,1,2
2020-02-27,sweden,Europe,10216549,1,3
2020-02-28,sweden,Europe,10216549,8,11
2020-02-29,sweden,Europe,10216549,3,14
2020-03-01,sweden,Europe,10216549,0,14
2020-03-02,sweden,Europe,10216549,5,19
2020-03-03,sweden,Europe,10216549,13,32
2020-03-04,sweden,Europe,10216549,30,62
2020-03-05,sweden,Europe,10216549,25,87
2020-03-06,sweden,Europe,10216549,59,146
2020-03-07,sweden,Europe,10216549,33,179
2020-03-08,sweden,Europe,10216549,46,225
2020-03-09,sweden,Europe,10216549,101,326
2020-03-10,sweden,Europe,10216549,98,424
2020-03-11,sweden,Europe,10216549,196,620
2020-03-12,sweden,Europe,10216549,151,771
2020-03-13,sweden,Europe,10216549,152,923
2020-03-14,sweden,Europe,10216549,71,994
2020-03-15,sweden,Europe,10216549,69,1063
2020-03-16,sweden,Europe,10216549,83,1146
2020-03-17,sweden,Europe,10216549,119,1265
2020-03-18,sweden,Europe,10216549,145,1410
2020-03-19,sweden,Europe,10216549,143,1553
2020-03-20,sweden,Europe,10216549,180,1733
2020-03-21,sweden,Europe,10216549,136,1869
2020-03-22,sweden,Europe,10216549,118,1987
2020-03-23,sweden,Europe,10216549,182,2169
2020-03-24,sweden,Europe,10216549,230,2399
2020-03-25,sweden,Europe,10216549,314,2713
2020-03-26,sweden,Europe,10216549,286,2999
2020-03-27,sweden,Europe,10216549,365,3364
2020-03-28,sweden,Europe,10216549,300,3664
2020-03-29,sweden,Europe,10216549,280,3944
2020-03-30,sweden,Europe,10216549,416,4360
2020-03-31,sweden,Europe,10216549,475,4835
2020-04-01,sweden,Europe,10216549,486,5321
2020-04-02,sweden,Europe,10216549,554,5875
2020-04-03,sweden,Europe,10216549,602,6477
2020-04-04,sweden,Europe,10216549,357,6834
2020-04-05,sweden,Europe,10216549,340,7174
2020-04-06,sweden,Europe,10216549,389,7563
2020-04-07,sweden,Europe,10216549,739,8302
2020-04-08,sweden,Europe,10216549,654,8956
2020-04-09,sweden,Europe,10216549,645,9601
2020-04-10,sweden,Europe,10216549,454,10055
2020-04-11,sweden,Europe,10216549,395,10450
2020-04-12,sweden,Europe,10216549,464,10914
2020-04-13,sweden,Europe,10216549,437,11351
2020-04-14,sweden,Europe,10216549,479,11830
2020-04-15,sweden,Europe,10216549,604,12434
2020-04-16,sweden,Europe,10216549,623,13057
2020-04-17,sweden,Europe,10216549,688,13745
2020-04-18,sweden,Europe,10216549,532,14277
2020-04-19,sweden,Europe,10216549,388,14665
2020-04-20,sweden,Europe,10216549,461,15126
2020-04-21,sweden,Europe,10216549,707,15833
2020-04-22,sweden,Europe,10216549,722,16555
2020-04-23,sweden,Europe,10216549,758,17313
2020-04-24,sweden,Europe,10216549,782,18095
2020-04-25,sweden,Europe,10216549,473,18568
2020-04-26,sweden,Europe,10216549,300,18868
2020-04-27,sweden,Europe,10216549,563,19431
2020-04-28,sweden,Europe,10216549,742,20173
2020-04-29,sweden,Europe,10216549,799,20972
2020-04-30,sweden,Europe,10216549,636,21608
2020-05-01,sweden,Europe,10216549,532,22140
2020-05-02,sweden,Europe,10216549,299,22439
2020-05-03,sweden,Europe,10216549,261,22700
2020-05-04,sweden,Europe,10216549,477,23177
2020-05-05,sweden,Europe,10216549,657,23834
2020-05-06,sweden,Europe,10216549,745,24579
2020-05-07,sweden,Europe,10216549,785,25364
2020-05-08,sweden,Europe,10216549,701,26065
2020-05-09,sweden,Europe,10216549,509,26574
2020-05-10,sweden,Europe,10216549,279,26853
2020-05-11,sweden,Europe,10216549,455,27308
2020-05-12,sweden,Europe,10216549,754,28062
2020-05-13,sweden,Europe,10216549,698,28760
2020-05-14,sweden,Europe,10216549,657,29417
2020-05-15,sweden,Europe,10216549,688,30105
2020-05-16,sweden,Europe,10216549,358,30463
2020-05-17,sweden,Europe,10216549,259,30722
2020-05-18,sweden,Europe,10216549,430,31152
2020-05-19,sweden,Europe,10216549,666,31818
2020-05-20,sweden,Europe,10216549,808,32626
2020-05-21,sweden,Europe,10216549,610,33236
2020-05-22,sweden,Europe,10216549,532,33768
2020-05-23,sweden,Europe,10216549,403,34171
2020-05-24,sweden,Europe,10216549,210,34381
2020-05-25,sweden,Europe,10216549,490,34871
2020-05-26,sweden,Europe,10216549,746,35617
2020-05-27,sweden,Europe,10216549,800,36417
2020-05-28,sweden,Europe,10216549,774,37191
2020-05-29,sweden,Europe,10216549,773,37964
2020-05-30,sweden,Europe,10216549,432,38396
2020-05-31,sweden,Europe,10216549,265,38661
2020-06-01,sweden,Europe,10216549,648,39309
2020-06-02,sweden,Europe,10216549,900,40209
2020-06-03,sweden,Europe,10216549,1046,41255
2020-06-04,sweden,Europe,10216549,1039,42294
2020-06-05,sweden,Europe,10216549,1146,43440
2020-06-06,sweden,Europe,10216549,780,44220
2020-06-07,sweden,Europe,10216549,462,44682
2020-06-08,sweden,Europe,10216549,677,45359
2020-06-09,sweden,Europe,10216549,937,46296
2020-06-10,sweden,Europe,10216549,1437,47733
2020-06-11,sweden,Europe,10216549,1293,49026
2020-06-12,sweden,Europe,10216549,1329,50355
2020-06-13,sweden,Europe,10216549,1032,51387
2020-06-14,sweden,Europe,10216549,418,51805
2020-06-15,sweden,Europe,10216549,685,52490
2020-06-16,sweden,Europe,10216549,1209,53699
2020-06-17,sweden,Europe,10216549,1457,55156
2020-06-18,sweden,Europe,10216549,1494,56650
2020-06-19,sweden,Europe,10216549,1209,57859
2020-06-20,sweden,Europe,10216549,698,58557
2020-06-21,sweden,Europe,10216549,315,58872
2020-06-22,sweden,Europe,10216549,801,59673
2020-06-23,sweden,Europe,10216549,1309,60982
2020-06-24,sweden,Europe,10216549,1698,62680
2020-06-25,sweden,Europe,10216549,1279,63959
2020-06-26,sweden,Europe,10216549,1204,65163
2020-06-27,sweden,Europe,10216549,755,65918
2020-06-28,sweden,Europe,10216549,415,66333
2020-06-29,sweden,Europe,10216549,726,67059
2020-06-30,sweden,Europe,10216549,808,67867
2020-07-01,sweden,Europe,10216549,685,68552
2020-07-02,sweden,Europe,10216549,687,69239
2020-07-03,sweden,Europe,10216549,694,69933
2020-07-04,sweden,Europe,10216549,364,70297
2020-07-05,sweden,Europe,10216549,315,70612
2020-07-06,sweden,Europe,10216549,251,70863
2020-07-07,sweden,Europe,10216549,278,71141
2020-07-08,sweden,Europe,10216549,533,71674
2020-07-09,sweden,Europe,10216549,334,72008
2020-07-10,sweden,Europe,10216549,369,72377
2020-07-11,sweden,Europe,10216549,308,72685
2020-07-12,sweden,Europe,10216549,106,72791
2020-07-13,sweden,Europe,10216549,170,72961
2020-07-14,sweden,Europe,10216549,312,73273
2020-07-15,sweden,Europe,10216549,287,73560
2020-07-16,sweden,Europe,10216549,268,73828
2020-07-17,sweden,Europe,10216549,284,74112
2020-07-18,sweden,Europe,10216549,191,74303
2020-07-19,sweden,Europe,10216549,110,74413
2020-07-20,sweden,Europe,10216549,131,74544
2020-07-21,sweden,Europe,10216549,226,74770
2020-07-22,sweden,Europe,10216549,297,75067
2020-07-23,sweden,Europe,10216549,220,75287
2020-07-24,sweden,Europe,10216549,262,75549
2020-07-25,sweden,Europe,10216549,138,75687
2020-07-26,sweden,Europe,10216549,42,75729
2020-07-27,sweden,Europe,10216549,71,75800
2020-07-28,sweden,Europe,10216549,283,76083
2020-07-29,sweden,Europe,10216549,301,76384
2020-07-30,sweden,Europe,10216549,302,76686
2020-07-31,sweden,Europe,10216549,258,76944
2020-08-01,sweden,Europe,10216549,303,77247
2020-08-02,sweden,Europe,10216549,38,77285
2020-08-03,sweden,Europe,10216549,165,77450
2020-08-04,sweden,Europe,10216549,333,77783
2020-08-05,sweden,Europe,10216549,425,78208
2020-08-06,sweden,Europe,10216549,378,78586
2020-08-07,sweden,Europe,10216549,380,78966
2020-08-08,sweden,Europe,10216549,260,79226
2020-08-09,sweden,Europe,10216549,73,79299
2020-08-10,sweden,Europe,10216549,196,79495
2020-08-11,sweden,Europe,10216549,417,79912
2020-08-12,sweden,Europe,10216549,443,80355
2020-08-13,sweden,Europe,10216549,363,80718
2020-08-14,sweden,Europe,10216549,344,81062
2020-08-15,sweden,Europe,10216549,226,81288
2020-08-16,sweden,Europe,10216549,63,81351
2020-08-17,sweden,Europe,10216549,174,81525
2020-08-18,sweden,Europe,10216549,314,81839
2020-08-19,sweden,Europe,10216549,351,82190
2020-08-20,sweden,Europe,10216549,333,82523
2020-08-21,sweden,Europe,10216549,298,82821
2020-08-22,sweden,Europe,10216549,160,82981
2020-08-23,sweden,Europe,10216549,57,83038
2020-08-24,sweden,Europe,10216549,174,83212
2020-08-25,sweden,Europe,10216549,222,83434
2020-08-26,sweden,Europe,10216549,244,83678
2020-08-27,sweden,Europe,10216549,202,83880
2020-08-28,sweden,Europe,10216549,179,84059
2020-08-29,sweden,Europe,10216549,131,84190
2020-08-30,sweden,Europe,10216549,48,84238
2020-08-31,sweden,Europe,10216549,162,84400
2020-09-01,sweden,Europe,10216549,171,84571
2020-09-02,sweden,Europe,10216549,213,84784
2020-09-03,sweden,Europe,10216549,286,85070
2020-09-04,sweden,Europe,10216549,262,85332
2020-09-05,sweden,Europe,10216549,171,85503
2020-09-06,sweden,Europe,10216549,67,85570
2020-09-07,sweden,Europe,10216549,185,85755
2020-09-08,sweden,Europe,10216549,236,85991
2020-09-09,sweden,Europe,10216549,314,86305
2020-09-10,sweden,Europe,10216549,254,86559
2020-09-11,sweden,Europe,10216549,291,86850
2020-09-12,sweden,Europe,10216549,206,87056
2020-09-13,sweden,Europe,10216549,106,87162
2020-09-14,sweden,Europe,10216549,220,87382
2020-09-15,sweden,Europe,10216549,292,87674
2020-09-16,sweden,Europe,10216549,330,88004
2020-09-17,sweden,Europe,10216549,389,88393
2020-09-18,sweden,Europe,10216549,437,88830
2020-09-19,sweden,Europe,10216549,279,89109
2020-09-20,sweden,Europe,10216549,133,89242
2020-09-21,sweden,Europe,10216549,266,89508
2020-09-22,sweden,Europe,10216549,438,89946
2020-09-23,sweden,Europe,10216549,553,90499
2020-09-24,sweden,Europe,10216549,540,91039
2020-09-25,sweden,Europe,10216549,630,91669
2020-09-26,sweden,Europe,10216549,325,91994
2020-09-27,sweden,Europe,10216549,167,92161
2020-09-28,sweden,Europe,10216549,378,92539
2020-09-29,sweden,Europe,10216549,613,93152
2020-09-30,sweden,Europe,10216549,689,93841
2020-10-01,sweden,Europe,10216549,633,94474
2020-10-02,sweden,Europe,10216549,712,95186
2020-10-03,sweden,Europe,10216549,461,95647
2020-10-04,sweden,Europe,10216549,156,95803
2020-10-05,sweden,Europe,10216549,374,96177
2020-10-06,sweden,Europe,10216549,786,96963
2020-10-07,sweden,Europe,10216549,831,97794
2020-10-08,sweden,Europe,10216549,834,98628
2020-10-09,sweden,Europe,10216549,783,99411
2020-10-10,sweden,Europe,10216549,509,99920
2020-10-11,sweden,Europe,10216549,161,100081
2020-10-12,sweden,Europe,10216549,637,100718
2020-10-13,sweden,Europe,10216549,916,101634
2020-10-14,sweden,Europe,10216549,968,102602
2020-10-15,sweden,Europe,10216549,902,103504
2020-10-16,sweden,Europe,10216549,1179,104683
2020-10-17,sweden,Europe,10216549,697,105380
2020-10-18,sweden,Europe,10216549,321,105701
2020-10-19,sweden,Europe,10216549,770,106471
2020-10-20,sweden,Europe,10216549,1290,107761
2020-10-21,sweden,Europe,10216549,1571,109332
2020-10-22,sweden,Europe,10216549,1666,110998
2020-10-23,sweden,Europe,10216549,1867,112865
2020-10-24,sweden,Europe,10216549,1477,114342
2020-10-25,sweden,Europe,10216549,514,114856
2020-10-26,sweden,Europe,10216549,1069,115925
2020-10-27,sweden,Europe,10216549,2414,118339
2020-10-28,sweden,Europe,10216549,3389,121728
2020-10-29,sweden,Europe,10216549,3262,124990
2020-10-30,sweden,Europe,10216549,4056,129046
2020-10-31,sweden,Europe,10216549,2987,132033
2020-11-01,sweden,Europe,10216549,1297,133330
2020-11-02,sweden,Europe,10216549,1569,134899
2020-11-03,sweden,Europe,10216549,3608,138507
2020-11-04,sweden,Europe,10216549,4482,142989
2020-11-05,sweden,Europe,10216549,4744,147733
2020-11-06,sweden,Europe,10216549,4454,152187
2020-11-07,sweden,Europe,10216549,4451,156638
2020-11-08,sweden,Europe,10216549,2097,158735
2020-11-09,sweden,Europe,10216549,3725,162460
2020-11-10,sweden,Europe,10216549,4497,166957
2020-11-11,sweden,Europe,10216549,5709,172666
2020-11-12,sweden,Europe,10216549,5564,178230
2020-11-13,sweden,Europe,10216549,6732,184962
2020-11-14,sweden,Europe,10216549,3511,188473
2020-11-15,sweden,Europe,10216549,1581,190054
2020-11-16,sweden,Europe,10216549,2544,192598
2020-11-17,sweden,Europe,10216549,4458,197056
2020-11-18,sweden,Europe,10216549,4961,202017
2020-11-19,sweden,Europe,10216549,7609,209626
2020-11-20,sweden,Europe,10216549,5459,215085
2020-11-21,sweden,Europe,10216549,4492,219577
2020-11-22,sweden,Europe,10216549,2422,221999
2020-11-23,sweden,Europe,10216549,3876,225875
2020-11-24,sweden,Europe,10216549,5674,231549
2020-11-25,sweden,Europe,10216549,6066,237615
2020-11-26,sweden,Europe,10216549,6903,244518
2020-11-27,sweden,Europe,10216549,6462,250980
2020-11-28,sweden,Europe,10216549,3825,254805
2020-11-29,sweden,Europe,10216549,2753,257558
2020-11-30,sweden,Europe,10216549,3480,261038
2020-12-01,sweden,Europe,10216549,5819,266857
2020-12-02,sweden,Europe,10216549,6547,273404
2020-12-03,sweden,Europe,10216549,6986,280390
2020-12-04,sweden,Europe,10216549,7338,287728
2020-12-05,sweden,Europe,10216549,4864,292592
2020-12-06,sweden,Europe,10216549,1803,294395
2020-12-07,sweden,Europe,10216549,3782,298177
2020-12-08,sweden,Europe,10216549,7446,305623
2020-12-09,sweden,Europe,10216549,8398,314021
2020-12-10,sweden,Europe,10216549,6693,320714
2020-12-11,sweden,Europe,10216549,7717,328431
2020-12-12,sweden,Europe,10216549,6538,334969
2020-12-13,sweden,Europe,10216549,3057,338026
2020-12-14,sweden,Europe,10216549,3534,341560
2020-12-15,sweden,Europe,10216549,7001,348561
2020-12-16,sweden,Europe,10216549,8824,357385
2020-12-17,sweden,Europe,10216549,9640,367025
2020-12-18,sweden,Europe,10216549,7917,374942
2020-12-19,sweden,Europe,10216549,5509,380451
2020-12-20,sweden,Europe,10216549,3752,384203
2020-12-21,sweden,Europe,10216549,5160,389363
2020-12-22,sweden,Europe,10216549,6595,395958
2020-12-23,sweden,Europe,10216549,11376,407334
2020-12-24,sweden,Europe,10216549,5036,412370
2020-12-25,sweden,Europe,10216549,3793,416163
2020-12-26,sweden,Europe,10216549,1966,418129
2020-12-27,sweden,Europe,10216549,3208,421337
2020-12-28,sweden,Europe,10216549,7091,428428
2020-12-29,sweden,Europe,10216549,8872,437300
2020-12-30,sweden,Europe,10216549,10459,447759
2020-12-31,sweden,Europe,10216549,6999,454758
2021-01-01,sweden,Europe,10216549,2618,457376
2021-01-02,sweden,Europe,10216549,2530,459906
2021-01-03,sweden,Europe,10216549,2754,462660
2021-01-04,sweden,Europe,10216549,6982,469642
2021-01-05,sweden,Europe,10216549,7545,477187
2021-01-06,sweden,Europe,10216549,5029,482216
2021-01-07,sweden,Europe,10216549,7148,489364
2021-01-08,sweden,Europe,10216549,5691,495055
2021-01-09,sweden,Europe,10216549,4735,499790
2021-01-10,sweden,Europe,10216549,2318,502108
2021-01-11,sweden,Europe,10216549,4647,506755
2021-01-12,sweden,Europe,10216549,5334,512089
2021-01-13,sweden,Europe,10216549,6595,518684
2021-01-14,sweden,Europe,10216549,4743,523427
2021-01-15,sweden,Europe,10216549,4205,527632
2021-01-16,sweden,Europe,10216549,2160,529792
2021-01-17,sweden,Europe,10216549,1250,531042
2021-01-18,sweden,Europe,10216549,2111,533153
2021-01-19,sweden,Europe,10216549,4732,537885
2021-01-20,sweden,Europe,10216549,4946,542831
2021-01-21,sweden,Europe,10216549,4196,547027
2021-01-22,sweden,Europe,10216549,3722,550749
2021-01-23,sweden,Europe,10216549,2368,553117
2021-01-24,sweden,Europe,10216549,1147,554264
2021-01-25,sweden,Europe,10216549,1884,556148
2021-01-26,sweden,Europe,10216549,4188,560336
2021-01-27,sweden,Europe,10216549,4103,564439
2021-01-28,sweden,Europe,10216549,2368,566807
2021-01-29,sweden,Europe,10216549,4252,571059
2021-01-30,sweden,Europe,10216549,2695,573754
2021-01-31,sweden,Europe,10216549,1164,574918
2021-02-01,sweden,Europe,10216549,1551,576469
2021-02-02,sweden,Europe,10216549,4315,580784
2021-02-03,sweden,Europe,10216549,3737,584521
2021-02-04,sweden,Europe,10216549,3395,587916
2021-02-05,sweden,Europe,10216549,3260,591176
2021-02-06,sweden,Europe,10216549,2333,593509
2021-02-07,sweden,Europe,10216549,1013,594522
2021-02-08,sweden,Europe,10216549,1505,596027
2021-02-09,sweden,Europe,10216549,4069,600096
2021-02-10,sweden,Europe,10216549,4353,604449
2021-02-11,sweden,Europe,10216549,3805,608254
2021-02-12,sweden,Europe,10216549,3568,611822
2021-02-13,sweden,Europe,10216549,2771,614593
2021-02-14,sweden,Europe,10216549,1211,615804
2021-02-15,sweden,Europe,10216549,1900,617704
2021-02-16,sweden,Europe,10216549,4206,621910
2021-02-17,sweden,Europe,10216549,4965,626875
2021-02-18,sweden,Europe,10216549,4134,631009
2021-02-19,sweden,Europe,10216549,4028,635037
2021-02-20,sweden,Europe,10216549,2781,637818
2021-02-21,sweden,Europe,10216549,1599,639417
2021-02-22,sweden,Europe,10216549,2538,641955
2021-02-23,sweden,Europe,10216549,5407,647362
2021-02-24,sweden,Europe,10216549,4974,652336
2021-02-25,sweden,Europe,10216549,4830,657166
2021-02-26,sweden,Europe,10216549,4583,661749
2021-02-27,sweden,Europe,10216549,3107,664856
2021-02-28,sweden,Europe,10216549,1242,666098
2021-03-01,sweden,Europe,10216549,2826,668924
2021-03-02,sweden,Europe,10216549,6190,675114
2021-03-03,sweden,Europe,10216549,4868,679982
2021-03-04,sweden,Europe,10216549,4883,684865
2021-03-05,sweden,Europe,10216549,4069,688934
2021-03-06,sweden,Europe,10216549,3454,692388
2021-03-07,sweden,Europe,10216549,1449,693837
2021-03-08,sweden,Europe,10216549,1982,695819
2021-03-09,sweden,Europe,10216549,5928,701747
2021-03-10,sweden,Europe,10216549,5326,707073
2021-03-11,sweden,Europe,10216549,5332,712405
2021-03-12,sweden,Europe,10216549,4994,717399
2021-03-13,sweden,Europe,10216549,3953,721352
2021-03-14,sweden,Europe,10216549,1039,722391
2021-03-15,sweden,Europe,10216549,2715,725106
2021-03-16,sweden,Europe,10216549,6786,731892
2021-03-17,sweden,Europe,10216549,6431,738323
2021-03-18,sweden,Europe,10216549,5736,744059
2021-03-19,sweden,Europe,10216549,5406,749465
2021-03-20,sweden,Europe,10216549,4380,753845
2021-03-21,sweden,Europe,10216549,1579,755424
2021-03-22,sweden,Europe,10216549,2687,758111
2021-03-23,sweden,Europe,10216549,7652,765763
2021-03-24,sweden,Europe,10216549,7706,773469
2021-03-25,sweden,Europe,10216549,6365,779834
2021-03-26,sweden,Europe,10216549,6294,786128
2021-03-27,sweden,Europe,10216549,5196,791324
2021-03-28,sweden,Europe,10216549,1980,793304
2021-03-29,sweden,Europe,10216549,2962,796266
2021-03-30,sweden,Europe,10216549,8468,804734
2021-03-31,sweden,Europe,10216549,8289,813023
2021-04-01,sweden,Europe,10216549,6977,820000
2021-04-02,sweden,Europe,10216549,6836,826836
2021-04-03,sweden,Europe,10216549,3403,830239
2021-04-04,sweden,Europe,10216549,1449,831688
2021-04-05,sweden,Europe,10216549,3103,834791
2021-04-06,sweden,Europe,10216549,6813,841604
2021-04-07,sweden,Europe,10216549,7824,849428
2021-04-08,sweden,Europe,10216549,7760,857188
2021-04-09,sweden,Europe,10216549,7626,864814
2021-04-10,sweden,Europe,10216549,5626,870440
2021-04-11,sweden,Europe,10216549,2390,872830
2021-04-12,sweden,Europe,10216549,3471,876301
2021-04-13,sweden,Europe,10216549,8870,885171
2021-04-14,sweden,Europe,10216549,7093,892264
2021-04-15,sweden,Europe,10216549,7665,899929
2021-04-16,sweden,Europe,10216549,6440,906369
2021-04-17,sweden,Europe,10216549,4983,911352
2021-04-18,sweden,Europe,10216549,2514,913866
2021-04-19,sweden,Europe,10216549,2713,916579
2021-04-20,sweden,Europe,10216549,7538,924117
2021-04-21,sweden,Europe,10216549,7706,931823
2021-04-22,sweden,Europe,10216549,6248,938071
2021-04-23,sweden,Europe,10216549,5502,943573
2021-04-24,sweden,Europe,10216549,4567,948140
2021-04-25,sweden,Europe,10216549,1756,949896
2021-04-26,sweden,Europe,10216549,3069,952965
2021-04-27,sweden,Europe,10216549,7267,960232
2021-04-28,sweden,Europe,10216549,7144,967376
2021-04-29,sweden,Europe,10216549,5931,973307
2021-04-30,sweden,Europe,10216549,5424,978731
2021-05-01,sweden,Europe,10216549,4753,983484
2021-05-02,sweden,Europe,10216549,1718,985202
2021-05-03,sweden,Europe,10216549,3068,988270
2021-05-04,sweden,Europe,10216549,7035,995305
2021-05-05,sweden,Europe,10216549,6482,1001787
2021-05-06,sweden,Europe,10216549,5716,1007503
2021-05-07,sweden,Europe,10216549,5244,1012747
2021-05-08,sweden,Europe,10216549,4476,1017223
2021-05-09,sweden,Europe,10216549,1657,1018880
2021-05-10,sweden,Europe,10216549,2460,1021340
2021-05-11,sweden,Europe,10216549,6311,1027651
2021-05-12,sweden,Europe,10216549,5269,1032920
2021-05-13,sweden,Europe,10216549,3918,1036838
2021-05-14,sweden,Europe,10216549,2579,1039417
2021-05-15,sweden,Europe,10216549,3969,1043386
2021-05-16,sweden,Europe,10216549,1408,1044794
2021-05-17,sweden,Europe,10216549,2106,1046900
2021-05-18,sweden,Europe,10216549,4642,1051542
2021-05-19,sweden,Europe,10216549,3410,1054952
2021-05-20,sweden,Europe,10216549,3166,1058118
2021-05-21,sweden,Europe,10216549,2317,1060435
2021-05-22,sweden,Europe,10216549,1909,1062344
2021-05-23,sweden,Europe,10216549,620,1062964
2021-05-24,sweden,Europe,10216549,1195,1064159
2021-05-25,sweden,Europe,10216549,2737,1066896
2021-05-26,sweden,Europe,10216549,1420,1068316
2021-05-27,sweden,Europe,10216549,92,1068408
2021-05-28,sweden,Europe,10216549,297,1068705
2021-05-29,sweden,Europe,10216549,285,1068990
2021-05-30,sweden,Europe,10216549,1948,1070938
2021-05-31,sweden,Europe,10216549,1898,1072836
2021-06-01,sweden,Europe,10216549,2783,1075619
2021-06-02,sweden,Europe,10216549,1364,1076983
2021-06-03,sweden,Europe,10216549,1080,1078063
2021-06-04,sweden,Europe,10216549,989,1079052
2021-06-05,sweden,Europe,10216549,758,1079810
2021-06-06,sweden,Europe,10216549,222,1080032
2021-06-07,sweden,Europe,10216549,490,1080522
2021-06-08,sweden,Europe,10216549,1183,1081705
2021-06-09,sweden,Europe,10216549,825,1082530
2021-06-10,sweden,Europe,10216549,729,1083259
2021-06-11,sweden,Europe,10216549,484,1083743
2021-06-12,sweden,Europe,10216549,524,1084267
2021-06-13,sweden,Europe,10216549,159,1084426
2021-06-14,sweden,Europe,10216549,0,1084426
2021-06-15,sweden,Europe,10216549,1,1084427
2021-06-16,sweden,Europe,10216549,396,1084823
2021-06-17,sweden,Europe,10216549,1830,1086653
2021-06-18,sweden,Europe,10216549,601,1087254
2021-06-19,sweden,Europe,10216549,19,1087273
2021-06-20,sweden,Europe,10216549,1,1087274
2021-06-21,sweden,Europe,10216549,678,1087952
2021-06-22,sweden,Europe,10216549,505,1088457
2021-06-23,sweden,Europe,10216549,380,1088837
2021-06-24,sweden,Europe,10216549,373,1089210
2021-06-25,sweden,Europe,10216549,31,1089241
2021-06-26,sweden,Europe,10216549,8,1089249
2021-06-27,sweden,Europe,10216549,8,1089257
2021-06-28,sweden,Europe,10216549,444,1089701
2021-06-29,sweden,Europe,10216549,251,1089952
2021-06-30,sweden,Europe,10216549,560,1090512
2021-07-01,sweden,Europe,10216549,284,1090796
2021-07-02,sweden,Europe,10216549,326,1091122
2021-07-03,sweden,Europe,10216549,3,1091125
2021-07-04,sweden,Europe,10216549,2,1091127
2021-07-05,sweden,Europe,10216549,415,1091542
2021-07-06,sweden,Europe,10216549,369,1091911
2021-07-07,sweden,Europe,10216549,258,1092169
2021-07-08,sweden,Europe,10216549,237,1092406
2021-07-09,sweden,Europe,10216549,228,1092634
2021-07-10,sweden,Europe,10216549,7,1092641
2021-07-11,sweden,Europe,10216549,0,1092641
2021-07-12,sweden,Europe,10216549,443,1093084
2021-07-13,sweden,Europe,10216549,369,1093453
2021-07-14,sweden,Europe,10216549,351,1093804
2021-07-15,sweden,Europe,10216549,366,1094170
2021-07-16,sweden,Europe,10216549,337,1094507
2021-07-17,sweden,Europe,10216549,11,1094518
2021-07-18,sweden,Europe,10216549,6,1094524
2021-07-19,sweden,Europe,10216549,628,1095152
2021-07-20,sweden,Europe,10216549,517,1095669
2021-07-21,sweden,Europe,10216549,582,1096251
2021-07-22,sweden,Europe,10216549,477,1096728
2021-07-23,sweden,Europe,10216549,444,1097172
2021-07-24,sweden,Europe,10216549,11,1097183
2021-07-25,sweden,Europe,10216549,2,1097185
2021-07-26,sweden,Europe,10216549,839,1098024
2021-07-27,sweden,Europe,10216549,653,1098677
2021-07-28,sweden,Europe,10216549,656,1099333
2021-07-29,sweden,Europe,10216549,621,1099954
2021-07-30,sweden,Europe,10216549,686,1100640
2021-07-31,sweden,Europe,10216549,4,1100644
2021-08-01,sweden,Europe,10216549,1,1100645
2021-08-02,sweden,Europe,10216549,1151,1101796
2021-08-03,sweden,Europe,10216549,959,1102755
2021-08-04,sweden,Europe,10216549,852,1103607
2021-08-05,sweden,Europe,10216549,819,1104426
2021-08-06,sweden,Europe,10216549,819,1105245
2021-08-07,sweden,Europe,10216549,6,1105251
2021-08-08,sweden,Europe,10216549,3,1105254
2021-08-09,sweden,Europe,10216549,1483,1106737
2021-08-10,sweden,Europe,10216549,1203,1107940
2021-08-11,sweden,Europe,10216549,1057,1108997
2021-08-12,sweden,Europe,10216549,1040,1110037
2021-08-13,sweden,Europe,10216549,1016,1111053
2021-08-14,sweden,Europe,10216549,8,1111061
2021-08-15,sweden,Europe,10216549,10,1111071
2021-08-16,sweden,Europe,10216549,1781,1112852
2021-08-17,sweden,Europe,10216549,1330,1114182
2021-08-18,sweden,Europe,10216549,1275,1115457
2021-08-19,sweden,Europe,10216549,1028,1116485
2021-08-20,sweden,Europe,10216549,1045,1117530
2021-08-21,sweden,Europe,10216549,1,1117531
2021-08-22,sweden,Europe,10216549,3,1117534
2021-08-23,sweden,Europe,10216549,1708,1119242
2021-08-24,sweden,Europe,10216549,2785,1122027
2021-08-25,sweden,Europe,10216549,0,1122027
2021-08-26,sweden,Europe,10216549,1269,1123296
2021-08-27,sweden,Europe,10216549,915,1124211
2021-08-28,sweden,Europe,10216549,0,1124211
2021-08-29,sweden,Europe,10216549,8,1124219
2021-08-30,sweden,Europe,10216549,2353,1126572
2021-08-31,sweden,Europe,10216549,1022,1127594
2021-09-01,sweden,Europe,10216549,1103,1128697
2021-09-02,sweden,Europe,10216549,1425,1130122
2021-09-03,sweden,Europe,10216549,1323,1131445
2021-09-04,sweden,Europe,10216549,1,1131446
2021-09-05,sweden,Europe,10216549,9,1131455
2021-09-06,sweden,Europe,10216549,2179,1133634
2021-09-07,sweden,Europe,10216549,1399,1135033
2021-09-08,sweden,Europe,10216549,1395,1136428
2021-09-09,sweden,Europe,10216549,1478,1137906
2021-09-10,sweden,Europe,10216549,1516,1139422
2021-09-11,sweden,Europe,10216549,2,1139424
2021-09-12,sweden,Europe,10216549,0,1139424
2021-09-13,sweden,Europe,10216549,2137,1141561
2021-09-14,sweden,Europe,10216549,1114,1142675
2021-09-15,sweden,Europe,10216549,1184,1143859
2021-09-16,sweden,Europe,10216549,994,1144853
2021-09-17,sweden,Europe,10216549,829,1145682
2021-09-18,sweden,Europe,10216549,1,1145683
2021-09-19,sweden,Europe,10216549,0,1145683
2021-09-20,sweden,Europe,10216549,1178,1146861
2021-09-21,sweden,Europe,10216549,891,1147752
2021-09-22,sweden,Europe,10216549,742,1148494
2021-09-23,sweden,Europe,10216549,771,1149265
2021-09-24,sweden,Europe,10216549,716,1149981
2021-09-25,sweden,Europe,10216549,0,1149981
2021-09-26,sweden,Europe,10216549,6,1149987
2021-09-27,sweden,Europe,10216549,1069,1151056
2021-09-28,sweden,Europe,10216549,845,1151901
2021-09-29,sweden,Europe,10216549,852,1152753
2021-09-30,sweden,Europe,10216549,766,1153519
2021-10-01,sweden,Europe,10216549,698,1154217
2021-10-02,sweden,Europe,10216549,2,1154219
2021-10-03,sweden,Europe,10216549,0,1154219
2021-10-04,sweden,Europe,10216549,1192,1155411
2021-10-05,sweden,Europe,10216549,738,1156149
2021-10-06,sweden,Europe,10216549,842,1156991
2021-10-07,sweden,Europe,10216549,741,1157732
2021-10-08,sweden,Europe,10216549,600,1158332
2021-10-09,sweden,Europe,10216549,15,1158347
2021-10-10,sweden,Europe,10216549,9,1158356
2021-10-11,sweden,Europe,10216549,1121,1159477
2021-10-12,sweden,Europe,10216549,905,1160382
2021-10-13,sweden,Europe,10216549,796,1161178
2021-10-14,sweden,Europe,10216549,668,1161846
2021-10-15,sweden,Europe,10216549,565,1162411
2021-10-16,sweden,Europe,10216549,14,1162425
2021-10-17,sweden,Europe,10216549,0,1162425
2021-10-18,sweden,Europe,10216549,1078,1163503
2021-10-19,sweden,Europe,10216549,818,1164321
2021-10-20,sweden,Europe,10216549,786,1165107
2021-10-21,sweden,Europe,10216549,777,1165884
2021-10-22,sweden,Europe,10216549,891,1166775
2021-10-23,sweden,Europe,10216549,525,1167300
2021-10-24,sweden,Europe,10216549,319,1167619
2021-10-25,sweden,Europe,10216549,539,1168158
2021-10-26,sweden,Europe,10216549,1262,1169420
2021-10-27,sweden,Europe,10216549,891,1170311
2021-10-28,sweden,Europe,10216549,1079,1171390
2021-10-29,sweden,Europe,10216549,977,1172367
2021-10-30,sweden,Europe,10216549,861,1173228
2021-10-31,sweden,Europe,10216549,301,1173529
2021-11-01,sweden,Europe,10216549,629,1174158
2021-11-02,sweden,Europe,10216549,1162,1175320
2021-11-03,sweden,Europe,10216549,837,1176157
2021-11-04,sweden,Europe,10216549,870,1177027
2021-11-05,sweden,Europe,10216549,687,1177714
2021-11-06,sweden,Europe,10216549,597,1178311
2021-11-07,sweden,Europe,10216549,278,1178589
2021-11-08,sweden,Europe,10216549,546,1179135
2021-11-09,sweden,Europe,10216549,1277,1180412
2021-11-10,sweden,Europe,10216549,1020,1181432
2021-11-11,sweden,Europe,10216549,925,1182357
2021-11-12,sweden,Europe,10216549,955,1183312
2021-11-13,sweden,Europe,10216549,785,1184097
2021-11-14,sweden,Europe,10216549,311,1184408
2021-11-15,sweden,Europe,10216549,574,1184982
2021-11-16,sweden,Europe,10216549,1340,1186322
2021-11-17,sweden,Europe,10216549,1161,1187483
2021-11-18,sweden,Europe,10216549,1130,1188613
2021-11-19,sweden,Europe,10216549,1314,1189927
2021-11-20,sweden,Europe,10216549,1137,1191064
2021-11-21,sweden,Europe,10216549,437,1191501
2021-11-22,sweden,Europe,10216549,953,1192454
2021-11-23,sweden,Europe,10216549,2077,1194531
2021-11-24,sweden,Europe,10216549,2151,1196682
2021-11-25,sweden,Europe,10216549,2070,1198752
2021-11-26,sweden,Europe,10216549,2025,1200777
2021-11-27,sweden,Europe,10216549,1759,1202536
2021-11-28,sweden,Europe,10216549,924,1203460
2021-11-29,sweden,Europe,10216549,1303,1204763
2021-11-30,sweden,Europe,10216549,2657,1207420
2021-12-01,sweden,Europe,10216549,2424,1209844
2021-12-02,sweden,Europe,10216549,2252,1212096
2021-12-03,sweden,Europe,10216549,2110,1214206
2021-12-04,sweden,Europe,10216549,2084,1216290
2021-12-05,sweden,Europe,10216549,927,1217217
2021-12-06,sweden,Europe,10216549,2298,1219515
2021-12-07,sweden,Europe,10216549,3289,1222804
2021-12-08,sweden,Europe,10216549,3255,1226059
2021-12-09,sweden,Europe,10216549,3072,1229131
2021-12-10,sweden,Europe,10216549,2865,1231996
2021-12-11,sweden,Europe,10216549,2395,1234391
2021-12-12,sweden,Europe,10216549,1475,1235866
2021-12-13,sweden,Europe,10216549,2712,1238578
2021-12-14,sweden,Europe,10216549,4063,1242641
2021-12-15,sweden,Europe,10216549,4008,1246649
2021-12-16,sweden,Europe,10216549,4116,1250765
2021-12-17,sweden,Europe,10216549,4179,1254944
2021-12-18,sweden,Europe,10216549,3470,1258414
2021-12-19,sweden,Europe,10216549,1938,1260352
2021-12-20,sweden,Europe,10216549,3036,1263388
2021-12-21,sweden,Europe,10216549,4668,1268056
2021-12-22,sweden,Europe,10216549,5256,1273312
2021-12-23,sweden,Europe,10216549,4978,1278290
2021-12-24,sweden,Europe,10216549,5815,1284105
2021-12-25,sweden,Europe,10216549,2364,1286469
2021-12-26,sweden,Europe,10216549,1791,1288260
2021-12-27,sweden,Europe,10216549,6125,1294385
2021-12-28,sweden,Europe,10216549,9231,1303616
2021-12-29,sweden,Europe,10216549,10926,1314542
2021-12-30,sweden,Europe,10216549,11462,1326004
2021-12-31,sweden,Europe,10216549,10599,1336603
2022-01-01,sweden,Europe,10216549,5271,1341874
2022-01-02,sweden,Europe,10216549,5727,1347601
2020-03-30,syria,Asia,18292142,1,10
2020-03-31,syria,Asia,18292142,0,10
2020-04-01,syria,Asia,18292142,0,10
2020-04-02,syria,Asia,18292142,6,16
2020-04-03,syria,Asia,18292142,0,16
2020-04-04,syria,Asia,18292142,0,16
2020-04-05,syria,Asia,18292142,3,19
2020-04-06,syria,Asia,18292142,0,19
2020-04-07,syria,Asia,18292142,0,19
2020-04-08,syria,Asia,18292142,0,19
2020-04-09,syria,Asia,18292142,0,19
2020-04-10,syria,Asia,18292142,0,19
2020-04-11,syria,Asia,18292142,6,25
2020-04-12,syria,Asia,18292142,0,25
2020-04-13,syria,Asia,18292142,0,25
2020-04-14,syria,Asia,18292142,4,29
2020-04-15,syria,Asia,18292142,4,33
2020-04-16,syria,Asia,18292142,0,33
2020-04-17,syria,Asia,18292142,5,38
2020-04-18,syria,Asia,18292142,0,38
2020-04-19,syria,Asia,18292142,1,39
2020-04-20,syria,Asia,18292142,0,39
2020-04-21,syria,Asia,18292142,3,42
2020-04-22,syria,Asia,18292142,0,42
2020-04-23,syria,Asia,18292142,0,42
2020-04-24,syria,Asia,18292142,0,42
2020-04-25,syria,Asia,18292142,0,42
2020-04-26,syria,Asia,18292142,1,43
2020-04-27,syria,Asia,18292142,0,43
2020-04-28,syria,Asia,18292142,0,43
2020-04-29,syria,Asia,18292142,0,43
2020-04-30,syria,Asia,18292142,0,43
2020-05-01,syria,Asia,18292142,1,44
2020-05-02,syria,Asia,18292142,0,44
2020-05-03,syria,Asia,18292142,0,44
2020-05-04,syria,Asia,18292142,0,44
2020-05-05,syria,Asia,18292142,0,44
2020-05-06,syria,Asia,18292142,1,45
2020-05-07,syria,Asia,18292142,0,45
2020-05-08,syria,Asia,18292142,2,47
2020-05-09,syria,Asia,18292142,0,47
2020-05-10,syria,Asia,18292142,0,47
2020-05-11,syria,Asia,18292142,0,47
2020-05-12,syria,Asia,18292142,0,47
2020-05-13,syria,Asia,18292142,1,48
2020-05-14,syria,Asia,18292142,0,48
2020-05-15,syria,Asia,18292142,2,50
2020-05-16,syria,Asia,18292142,1,51
2020-05-17,syria,Asia,18292142,7,58
2020-05-18,syria,Asia,18292142,0,58
2020-05-19,syria,Asia,18292142,0,58
2020-05-20,syria,Asia,18292142,0,58
2020-05-21,syria,Asia,18292142,0,58
2020-05-22,syria,Asia,18292142,1,59
2020-05-23,syria,Asia,18292142,11,70
2020-05-24,syria,Asia,18292142,16,86
2020-05-25,syria,Asia,18292142,20,106
2020-05-26,syria,Asia,18292142,15,121
2020-05-27,syria,Asia,18292142,0,121
2020-02-17,taiwan,Asia,23897056,2,22
2020-02-18,taiwan,Asia,23897056,0,22
2020-02-19,taiwan,Asia,23897056,1,23
2020-02-20,taiwan,Asia,23897056,1,24
2020-02-21,taiwan,Asia,23897056,2,26
2020-02-22,taiwan,Asia,23897056,0,26
2020-02-23,taiwan,Asia,23897056,2,28
2020-02-24,taiwan,Asia,23897056,2,30
2020-02-25,taiwan,Asia,23897056,1,31
2020-02-26,taiwan,Asia,23897056,1,32
2020-02-27,taiwan,Asia,23897056,0,32
2020-02-28,taiwan,Asia,23897056,2,34
2020-02-29,taiwan,Asia,23897056,5,39
2020-03-01,taiwan,Asia,23897056,1,40
2020-03-02,taiwan,Asia,23897056,1,41
2020-03-03,taiwan,Asia,23897056,1,42
2020-03-04,taiwan,Asia,23897056,0,42
2020-03-05,taiwan,Asia,23897056,2,44
2020-03-06,taiwan,Asia,23897056,1,45
2020-03-07,taiwan,Asia,23897056,0,45
2020-03-08,taiwan,Asia,23897056,0,45
2020-03-09,taiwan,Asia,23897056,0,45
2020-03-10,taiwan,Asia,23897056,2,47
2020-03-11,taiwan,Asia,23897056,1,48
2020-03-12,taiwan,Asia,23897056,1,49
2020-03-13,taiwan,Asia,23897056,1,50
2020-03-14,taiwan,Asia,23897056,3,53
2020-03-15,taiwan,Asia,23897056,6,59
2020-03-16,taiwan,Asia,23897056,8,67
2020-03-17,taiwan,Asia,23897056,10,77
2020-03-18,taiwan,Asia,23897056,23,100
2020-03-19,taiwan,Asia,23897056,8,108
2020-03-20,taiwan,Asia,23897056,27,135
2020-03-21,taiwan,Asia,23897056,18,153
2020-03-22,taiwan,Asia,23897056,16,169
2020-03-23,taiwan,Asia,23897056,26,195
2020-03-24,taiwan,Asia,23897056,21,216
2020-03-25,taiwan,Asia,23897056,19,235
2020-03-26,taiwan,Asia,23897056,17,252
2020-03-27,taiwan,Asia,23897056,15,267
2020-03-28,taiwan,Asia,23897056,16,283
2020-03-29,taiwan,Asia,23897056,15,298
2020-03-30,taiwan,Asia,23897056,8,306
2020-03-31,taiwan,Asia,23897056,16,322
2020-04-01,taiwan,Asia,23897056,7,329
2020-04-02,taiwan,Asia,23897056,10,339
2020-04-03,taiwan,Asia,23897056,9,348
2020-04-04,taiwan,Asia,23897056,7,355
2020-04-05,taiwan,Asia,23897056,8,363
2020-04-06,taiwan,Asia,23897056,10,373
2020-04-07,taiwan,Asia,23897056,3,376
2020-04-08,taiwan,Asia,23897056,3,379
2020-04-09,taiwan,Asia,23897056,1,380
2020-04-10,taiwan,Asia,23897056,2,382
2020-04-11,taiwan,Asia,23897056,3,385
2020-04-12,taiwan,Asia,23897056,3,388
2020-04-13,taiwan,Asia,23897056,5,393
2020-04-14,taiwan,Asia,23897056,0,393
2020-04-15,taiwan,Asia,23897056,2,395
2020-04-16,taiwan,Asia,23897056,0,395
2020-04-17,taiwan,Asia,23897056,0,395
2020-04-18,taiwan,Asia,23897056,3,398
2020-04-19,taiwan,Asia,23897056,22,420
2020-04-20,taiwan,Asia,23897056,2,422
2020-04-21,taiwan,Asia,23897056,3,425
2020-04-22,taiwan,Asia,23897056,1,426
2020-04-23,taiwan,Asia,23897056,1,427
2020-04-24,taiwan,Asia,23897056,1,428
2020-04-25,taiwan,Asia,23897056,1,429
2020-04-26,taiwan,Asia,23897056,0,429
2020-04-27,taiwan,Asia,23897056,0,429
2020-04-28,taiwan,Asia,23897056,0,429
2020-04-29,taiwan,Asia,23897056,0,429
2020-04-30,taiwan,Asia,23897056,0,429
2020-05-01,taiwan,Asia,23897056,0,429
2020-05-02,taiwan,Asia,23897056,3,432
2020-05-03,taiwan,Asia,23897056,0,432
2020-05-04,taiwan,Asia,23897056,6,438
2020-05-05,taiwan,Asia,23897056,0,438
2020-05-06,taiwan,Asia,23897056,1,439
2020-05-07,taiwan,Asia,23897056,1,440
2020-05-08,taiwan,Asia,23897056,0,440
2020-05-09,taiwan,Asia,23897056,0,440
2020-05-10,taiwan,Asia,23897056,0,440
2020-05-11,taiwan,Asia,23897056,0,440
2020-05-12,taiwan,Asia,23897056,0,440
2020-05-13,taiwan,Asia,23897056,0,440
2020-05-14,taiwan,Asia,23897056,0,440
2020-05-15,taiwan,Asia,23897056,0,440
2020-05-16,taiwan,Asia,23897056,0,440
2020-05-17,taiwan,Asia,23897056,0,440
2020-05-18,taiwan,Asia,23897056,0,440
2020-05-19,taiwan,Asia,23897056,0,440
2020-05-20,taiwan,Asia,23897056,0,440
2020-05-21,taiwan,Asia,23897056,1,441
2020-05-22,taiwan,Asia,23897056,0,441
2020-05-23,taiwan,Asia,23897056,0,441
2020-05-24,taiwan,Asia,23897056,0,441
2020-05-25,taiwan,Asia,23897056,0,441
2020-05-26,taiwan,Asia,23897056,0,441
2020-05-27,taiwan,Asia,23897056,0,441
2020-05-28,taiwan,Asia,23897056,0,441
2020-05-29,taiwan,Asia,23897056,1,442
2020-05-30,taiwan,Asia,23897056,0,442
2020-05-31,taiwan,Asia,23897056,0,442
2020-06-01,taiwan,Asia,23897056,1,443
2020-06-02,taiwan,Asia,23897056,0,443
2020-06-03,taiwan,Asia,23897056,0,443
2020-06-04,taiwan,Asia,23897056,0,443
2020-06-05,taiwan,Asia,23897056,0,443
2020-06-06,taiwan,Asia,23897056,0,443
2020-06-07,taiwan,Asia,23897056,0,443
2020-06-08,taiwan,Asia,23897056,0,443
2020-06-09,taiwan,Asia,23897056,0,443
2020-06-10,taiwan,Asia,23897056,0,443
2020-06-11,taiwan,Asia,23897056,0,443
2020-06-12,taiwan,Asia,23897056,0,443
2020-06-13,taiwan,Asia,23897056,0,443
2020-06-14,taiwan,Asia,23897056,0,443
2020-06-15,taiwan,Asia,23897056,2,445
2020-06-16,taiwan,Asia,23897056,0,445
2020-06-17,taiwan,Asia,23897056,0,445
2020-06-18,taiwan,Asia,23897056,1,446
2020-06-19,taiwan,Asia,23897056,0,446
2020-06-20,taiwan,Asia,23897056,0,446
2020-06-21,taiwan,Asia,23897056,0,446
2020-06-22,taiwan,Asia,23897056,0,446
2020-06-23,taiwan,Asia,23897056,0,446
2020-06-24,taiwan,Asia,23897056,0,446
2020-06-25,taiwan,Asia,23897056,1,447
2020-06-26,taiwan,Asia,23897056,0,447
2020-06-27,taiwan,Asia,23897056,0,447
2020-06-28,taiwan,Asia,23897056,0,447
2020-06-29,taiwan,Asia,23897056,0,447
2020-06-30,taiwan,Asia,23897056,0,447
2020-07-01,taiwan,Asia,23897056,0,447
2020-07-02,taiwan,Asia,23897056,1,448
2020-07-03,taiwan,Asia,23897056,1,449
2020-07-04,taiwan,Asia,23897056,0,449
2020-07-05,taiwan,Asia,23897056,0,449
2020-07-06,taiwan,Asia,23897056,0,449
2020-07-07,taiwan,Asia,23897056,0,449
2020-07-08,taiwan,Asia,23897056,0,449
2020-07-09,taiwan,Asia,23897056,0,449
2020-07-10,taiwan,Asia,23897056,2,451
2020-07-11,taiwan,Asia,23897056,0,451
2020-07-12,taiwan,Asia,23897056,0,451
2020-07-13,taiwan,Asia,23897056,0,451
2020-07-14,taiwan,Asia,23897056,0,451
2020-07-15,taiwan,Asia,23897056,0,451
2020-07-16,taiwan,Asia,23897056,1,452
2020-07-17,taiwan,Asia,23897056,2,454
2020-07-18,taiwan,Asia,23897056,0,454
2020-07-19,taiwan,Asia,23897056,1,455
2020-07-20,taiwan,Asia,23897056,0,455
2020-07-21,taiwan,Asia,23897056,0,455
2020-07-22,taiwan,Asia,23897056,0,455
2020-07-23,taiwan,Asia,23897056,0,455
2020-07-24,taiwan,Asia,23897056,3,458
2020-07-25,taiwan,Asia,23897056,0,458
2020-07-26,taiwan,Asia,23897056,0,458
2020-07-27,taiwan,Asia,23897056,4,462
2020-07-28,taiwan,Asia,23897056,5,467
2020-07-29,taiwan,Asia,23897056,0,467
2020-07-30,taiwan,Asia,23897056,0,467
2020-07-31,taiwan,Asia,23897056,0,467
2020-08-01,taiwan,Asia,23897056,7,474
2020-08-02,taiwan,Asia,23897056,1,475
2020-08-03,taiwan,Asia,23897056,0,475
2020-08-04,taiwan,Asia,23897056,1,476
2020-08-05,taiwan,Asia,23897056,0,476
2020-08-06,taiwan,Asia,23897056,1,477
2020-08-07,taiwan,Asia,23897056,0,477
2020-08-08,taiwan,Asia,23897056,2,479
2020-08-09,taiwan,Asia,23897056,1,480
2020-08-10,taiwan,Asia,23897056,0,480
2020-08-11,taiwan,Asia,23897056,0,480
2020-08-12,taiwan,Asia,23897056,1,481
2020-08-13,taiwan,Asia,23897056,0,481
2020-08-14,taiwan,Asia,23897056,0,481
2020-08-15,taiwan,Asia,23897056,1,482
2020-08-16,taiwan,Asia,23897056,2,484
2020-08-17,taiwan,Asia,23897056,1,485
2020-08-18,taiwan,Asia,23897056,1,486
2020-08-19,taiwan,Asia,23897056,0,486
2020-08-20,taiwan,Asia,23897056,0,486
2020-08-21,taiwan,Asia,23897056,1,487
2020-08-22,taiwan,Asia,23897056,0,487
2020-08-23,taiwan,Asia,23897056,0,487
2020-08-24,taiwan,Asia,23897056,0,487
2020-08-25,taiwan,Asia,23897056,0,487
2020-08-26,taiwan,Asia,23897056,0,487
2020-08-27,taiwan,Asia,23897056,0,487
2020-08-28,taiwan,Asia,23897056,0,487
2020-08-29,taiwan,Asia,23897056,1,488
2020-08-30,taiwan,Asia,23897056,0,488
2020-08-31,taiwan,Asia,23897056,0,488
2020-09-01,taiwan,Asia,23897056,0,488
2020-09-02,taiwan,Asia,23897056,1,489
2020-09-03,taiwan,Asia,23897056,0,489
2020-09-04,taiwan,Asia,23897056,1,490
2020-09-05,taiwan,Asia,23897056,2,492
2020-09-06,taiwan,Asia,23897056,1,493
2020-09-07,taiwan,Asia,23897056,1,494
2020-09-08,taiwan,Asia,23897056,1,495
2020-09-09,taiwan,Asia,23897056,0,495
2020-09-10,taiwan,Asia,23897056,1,496
2020-09-11,taiwan,Asia,23897056,2,498
2020-09-12,taiwan,Asia,23897056,0,498
2020-09-13,taiwan,Asia,23897056,0,498
2020-09-14,taiwan,Asia,23897056,1,499
2020-09-15,taiwan,Asia,23897056,0,499
2020-09-16,taiwan,Asia,23897056,1,500
2020-09-17,taiwan,Asia,23897056,3,503
2020-09-18,taiwan,Asia,23897056,0,503
2020-09-19,taiwan,Asia,23897056,3,506
2020-09-20,taiwan,Asia,23897056,1,507
2020-09-21,taiwan,Asia,23897056,2,509
2020-09-22,taiwan,Asia,23897056,0,509
2020-09-23,taiwan,Asia,23897056,0,509
2020-09-24,taiwan,Asia,23897056,0,509
2020-09-25,taiwan,Asia,23897056,1,510
2020-09-26,taiwan,Asia,23897056,0,510
2020-09-27,taiwan,Asia,23897056,0,510
2020-09-28,taiwan,Asia,23897056,3,513
2020-09-29,taiwan,Asia,23897056,0,513
2020-09-30,taiwan,Asia,23897056,1,514
2020-10-01,taiwan,Asia,23897056,1,515
2020-10-02,taiwan,Asia,23897056,2,517
2020-10-03,taiwan,Asia,23897056,0,517
2020-10-04,taiwan,Asia,23897056,0,517
2020-10-05,taiwan,Asia,23897056,1,518
2020-10-06,taiwan,Asia,23897056,3,521
2020-10-07,taiwan,Asia,23897056,2,523
2020-10-08,taiwan,Asia,23897056,1,524
2020-10-09,taiwan,Asia,23897056,3,527
2020-10-10,taiwan,Asia,23897056,0,527
2020-10-11,taiwan,Asia,23897056,0,527
2020-10-12,taiwan,Asia,23897056,2,529
2020-10-13,taiwan,Asia,23897056,1,530
2020-10-14,taiwan,Asia,23897056,0,530
2020-10-15,taiwan,Asia,23897056,1,531
2020-10-16,taiwan,Asia,23897056,4,535
2020-10-17,taiwan,Asia,23897056,0,535
2020-10-18,taiwan,Asia,23897056,0,535
2020-10-19,taiwan,Asia,23897056,5,540
2020-10-20,taiwan,Asia,23897056,3,543
2020-10-21,taiwan,Asia,23897056,1,544
2020-10-22,taiwan,Asia,23897056,4,548
2020-10-23,taiwan,Asia,23897056,0,548
2020-10-24,taiwan,Asia,23897056,2,550
2020-10-25,taiwan,Asia,23897056,0,550
2020-10-26,taiwan,Asia,23897056,0,550
2020-10-27,taiwan,Asia,23897056,0,550
2020-10-28,taiwan,Asia,23897056,0,550
2020-10-29,taiwan,Asia,23897056,3,553
2020-10-30,taiwan,Asia,23897056,1,554
2020-10-31,taiwan,Asia,23897056,1,555
2020-11-01,taiwan,Asia,23897056,3,558
2020-11-02,taiwan,Asia,23897056,5,563
2020-11-03,taiwan,Asia,23897056,4,567
2020-11-04,taiwan,Asia,23897056,1,568
2020-11-05,taiwan,Asia,23897056,1,569
2020-11-06,taiwan,Asia,23897056,4,573
2020-11-07,taiwan,Asia,23897056,0,573
2020-11-08,taiwan,Asia,23897056,4,577
2020-11-09,taiwan,Asia,23897056,1,578
2020-11-10,taiwan,Asia,23897056,2,580
2020-11-11,taiwan,Asia,23897056,4,584
2020-11-12,taiwan,Asia,23897056,5,589
2020-11-13,taiwan,Asia,23897056,8,597
2020-11-14,taiwan,Asia,23897056,3,600
2020-11-15,taiwan,Asia,23897056,2,602
2020-11-16,taiwan,Asia,23897056,1,603
2020-11-17,taiwan,Asia,23897056,2,605
2020-11-18,taiwan,Asia,23897056,2,607
2020-11-19,taiwan,Asia,23897056,2,609
2020-11-20,taiwan,Asia,23897056,2,611
2020-11-21,taiwan,Asia,23897056,0,611
2020-11-22,taiwan,Asia,23897056,6,617
2020-11-23,taiwan,Asia,23897056,1,618
2020-11-24,taiwan,Asia,23897056,0,618
2020-11-25,taiwan,Asia,23897056,5,623
2020-05-03,tajikistan,Asia,9936493,52,128
2020-05-04,tajikistan,Asia,9936493,102,230
2020-05-05,tajikistan,Asia,9936493,63,293
2020-05-06,tajikistan,Asia,9936493,86,379
2020-05-07,tajikistan,Asia,9936493,82,461
2020-05-08,tajikistan,Asia,9936493,61,522
2020-05-09,tajikistan,Asia,9936493,90,612
2020-05-10,tajikistan,Asia,9936493,0,612
2020-05-11,tajikistan,Asia,9936493,49,661
2020-05-12,tajikistan,Asia,9936493,68,729
2020-05-13,tajikistan,Asia,9936493,72,801
2020-05-14,tajikistan,Asia,9936493,106,907
2020-05-15,tajikistan,Asia,9936493,211,1118
2020-05-16,tajikistan,Asia,9936493,204,1322
2020-05-17,tajikistan,Asia,9936493,202,1524
2020-05-18,tajikistan,Asia,9936493,205,1729
2020-05-19,tajikistan,Asia,9936493,207,1936
2020-05-20,tajikistan,Asia,9936493,204,2140
2020-05-21,tajikistan,Asia,9936493,210,2350
2020-05-22,tajikistan,Asia,9936493,201,2551
2020-05-23,tajikistan,Asia,9936493,187,2738
2020-05-24,tajikistan,Asia,9936493,191,2929
2020-05-25,tajikistan,Asia,9936493,171,3100
2020-05-26,tajikistan,Asia,9936493,166,3266
2020-05-27,tajikistan,Asia,9936493,158,3424
2020-05-28,tajikistan,Asia,9936493,139,3563
2020-05-29,tajikistan,Asia,9936493,123,3686
2020-05-30,tajikistan,Asia,9936493,121,3807
2020-05-31,tajikistan,Asia,9936493,123,3930
2020-06-01,tajikistan,Asia,9936493,83,4013
2020-06-02,tajikistan,Asia,9936493,87,4100
2020-06-03,tajikistan,Asia,9936493,91,4191
2020-06-04,tajikistan,Asia,9936493,98,4289
2020-06-05,tajikistan,Asia,9936493,81,4370
2020-06-06,tajikistan,Asia,9936493,83,4453
2020-06-07,tajikistan,Asia,9936493,76,4529
2020-06-08,tajikistan,Asia,9936493,80,4609
2020-06-09,tajikistan,Asia,9936493,81,4690
2020-06-10,tajikistan,Asia,9936493,73,4763
2020-06-11,tajikistan,Asia,9936493,71,4834
2020-06-12,tajikistan,Asia,9936493,68,4902
2020-06-13,tajikistan,Asia,9936493,69,4971
2020-06-14,tajikistan,Asia,9936493,64,5035
2020-06-15,tajikistan,Asia,9936493,62,5097
2020-06-16,tajikistan,Asia,9936493,63,5160
2020-06-17,tajikistan,Asia,9936493,61,5221
2020-06-18,tajikistan,Asia,9936493,58,5279
2020-06-19,tajikistan,Asia,9936493,59,5338
2020-06-20,tajikistan,Asia,9936493,61,5399
2020-06-21,tajikistan,Asia,9936493,58,5457
2020-06-22,tajikistan,Asia,9936493,56,5513
2020-06-23,tajikistan,Asia,9936493,54,5567
2020-06-24,tajikistan,Asia,9936493,63,5630
2020-06-25,tajikistan,Asia,9936493,61,5691
2020-06-26,tajikistan,Asia,9936493,56,5747
2020-06-27,tajikistan,Asia,9936493,52,5799
2020-06-28,tajikistan,Asia,9936493,50,5849
2020-06-29,tajikistan,Asia,9936493,51,5900
2020-06-30,tajikistan,Asia,9936493,0,5900
2020-07-01,tajikistan,Asia,9936493,105,6005
2020-07-02,tajikistan,Asia,9936493,53,6058
2020-07-03,tajikistan,Asia,9936493,0,6058
2020-07-04,tajikistan,Asia,9936493,101,6159
2020-07-05,tajikistan,Asia,9936493,54,6213
2020-07-06,tajikistan,Asia,9936493,49,6262
2020-07-07,tajikistan,Asia,9936493,53,6315
2020-07-08,tajikistan,Asia,9936493,49,6364
2020-07-09,tajikistan,Asia,9936493,46,6410
2020-07-10,tajikistan,Asia,9936493,47,6457
2020-07-11,tajikistan,Asia,9936493,49,6506
2020-07-12,tajikistan,Asia,9936493,46,6552
2020-07-13,tajikistan,Asia,9936493,44,6596
2020-07-14,tajikistan,Asia,9936493,47,6643
2020-07-15,tajikistan,Asia,9936493,52,6695
2020-07-16,tajikistan,Asia,9936493,46,6741
2020-07-17,tajikistan,Asia,9936493,45,6786
2020-07-18,tajikistan,Asia,9936493,48,6834
2020-07-19,tajikistan,Asia,9936493,44,6878
2020-07-20,tajikistan,Asia,9936493,43,6921
2020-07-21,tajikistan,Asia,9936493,46,6967
2020-07-22,tajikistan,Asia,9936493,48,7015
2020-07-23,tajikistan,Asia,9936493,45,7060
2020-07-24,tajikistan,Asia,9936493,44,7104
2020-07-25,tajikistan,Asia,9936493,46,7150
2020-07-26,tajikistan,Asia,9936493,42,7192
2020-07-27,tajikistan,Asia,9936493,43,7235
2020-07-28,tajikistan,Asia,9936493,41,7276
2020-07-29,tajikistan,Asia,9936493,44,7320
2020-07-30,tajikistan,Asia,9936493,46,7366
2020-07-31,tajikistan,Asia,9936493,43,7409
2020-08-01,tajikistan,Asia,9936493,42,7451
2020-08-02,tajikistan,Asia,9936493,44,7495
2020-08-03,tajikistan,Asia,9936493,43,7538
2020-08-04,tajikistan,Asia,9936493,45,7583
2020-08-05,tajikistan,Asia,9936493,42,7625
2020-08-06,tajikistan,Asia,9936493,40,7665
2020-08-07,tajikistan,Asia,9936493,41,7706
2020-08-08,tajikistan,Asia,9936493,0,7706
2020-08-09,tajikistan,Asia,9936493,39,7745
2020-08-10,tajikistan,Asia,9936493,82,7827
2020-08-11,tajikistan,Asia,9936493,44,7871
2020-08-12,tajikistan,Asia,9936493,41,7912
2020-08-13,tajikistan,Asia,9936493,38,7950
2020-08-14,tajikistan,Asia,9936493,39,7989
2020-08-15,tajikistan,Asia,9936493,40,8029
2020-08-16,tajikistan,Asia,9936493,36,8065
2020-08-17,tajikistan,Asia,9936493,34,8099
2020-08-18,tajikistan,Asia,9936493,32,8131
2020-08-19,tajikistan,Asia,9936493,35,8166
2020-08-20,tajikistan,Asia,9936493,37,8203
2020-08-21,tajikistan,Asia,9936493,38,8241
2020-08-22,tajikistan,Asia,9936493,36,8277
2020-08-23,tajikistan,Asia,9936493,34,8311
2020-08-24,tajikistan,Asia,9936493,35,8346
2020-08-25,tajikistan,Asia,9936493,33,8379
2020-08-26,tajikistan,Asia,9936493,34,8413
2020-08-27,tajikistan,Asia,9936493,36,8449
2020-08-28,tajikistan,Asia,9936493,32,8481
2020-08-29,tajikistan,Asia,9936493,35,8516
2020-08-30,tajikistan,Asia,9936493,34,8550
2020-08-31,tajikistan,Asia,9936493,33,8583
2020-09-01,tajikistan,Asia,9936493,36,8619
2020-09-02,tajikistan,Asia,9936493,35,8654
2020-09-03,tajikistan,Asia,9936493,36,8690
2020-09-04,tajikistan,Asia,9936493,34,8724
2020-09-05,tajikistan,Asia,9936493,33,8757
2020-09-06,tajikistan,Asia,9936493,35,8792
2020-09-07,tajikistan,Asia,9936493,32,8824
2020-09-08,tajikistan,Asia,9936493,36,8860
2020-09-09,tajikistan,Asia,9936493,39,8899
2020-09-10,tajikistan,Asia,9936493,40,8939
2020-09-11,tajikistan,Asia,9936493,38,8977
2020-09-12,tajikistan,Asia,9936493,37,9014
2020-09-13,tajikistan,Asia,9936493,35,9049
2020-09-14,tajikistan,Asia,9936493,39,9088
2020-09-15,tajikistan,Asia,9936493,41,9129
2020-09-16,tajikistan,Asia,9936493,42,9171
2020-09-17,tajikistan,Asia,9936493,43,9214
2020-09-18,tajikistan,Asia,9936493,45,9259
2020-09-19,tajikistan,Asia,9936493,44,9303
2020-09-20,tajikistan,Asia,9936493,43,9346
2020-09-21,tajikistan,Asia,9936493,42,9388
2020-09-22,tajikistan,Asia,9936493,44,9432
2020-09-23,tajikistan,Asia,9936493,43,9475
2020-09-24,tajikistan,Asia,9936493,45,9520
2020-09-25,tajikistan,Asia,9936493,42,9562
2020-09-26,tajikistan,Asia,9936493,43,9605
2020-09-27,tajikistan,Asia,9936493,41,9646
2020-09-28,tajikistan,Asia,9936493,39,9685
2020-09-29,tajikistan,Asia,9936493,41,9726
2020-09-30,tajikistan,Asia,9936493,43,9769
2020-10-01,tajikistan,Asia,9936493,42,9811
2020-10-02,tajikistan,Asia,9936493,41,9852
2020-10-03,tajikistan,Asia,9936493,43,9895
2020-10-04,tajikistan,Asia,9936493,40,9935
2020-10-05,tajikistan,Asia,9936493,39,9974
2020-10-06,tajikistan,Asia,9936493,40,10014
2020-10-07,tajikistan,Asia,9936493,41,10055
2020-10-08,tajikistan,Asia,9936493,42,10097
2020-10-09,tajikistan,Asia,9936493,40,10137
2020-10-10,tajikistan,Asia,9936493,43,10180
2020-10-11,tajikistan,Asia,9936493,42,10222
2020-10-12,tajikistan,Asia,9936493,38,10260
2020-10-13,tajikistan,Asia,9936493,37,10297
2020-10-14,tajikistan,Asia,9936493,39,10336
2020-10-15,tajikistan,Asia,9936493,38,10374
2020-10-16,tajikistan,Asia,9936493,40,10414
2020-10-17,tajikistan,Asia,9936493,41,10455
2020-10-18,tajikistan,Asia,9936493,38,10493
2020-10-19,tajikistan,Asia,9936493,40,10533
2020-10-20,tajikistan,Asia,9936493,41,10574
2020-10-21,tajikistan,Asia,9936493,39,10613
2020-10-22,tajikistan,Asia,9936493,40,10653
2020-10-23,tajikistan,Asia,9936493,42,10695
2020-10-24,tajikistan,Asia,9936493,41,10736
2020-10-25,tajikistan,Asia,9936493,40,10776
2020-10-26,tajikistan,Asia,9936493,43,10819
2020-10-27,tajikistan,Asia,9936493,41,10860
2020-10-28,tajikistan,Asia,9936493,40,10900
2020-10-29,tajikistan,Asia,9936493,39,10939
2020-10-30,tajikistan,Asia,9936493,38,10977
2020-10-31,tajikistan,Asia,9936493,40,11017
2020-11-01,tajikistan,Asia,9936493,37,11054
2020-11-02,tajikistan,Asia,9936493,42,11096
2020-11-03,tajikistan,Asia,9936493,43,11139
2020-11-04,tajikistan,Asia,9936493,41,11180
2020-11-05,tajikistan,Asia,9936493,39,11219
2020-11-06,tajikistan,Asia,9936493,37,11256
2020-11-07,tajikistan,Asia,9936493,38,11294
2020-11-08,tajikistan,Asia,9936493,42,11336
2020-11-09,tajikistan,Asia,9936493,40,11376
2020-11-10,tajikistan,Asia,9936493,41,11417
2020-11-11,tajikistan,Asia,9936493,39,11456
2020-11-12,tajikistan,Asia,9936493,40,11496
2020-11-13,tajikistan,Asia,9936493,38,11534
2020-11-14,tajikistan,Asia,9936493,39,11573
2020-11-15,tajikistan,Asia,9936493,37,11610
2020-11-16,tajikistan,Asia,9936493,39,11649
2020-11-17,tajikistan,Asia,9936493,40,11689
2020-11-18,tajikistan,Asia,9936493,42,11731
2020-11-19,tajikistan,Asia,9936493,41,11772
2020-11-20,tajikistan,Asia,9936493,43,11815
2020-11-21,tajikistan,Asia,9936493,39,11854
2020-11-22,tajikistan,Asia,9936493,40,11894
2020-11-23,tajikistan,Asia,9936493,38,11932
2020-11-24,tajikistan,Asia,9936493,39,11971
2020-11-25,tajikistan,Asia,9936493,37,12008
2020-11-26,tajikistan,Asia,9936493,36,12044
2020-11-27,tajikistan,Asia,9936493,38,12082
2020-11-28,tajikistan,Asia,9936493,36,12118
2020-11-29,tajikistan,Asia,9936493,37,12155
2020-11-30,tajikistan,Asia,9936493,39,12194
2020-12-01,tajikistan,Asia,9936493,37,12231
2020-12-02,tajikistan,Asia,9936493,38,12269
2020-12-03,tajikistan,Asia,9936493,39,12308
2020-12-04,tajikistan,Asia,9936493,41,12349
2020-12-05,tajikistan,Asia,9936493,40,12389
2020-12-06,tajikistan,Asia,9936493,39,12428
2020-12-07,tajikistan,Asia,9936493,41,12469
2020-12-08,tajikistan,Asia,9936493,42,12511
2020-12-09,tajikistan,Asia,9936493,40,12551
2020-12-10,tajikistan,Asia,9936493,37,12588
2020-12-11,tajikistan,Asia,9936493,0,12588
2020-12-12,tajikistan,Asia,9936493,36,12624
2020-12-13,tajikistan,Asia,9936493,80,12704
2020-12-14,tajikistan,Asia,9936493,37,12741
2020-12-15,tajikistan,Asia,9936493,36,12777
2020-12-16,tajikistan,Asia,9936493,38,12815
2020-12-17,tajikistan,Asia,9936493,37,12852
2020-12-18,tajikistan,Asia,9936493,36,12888
2020-12-19,tajikistan,Asia,9936493,35,12923
2020-12-20,tajikistan,Asia,9936493,37,12960
2020-12-21,tajikistan,Asia,9936493,38,12998
2020-12-22,tajikistan,Asia,9936493,36,13034
2020-12-23,tajikistan,Asia,9936493,37,13071
2020-12-24,tajikistan,Asia,9936493,35,13106
2020-12-25,tajikistan,Asia,9936493,32,13138
2020-12-26,tajikistan,Asia,9936493,34,13172
2020-12-27,tajikistan,Asia,9936493,33,13205
2020-12-28,tajikistan,Asia,9936493,32,13237
2020-12-29,tajikistan,Asia,9936493,28,13265
2020-12-30,tajikistan,Asia,9936493,31,13296
2020-12-31,tajikistan,Asia,9936493,0,13296
2021-01-01,tajikistan,Asia,9936493,0,13296
2021-01-02,tajikistan,Asia,9936493,4,13300
2021-01-03,tajikistan,Asia,9936493,0,13300
2021-01-04,tajikistan,Asia,9936493,0,13300
2021-01-05,tajikistan,Asia,9936493,5,13305
2021-01-06,tajikistan,Asia,9936493,0,13305
2021-01-07,tajikistan,Asia,9936493,0,13305
2021-01-08,tajikistan,Asia,9936493,0,13305
2021-01-09,tajikistan,Asia,9936493,0,13305
2021-01-10,tajikistan,Asia,9936493,3,13308
2021-01-11,tajikistan,Asia,9936493,0,13308
2021-01-12,tajikistan,Asia,9936493,0,13308
2021-01-13,tajikistan,Asia,9936493,0,13308
2021-01-14,tajikistan,Asia,9936493,0,13308
2021-01-15,tajikistan,Asia,9936493,0,13308
2021-01-16,tajikistan,Asia,9936493,0,13308
2021-01-17,tajikistan,Asia,9936493,0,13308
2021-01-18,tajikistan,Asia,9936493,0,13308
2021-01-19,tajikistan,Asia,9936493,0,13308
2021-01-20,tajikistan,Asia,9936493,0,13308
2021-01-21,tajikistan,Asia,9936493,0,13308
2021-01-22,tajikistan,Asia,9936493,0,13308
2021-01-23,tajikistan,Asia,9936493,0,13308
2021-01-24,tajikistan,Asia,9936493,0,13308
2021-01-25,tajikistan,Asia,9936493,0,13308
2021-01-26,tajikistan,Asia,9936493,0,13308
2021-01-27,tajikistan,Asia,9936493,0,13308
2021-01-28,tajikistan,Asia,9936493,0,13308
2021-01-29,tajikistan,Asia,9936493,0,13308
2021-01-30,tajikistan,Asia,9936493,0,13308
2021-01-31,tajikistan,Asia,9936493,0,13308
2021-02-01,tajikistan,Asia,9936493,0,13308
2021-02-02,tajikistan,Asia,9936493,0,13308
2021-02-03,tajikistan,Asia,9936493,0,13308
2021-02-04,tajikistan,Asia,9936493,0,13308
2021-02-05,tajikistan,Asia,9936493,0,13308
2021-02-06,tajikistan,Asia,9936493,0,13308
2021-02-07,tajikistan,Asia,9936493,0,13308
2021-02-08,tajikistan,Asia,9936493,0,13308
2021-02-09,tajikistan,Asia,9936493,0,13308
2021-02-10,tajikistan,Asia,9936493,0,13308
2021-02-11,tajikistan,Asia,9936493,0,13308
2021-02-12,tajikistan,Asia,9936493,0,13308
2021-02-13,tajikistan,Asia,9936493,0,13308
2021-02-14,tajikistan,Asia,9936493,0,13308
2021-02-15,tajikistan,Asia,9936493,0,13308
2021-02-16,tajikistan,Asia,9936493,0,13308
2021-02-17,tajikistan,Asia,9936493,0,13308
2021-02-18,tajikistan,Asia,9936493,0,13308
2021-02-19,tajikistan,Asia,9936493,0,13308
2021-02-20,tajikistan,Asia,9936493,0,13308
2021-02-21,tajikistan,Asia,9936493,0,13308
2021-02-22,tajikistan,Asia,9936493,0,13308
2021-02-23,tajikistan,Asia,9936493,0,13308
2021-02-24,tajikistan,Asia,9936493,0,13308
2021-02-25,tajikistan,Asia,9936493,0,13308
2021-02-26,tajikistan,Asia,9936493,0,13308
2021-02-27,tajikistan,Asia,9936493,0,13308
2021-02-28,tajikistan,Asia,9936493,0,13308
2021-03-01,tajikistan,Asia,9936493,0,13308
2021-03-02,tajikistan,Asia,9936493,0,13308
2021-03-03,tajikistan,Asia,9936493,0,13308
2021-03-04,tajikistan,Asia,9936493,0,13308
2021-03-05,tajikistan,Asia,9936493,0,13308
2021-03-06,tajikistan,Asia,9936493,0,13308
2021-03-07,tajikistan,Asia,9936493,0,13308
2021-03-08,tajikistan,Asia,9936493,0,13308
2021-03-09,tajikistan,Asia,9936493,0,13308
2021-03-10,tajikistan,Asia,9936493,0,13308
2021-03-11,tajikistan,Asia,9936493,0,13308
2021-03-12,tajikistan,Asia,9936493,0,13308
2021-03-13,tajikistan,Asia,9936493,0,13308
2021-03-14,tajikistan,Asia,9936493,0,13308
2021-03-15,tajikistan,Asia,9936493,0,13308
2021-03-16,tajikistan,Asia,9936493,0,13308
2021-03-17,tajikistan,Asia,9936493,0,13308
2021-03-18,tajikistan,Asia,9936493,0,13308
2021-03-19,tajikistan,Asia,9936493,0,13308
2021-03-20,tajikistan,Asia,9936493,0,13308
2021-03-21,tajikistan,Asia,9936493,0,13308
2021-03-22,tajikistan,Asia,9936493,0,13308
2021-03-23,tajikistan,Asia,9936493,0,13308
2021-03-24,tajikistan,Asia,9936493,0,13308
2021-03-25,tajikistan,Asia,9936493,0,13308
2021-03-26,tajikistan,Asia,9936493,0,13308
2021-03-27,tajikistan,Asia,9936493,0,13308
2021-03-28,tajikistan,Asia,9936493,0,13308
2021-03-29,tajikistan,Asia,9936493,0,13308
2021-03-30,tajikistan,Asia,9936493,0,13308
2021-03-31,tajikistan,Asia,9936493,0,13308
2021-04-01,tajikistan,Asia,9936493,0,13308
2021-04-02,tajikistan,Asia,9936493,0,13308
2021-04-03,tajikistan,Asia,9936493,0,13308
2021-04-04,tajikistan,Asia,9936493,0,13308
2021-04-05,tajikistan,Asia,9936493,0,13308
2021-04-06,tajikistan,Asia,9936493,0,13308
2021-04-07,tajikistan,Asia,9936493,0,13308
2021-04-08,tajikistan,Asia,9936493,0,13308
2021-04-09,tajikistan,Asia,9936493,0,13308
2021-04-10,tajikistan,Asia,9936493,0,13308
2021-04-11,tajikistan,Asia,9936493,0,13308
2021-04-12,tajikistan,Asia,9936493,0,13308
2021-04-13,tajikistan,Asia,9936493,0,13308
2021-04-14,tajikistan,Asia,9936493,0,13308
2021-04-15,tajikistan,Asia,9936493,0,13308
2021-04-16,tajikistan,Asia,9936493,0,13308
2021-04-17,tajikistan,Asia,9936493,0,13308
2021-04-18,tajikistan,Asia,9936493,0,13308
2021-04-19,tajikistan,Asia,9936493,0,13308
2021-04-20,tajikistan,Asia,9936493,0,13308
2021-04-21,tajikistan,Asia,9936493,0,13308
2021-04-22,tajikistan,Asia,9936493,0,13308
2021-04-23,tajikistan,Asia,9936493,0,13308
2021-04-24,tajikistan,Asia,9936493,0,13308
2021-04-25,tajikistan,Asia,9936493,0,13308
2021-04-26,tajikistan,Asia,9936493,0,13308
2021-04-27,tajikistan,Asia,9936493,0,13308
2021-04-28,tajikistan,Asia,9936493,0,13308
2021-04-29,tajikistan,Asia,9936493,0,13308
2021-04-30,tajikistan,Asia,9936493,0,13308
2021-05-01,tajikistan,Asia,9936493,0,13308
2021-05-02,tajikistan,Asia,9936493,0,13308
2021-05-03,tajikistan,Asia,9936493,0,13308
2021-05-04,tajikistan,Asia,9936493,0,13308
2021-05-05,tajikistan,Asia,9936493,0,13308
2021-05-06,tajikistan,Asia,9936493,0,13308
2021-05-07,tajikistan,Asia,9936493,0,13308
2021-05-08,tajikistan,Asia,9936493,0,13308
2021-05-09,tajikistan,Asia,9936493,0,13308
2021-05-10,tajikistan,Asia,9936493,0,13308
2021-05-11,tajikistan,Asia,9936493,0,13308
2021-05-12,tajikistan,Asia,9936493,0,13308
2021-05-13,tajikistan,Asia,9936493,0,13308
2021-05-14,tajikistan,Asia,9936493,0,13308
2021-05-15,tajikistan,Asia,9936493,0,13308
2021-05-16,tajikistan,Asia,9936493,0,13308
2021-05-17,tajikistan,Asia,9936493,0,13308
2021-05-18,tajikistan,Asia,9936493,0,13308
2021-05-19,tajikistan,Asia,9936493,0,13308
2021-05-20,tajikistan,Asia,9936493,0,13308
2021-05-21,tajikistan,Asia,9936493,0,13308
2021-05-22,tajikistan,Asia,9936493,0,13308
2021-05-23,tajikistan,Asia,9936493,0,13308
2021-05-24,tajikistan,Asia,9936493,0,13308
2021-05-25,tajikistan,Asia,9936493,0,13308
2021-05-26,tajikistan,Asia,9936493,0,13308
2021-05-27,tajikistan,Asia,9936493,0,13308
2021-05-28,tajikistan,Asia,9936493,0,13308
2021-05-29,tajikistan,Asia,9936493,0,13308
2021-05-30,tajikistan,Asia,9936493,0,13308
2021-05-31,tajikistan,Asia,9936493,0,13308
2021-06-01,tajikistan,Asia,9936493,0,13308
2021-06-02,tajikistan,Asia,9936493,0,13308
2021-06-03,tajikistan,Asia,9936493,0,13308
2021-06-04,tajikistan,Asia,9936493,0,13308
2021-06-05,tajikistan,Asia,9936493,0,13308
2021-06-06,tajikistan,Asia,9936493,0,13308
2021-06-07,tajikistan,Asia,9936493,0,13308
2021-06-08,tajikistan,Asia,9936493,0,13308
2021-06-09,tajikistan,Asia,9936493,0,13308
2021-06-10,tajikistan,Asia,9936493,0,13308
2021-06-11,tajikistan,Asia,9936493,0,13308
2021-06-12,tajikistan,Asia,9936493,0,13308
2021-06-13,tajikistan,Asia,9936493,0,13308
2021-06-14,tajikistan,Asia,9936493,0,13308
2021-06-15,tajikistan,Asia,9936493,0,13308
2021-06-16,tajikistan,Asia,9936493,0,13308
2021-06-17,tajikistan,Asia,9936493,0,13308
2021-06-18,tajikistan,Asia,9936493,0,13308
2021-06-19,tajikistan,Asia,9936493,0,13308
2021-06-20,tajikistan,Asia,9936493,0,13308
2021-06-21,tajikistan,Asia,9936493,0,13308
2021-06-22,tajikistan,Asia,9936493,32,13340
2021-06-23,tajikistan,Asia,9936493,18,13358
2021-06-24,tajikistan,Asia,9936493,13,13371
2021-06-25,tajikistan,Asia,9936493,21,13392
2021-06-26,tajikistan,Asia,9936493,23,13415
2021-06-27,tajikistan,Asia,9936493,24,13439
2021-06-28,tajikistan,Asia,9936493,21,13460
2021-06-29,tajikistan,Asia,9936493,18,13478
2021-06-30,tajikistan,Asia,9936493,21,13499
2021-07-01,tajikistan,Asia,9936493,24,13523
2021-07-02,tajikistan,Asia,9936493,0,13523
2021-07-03,tajikistan,Asia,9936493,46,13569
2021-07-04,tajikistan,Asia,9936493,28,13597
2021-07-05,tajikistan,Asia,9936493,26,13623
2021-07-06,tajikistan,Asia,9936493,0,13623
2021-07-07,tajikistan,Asia,9936493,67,13690
2021-07-08,tajikistan,Asia,9936493,29,13719
2021-07-09,tajikistan,Asia,9936493,34,13753
2021-07-10,tajikistan,Asia,9936493,43,13796
2021-07-11,tajikistan,Asia,9936493,38,13834
2021-07-12,tajikistan,Asia,9936493,34,13868
2021-07-13,tajikistan,Asia,9936493,43,13911
2021-07-14,tajikistan,Asia,9936493,47,13958
2021-07-15,tajikistan,Asia,9936493,42,14000
2021-07-16,tajikistan,Asia,9936493,0,14000
2021-07-17,tajikistan,Asia,9936493,37,14037
2021-07-18,tajikistan,Asia,9936493,41,14078
2021-07-19,tajikistan,Asia,9936493,99,14177
2021-07-20,tajikistan,Asia,9936493,51,14228
2021-07-21,tajikistan,Asia,9936493,63,14291
2021-07-22,tajikistan,Asia,9936493,68,14359
2021-07-23,tajikistan,Asia,9936493,68,14427
2021-07-24,tajikistan,Asia,9936493,78,14505
2021-07-25,tajikistan,Asia,9936493,87,14592
2021-07-26,tajikistan,Asia,9936493,81,14673
2021-07-27,tajikistan,Asia,9936493,88,14761
2021-07-28,tajikistan,Asia,9936493,84,14845
2021-07-29,tajikistan,Asia,9936493,84,14929
2021-07-30,tajikistan,Asia,9936493,75,15004
2021-07-31,tajikistan,Asia,9936493,78,15082
2021-08-01,tajikistan,Asia,9936493,68,15150
2021-08-02,tajikistan,Asia,9936493,69,15219
2021-08-03,tajikistan,Asia,9936493,74,15293
2021-08-04,tajikistan,Asia,9936493,71,15364
2021-08-05,tajikistan,Asia,9936493,76,15440
2021-08-06,tajikistan,Asia,9936493,73,15513
2021-08-07,tajikistan,Asia,9936493,70,15583
2021-08-08,tajikistan,Asia,9936493,68,15651
2021-08-09,tajikistan,Asia,9936493,69,15720
2021-08-10,tajikistan,Asia,9936493,72,15792
2020-02-20,thailand,Asia,70126166,0,35
2020-02-21,thailand,Asia,70126166,0,35
2020-02-22,thailand,Asia,70126166,0,35
2020-02-23,thailand,Asia,70126166,0,35
2020-02-24,thailand,Asia,70126166,0,35
2020-02-25,thailand,Asia,70126166,2,37
2020-02-26,thailand,Asia,70126166,3,40
2020-02-27,thailand,Asia,70126166,0,40
2020-02-28,thailand,Asia,70126166,1,41
2020-02-29,thailand,Asia,70126166,1,42
2020-03-01,thailand,Asia,70126166,0,42
2020-03-02,thailand,Asia,70126166,1,43
2020-03-03,thailand,Asia,70126166,0,43
2020-03-04,thailand,Asia,70126166,0,43
2020-03-05,thailand,Asia,70126166,4,47
2020-03-06,thailand,Asia,70126166,1,48
2020-03-07,thailand,Asia,70126166,2,50
2020-03-08,thailand,Asia,70126166,0,50
2020-03-09,thailand,Asia,70126166,0,50
2020-03-10,thailand,Asia,70126166,3,53
2020-03-11,thailand,Asia,70126166,6,59
2020-03-12,thailand,Asia,70126166,11,70
2020-03-13,thailand,Asia,70126166,5,75
2020-03-14,thailand,Asia,70126166,7,82
2020-03-15,thailand,Asia,70126166,32,114
2020-03-16,thailand,Asia,70126166,33,147
2020-03-17,thailand,Asia,70126166,30,177
2020-03-18,thailand,Asia,70126166,35,212
2020-03-19,thailand,Asia,70126166,60,272
2020-03-20,thailand,Asia,70126166,50,322
2020-03-21,thailand,Asia,70126166,89,411
2020-03-22,thailand,Asia,70126166,188,599
2020-03-23,thailand,Asia,70126166,122,721
2020-03-24,thailand,Asia,70126166,106,827
2020-03-25,thailand,Asia,70126166,107,934
2020-03-26,thailand,Asia,70126166,111,1045
2020-03-27,thailand,Asia,70126166,91,1136
2020-03-28,thailand,Asia,70126166,109,1245
2020-03-29,thailand,Asia,70126166,143,1388
2020-03-30,thailand,Asia,70126166,136,1524
2020-03-31,thailand,Asia,70126166,127,1651
2020-04-01,thailand,Asia,70126166,120,1771
2020-04-02,thailand,Asia,70126166,104,1875
2020-04-03,thailand,Asia,70126166,103,1978
2020-04-04,thailand,Asia,70126166,89,2067
2020-04-05,thailand,Asia,70126166,102,2169
2020-04-06,thailand,Asia,70126166,51,2220
2020-04-07,thailand,Asia,70126166,38,2258
2020-04-08,thailand,Asia,70126166,111,2369
2020-04-09,thailand,Asia,70126166,54,2423
2020-04-10,thailand,Asia,70126166,50,2473
2020-04-11,thailand,Asia,70126166,45,2518
2020-04-12,thailand,Asia,70126166,33,2551
2020-04-13,thailand,Asia,70126166,28,2579
2020-04-14,thailand,Asia,70126166,34,2613
2020-04-15,thailand,Asia,70126166,30,2643
2020-04-16,thailand,Asia,70126166,29,2672
2020-04-17,thailand,Asia,70126166,28,2700
2020-04-18,thailand,Asia,70126166,33,2733
2020-04-19,thailand,Asia,70126166,32,2765
2020-04-20,thailand,Asia,70126166,27,2792
2020-04-21,thailand,Asia,70126166,19,2811
2020-04-22,thailand,Asia,70126166,15,2826
2020-04-23,thailand,Asia,70126166,13,2839
2020-04-24,thailand,Asia,70126166,15,2854
2020-04-25,thailand,Asia,70126166,53,2907
2020-04-26,thailand,Asia,70126166,15,2922
2020-04-27,thailand,Asia,70126166,9,2931
2020-04-28,thailand,Asia,70126166,7,2938
2020-04-29,thailand,Asia,70126166,9,2947
2020-04-30,thailand,Asia,70126166,7,2954
2020-05-01,thailand,Asia,70126166,6,2960
2020-05-02,thailand,Asia,70126166,6,2966
2020-05-03,thailand,Asia,70126166,3,2969
2020-05-04,thailand,Asia,70126166,18,2987
2020-05-05,thailand,Asia,70126166,1,2988
2020-05-06,thailand,Asia,70126166,1,2989
2020-05-07,thailand,Asia,70126166,3,2992
2020-05-08,thailand,Asia,70126166,8,3000
2020-05-09,thailand,Asia,70126166,4,3004
2020-05-10,thailand,Asia,70126166,5,3009
2020-05-11,thailand,Asia,70126166,6,3015
2020-05-12,thailand,Asia,70126166,2,3017
2020-05-13,thailand,Asia,70126166,0,3017
2020-05-14,thailand,Asia,70126166,1,3018
2020-05-15,thailand,Asia,70126166,7,3025
2020-05-16,thailand,Asia,70126166,0,3025
2020-05-17,thailand,Asia,70126166,3,3028
2020-05-18,thailand,Asia,70126166,3,3031
2020-05-19,thailand,Asia,70126166,2,3033
2020-05-20,thailand,Asia,70126166,1,3034
2020-05-21,thailand,Asia,70126166,3,3037
2020-05-22,thailand,Asia,70126166,0,3037
2020-05-23,thailand,Asia,70126166,3,3040
2020-05-24,thailand,Asia,70126166,0,3040
2020-05-25,thailand,Asia,70126166,2,3042
2020-05-26,thailand,Asia,70126166,3,3045
2020-05-27,thailand,Asia,70126166,9,3054
2020-05-28,thailand,Asia,70126166,11,3065
2020-05-29,thailand,Asia,70126166,11,3076
2020-05-30,thailand,Asia,70126166,1,3077
2020-05-31,thailand,Asia,70126166,4,3081
2020-06-01,thailand,Asia,70126166,1,3082
2020-06-02,thailand,Asia,70126166,1,3083
2020-06-03,thailand,Asia,70126166,1,3084
2020-06-04,thailand,Asia,70126166,17,3101
2020-06-05,thailand,Asia,70126166,1,3102
2020-06-06,thailand,Asia,70126166,2,3104
2020-06-07,thailand,Asia,70126166,8,3112
2020-06-08,thailand,Asia,70126166,7,3119
2020-06-09,thailand,Asia,70126166,2,3121
2020-06-10,thailand,Asia,70126166,4,3125
2020-06-11,thailand,Asia,70126166,0,3125
2020-06-12,thailand,Asia,70126166,4,3129
2020-06-13,thailand,Asia,70126166,5,3134
2020-06-14,thailand,Asia,70126166,1,3135
2020-06-15,thailand,Asia,70126166,0,3135
2020-06-16,thailand,Asia,70126166,0,3135
2020-06-17,thailand,Asia,70126166,0,3135
2020-06-18,thailand,Asia,70126166,6,3141
2020-06-19,thailand,Asia,70126166,5,3146
2020-06-20,thailand,Asia,70126166,1,3147
2020-06-21,thailand,Asia,70126166,1,3148
2020-06-22,thailand,Asia,70126166,3,3151
2020-06-23,thailand,Asia,70126166,5,3156
2020-06-24,thailand,Asia,70126166,1,3157
2020-06-25,thailand,Asia,70126166,1,3158
2020-06-26,thailand,Asia,70126166,4,3162
2020-06-27,thailand,Asia,70126166,0,3162
2020-06-28,thailand,Asia,70126166,0,3162
2020-06-29,thailand,Asia,70126166,7,3169
2020-06-30,thailand,Asia,70126166,2,3171
2020-07-01,thailand,Asia,70126166,2,3173
2020-07-02,thailand,Asia,70126166,6,3179
2020-07-03,thailand,Asia,70126166,1,3180
2020-07-04,thailand,Asia,70126166,5,3185
2020-07-05,thailand,Asia,70126166,5,3190
2020-07-06,thailand,Asia,70126166,5,3195
2020-07-07,thailand,Asia,70126166,0,3195
2020-07-08,thailand,Asia,70126166,2,3197
2020-07-09,thailand,Asia,70126166,5,3202
2020-07-10,thailand,Asia,70126166,0,3202
2020-07-11,thailand,Asia,70126166,14,3216
2020-07-12,thailand,Asia,70126166,1,3217
2020-07-13,thailand,Asia,70126166,3,3220
2020-07-14,thailand,Asia,70126166,7,3227
2020-07-15,thailand,Asia,70126166,5,3232
2020-07-16,thailand,Asia,70126166,4,3236
2020-07-17,thailand,Asia,70126166,3,3239
2020-07-18,thailand,Asia,70126166,7,3246
2020-07-19,thailand,Asia,70126166,3,3249
2020-07-20,thailand,Asia,70126166,1,3250
2020-07-21,thailand,Asia,70126166,5,3255
2020-07-22,thailand,Asia,70126166,6,3261
2020-07-23,thailand,Asia,70126166,8,3269
2020-07-24,thailand,Asia,70126166,10,3279
2020-07-25,thailand,Asia,70126166,3,3282
2020-07-26,thailand,Asia,70126166,9,3291
2020-07-27,thailand,Asia,70126166,4,3295
2020-07-28,thailand,Asia,70126166,2,3297
2020-07-29,thailand,Asia,70126166,1,3298
2020-07-30,thailand,Asia,70126166,6,3304
2020-07-31,thailand,Asia,70126166,6,3310
2020-08-01,thailand,Asia,70126166,2,3312
2020-08-02,thailand,Asia,70126166,5,3317
2020-08-03,thailand,Asia,70126166,3,3320
2020-08-04,thailand,Asia,70126166,1,3321
2020-08-05,thailand,Asia,70126166,7,3328
2020-08-06,thailand,Asia,70126166,2,3330
2020-08-07,thailand,Asia,70126166,15,3345
2020-08-08,thailand,Asia,70126166,3,3348
2020-08-09,thailand,Asia,70126166,3,3351
2020-08-10,thailand,Asia,70126166,0,3351
2020-08-11,thailand,Asia,70126166,0,3351
2020-08-12,thailand,Asia,70126166,5,3356
2020-08-13,thailand,Asia,70126166,3,3359
2020-08-14,thailand,Asia,70126166,17,3376
2020-08-15,thailand,Asia,70126166,0,3376
2020-08-16,thailand,Asia,70126166,1,3377
2020-08-17,thailand,Asia,70126166,1,3378
2020-08-18,thailand,Asia,70126166,3,3381
2020-08-19,thailand,Asia,70126166,1,3382
2020-08-20,thailand,Asia,70126166,7,3389
2020-08-21,thailand,Asia,70126166,1,3390
2020-08-22,thailand,Asia,70126166,0,3390
2020-08-23,thailand,Asia,70126166,5,3395
2020-08-24,thailand,Asia,70126166,2,3397
2020-08-25,thailand,Asia,70126166,5,3402
2020-08-26,thailand,Asia,70126166,1,3403
2020-08-27,thailand,Asia,70126166,1,3404
2020-08-28,thailand,Asia,70126166,6,3410
2020-08-29,thailand,Asia,70126166,1,3411
2020-08-30,thailand,Asia,70126166,0,3411
2020-08-31,thailand,Asia,70126166,1,3412
2020-09-01,thailand,Asia,70126166,5,3417
2020-09-02,thailand,Asia,70126166,8,3425
2020-09-03,thailand,Asia,70126166,2,3427
2020-09-04,thailand,Asia,70126166,4,3431
2020-09-05,thailand,Asia,70126166,7,3438
2020-09-06,thailand,Asia,70126166,6,3444
2020-09-07,thailand,Asia,70126166,1,3445
2020-09-08,thailand,Asia,70126166,1,3446
2020-09-09,thailand,Asia,70126166,1,3447
2020-09-10,thailand,Asia,70126166,7,3454
2020-09-11,thailand,Asia,70126166,7,3461
2020-09-12,thailand,Asia,70126166,5,3466
2020-09-13,thailand,Asia,70126166,7,3473
2020-09-14,thailand,Asia,70126166,2,3475
2020-09-15,thailand,Asia,70126166,5,3480
2020-09-16,thailand,Asia,70126166,10,3490
2020-09-17,thailand,Asia,70126166,0,3490
2020-09-18,thailand,Asia,70126166,7,3497
2020-09-19,thailand,Asia,70126166,3,3500
2020-09-20,thailand,Asia,70126166,6,3506
2020-09-21,thailand,Asia,70126166,0,3506
2020-09-22,thailand,Asia,70126166,5,3511
2020-09-23,thailand,Asia,70126166,3,3514
2020-09-24,thailand,Asia,70126166,2,3516
2020-09-25,thailand,Asia,70126166,3,3519
2020-09-26,thailand,Asia,70126166,3,3522
2020-09-27,thailand,Asia,70126166,1,3523
2020-09-28,thailand,Asia,70126166,22,3545
2020-09-29,thailand,Asia,70126166,14,3559
2020-09-30,thailand,Asia,70126166,5,3564
2020-10-01,thailand,Asia,70126166,5,3569
2020-10-02,thailand,Asia,70126166,6,3575
2020-10-03,thailand,Asia,70126166,8,3583
2020-10-04,thailand,Asia,70126166,2,3585
2020-10-05,thailand,Asia,70126166,5,3590
2020-10-06,thailand,Asia,70126166,10,3600
2020-10-07,thailand,Asia,70126166,15,3615
2020-10-08,thailand,Asia,70126166,7,3622
2020-10-09,thailand,Asia,70126166,6,3628
2020-10-10,thailand,Asia,70126166,6,3634
2020-10-11,thailand,Asia,70126166,2,3636
2020-10-12,thailand,Asia,70126166,5,3641
2020-10-13,thailand,Asia,70126166,2,3643
2020-10-14,thailand,Asia,70126166,9,3652
2020-10-15,thailand,Asia,70126166,13,3665
2020-10-16,thailand,Asia,70126166,4,3669
2020-10-17,thailand,Asia,70126166,10,3679
2020-10-18,thailand,Asia,70126166,7,3686
2020-10-19,thailand,Asia,70126166,5,3691
2020-10-20,thailand,Asia,70126166,9,3700
2020-10-21,thailand,Asia,70126166,9,3709
2020-10-22,thailand,Asia,70126166,10,3719
2020-10-23,thailand,Asia,70126166,8,3727
2020-10-24,thailand,Asia,70126166,4,3731
2020-10-25,thailand,Asia,70126166,5,3736
2020-10-26,thailand,Asia,70126166,7,3743
2020-10-27,thailand,Asia,70126166,3,3746
2020-10-28,thailand,Asia,70126166,13,3759
2020-10-29,thailand,Asia,70126166,4,3763
2020-10-30,thailand,Asia,70126166,12,3775
2020-10-31,thailand,Asia,70126166,5,3780
2020-11-01,thailand,Asia,70126166,4,3784
2020-11-02,thailand,Asia,70126166,3,3787
2020-11-03,thailand,Asia,70126166,10,3797
2020-11-04,thailand,Asia,70126166,7,3804
2020-11-05,thailand,Asia,70126166,6,3810
2020-11-06,thailand,Asia,70126166,8,3818
2020-11-07,thailand,Asia,70126166,12,3830
2020-11-08,thailand,Asia,70126166,7,3837
2020-11-09,thailand,Asia,70126166,3,3840
2020-11-10,thailand,Asia,70126166,4,3844
2020-11-11,thailand,Asia,70126166,3,3847
2020-11-12,thailand,Asia,70126166,5,3852
2020-11-13,thailand,Asia,70126166,9,3861
2020-11-14,thailand,Asia,70126166,5,3866
2020-11-15,thailand,Asia,70126166,8,3874
2020-11-16,thailand,Asia,70126166,1,3875
2020-11-17,thailand,Asia,70126166,3,3878
2020-11-18,thailand,Asia,70126166,2,3880
2020-11-19,thailand,Asia,70126166,8,3888
2020-11-20,thailand,Asia,70126166,4,3892
2020-11-21,thailand,Asia,70126166,10,3902
2020-11-22,thailand,Asia,70126166,11,3913
2020-11-23,thailand,Asia,70126166,7,3920
2020-11-24,thailand,Asia,70126166,2,3922
2020-11-25,thailand,Asia,70126166,4,3926
2020-11-26,thailand,Asia,70126166,16,3942
2020-11-27,thailand,Asia,70126166,19,3961
2020-11-28,thailand,Asia,70126166,5,3966
2020-11-29,thailand,Asia,70126166,11,3977
2020-11-30,thailand,Asia,70126166,21,3998
2020-12-01,thailand,Asia,70126166,10,4008
2020-12-02,thailand,Asia,70126166,18,4026
2020-12-03,thailand,Asia,70126166,13,4039
2020-12-04,thailand,Asia,70126166,14,4053
2020-12-05,thailand,Asia,70126166,19,4072
2020-12-06,thailand,Asia,70126166,14,4086
2020-12-07,thailand,Asia,70126166,21,4107
2020-12-08,thailand,Asia,70126166,19,4126
2020-12-09,thailand,Asia,70126166,25,4151
2020-12-10,thailand,Asia,70126166,18,4169
2020-12-11,thailand,Asia,70126166,11,4180
2020-12-12,thailand,Asia,70126166,12,4192
2020-12-13,thailand,Asia,70126166,17,4209
2020-12-14,thailand,Asia,70126166,28,4237
2020-12-15,thailand,Asia,70126166,9,4246
2020-12-16,thailand,Asia,70126166,15,4261
2020-12-17,thailand,Asia,70126166,20,4281
2020-12-18,thailand,Asia,70126166,16,4297
2020-12-19,thailand,Asia,70126166,34,4331
2020-12-20,thailand,Asia,70126166,576,4907
2020-12-21,thailand,Asia,70126166,382,5289
2020-12-22,thailand,Asia,70126166,427,5716
2020-12-23,thailand,Asia,70126166,46,5762
2020-12-24,thailand,Asia,70126166,67,5829
2020-12-25,thailand,Asia,70126166,81,5910
2020-12-26,thailand,Asia,70126166,110,6020
2020-12-27,thailand,Asia,70126166,121,6141
2020-12-28,thailand,Asia,70126166,144,6285
2020-12-29,thailand,Asia,70126166,155,6440
2020-12-30,thailand,Asia,70126166,250,6690
2020-12-31,thailand,Asia,70126166,194,6884
2021-01-01,thailand,Asia,70126166,279,7163
2021-01-02,thailand,Asia,70126166,216,7379
2021-01-03,thailand,Asia,70126166,315,7694
2021-01-04,thailand,Asia,70126166,745,8439
2021-01-05,thailand,Asia,70126166,527,8966
2021-01-06,thailand,Asia,70126166,365,9331
2021-01-07,thailand,Asia,70126166,305,9636
2021-01-08,thailand,Asia,70126166,205,9841
2021-01-09,thailand,Asia,70126166,212,10053
2021-01-10,thailand,Asia,70126166,245,10298
2021-01-11,thailand,Asia,70126166,249,10547
2021-01-12,thailand,Asia,70126166,287,10834
2021-01-13,thailand,Asia,70126166,157,10991
2021-01-14,thailand,Asia,70126166,271,11262
2021-01-15,thailand,Asia,70126166,188,11450
2021-01-16,thailand,Asia,70126166,230,11680
2021-01-17,thailand,Asia,70126166,374,12054
2021-01-18,thailand,Asia,70126166,369,12423
2021-01-19,thailand,Asia,70126166,171,12594
2021-01-20,thailand,Asia,70126166,59,12653
2021-01-21,thailand,Asia,70126166,142,12795
2021-01-22,thailand,Asia,70126166,309,13104
2021-01-23,thailand,Asia,70126166,198,13302
2021-01-24,thailand,Asia,70126166,198,13500
2021-01-25,thailand,Asia,70126166,187,13687
2021-01-26,thailand,Asia,70126166,959,14646
2021-01-27,thailand,Asia,70126166,819,15465
2021-01-28,thailand,Asia,70126166,756,16221
2021-01-29,thailand,Asia,70126166,802,17023
2021-01-30,thailand,Asia,70126166,930,17953
2021-01-31,thailand,Asia,70126166,829,18782
2021-02-01,thailand,Asia,70126166,836,19618
2021-02-02,thailand,Asia,70126166,836,20454
2021-02-03,thailand,Asia,70126166,795,21249
2021-02-04,thailand,Asia,70126166,809,22058
2021-02-05,thailand,Asia,70126166,586,22644
2021-02-06,thailand,Asia,70126166,490,23134
2021-02-07,thailand,Asia,70126166,237,23371
2021-02-08,thailand,Asia,70126166,186,23557
2021-02-09,thailand,Asia,70126166,189,23746
2021-02-10,thailand,Asia,70126166,157,23903
2021-02-11,thailand,Asia,70126166,201,24104
2021-02-12,thailand,Asia,70126166,175,24279
2021-02-13,thailand,Asia,70126166,126,24405
2021-02-14,thailand,Asia,70126166,166,24571
2021-02-15,thailand,Asia,70126166,143,24714
2021-02-16,thailand,Asia,70126166,72,24786
2021-02-17,thailand,Asia,70126166,175,24961
2021-02-18,thailand,Asia,70126166,150,25111
2021-02-19,thailand,Asia,70126166,130,25241
2021-02-20,thailand,Asia,70126166,82,25323
2021-02-21,thailand,Asia,70126166,92,25415
2021-02-22,thailand,Asia,70126166,89,25504
2021-02-23,thailand,Asia,70126166,95,25599
2021-02-24,thailand,Asia,70126166,93,25692
2021-02-25,thailand,Asia,70126166,72,25764
2021-02-26,thailand,Asia,70126166,45,25809
2021-02-27,thailand,Asia,70126166,72,25881
2021-02-28,thailand,Asia,70126166,70,25951
2021-03-01,thailand,Asia,70126166,80,26031
2021-03-02,thailand,Asia,70126166,42,26073
2021-03-03,thailand,Asia,70126166,35,26108
2021-03-04,thailand,Asia,70126166,54,26162
2021-03-05,thailand,Asia,70126166,79,26241
2021-03-06,thailand,Asia,70126166,64,26305
2021-03-07,thailand,Asia,70126166,65,26370
2021-03-08,thailand,Asia,70126166,71,26441
2021-03-09,thailand,Asia,70126166,60,26501
2021-03-10,thailand,Asia,70126166,39,26540
2021-03-11,thailand,Asia,70126166,58,26598
2021-03-12,thailand,Asia,70126166,81,26679
2021-03-13,thailand,Asia,70126166,78,26757
2021-03-14,thailand,Asia,70126166,170,26927
2021-03-15,thailand,Asia,70126166,78,27005
2021-03-16,thailand,Asia,70126166,149,27154
2021-03-17,thailand,Asia,70126166,248,27402
2021-03-18,thailand,Asia,70126166,92,27494
2021-03-19,thailand,Asia,70126166,100,27594
2021-03-20,thailand,Asia,70126166,119,27713
2021-03-21,thailand,Asia,70126166,90,27803
2021-03-22,thailand,Asia,70126166,73,27876
2021-03-23,thailand,Asia,70126166,401,28277
2021-03-24,thailand,Asia,70126166,69,28346
2021-03-25,thailand,Asia,70126166,97,28443
2021-03-26,thailand,Asia,70126166,134,28577
2021-03-27,thailand,Asia,70126166,80,28657
2021-03-28,thailand,Asia,70126166,77,28734
2021-03-29,thailand,Asia,70126166,39,28773
2021-03-30,thailand,Asia,70126166,48,28821
2021-03-31,thailand,Asia,70126166,42,28863
2021-04-01,thailand,Asia,70126166,26,28889
2021-04-02,thailand,Asia,70126166,58,28947
2021-04-03,thailand,Asia,70126166,84,29031
2021-04-04,thailand,Asia,70126166,96,29127
2021-04-05,thailand,Asia,70126166,194,29321
2021-04-06,thailand,Asia,70126166,250,29571
2021-04-07,thailand,Asia,70126166,334,29905
2021-04-08,thailand,Asia,70126166,405,30310
2021-04-09,thailand,Asia,70126166,559,30869
2021-04-10,thailand,Asia,70126166,789,31658
2021-04-11,thailand,Asia,70126166,967,32625
2021-04-12,thailand,Asia,70126166,985,33610
2021-04-13,thailand,Asia,70126166,965,34575
2021-04-14,thailand,Asia,70126166,1335,35910
2021-04-15,thailand,Asia,70126166,1543,37453
2021-04-16,thailand,Asia,70126166,1585,39038
2021-04-17,thailand,Asia,70126166,1547,40585
2021-04-18,thailand,Asia,70126166,1767,42352
2021-04-19,thailand,Asia,70126166,1390,43742
2021-04-20,thailand,Asia,70126166,1443,45185
2021-04-21,thailand,Asia,70126166,1458,46643
2021-04-22,thailand,Asia,70126166,1470,48113
2021-04-23,thailand,Asia,70126166,2070,50183
2021-04-24,thailand,Asia,70126166,2839,53022
2021-04-25,thailand,Asia,70126166,2438,55460
2021-04-26,thailand,Asia,70126166,2048,57508
2021-04-27,thailand,Asia,70126166,2179,59687
2021-04-28,thailand,Asia,70126166,2012,61699
2021-04-29,thailand,Asia,70126166,1871,63570
2021-04-30,thailand,Asia,70126166,1583,65153
2021-05-01,thailand,Asia,70126166,1891,67044
2021-05-02,thailand,Asia,70126166,1940,68984
2021-05-03,thailand,Asia,70126166,2041,71025
2021-05-04,thailand,Asia,70126166,1763,72788
2021-05-05,thailand,Asia,70126166,2112,74900
2021-05-06,thailand,Asia,70126166,1911,76811
2021-05-07,thailand,Asia,70126166,2044,78855
2021-05-08,thailand,Asia,70126166,2419,81274
2021-05-09,thailand,Asia,70126166,2101,83375
2021-05-10,thailand,Asia,70126166,1630,85005
2021-05-11,thailand,Asia,70126166,1919,86924
2021-05-12,thailand,Asia,70126166,1983,88907
2021-05-13,thailand,Asia,70126166,4887,93794
2021-05-14,thailand,Asia,70126166,2256,96050
2021-05-15,thailand,Asia,70126166,3095,99145
2021-05-16,thailand,Asia,70126166,2302,101447
2021-05-17,thailand,Asia,70126166,9635,111082
2021-05-18,thailand,Asia,70126166,2473,113555
2021-05-19,thailand,Asia,70126166,3394,116949
2021-05-20,thailand,Asia,70126166,2636,119585
2021-05-21,thailand,Asia,70126166,3481,123066
2021-05-22,thailand,Asia,70126166,3052,126118
2021-05-23,thailand,Asia,70126166,3382,129500
2021-05-24,thailand,Asia,70126166,2713,132213
2021-05-25,thailand,Asia,70126166,3226,135439
2021-05-26,thailand,Asia,70126166,2455,137894
2021-05-27,thailand,Asia,70126166,3323,141217
2021-05-28,thailand,Asia,70126166,3759,144976
2021-05-29,thailand,Asia,70126166,4803,149779
2021-05-30,thailand,Asia,70126166,4528,154307
2021-05-31,thailand,Asia,70126166,5485,159792
2021-06-01,thailand,Asia,70126166,2230,162022
2021-06-02,thailand,Asia,70126166,3440,165462
2021-06-03,thailand,Asia,70126166,3886,169348
2021-06-04,thailand,Asia,70126166,2631,171979
2021-06-05,thailand,Asia,70126166,2817,174796
2021-06-06,thailand,Asia,70126166,2671,177467
2021-06-07,thailand,Asia,70126166,2419,179886
2021-06-08,thailand,Asia,70126166,2662,182548
2021-06-09,thailand,Asia,70126166,2680,185228
2021-06-10,thailand,Asia,70126166,2310,187538
2021-06-11,thailand,Asia,70126166,2290,189828
2021-06-12,thailand,Asia,70126166,3277,193105
2021-06-13,thailand,Asia,70126166,2804,195909
2021-06-14,thailand,Asia,70126166,3355,199264
2021-06-15,thailand,Asia,70126166,3000,202264
2021-06-16,thailand,Asia,70126166,2331,204595
2021-06-17,thailand,Asia,70126166,3129,207724
2021-06-18,thailand,Asia,70126166,3058,210782
2021-06-19,thailand,Asia,70126166,3667,214449
2021-06-20,thailand,Asia,70126166,3682,218131
2021-06-21,thailand,Asia,70126166,3175,221306
2021-06-22,thailand,Asia,70126166,4059,225365
2021-06-23,thailand,Asia,70126166,3174,228539
2021-06-24,thailand,Asia,70126166,4108,232647
2021-06-25,thailand,Asia,70126166,3644,236291
2021-06-26,thailand,Asia,70126166,4161,240452
2021-06-27,thailand,Asia,70126166,3995,244447
2021-06-28,thailand,Asia,70126166,5406,249853
2021-06-29,thailand,Asia,70126166,4662,254515
2021-06-30,thailand,Asia,70126166,4786,259301
2021-07-01,thailand,Asia,70126166,5533,264834
2021-07-02,thailand,Asia,70126166,6087,270921
2021-07-03,thailand,Asia,70126166,6230,277151
2021-07-04,thailand,Asia,70126166,5916,283067
2021-07-05,thailand,Asia,70126166,6166,289233
2021-07-06,thailand,Asia,70126166,5420,294653
2021-07-07,thailand,Asia,70126166,6519,301172
2021-07-08,thailand,Asia,70126166,7058,308230
2021-07-09,thailand,Asia,70126166,9276,317506
2021-07-10,thailand,Asia,70126166,9326,326832
2021-07-11,thailand,Asia,70126166,9539,336371
2021-07-12,thailand,Asia,70126166,8656,345027
2021-07-13,thailand,Asia,70126166,8685,353712
2021-07-14,thailand,Asia,70126166,9317,363029
2021-07-15,thailand,Asia,70126166,9186,372215
2021-07-16,thailand,Asia,70126166,9692,381907
2021-07-17,thailand,Asia,70126166,10082,391989
2021-07-18,thailand,Asia,70126166,11397,403386
2021-07-19,thailand,Asia,70126166,11784,415170
2021-07-20,thailand,Asia,70126166,11305,426475
2021-07-21,thailand,Asia,70126166,13002,439477
2021-07-22,thailand,Asia,70126166,13655,453132
2021-07-23,thailand,Asia,70126166,14575,467707
2021-07-24,thailand,Asia,70126166,14260,481967
2021-07-25,thailand,Asia,70126166,15335,497302
2021-07-26,thailand,Asia,70126166,15376,512678
2021-07-27,thailand,Asia,70126166,14150,526828
2021-07-28,thailand,Asia,70126166,16533,543361
2021-07-29,thailand,Asia,70126166,17669,561030
2021-07-30,thailand,Asia,70126166,17345,578375
2021-07-31,thailand,Asia,70126166,18912,597287
2021-08-01,thailand,Asia,70126166,18027,615314
2021-08-02,thailand,Asia,70126166,17970,633284
2021-08-03,thailand,Asia,70126166,18901,652185
2021-08-04,thailand,Asia,70126166,20200,672385
2021-08-05,thailand,Asia,70126166,20920,693305
2021-08-06,thailand,Asia,70126166,21379,714684
2021-08-07,thailand,Asia,70126166,21838,736522
2021-08-08,thailand,Asia,70126166,19983,756505
2021-08-09,thailand,Asia,70126166,19603,776108
2021-08-10,thailand,Asia,70126166,19843,795951
2021-08-11,thailand,Asia,70126166,21038,816989
2021-08-12,thailand,Asia,70126166,22782,839771
2021-08-13,thailand,Asia,70126166,23418,863189
2021-08-14,thailand,Asia,70126166,22086,885275
2021-08-15,thailand,Asia,70126166,21882,907157
2021-08-16,thailand,Asia,70126166,21157,928314
2021-08-17,thailand,Asia,70126166,20128,948442
2021-08-18,thailand,Asia,70126166,20515,968957
2021-08-19,thailand,Asia,70126166,20902,989859
2021-08-20,thailand,Asia,70126166,19851,1009710
2021-08-21,thailand,Asia,70126166,20571,1030281
2021-08-22,thailand,Asia,70126166,19014,1049295
2021-08-23,thailand,Asia,70126166,17491,1066786
2021-08-24,thailand,Asia,70126166,17165,1083951
2021-08-25,thailand,Asia,70126166,18417,1102368
2021-08-26,thailand,Asia,70126166,18501,1120869
2021-08-27,thailand,Asia,70126166,18702,1139571
2021-08-28,thailand,Asia,70126166,17984,1157555
2021-08-29,thailand,Asia,70126166,16536,1174091
2021-08-30,thailand,Asia,70126166,15972,1190063
2021-08-31,thailand,Asia,70126166,14666,1204729
2021-09-01,thailand,Asia,70126166,14802,1219531
2021-09-02,thailand,Asia,70126166,14956,1234487
2021-09-03,thailand,Asia,70126166,14653,1249140
2021-09-04,thailand,Asia,70126166,15942,1265082
2021-09-05,thailand,Asia,70126166,15452,1280534
2021-09-06,thailand,Asia,70126166,13988,1294522
2021-09-07,thailand,Asia,70126166,13821,1308343
2021-09-08,thailand,Asia,70126166,14176,1322519
2021-09-09,thailand,Asia,70126166,16031,1338550
2021-09-10,thailand,Asia,70126166,14403,1352953
2021-09-11,thailand,Asia,70126166,15191,1368144
2021-09-12,thailand,Asia,70126166,14029,1382173
2021-09-13,thailand,Asia,70126166,12583,1394756
2021-09-14,thailand,Asia,70126166,11786,1406542
2021-09-15,thailand,Asia,70126166,13798,1420340
2021-09-16,thailand,Asia,70126166,13897,1434237
2021-09-17,thailand,Asia,70126166,14555,1448792
2021-09-18,thailand,Asia,70126166,14109,1462901
2021-09-19,thailand,Asia,70126166,13576,1476477
2021-09-20,thailand,Asia,70126166,12709,1489186
2021-09-21,thailand,Asia,70126166,10919,1500105
2021-09-22,thailand,Asia,70126166,11252,1511357
2021-09-23,thailand,Asia,70126166,13256,1524613
2021-09-24,thailand,Asia,70126166,12697,1537310
2021-09-25,thailand,Asia,70126166,11975,1549285
2021-09-26,thailand,Asia,70126166,12353,1561638
2021-09-27,thailand,Asia,70126166,10288,1571926
2021-09-28,thailand,Asia,70126166,9489,1581415
2021-09-29,thailand,Asia,70126166,10414,1591829
2021-09-30,thailand,Asia,70126166,11646,1603475
2021-10-01,thailand,Asia,70126166,11754,1615229
2021-10-02,thailand,Asia,70126166,11375,1626604
2021-10-03,thailand,Asia,70126166,10828,1637432
2021-10-04,thailand,Asia,70126166,9930,1647362
2021-10-05,thailand,Asia,70126166,9869,1657231
2021-10-06,thailand,Asia,70126166,9866,1667097
2021-10-07,thailand,Asia,70126166,11200,1678297
2021-10-08,thailand,Asia,70126166,11140,1689437
2021-10-09,thailand,Asia,70126166,10630,1700067
2021-10-10,thailand,Asia,70126166,10817,1710884
2021-10-11,thailand,Asia,70126166,10035,1720919
2021-10-12,thailand,Asia,70126166,9445,1730364
2021-10-13,thailand,Asia,70126166,10064,1740428
2021-10-14,thailand,Asia,70126166,11276,1751704
2021-10-15,thailand,Asia,70126166,10486,1762190
2021-10-16,thailand,Asia,70126166,10648,1772838
2021-10-17,thailand,Asia,70126166,10863,1783701
2021-10-18,thailand,Asia,70126166,10111,1793812
2021-10-19,thailand,Asia,70126166,9122,1802934
2021-10-20,thailand,Asia,70126166,8918,1811852
2021-10-21,thailand,Asia,70126166,9727,1821579
2021-10-22,thailand,Asia,70126166,9810,1831389
2021-10-23,thailand,Asia,70126166,9742,1841131
2021-10-24,thailand,Asia,70126166,9351,1850482
2021-10-25,thailand,Asia,70126166,8675,1859157
2021-10-26,thailand,Asia,70126166,7706,1866863
2021-10-27,thailand,Asia,70126166,8452,1875315
2021-10-28,thailand,Asia,70126166,9658,1884973
2021-10-29,thailand,Asia,70126166,8968,1893941
2021-10-30,thailand,Asia,70126166,9224,1903165
2021-10-31,thailand,Asia,70126166,8859,1912024
2021-11-01,thailand,Asia,70126166,8165,1920189
2021-11-02,thailand,Asia,70126166,7574,1927763
2021-11-03,thailand,Asia,70126166,7679,1935442
2021-11-04,thailand,Asia,70126166,7982,1943424
2021-11-05,thailand,Asia,70126166,8148,1951572
2021-11-06,thailand,Asia,70126166,8467,1960039
2021-11-07,thailand,Asia,70126166,7960,1967999
2021-11-08,thailand,Asia,70126166,7592,1975591
2021-11-09,thailand,Asia,70126166,6904,1982495
2021-11-10,thailand,Asia,70126166,6978,1989473
2021-11-11,thailand,Asia,70126166,7496,1996969
2021-11-12,thailand,Asia,70126166,7305,2004274
2021-11-13,thailand,Asia,70126166,7057,2011331
2021-11-14,thailand,Asia,70126166,7079,2018410
2021-11-15,thailand,Asia,70126166,6343,2024753
2021-11-16,thailand,Asia,70126166,5947,2030700
2021-11-17,thailand,Asia,70126166,6524,2037224
2021-11-18,thailand,Asia,70126166,6901,2044125
2021-11-19,thailand,Asia,70126166,6855,2050980
2021-11-20,thailand,Asia,70126166,6595,2057575
2021-11-21,thailand,Asia,70126166,7006,2064581
2021-11-22,thailand,Asia,70126166,6428,2071009
2021-11-23,thailand,Asia,70126166,5126,2076135
2021-11-24,thailand,Asia,70126166,5857,2081992
2021-11-25,thailand,Asia,70126166,6335,2088327
2021-11-26,thailand,Asia,70126166,6559,2094886
2021-11-27,thailand,Asia,70126166,6073,2100959
2021-11-28,thailand,Asia,70126166,5854,2106813
2021-11-29,thailand,Asia,70126166,4753,2111566
2021-11-30,thailand,Asia,70126166,4306,2115872
2021-12-01,thailand,Asia,70126166,4886,2120758
2021-12-02,thailand,Asia,70126166,4971,2125729
2021-12-03,thailand,Asia,70126166,4912,2130641
2021-12-04,thailand,Asia,70126166,5896,2136537
2021-12-05,thailand,Asia,70126166,4704,2141241
2021-12-06,thailand,Asia,70126166,4000,2145241
2021-12-07,thailand,Asia,70126166,3525,2148766
2021-12-08,thailand,Asia,70126166,3618,2152384
2021-12-09,thailand,Asia,70126166,4203,2156587
2021-12-10,thailand,Asia,70126166,4193,2160780
2021-12-11,thailand,Asia,70126166,4079,2164859
2021-12-12,thailand,Asia,70126166,3787,2168646
2021-12-13,thailand,Asia,70126166,3398,2172044
2021-12-14,thailand,Asia,70126166,2862,2174906
2021-12-15,thailand,Asia,70126166,3370,2178276
2021-12-16,thailand,Asia,70126166,3684,2181960
2021-12-17,thailand,Asia,70126166,3537,2185497
2021-12-18,thailand,Asia,70126166,3132,2188629
2021-12-19,thailand,Asia,70126166,2899,2191528
2021-12-20,thailand,Asia,70126166,2525,2194053
2021-12-21,thailand,Asia,70126166,2476,2196529
2021-12-22,thailand,Asia,70126166,2532,2199061
2021-12-23,thailand,Asia,70126166,2940,2202001
2021-12-24,thailand,Asia,70126166,2671,2204672
2021-12-25,thailand,Asia,70126166,2766,2207438
2021-12-26,thailand,Asia,70126166,2532,2209970
2021-12-27,thailand,Asia,70126166,2437,2212407
2021-12-28,thailand,Asia,70126166,2305,2214712
2021-12-29,thailand,Asia,70126166,2575,2217287
2021-12-30,thailand,Asia,70126166,3037,2220324
2021-12-31,thailand,Asia,70126166,3111,2223435
2022-01-01,thailand,Asia,70126166,3011,2226446
2022-01-02,thailand,Asia,70126166,3112,2229558
2022-01-03,thailand,Asia,70126166,2927,2232485
2022-01-04,thailand,Asia,70126166,3091,2235576
2022-01-05,thailand,Asia,70126166,3899,2239475
2022-01-06,thailand,Asia,70126166,5775,2245250
2022-01-07,thailand,Asia,70126166,7526,2252776
2022-01-08,thailand,Asia,70126166,8263,2261039
2022-01-09,thailand,Asia,70126166,8511,2269550
2022-01-10,thailand,Asia,70126166,7926,2277476
2022-01-11,thailand,Asia,70126166,7133,2284609
2022-01-12,thailand,Asia,70126166,7681,2292290
2022-01-13,thailand,Asia,70126166,8167,2300457
2022-01-14,thailand,Asia,70126166,8158,2308615
2022-01-15,thailand,Asia,70126166,7793,2316408
2022-01-16,thailand,Asia,70126166,8077,2324485
2022-01-17,thailand,Asia,70126166,6929,2331414
2022-01-18,thailand,Asia,70126166,6397,2337811
2022-01-19,thailand,Asia,70126166,7122,2344933
2022-01-20,thailand,Asia,70126166,8129,2353062
2022-01-21,thailand,Asia,70126166,8640,2361702
2022-01-22,thailand,Asia,70126166,8112,2369814
2022-01-23,thailand,Asia,70126166,7686,2377500
2022-01-24,thailand,Asia,70126166,7139,2384639
2022-01-25,thailand,Asia,70126166,6718,2391357
2022-01-26,thailand,Asia,70126166,7587,2398944
2022-01-27,thailand,Asia,70126166,8078,2407022
2022-01-28,thailand,Asia,70126166,8450,2415472
2022-01-29,thailand,Asia,70126166,8618,2424090
2022-01-30,thailand,Asia,70126166,8444,2432534
2022-01-31,thailand,Asia,70126166,8008,2440542
2022-02-01,thailand,Asia,70126166,7422,2447964
2022-02-02,thailand,Asia,70126166,8587,2456551
2022-02-03,thailand,Asia,70126166,9172,2465723
2022-02-04,thailand,Asia,70126166,9909,2475632
2022-02-05,thailand,Asia,70126166,10490,2486122
2022-02-06,thailand,Asia,70126166,10879,2497001
2022-02-07,thailand,Asia,70126166,10470,2507471
2022-02-08,thailand,Asia,70126166,10398,2517869
2022-02-09,thailand,Asia,70126166,13182,2531051
2022-02-10,thailand,Asia,70126166,14822,2545873
2022-02-11,thailand,Asia,70126166,15242,2561115
2020-03-28,togo,Africa,8639966,0,25
2020-03-29,togo,Africa,8639966,0,25
2020-03-30,togo,Africa,8639966,5,30
2020-03-31,togo,Africa,8639966,4,34
2020-04-01,togo,Africa,8639966,2,36
2020-04-02,togo,Africa,8639966,3,39
2020-04-03,togo,Africa,8639966,1,40
2020-04-04,togo,Africa,8639966,1,41
2020-04-05,togo,Africa,8639966,3,44
2020-04-06,togo,Africa,8639966,14,58
2020-04-07,togo,Africa,8639966,7,65
2020-04-08,togo,Africa,8639966,5,70
2020-04-09,togo,Africa,8639966,3,73
2020-04-10,togo,Africa,8639966,3,76
2020-04-11,togo,Africa,8639966,0,76
2020-04-12,togo,Africa,8639966,0,76
2020-04-13,togo,Africa,8639966,1,77
2020-04-14,togo,Africa,8639966,0,77
2020-04-15,togo,Africa,8639966,4,81
2020-04-16,togo,Africa,8639966,0,81
2020-04-17,togo,Africa,8639966,2,83
2020-04-18,togo,Africa,8639966,1,84
2020-04-19,togo,Africa,8639966,0,84
2020-04-20,togo,Africa,8639966,0,84
2020-04-21,togo,Africa,8639966,2,86
2020-04-22,togo,Africa,8639966,2,88
2020-04-23,togo,Africa,8639966,0,88
2020-04-24,togo,Africa,8639966,2,90
2020-04-25,togo,Africa,8639966,6,96
2020-04-26,togo,Africa,8639966,2,98
2020-04-27,togo,Africa,8639966,0,98
2020-04-28,togo,Africa,8639966,1,99
2020-04-29,togo,Africa,8639966,10,109
2020-04-30,togo,Africa,8639966,7,116
2020-05-01,togo,Africa,8639966,7,123
2020-05-02,togo,Africa,8639966,0,123
2020-05-03,togo,Africa,8639966,1,124
2020-05-04,togo,Africa,8639966,2,126
2020-05-05,togo,Africa,8639966,2,128
2020-05-06,togo,Africa,8639966,0,128
2020-05-07,togo,Africa,8639966,7,135
2020-05-08,togo,Africa,8639966,10,145
2020-05-09,togo,Africa,8639966,8,153
2020-05-10,togo,Africa,8639966,21,174
2020-05-11,togo,Africa,8639966,7,181
2020-05-12,togo,Africa,8639966,18,199
2020-05-13,togo,Africa,8639966,20,219
2020-05-14,togo,Africa,8639966,19,238
2020-05-15,togo,Africa,8639966,25,263
2020-05-16,togo,Africa,8639966,35,298
2020-05-17,togo,Africa,8639966,3,301
2020-05-18,togo,Africa,8639966,29,330
2020-05-19,togo,Africa,8639966,8,338
2020-05-20,togo,Africa,8639966,2,340
2020-05-21,togo,Africa,8639966,14,354
2020-05-22,togo,Africa,8639966,9,363
2020-05-23,togo,Africa,8639966,10,373
2020-05-24,togo,Africa,8639966,8,381
2020-05-25,togo,Africa,8639966,5,386
2020-05-26,togo,Africa,8639966,5,391
2020-05-27,togo,Africa,8639966,4,395
2020-05-28,togo,Africa,8639966,27,422
2020-05-29,togo,Africa,8639966,6,428
2020-05-30,togo,Africa,8639966,5,433
2020-05-31,togo,Africa,8639966,9,442
2020-06-01,togo,Africa,8639966,1,443
2020-06-02,togo,Africa,8639966,2,445
2020-06-03,togo,Africa,8639966,7,452
2020-06-04,togo,Africa,8639966,13,465
2020-06-05,togo,Africa,8639966,20,485
2020-06-06,togo,Africa,8639966,2,487
2020-06-07,togo,Africa,8639966,8,495
2020-06-08,togo,Africa,8639966,2,497
2020-06-09,togo,Africa,8639966,4,501
2020-06-10,togo,Africa,8639966,21,522
2020-06-11,togo,Africa,8639966,2,524
2020-06-12,togo,Africa,8639966,1,525
2020-06-13,togo,Africa,8639966,5,530
2020-06-14,togo,Africa,8639966,0,530
2020-06-15,togo,Africa,8639966,1,531
2020-06-16,togo,Africa,8639966,6,537
2020-06-17,togo,Africa,8639966,7,544
2020-06-18,togo,Africa,8639966,3,547
2020-06-19,togo,Africa,8639966,8,555
2020-06-20,togo,Africa,8639966,6,561
2020-06-21,togo,Africa,8639966,8,569
2020-06-22,togo,Africa,8639966,0,569
2020-06-23,togo,Africa,8639966,7,576
2020-06-24,togo,Africa,8639966,7,583
2020-06-25,togo,Africa,8639966,5,588
2020-06-26,togo,Africa,8639966,3,591
2020-06-27,togo,Africa,8639966,24,615
2020-06-28,togo,Africa,8639966,27,642
2020-06-29,togo,Africa,8639966,1,643
2020-06-30,togo,Africa,8639966,7,650
2020-07-01,togo,Africa,8639966,11,661
2020-07-02,togo,Africa,8639966,6,667
2020-07-03,togo,Africa,8639966,4,671
2020-07-04,togo,Africa,8639966,5,676
2020-07-05,togo,Africa,8639966,4,680
2020-07-06,togo,Africa,8639966,0,680
2020-07-07,togo,Africa,8639966,9,689
2020-07-08,togo,Africa,8639966,6,695
2020-07-09,togo,Africa,8639966,9,704
2020-07-10,togo,Africa,8639966,6,710
2020-07-11,togo,Africa,8639966,0,710
2020-07-12,togo,Africa,8639966,10,720
2020-07-13,togo,Africa,8639966,1,721
2020-07-14,togo,Africa,8639966,10,731
2020-07-15,togo,Africa,8639966,9,740
2020-07-16,togo,Africa,8639966,9,749
2020-07-17,togo,Africa,8639966,17,766
2020-07-18,togo,Africa,8639966,8,774
2020-07-19,togo,Africa,8639966,4,778
2020-07-20,togo,Africa,8639966,5,783
2020-07-21,togo,Africa,8639966,7,790
2020-07-22,togo,Africa,8639966,16,806
2020-07-23,togo,Africa,8639966,22,828
2020-07-24,togo,Africa,8639966,11,839
2020-07-25,togo,Africa,8639966,14,853
2020-07-26,togo,Africa,8639966,15,868
2020-07-27,togo,Africa,8639966,6,874
2020-07-28,togo,Africa,8639966,22,896
2020-07-29,togo,Africa,8639966,0,896
2020-07-30,togo,Africa,8639966,12,908
2020-07-31,togo,Africa,8639966,33,941
2020-08-01,togo,Africa,8639966,17,958
2020-08-02,togo,Africa,8639966,3,961
2020-08-03,togo,Africa,8639966,15,976
2020-08-04,togo,Africa,8639966,12,988
2020-08-05,togo,Africa,8639966,13,1001
2020-08-06,togo,Africa,8639966,11,1012
2020-08-07,togo,Africa,8639966,16,1028
2020-08-08,togo,Africa,8639966,18,1046
2020-08-09,togo,Africa,8639966,14,1060
2020-08-10,togo,Africa,8639966,7,1067
2020-08-11,togo,Africa,8639966,3,1070
2020-08-12,togo,Africa,8639966,22,1092
2020-08-13,togo,Africa,8639966,12,1104
2020-08-14,togo,Africa,8639966,20,1124
2020-08-15,togo,Africa,8639966,6,1130
2020-08-16,togo,Africa,8639966,17,1147
2020-08-17,togo,Africa,8639966,7,1154
2020-08-18,togo,Africa,8639966,19,1173
2020-08-19,togo,Africa,8639966,17,1190
2020-08-20,togo,Africa,8639966,22,1212
2020-08-21,togo,Africa,8639966,27,1239
2020-08-22,togo,Africa,8639966,36,1275
2020-08-23,togo,Africa,8639966,2,1277
2020-08-24,togo,Africa,8639966,18,1295
2020-08-25,togo,Africa,8639966,14,1309
2020-08-26,togo,Africa,8639966,17,1326
2020-08-27,togo,Africa,8639966,0,1326
2020-08-28,togo,Africa,8639966,39,1365
2020-08-29,togo,Africa,8639966,25,1390
2020-08-30,togo,Africa,8639966,6,1396
2020-08-31,togo,Africa,8639966,4,1400
2020-09-01,togo,Africa,8639966,16,1416
2020-09-02,togo,Africa,8639966,18,1434
2020-09-03,togo,Africa,8639966,9,1443
2020-09-04,togo,Africa,8639966,14,1457
2020-09-05,togo,Africa,8639966,20,1477
2020-09-06,togo,Africa,8639966,11,1488
2020-09-07,togo,Africa,8639966,5,1493
2020-09-08,togo,Africa,8639966,20,1513
2020-09-09,togo,Africa,8639966,15,1528
2020-09-10,togo,Africa,8639966,9,1537
2020-09-11,togo,Africa,8639966,11,1548
2020-09-12,togo,Africa,8639966,7,1555
2020-09-13,togo,Africa,8639966,17,1572
2020-09-14,togo,Africa,8639966,6,1578
2020-09-15,togo,Africa,8639966,17,1595
2020-09-16,togo,Africa,8639966,13,1608
2020-09-17,togo,Africa,8639966,10,1618
2020-09-18,togo,Africa,8639966,22,1640
2020-09-19,togo,Africa,8639966,19,1659
2020-09-20,togo,Africa,8639966,7,1666
2020-09-21,togo,Africa,8639966,3,1669
2020-09-22,togo,Africa,8639966,14,1683
2020-09-23,togo,Africa,8639966,18,1701
2020-09-24,togo,Africa,8639966,6,1707
2020-09-25,togo,Africa,8639966,15,1722
2020-09-26,togo,Africa,8639966,14,1736
2020-09-27,togo,Africa,8639966,7,1743
2020-09-28,togo,Africa,8639966,6,1749
2020-09-29,togo,Africa,8639966,10,1759
2020-09-30,togo,Africa,8639966,25,1784
2020-10-01,togo,Africa,8639966,25,1809
2020-10-02,togo,Africa,8639966,9,1818
2020-10-03,togo,Africa,8639966,22,1840
2020-10-04,togo,Africa,8639966,14,1854
2020-10-05,togo,Africa,8639966,10,1864
2020-10-06,togo,Africa,8639966,17,1881
2020-10-07,togo,Africa,8639966,17,1898
2020-10-08,togo,Africa,8639966,9,1907
2020-10-09,togo,Africa,8639966,14,1921
2020-10-10,togo,Africa,8639966,14,1935
2020-10-11,togo,Africa,8639966,5,1940
2020-10-12,togo,Africa,8639966,9,1949
2020-10-13,togo,Africa,8639966,23,1972
2020-10-14,togo,Africa,8639966,11,1983
2020-10-15,togo,Africa,8639966,13,1996
2020-10-16,togo,Africa,8639966,31,2027
2020-10-17,togo,Africa,8639966,22,2049
2020-10-18,togo,Africa,8639966,8,2057
2020-10-19,togo,Africa,8639966,14,2071
2020-10-20,togo,Africa,8639966,33,2104
2020-10-21,togo,Africa,8639966,16,2120
2020-10-22,togo,Africa,8639966,19,2139
2020-10-23,togo,Africa,8639966,23,2162
2020-10-24,togo,Africa,8639966,25,2187
2020-10-25,togo,Africa,8639966,13,2200
2020-10-26,togo,Africa,8639966,4,2204
2020-10-27,togo,Africa,8639966,25,2229
2020-10-28,togo,Africa,8639966,9,2238
2020-10-29,togo,Africa,8639966,58,2296
2020-10-30,togo,Africa,8639966,16,2312
2020-10-31,togo,Africa,8639966,19,2331
2020-11-01,togo,Africa,8639966,26,2357
2020-11-02,togo,Africa,8639966,7,2364
2020-11-03,togo,Africa,8639966,17,2381
2020-11-04,togo,Africa,8639966,25,2406
2020-11-05,togo,Africa,8639966,36,2442
2020-11-06,togo,Africa,8639966,18,2460
2020-11-07,togo,Africa,8639966,23,2483
2020-11-08,togo,Africa,8639966,33,2516
2020-11-09,togo,Africa,8639966,7,2523
2020-11-10,togo,Africa,8639966,35,2558
2020-11-11,togo,Africa,8639966,35,2593
2020-11-12,togo,Africa,8639966,12,2605
2020-11-13,togo,Africa,8639966,22,2627
2020-11-14,togo,Africa,8639966,24,2651
2020-11-15,togo,Africa,8639966,24,2675
2020-11-16,togo,Africa,8639966,18,2693
2020-11-17,togo,Africa,8639966,29,2722
2020-11-18,togo,Africa,8639966,30,2752
2020-11-19,togo,Africa,8639966,19,2771
2020-11-20,togo,Africa,8639966,25,2796
2020-11-21,togo,Africa,8639966,33,2829
2020-11-22,togo,Africa,8639966,14,2843
2020-11-23,togo,Africa,8639966,11,2854
2020-11-24,togo,Africa,8639966,18,2872
2020-11-25,togo,Africa,8639966,17,2889
2020-11-26,togo,Africa,8639966,15,2904
2020-11-27,togo,Africa,8639966,22,2926
2020-11-28,togo,Africa,8639966,20,2946
2020-11-29,togo,Africa,8639966,16,2962
2020-11-30,togo,Africa,8639966,12,2974
2020-12-01,togo,Africa,8639966,23,2997
2020-12-02,togo,Africa,8639966,17,3014
2020-12-03,togo,Africa,8639966,25,3039
2020-12-04,togo,Africa,8639966,12,3051
2020-12-05,togo,Africa,8639966,34,3085
2020-12-06,togo,Africa,8639966,10,3095
2020-12-07,togo,Africa,8639966,16,3111
2020-12-08,togo,Africa,8639966,21,3132
2020-12-09,togo,Africa,8639966,19,3151
2020-12-10,togo,Africa,8639966,31,3182
2020-12-11,togo,Africa,8639966,20,3202
2020-12-12,togo,Africa,8639966,19,3221
2020-12-13,togo,Africa,8639966,30,3251
2020-12-14,togo,Africa,8639966,15,3266
2020-12-15,togo,Africa,8639966,29,3295
2020-12-16,togo,Africa,8639966,20,3315
2020-12-17,togo,Africa,8639966,15,3330
2020-12-18,togo,Africa,8639966,20,3350
2020-12-19,togo,Africa,8639966,46,3396
2020-12-20,togo,Africa,8639966,20,3416
2020-12-21,togo,Africa,8639966,20,3436
2020-12-22,togo,Africa,8639966,31,3467
2020-12-23,togo,Africa,8639966,27,3494
2020-12-24,togo,Africa,8639966,26,3520
2020-12-25,togo,Africa,8639966,26,3546
2020-12-26,togo,Africa,8639966,9,3555
2020-12-27,togo,Africa,8639966,0,3555
2020-12-28,togo,Africa,8639966,21,3576
2020-12-29,togo,Africa,8639966,28,3604
2020-12-30,togo,Africa,8639966,7,3611
2020-12-31,togo,Africa,8639966,22,3633
2021-01-01,togo,Africa,8639966,29,3662
2021-01-02,togo,Africa,8639966,21,3683
2021-01-03,togo,Africa,8639966,19,3702
2021-01-04,togo,Africa,8639966,20,3722
2021-01-05,togo,Africa,8639966,48,3770
2021-01-06,togo,Africa,8639966,37,3807
2021-01-07,togo,Africa,8639966,38,3845
2021-01-08,togo,Africa,8639966,49,3894
2021-01-09,togo,Africa,8639966,38,3932
2021-01-10,togo,Africa,8639966,25,3957
2021-01-11,togo,Africa,8639966,21,3978
2021-01-12,togo,Africa,8639966,67,4045
2021-01-13,togo,Africa,8639966,64,4109
2021-01-14,togo,Africa,8639966,56,4165
2021-01-15,togo,Africa,8639966,55,4220
2021-01-16,togo,Africa,8639966,52,4272
2021-01-17,togo,Africa,8639966,30,4302
2021-01-18,togo,Africa,8639966,22,4324
2021-01-19,togo,Africa,8639966,59,4383
2021-01-20,togo,Africa,8639966,76,4459
2021-01-21,togo,Africa,8639966,46,4505
2021-01-22,togo,Africa,8639966,40,4545
2021-01-23,togo,Africa,8639966,91,4636
2021-01-24,togo,Africa,8639966,26,4662
2021-01-25,togo,Africa,8639966,20,4682
2021-01-26,togo,Africa,8639966,83,4765
2021-01-27,togo,Africa,8639966,105,4870
2021-01-28,togo,Africa,8639966,52,4922
2021-01-29,togo,Africa,8639966,53,4975
2021-01-30,togo,Africa,8639966,66,5041
2021-01-31,togo,Africa,8639966,33,5074
2021-02-01,togo,Africa,8639966,18,5092
2021-02-02,togo,Africa,8639966,74,5166
2021-02-03,togo,Africa,8639966,58,5224
2021-02-04,togo,Africa,8639966,66,5290
2021-02-05,togo,Africa,8639966,66,5356
2021-02-06,togo,Africa,8639966,80,5436
2021-02-07,togo,Africa,8639966,47,5483
2021-02-08,togo,Africa,8639966,13,5496
2021-02-09,togo,Africa,8639966,80,5576
2021-02-10,togo,Africa,8639966,30,5606
2021-02-11,togo,Africa,8639966,81,5687
2021-02-12,togo,Africa,8639966,70,5757
2021-02-13,togo,Africa,8639966,66,5823
2021-02-14,togo,Africa,8639966,51,5874
2021-02-15,togo,Africa,8639966,8,5882
2021-02-16,togo,Africa,8639966,71,5953
2021-02-17,togo,Africa,8639966,54,6007
2021-02-18,togo,Africa,8639966,78,6085
2021-02-19,togo,Africa,8639966,97,6182
2021-02-20,togo,Africa,8639966,86,6268
2021-02-21,togo,Africa,8639966,51,6319
2021-02-22,togo,Africa,8639966,29,6348
2021-02-23,togo,Africa,8639966,118,6466
2021-02-24,togo,Africa,8639966,82,6548
2021-02-25,togo,Africa,8639966,89,6637
2021-02-26,togo,Africa,8639966,93,6730
2021-02-27,togo,Africa,8639966,121,6851
2021-02-28,togo,Africa,8639966,50,6901
2021-03-01,togo,Africa,8639966,32,6933
2021-03-02,togo,Africa,8639966,153,7086
2021-03-03,togo,Africa,8639966,102,7188
2021-03-04,togo,Africa,8639966,135,7323
2021-03-05,togo,Africa,8639966,105,7428
2021-03-06,togo,Africa,8639966,93,7521
2021-03-07,togo,Africa,8639966,49,7570
2021-03-08,togo,Africa,8639966,28,7598
2021-03-09,togo,Africa,8639966,82,7680
2021-03-10,togo,Africa,8639966,57,7737
2021-03-11,togo,Africa,8639966,120,7857
2021-03-12,togo,Africa,8639966,96,7953
2021-03-13,togo,Africa,8639966,0,7953
2021-03-14,togo,Africa,8639966,117,8070
2021-03-15,togo,Africa,8639966,152,8222
2021-03-16,togo,Africa,8639966,100,8322
2021-03-17,togo,Africa,8639966,150,8472
2021-03-18,togo,Africa,8639966,110,8582
2021-03-19,togo,Africa,8639966,113,8695
2021-03-20,togo,Africa,8639966,144,8839
2021-03-21,togo,Africa,8639966,79,8918
2021-03-22,togo,Africa,8639966,42,8960
2021-03-23,togo,Africa,8639966,187,9147
2021-03-24,togo,Africa,8639966,0,9147
2021-03-25,togo,Africa,8639966,359,9506
2021-03-26,togo,Africa,8639966,170,9676
2021-03-27,togo,Africa,8639966,0,9676
2021-03-28,togo,Africa,8639966,279,9955
2021-03-29,togo,Africa,8639966,37,9992
2021-03-30,togo,Africa,8639966,257,10249
2021-03-31,togo,Africa,8639966,0,10249
2021-04-01,togo,Africa,8639966,405,10654
2021-04-02,togo,Africa,8639966,194,10848
2021-04-03,togo,Africa,8639966,216,11064
2021-04-04,togo,Africa,8639966,123,11187
2021-04-05,togo,Africa,8639966,62,11249
2021-04-06,togo,Africa,8639966,61,11310
2021-04-07,togo,Africa,8639966,191,11501
2021-04-08,togo,Africa,8639966,148,11649
2021-04-09,togo,Africa,8639966,165,11814
2021-04-10,togo,Africa,8639966,133,11947
2021-04-11,togo,Africa,8639966,59,12006
2021-04-12,togo,Africa,8639966,28,12034
2021-04-13,togo,Africa,8639966,91,12125
2021-04-14,togo,Africa,8639966,89,12214
2021-04-15,togo,Africa,8639966,87,12301
2021-04-16,togo,Africa,8639966,90,12391
2021-04-17,togo,Africa,8639966,105,12496
2021-04-18,togo,Africa,8639966,37,12533
2021-04-19,togo,Africa,8639966,20,12553
2021-04-20,togo,Africa,8639966,57,12610
2021-04-21,togo,Africa,8639966,47,12657
2021-04-22,togo,Africa,8639966,41,12698
2021-04-23,togo,Africa,8639966,44,12742
2021-04-24,togo,Africa,8639966,45,12787
2021-04-25,togo,Africa,8639966,27,12814
2021-04-26,togo,Africa,8639966,13,12827
2021-04-27,togo,Africa,8639966,57,12884
2021-04-28,togo,Africa,8639966,14,12898
2021-04-29,togo,Africa,8639966,33,12931
2021-04-30,togo,Africa,8639966,36,12967
2021-05-01,togo,Africa,8639966,25,12992
2021-05-02,togo,Africa,8639966,18,13010
2021-05-03,togo,Africa,8639966,7,13017
2021-05-04,togo,Africa,8639966,20,13037
2021-05-05,togo,Africa,8639966,31,13068
2021-05-06,togo,Africa,8639966,22,13090
2021-05-07,togo,Africa,8639966,16,13106
2021-05-08,togo,Africa,8639966,0,13106
2021-05-09,togo,Africa,8639966,48,13154
2021-05-10,togo,Africa,8639966,13,13167
2021-05-11,togo,Africa,8639966,0,13167
2021-05-12,togo,Africa,8639966,43,13210
2021-05-13,togo,Africa,8639966,28,13238
2021-05-14,togo,Africa,8639966,6,13244
2021-05-15,togo,Africa,8639966,21,13265
2021-05-16,togo,Africa,8639966,10,13275
2021-05-17,togo,Africa,8639966,4,13279
2021-05-18,togo,Africa,8639966,7,13286
2021-05-19,togo,Africa,8639966,13,13299
2021-05-20,togo,Africa,8639966,41,13340
2021-05-21,togo,Africa,8639966,12,13352
2021-05-22,togo,Africa,8639966,11,13363
2021-05-23,togo,Africa,8639966,11,13374
2021-05-24,togo,Africa,8639966,0,13374
2021-05-25,togo,Africa,8639966,10,13384
2021-05-26,togo,Africa,8639966,12,13396
2021-05-27,togo,Africa,8639966,24,13420
2021-05-28,togo,Africa,8639966,12,13432
2021-05-29,togo,Africa,8639966,0,13432
2021-05-30,togo,Africa,8639966,25,13457
2021-05-31,togo,Africa,8639966,9,13466
2021-06-01,togo,Africa,8639966,15,13481
2021-06-02,togo,Africa,8639966,15,13496
2021-06-03,togo,Africa,8639966,17,13513
2021-06-04,togo,Africa,8639966,9,13522
2021-06-05,togo,Africa,8639966,11,13533
2021-06-06,togo,Africa,8639966,6,13539
2021-06-07,togo,Africa,8639966,3,13542
2021-06-08,togo,Africa,8639966,9,13551
2021-06-09,togo,Africa,8639966,12,13563
2021-06-10,togo,Africa,8639966,13,13576
2021-06-11,togo,Africa,8639966,21,13597
2021-06-12,togo,Africa,8639966,23,13620
2021-06-13,togo,Africa,8639966,7,13627
2021-06-14,togo,Africa,8639966,4,13631
2021-06-15,togo,Africa,8639966,20,13651
2021-06-16,togo,Africa,8639966,18,13669
2021-06-17,togo,Africa,8639966,13,13682
2021-06-18,togo,Africa,8639966,19,13701
2021-06-19,togo,Africa,8639966,14,13715
2021-06-20,togo,Africa,8639966,6,13721
2021-06-21,togo,Africa,8639966,10,13731
2021-06-22,togo,Africa,8639966,4,13735
2021-06-23,togo,Africa,8639966,14,13749
2021-06-24,togo,Africa,8639966,0,13749
2021-06-25,togo,Africa,8639966,39,13788
2021-06-26,togo,Africa,8639966,0,13788
2021-06-27,togo,Africa,8639966,28,13816
2021-06-28,togo,Africa,8639966,30,13846
2021-06-29,togo,Africa,8639966,35,13881
2021-06-30,togo,Africa,8639966,36,13917
2021-07-01,togo,Africa,8639966,45,13962
2021-07-02,togo,Africa,8639966,37,13999
2021-07-03,togo,Africa,8639966,40,14039
2021-07-04,togo,Africa,8639966,30,14069
2021-07-05,togo,Africa,8639966,13,14082
2021-07-06,togo,Africa,8639966,23,14105
2021-07-07,togo,Africa,8639966,35,14140
2021-07-08,togo,Africa,8639966,36,14176
2021-07-09,togo,Africa,8639966,0,14176
2021-07-10,togo,Africa,8639966,56,14232
2021-07-11,togo,Africa,8639966,38,14270
2021-07-12,togo,Africa,8639966,8,14278
2021-07-13,togo,Africa,8639966,42,14320
2021-07-14,togo,Africa,8639966,57,14377
2021-07-15,togo,Africa,8639966,49,14426
2021-07-16,togo,Africa,8639966,85,14511
2021-07-17,togo,Africa,8639966,91,14602
2021-07-18,togo,Africa,8639966,47,14649
2021-07-19,togo,Africa,8639966,31,14680
2021-07-20,togo,Africa,8639966,89,14769
2021-07-21,togo,Africa,8639966,32,14801
2021-07-22,togo,Africa,8639966,0,14801
2021-07-23,togo,Africa,8639966,169,14970
2021-07-24,togo,Africa,8639966,102,15072
2021-07-25,togo,Africa,8639966,77,15149
2021-07-26,togo,Africa,8639966,27,15176
2021-07-27,togo,Africa,8639966,116,15292
2021-07-28,togo,Africa,8639966,101,15393
2021-07-29,togo,Africa,8639966,129,15522
2021-07-30,togo,Africa,8639966,102,15624
2021-07-31,togo,Africa,8639966,174,15798
2021-08-01,togo,Africa,8639966,72,15870
2021-08-02,togo,Africa,8639966,54,15924
2021-08-03,togo,Africa,8639966,129,16053
2021-08-04,togo,Africa,8639966,179,16232
2021-08-05,togo,Africa,8639966,169,16401
2021-08-06,togo,Africa,8639966,158,16559
2021-08-07,togo,Africa,8639966,169,16728
2021-08-08,togo,Africa,8639966,146,16874
2021-08-09,togo,Africa,8639966,72,16946
2021-08-10,togo,Africa,8639966,158,17104
2021-08-11,togo,Africa,8639966,135,17239
2021-08-12,togo,Africa,8639966,195,17434
2021-08-13,togo,Africa,8639966,147,17581
2021-08-14,togo,Africa,8639966,0,17581
2020-03-26,trinidad_and_tobago,North America,1407928,5,65
2020-03-27,trinidad_and_tobago,North America,1407928,1,66
2020-03-28,trinidad_and_tobago,North America,1407928,10,76
2020-03-29,trinidad_and_tobago,North America,1407928,2,78
2020-03-30,trinidad_and_tobago,North America,1407928,5,83
2020-03-31,trinidad_and_tobago,North America,1407928,4,87
2020-04-01,trinidad_and_tobago,North America,1407928,3,90
2020-04-02,trinidad_and_tobago,North America,1407928,4,94
2020-04-03,trinidad_and_tobago,North America,1407928,4,98
2020-04-04,trinidad_and_tobago,North America,1407928,5,103
2020-04-05,trinidad_and_tobago,North America,1407928,1,104
2020-04-06,trinidad_and_tobago,North America,1407928,1,105
2020-04-07,trinidad_and_tobago,North America,1407928,2,107
2020-04-08,trinidad_and_tobago,North America,1407928,0,107
2020-04-09,trinidad_and_tobago,North America,1407928,2,109
2020-04-10,trinidad_and_tobago,North America,1407928,0,109
2020-04-11,trinidad_and_tobago,North America,1407928,3,112
2020-04-12,trinidad_and_tobago,North America,1407928,1,113
2020-04-13,trinidad_and_tobago,North America,1407928,0,113
2020-04-14,trinidad_and_tobago,North America,1407928,0,113
2020-04-15,trinidad_and_tobago,North America,1407928,1,114
2020-04-16,trinidad_and_tobago,North America,1407928,0,114
2020-04-17,trinidad_and_tobago,North America,1407928,0,114
2020-04-18,trinidad_and_tobago,North America,1407928,0,114
2020-04-19,trinidad_and_tobago,North America,1407928,0,114
2020-04-20,trinidad_and_tobago,North America,1407928,0,114
2020-04-21,trinidad_and_tobago,North America,1407928,1,115
2020-04-22,trinidad_and_tobago,North America,1407928,0,115
2020-04-23,trinidad_and_tobago,North America,1407928,0,115
2020-04-24,trinidad_and_tobago,North America,1407928,0,115
2020-04-25,trinidad_and_tobago,North America,1407928,0,115
2020-04-26,trinidad_and_tobago,North America,1407928,0,115
2020-04-27,trinidad_and_tobago,North America,1407928,1,116
2020-04-28,trinidad_and_tobago,North America,1407928,0,116
2020-04-29,trinidad_and_tobago,North America,1407928,0,116
2020-04-30,trinidad_and_tobago,North America,1407928,0,116
2020-05-01,trinidad_and_tobago,North America,1407928,0,116
2020-05-02,trinidad_and_tobago,North America,1407928,0,116
2020-05-03,trinidad_and_tobago,North America,1407928,0,116
2020-05-04,trinidad_and_tobago,North America,1407928,0,116
2020-05-05,trinidad_and_tobago,North America,1407928,0,116
2020-05-06,trinidad_and_tobago,North America,1407928,0,116
2020-05-07,trinidad_and_tobago,North America,1407928,0,116
2020-05-08,trinidad_and_tobago,North America,1407928,0,116
2020-05-09,trinidad_and_tobago,North America,1407928,0,116
2020-05-10,trinidad_and_tobago,North America,1407928,0,116
2020-05-11,trinidad_and_tobago,North America,1407928,0,116
2020-05-12,trinidad_and_tobago,North America,1407928,0,116
2020-05-13,trinidad_and_tobago,North America,1407928,0,116
2020-05-14,trinidad_and_tobago,North America,1407928,0,116
2020-05-15,trinidad_and_tobago,North America,1407928,0,116
2020-05-16,trinidad_and_tobago,North America,1407928,0,116
2020-05-17,trinidad_and_tobago,North America,1407928,0,116
2020-05-18,trinidad_and_tobago,North America,1407928,0,116
2020-05-19,trinidad_and_tobago,North America,1407928,0,116
2020-05-20,trinidad_and_tobago,North America,1407928,0,116
2020-05-21,trinidad_and_tobago,North America,1407928,0,116
2020-05-22,trinidad_and_tobago,North America,1407928,0,116
2020-05-23,trinidad_and_tobago,North America,1407928,0,116
2020-05-24,trinidad_and_tobago,North America,1407928,0,116
2020-05-25,trinidad_and_tobago,North America,1407928,0,116
2020-05-26,trinidad_and_tobago,North America,1407928,0,116
2020-05-27,trinidad_and_tobago,North America,1407928,0,116
2020-05-28,trinidad_and_tobago,North America,1407928,0,116
2020-05-29,trinidad_and_tobago,North America,1407928,0,116
2020-05-30,trinidad_and_tobago,North America,1407928,0,116
2020-05-31,trinidad_and_tobago,North America,1407928,1,117
2020-06-01,trinidad_and_tobago,North America,1407928,0,117
2020-06-02,trinidad_and_tobago,North America,1407928,0,117
2020-06-03,trinidad_and_tobago,North America,1407928,0,117
2020-06-04,trinidad_and_tobago,North America,1407928,0,117
2020-06-05,trinidad_and_tobago,North America,1407928,0,117
2020-06-06,trinidad_and_tobago,North America,1407928,0,117
2020-06-07,trinidad_and_tobago,North America,1407928,0,117
2020-06-08,trinidad_and_tobago,North America,1407928,0,117
2020-06-09,trinidad_and_tobago,North America,1407928,0,117
2020-06-10,trinidad_and_tobago,North America,1407928,0,117
2020-06-11,trinidad_and_tobago,North America,1407928,0,117
2020-06-12,trinidad_and_tobago,North America,1407928,0,117
2020-06-13,trinidad_and_tobago,North America,1407928,0,117
2020-06-14,trinidad_and_tobago,North America,1407928,6,123
2020-06-15,trinidad_and_tobago,North America,1407928,0,123
2020-06-16,trinidad_and_tobago,North America,1407928,0,123
2020-06-17,trinidad_and_tobago,North America,1407928,0,123
2020-06-18,trinidad_and_tobago,North America,1407928,0,123
2020-06-19,trinidad_and_tobago,North America,1407928,0,123
2020-06-20,trinidad_and_tobago,North America,1407928,0,123
2020-06-21,trinidad_and_tobago,North America,1407928,0,123
2020-06-22,trinidad_and_tobago,North America,1407928,0,123
2020-06-23,trinidad_and_tobago,North America,1407928,0,123
2020-06-24,trinidad_and_tobago,North America,1407928,0,123
2020-06-25,trinidad_and_tobago,North America,1407928,0,123
2020-06-26,trinidad_and_tobago,North America,1407928,1,124
2020-06-27,trinidad_and_tobago,North America,1407928,2,126
2020-06-28,trinidad_and_tobago,North America,1407928,0,126
2020-06-29,trinidad_and_tobago,North America,1407928,0,126
2020-06-30,trinidad_and_tobago,North America,1407928,4,130
2020-07-01,trinidad_and_tobago,North America,1407928,0,130
2020-07-02,trinidad_and_tobago,North America,1407928,0,130
2020-07-03,trinidad_and_tobago,North America,1407928,0,130
2020-07-04,trinidad_and_tobago,North America,1407928,0,130
2020-07-05,trinidad_and_tobago,North America,1407928,3,133
2020-07-06,trinidad_and_tobago,North America,1407928,0,133
2020-07-07,trinidad_and_tobago,North America,1407928,0,133
2020-07-08,trinidad_and_tobago,North America,1407928,0,133
2020-07-09,trinidad_and_tobago,North America,1407928,0,133
2020-07-10,trinidad_and_tobago,North America,1407928,0,133
2020-07-11,trinidad_and_tobago,North America,1407928,0,133
2020-07-12,trinidad_and_tobago,North America,1407928,0,133
2020-07-13,trinidad_and_tobago,North America,1407928,0,133
2020-07-14,trinidad_and_tobago,North America,1407928,0,133
2020-07-15,trinidad_and_tobago,North America,1407928,0,133
2020-07-16,trinidad_and_tobago,North America,1407928,0,133
2020-07-17,trinidad_and_tobago,North America,1407928,3,136
2020-07-18,trinidad_and_tobago,North America,1407928,1,137
2020-07-19,trinidad_and_tobago,North America,1407928,0,137
2020-07-20,trinidad_and_tobago,North America,1407928,0,137
2020-07-21,trinidad_and_tobago,North America,1407928,2,139
2020-07-22,trinidad_and_tobago,North America,1407928,2,141
2020-07-23,trinidad_and_tobago,North America,1407928,0,141
2020-07-24,trinidad_and_tobago,North America,1407928,1,142
2020-07-25,trinidad_and_tobago,North America,1407928,5,147
2020-07-26,trinidad_and_tobago,North America,1407928,0,147
2020-07-27,trinidad_and_tobago,North America,1407928,1,148
2020-07-28,trinidad_and_tobago,North America,1407928,5,153
2020-07-29,trinidad_and_tobago,North America,1407928,3,156
2020-07-30,trinidad_and_tobago,North America,1407928,8,164
2020-07-31,trinidad_and_tobago,North America,1407928,5,169
2020-08-01,trinidad_and_tobago,North America,1407928,4,173
2020-08-02,trinidad_and_tobago,North America,1407928,9,182
2020-08-03,trinidad_and_tobago,North America,1407928,0,182
2020-08-04,trinidad_and_tobago,North America,1407928,12,194
2020-08-05,trinidad_and_tobago,North America,1407928,5,199
2020-08-06,trinidad_and_tobago,North America,1407928,11,210
2020-08-07,trinidad_and_tobago,North America,1407928,15,225
2020-08-08,trinidad_and_tobago,North America,1407928,50,275
2020-08-09,trinidad_and_tobago,North America,1407928,4,279
2020-08-10,trinidad_and_tobago,North America,1407928,2,281
2020-08-11,trinidad_and_tobago,North America,1407928,19,300
2020-08-12,trinidad_and_tobago,North America,1407928,26,326
2020-08-13,trinidad_and_tobago,North America,1407928,78,404
2020-08-14,trinidad_and_tobago,North America,1407928,22,426
2020-08-15,trinidad_and_tobago,North America,1407928,71,497
2020-08-16,trinidad_and_tobago,North America,1407928,55,552
2020-08-17,trinidad_and_tobago,North America,1407928,36,588
2020-08-18,trinidad_and_tobago,North America,1407928,41,629
2020-08-19,trinidad_and_tobago,North America,1407928,57,686
2020-08-20,trinidad_and_tobago,North America,1407928,81,767
2020-08-21,trinidad_and_tobago,North America,1407928,97,864
2020-08-22,trinidad_and_tobago,North America,1407928,66,930
2020-08-23,trinidad_and_tobago,North America,1407928,77,1007
2020-08-24,trinidad_and_tobago,North America,1407928,92,1099
2020-08-25,trinidad_and_tobago,North America,1407928,153,1252
2020-08-26,trinidad_and_tobago,North America,1407928,159,1411
2020-08-27,trinidad_and_tobago,North America,1407928,65,1476
2020-08-28,trinidad_and_tobago,North America,1407928,78,1554
2020-08-29,trinidad_and_tobago,North America,1407928,91,1645
2020-08-30,trinidad_and_tobago,North America,1407928,38,1683
2020-08-31,trinidad_and_tobago,North America,1407928,76,1759
2020-09-01,trinidad_and_tobago,North America,1407928,38,1797
2020-09-02,trinidad_and_tobago,North America,1407928,123,1920
2020-09-03,trinidad_and_tobago,North America,1407928,64,1984
2020-09-04,trinidad_and_tobago,North America,1407928,56,2040
2020-09-05,trinidad_and_tobago,North America,1407928,190,2230
2020-09-06,trinidad_and_tobago,North America,1407928,20,2250
2020-09-07,trinidad_and_tobago,North America,1407928,27,2277
2020-09-08,trinidad_and_tobago,North America,1407928,114,2391
2020-09-09,trinidad_and_tobago,North America,1407928,197,2588
2020-09-10,trinidad_and_tobago,North America,1407928,110,2698
2020-09-11,trinidad_and_tobago,North America,1407928,127,2825
2020-09-12,trinidad_and_tobago,North America,1407928,168,2993
2020-09-13,trinidad_and_tobago,North America,1407928,49,3042
2020-09-14,trinidad_and_tobago,North America,1407928,99,3141
2020-09-15,trinidad_and_tobago,North America,1407928,82,3223
2020-09-16,trinidad_and_tobago,North America,1407928,104,3327
2020-09-17,trinidad_and_tobago,North America,1407928,107,3434
2020-09-18,trinidad_and_tobago,North America,1407928,217,3651
2020-09-19,trinidad_and_tobago,North America,1407928,202,3853
2020-09-20,trinidad_and_tobago,North America,1407928,48,3901
2020-09-21,trinidad_and_tobago,North America,1407928,44,3945
2020-09-22,trinidad_and_tobago,North America,1407928,81,4026
2020-09-23,trinidad_and_tobago,North America,1407928,110,4136
2020-09-24,trinidad_and_tobago,North America,1407928,99,4235
2020-09-25,trinidad_and_tobago,North America,1407928,42,4277
2020-09-26,trinidad_and_tobago,North America,1407928,35,4312
2020-09-27,trinidad_and_tobago,North America,1407928,50,4362
2020-09-28,trinidad_and_tobago,North America,1407928,24,4386
2020-09-29,trinidad_and_tobago,North America,1407928,77,4463
2020-09-30,trinidad_and_tobago,North America,1407928,68,4531
2020-10-01,trinidad_and_tobago,North America,1407928,39,4570
2020-10-02,trinidad_and_tobago,North America,1407928,59,4629
2020-10-03,trinidad_and_tobago,North America,1407928,86,4715
2020-10-04,trinidad_and_tobago,North America,1407928,48,4763
2020-10-05,trinidad_and_tobago,North America,1407928,4,4767
2020-10-06,trinidad_and_tobago,North America,1407928,79,4846
2020-10-07,trinidad_and_tobago,North America,1407928,41,4887
2020-10-08,trinidad_and_tobago,North America,1407928,76,4963
2020-10-09,trinidad_and_tobago,North America,1407928,58,5021
2020-10-10,trinidad_and_tobago,North America,1407928,22,5043
2020-10-11,trinidad_and_tobago,North America,1407928,58,5101
2020-10-12,trinidad_and_tobago,North America,1407928,15,5116
2020-10-13,trinidad_and_tobago,North America,1407928,11,5127
2020-10-14,trinidad_and_tobago,North America,1407928,27,5154
2020-10-15,trinidad_and_tobago,North America,1407928,40,5194
2020-10-16,trinidad_and_tobago,North America,1407928,47,5241
2020-10-17,trinidad_and_tobago,North America,1407928,40,5281
2020-10-18,trinidad_and_tobago,North America,1407928,16,5297
2020-10-19,trinidad_and_tobago,North America,1407928,1,5298
2020-10-20,trinidad_and_tobago,North America,1407928,35,5333
2020-10-21,trinidad_and_tobago,North America,1407928,59,5392
2020-10-22,trinidad_and_tobago,North America,1407928,54,5446
2020-10-23,trinidad_and_tobago,North America,1407928,41,5487
2020-10-24,trinidad_and_tobago,North America,1407928,16,5503
2020-10-25,trinidad_and_tobago,North America,1407928,8,5511
2020-10-26,trinidad_and_tobago,North America,1407928,24,5535
2020-10-27,trinidad_and_tobago,North America,1407928,33,5568
2020-10-28,trinidad_and_tobago,North America,1407928,26,5594
2020-10-29,trinidad_and_tobago,North America,1407928,42,5636
2020-10-30,trinidad_and_tobago,North America,1407928,32,5668
2020-10-31,trinidad_and_tobago,North America,1407928,24,5692
2020-11-01,trinidad_and_tobago,North America,1407928,12,5704
2020-11-02,trinidad_and_tobago,North America,1407928,0,5704
2020-11-03,trinidad_and_tobago,North America,1407928,50,5754
2020-11-04,trinidad_and_tobago,North America,1407928,10,5764
2020-11-05,trinidad_and_tobago,North America,1407928,10,5774
2020-11-06,trinidad_and_tobago,North America,1407928,24,5798
2020-11-07,trinidad_and_tobago,North America,1407928,40,5838
2020-11-08,trinidad_and_tobago,North America,1407928,11,5849
2020-11-09,trinidad_and_tobago,North America,1407928,0,5849
2020-11-10,trinidad_and_tobago,North America,1407928,31,5880
2020-11-11,trinidad_and_tobago,North America,1407928,24,5904
2020-11-12,trinidad_and_tobago,North America,1407928,26,5930
2020-11-13,trinidad_and_tobago,North America,1407928,50,5980
2020-11-14,trinidad_and_tobago,North America,1407928,97,6077
2020-11-15,trinidad_and_tobago,North America,1407928,3,6080
2020-11-16,trinidad_and_tobago,North America,1407928,16,6096
2020-11-17,trinidad_and_tobago,North America,1407928,39,6135
2020-11-18,trinidad_and_tobago,North America,1407928,45,6180
2020-11-19,trinidad_and_tobago,North America,1407928,53,6233
2020-11-20,trinidad_and_tobago,North America,1407928,28,6261
2020-11-21,trinidad_and_tobago,North America,1407928,63,6324
2020-11-22,trinidad_and_tobago,North America,1407928,126,6450
2020-11-23,trinidad_and_tobago,North America,1407928,25,6475
2020-11-24,trinidad_and_tobago,North America,1407928,13,6488
2020-11-25,trinidad_and_tobago,North America,1407928,15,6503
2020-11-26,trinidad_and_tobago,North America,1407928,67,6570
2020-11-27,trinidad_and_tobago,North America,1407928,16,6586
2020-11-28,trinidad_and_tobago,North America,1407928,44,6630
2020-11-29,trinidad_and_tobago,North America,1407928,30,6660
2020-11-30,trinidad_and_tobago,North America,1407928,9,6669
2020-12-01,trinidad_and_tobago,North America,1407928,16,6685
2020-12-02,trinidad_and_tobago,North America,1407928,19,6704
2020-12-03,trinidad_and_tobago,North America,1407928,21,6725
2020-12-04,trinidad_and_tobago,North America,1407928,10,6735
2020-12-05,trinidad_and_tobago,North America,1407928,16,6751
2020-12-06,trinidad_and_tobago,North America,1407928,16,6767
2020-12-07,trinidad_and_tobago,North America,1407928,8,6775
2020-12-08,trinidad_and_tobago,North America,1407928,7,6782
2020-12-09,trinidad_and_tobago,North America,1407928,26,6808
2020-12-10,trinidad_and_tobago,North America,1407928,25,6833
2020-12-11,trinidad_and_tobago,North America,1407928,19,6852
2020-12-12,trinidad_and_tobago,North America,1407928,12,6864
2020-12-13,trinidad_and_tobago,North America,1407928,15,6879
2020-12-14,trinidad_and_tobago,North America,1407928,6,6885
2020-12-15,trinidad_and_tobago,North America,1407928,15,6900
2020-12-16,trinidad_and_tobago,North America,1407928,17,6917
2020-12-17,trinidad_and_tobago,North America,1407928,23,6940
2020-12-18,trinidad_and_tobago,North America,1407928,15,6955
2020-12-19,trinidad_and_tobago,North America,1407928,19,6974
2020-12-20,trinidad_and_tobago,North America,1407928,26,7000
2020-12-21,trinidad_and_tobago,North America,1407928,12,7012
2020-12-22,trinidad_and_tobago,North America,1407928,12,7024
2020-12-23,trinidad_and_tobago,North America,1407928,47,7071
2020-12-24,trinidad_and_tobago,North America,1407928,18,7089
2020-12-25,trinidad_and_tobago,North America,1407928,8,7097
2020-12-26,trinidad_and_tobago,North America,1407928,7,7104
2020-12-27,trinidad_and_tobago,North America,1407928,8,7112
2020-12-28,trinidad_and_tobago,North America,1407928,3,7115
2020-12-29,trinidad_and_tobago,North America,1407928,12,7127
2020-12-30,trinidad_and_tobago,North America,1407928,5,7132
2020-12-31,trinidad_and_tobago,North America,1407928,18,7150
2021-01-01,trinidad_and_tobago,North America,1407928,8,7158
2021-01-02,trinidad_and_tobago,North America,1407928,4,7162
2021-01-03,trinidad_and_tobago,North America,1407928,6,7168
2021-01-04,trinidad_and_tobago,North America,1407928,10,7178
2021-01-05,trinidad_and_tobago,North America,1407928,8,7186
2021-01-06,trinidad_and_tobago,North America,1407928,10,7196
2021-01-07,trinidad_and_tobago,North America,1407928,14,7210
2021-01-08,trinidad_and_tobago,North America,1407928,9,7219
2021-01-09,trinidad_and_tobago,North America,1407928,25,7244
2021-01-10,trinidad_and_tobago,North America,1407928,21,7265
2021-01-11,trinidad_and_tobago,North America,1407928,8,7273
2021-01-12,trinidad_and_tobago,North America,1407928,13,7286
2021-01-13,trinidad_and_tobago,North America,1407928,19,7305
2021-01-14,trinidad_and_tobago,North America,1407928,15,7320
2021-01-15,trinidad_and_tobago,North America,1407928,23,7343
2021-01-16,trinidad_and_tobago,North America,1407928,27,7370
2021-01-17,trinidad_and_tobago,North America,1407928,23,7393
2021-01-18,trinidad_and_tobago,North America,1407928,6,7399
2021-01-19,trinidad_and_tobago,North America,1407928,16,7415
2021-01-20,trinidad_and_tobago,North America,1407928,15,7430
2021-01-21,trinidad_and_tobago,North America,1407928,20,7450
2021-01-22,trinidad_and_tobago,North America,1407928,6,7456
2021-01-23,trinidad_and_tobago,North America,1407928,6,7462
2021-01-24,trinidad_and_tobago,North America,1407928,11,7473
2021-01-25,trinidad_and_tobago,North America,1407928,17,7490
2021-01-26,trinidad_and_tobago,North America,1407928,6,7496
2021-01-27,trinidad_and_tobago,North America,1407928,13,7509
2021-01-28,trinidad_and_tobago,North America,1407928,11,7520
2021-01-29,trinidad_and_tobago,North America,1407928,13,7533
2021-01-30,trinidad_and_tobago,North America,1407928,9,7542
2021-01-31,trinidad_and_tobago,North America,1407928,22,7564
2021-02-01,trinidad_and_tobago,North America,1407928,2,7566
2021-02-02,trinidad_and_tobago,North America,1407928,12,7578
2021-02-03,trinidad_and_tobago,North America,1407928,8,7586
2021-02-04,trinidad_and_tobago,North America,1407928,21,7607
2021-02-05,trinidad_and_tobago,North America,1407928,0,7607
2021-02-06,trinidad_and_tobago,North America,1407928,5,7612
2021-02-07,trinidad_and_tobago,North America,1407928,4,7616
2021-02-08,trinidad_and_tobago,North America,1407928,0,7616
2021-02-09,trinidad_and_tobago,North America,1407928,1,7617
2021-02-10,trinidad_and_tobago,North America,1407928,14,7631
2021-02-11,trinidad_and_tobago,North America,1407928,1,7632
2021-02-12,trinidad_and_tobago,North America,1407928,5,7637
2021-02-13,trinidad_and_tobago,North America,1407928,5,7642
2021-02-14,trinidad_and_tobago,North America,1407928,0,7642
2021-02-15,trinidad_and_tobago,North America,1407928,4,7646
2021-02-16,trinidad_and_tobago,North America,1407928,10,7656
2021-02-17,trinidad_and_tobago,North America,1407928,7,7663
2021-02-18,trinidad_and_tobago,North America,1407928,3,7666
2021-02-19,trinidad_and_tobago,North America,1407928,0,7666
2021-02-20,trinidad_and_tobago,North America,1407928,10,7676
2021-02-21,trinidad_and_tobago,North America,1407928,4,7680
2021-02-22,trinidad_and_tobago,North America,1407928,2,7682
2021-02-23,trinidad_and_tobago,North America,1407928,4,7686
2021-02-24,trinidad_and_tobago,North America,1407928,4,7690
2021-02-25,trinidad_and_tobago,North America,1407928,7,7697
2021-02-26,trinidad_and_tobago,North America,1407928,7,7704
2021-02-27,trinidad_and_tobago,North America,1407928,1,7705
2021-02-28,trinidad_and_tobago,North America,1407928,8,7713
2021-03-01,trinidad_and_tobago,North America,1407928,3,7716
2021-03-02,trinidad_and_tobago,North America,1407928,1,7717
2021-03-03,trinidad_and_tobago,North America,1407928,6,7723
2021-03-04,trinidad_and_tobago,North America,1407928,4,7727
2021-03-05,trinidad_and_tobago,North America,1407928,2,7729
2021-03-06,trinidad_and_tobago,North America,1407928,3,7732
2021-03-07,trinidad_and_tobago,North America,1407928,4,7736
2021-03-08,trinidad_and_tobago,North America,1407928,0,7736
2021-03-09,trinidad_and_tobago,North America,1407928,0,7736
2021-03-10,trinidad_and_tobago,North America,1407928,7,7743
2021-03-11,trinidad_and_tobago,North America,1407928,10,7753
2021-03-12,trinidad_and_tobago,North America,1407928,6,7759
2021-03-13,trinidad_and_tobago,North America,1407928,10,7769
2021-03-14,trinidad_and_tobago,North America,1407928,14,7783
2021-03-15,trinidad_and_tobago,North America,1407928,5,7788
2021-03-16,trinidad_and_tobago,North America,1407928,2,7790
2021-03-17,trinidad_and_tobago,North America,1407928,17,7807
2021-03-18,trinidad_and_tobago,North America,1407928,5,7812
2021-03-19,trinidad_and_tobago,North America,1407928,9,7821
2021-03-20,trinidad_and_tobago,North America,1407928,18,7839
2021-03-21,trinidad_and_tobago,North America,1407928,16,7855
2021-03-22,trinidad_and_tobago,North America,1407928,6,7861
2021-03-23,trinidad_and_tobago,North America,1407928,4,7865
2021-03-24,trinidad_and_tobago,North America,1407928,38,7903
2021-03-25,trinidad_and_tobago,North America,1407928,21,7924
2021-03-26,trinidad_and_tobago,North America,1407928,15,7939
2021-03-27,trinidad_and_tobago,North America,1407928,15,7954
2021-03-28,trinidad_and_tobago,North America,1407928,23,7977
2021-03-29,trinidad_and_tobago,North America,1407928,9,7986
2021-03-30,trinidad_and_tobago,North America,1407928,18,8004
2021-03-31,trinidad_and_tobago,North America,1407928,22,8026
2021-04-01,trinidad_and_tobago,North America,1407928,46,8072
2021-04-02,trinidad_and_tobago,North America,1407928,44,8116
2021-04-03,trinidad_and_tobago,North America,1407928,20,8136
2021-04-04,trinidad_and_tobago,North America,1407928,42,8178
2021-04-05,trinidad_and_tobago,North America,1407928,14,8192
2021-04-06,trinidad_and_tobago,North America,1407928,22,8214
2021-04-07,trinidad_and_tobago,North America,1407928,21,8235
2021-04-08,trinidad_and_tobago,North America,1407928,41,8276
2021-04-09,trinidad_and_tobago,North America,1407928,47,8323
2021-04-10,trinidad_and_tobago,North America,1407928,59,8382
2021-04-11,trinidad_and_tobago,North America,1407928,22,8404
2021-04-12,trinidad_and_tobago,North America,1407928,37,8441
2021-04-13,trinidad_and_tobago,North America,1407928,70,8511
2021-04-14,trinidad_and_tobago,North America,1407928,85,8596
2021-04-15,trinidad_and_tobago,North America,1407928,82,8678
2021-04-16,trinidad_and_tobago,North America,1407928,0,8678
2021-04-17,trinidad_and_tobago,North America,1407928,128,8806
2021-04-18,trinidad_and_tobago,North America,1407928,134,8940
2021-04-19,trinidad_and_tobago,North America,1407928,24,8964
2021-04-20,trinidad_and_tobago,North America,1407928,171,9135
2021-04-21,trinidad_and_tobago,North America,1407928,81,9216
2021-04-22,trinidad_and_tobago,North America,1407928,167,9383
2021-04-23,trinidad_and_tobago,North America,1407928,0,9383
2021-04-24,trinidad_and_tobago,North America,1407928,104,9487
2021-04-25,trinidad_and_tobago,North America,1407928,189,9676
2021-04-26,trinidad_and_tobago,North America,1407928,120,9796
2021-04-27,trinidad_and_tobago,North America,1407928,151,9947
2021-04-28,trinidad_and_tobago,North America,1407928,223,10170
2021-04-29,trinidad_and_tobago,North America,1407928,328,10498
2021-04-30,trinidad_and_tobago,North America,1407928,326,10824
2021-05-01,trinidad_and_tobago,North America,1407928,248,11072
2021-05-02,trinidad_and_tobago,North America,1407928,241,11313
2021-05-03,trinidad_and_tobago,North America,1407928,158,11471
2021-05-04,trinidad_and_tobago,North America,1407928,235,11706
2021-05-05,trinidad_and_tobago,North America,1407928,399,12105
2021-05-06,trinidad_and_tobago,North America,1407928,291,12396
2021-05-07,trinidad_and_tobago,North America,1407928,324,12720
2021-05-08,trinidad_and_tobago,North America,1407928,402,13122
2021-05-09,trinidad_and_tobago,North America,1407928,233,13355
2021-05-10,trinidad_and_tobago,North America,1407928,99,13454
2021-05-11,trinidad_and_tobago,North America,1407928,348,13802
2021-05-12,trinidad_and_tobago,North America,1407928,615,14417
2021-05-13,trinidad_and_tobago,North America,1407928,397,14814
2021-05-14,trinidad_and_tobago,North America,1407928,565,15379
2021-05-15,trinidad_and_tobago,North America,1407928,520,15899
2021-05-16,trinidad_and_tobago,North America,1407928,356,16255
2021-05-17,trinidad_and_tobago,North America,1407928,294,16549
2021-05-18,trinidad_and_tobago,North America,1407928,601,17150
2021-05-19,trinidad_and_tobago,North America,1407928,519,17669
2021-05-20,trinidad_and_tobago,North America,1407928,558,18227
2021-05-21,trinidad_and_tobago,North America,1407928,708,18935
2021-05-22,trinidad_and_tobago,North America,1407928,509,19444
2021-05-23,trinidad_and_tobago,North America,1407928,573,20017
2021-05-24,trinidad_and_tobago,North America,1407928,250,20267
2021-05-25,trinidad_and_tobago,North America,1407928,612,20879
2021-05-26,trinidad_and_tobago,North America,1407928,582,21461
2021-05-27,trinidad_and_tobago,North America,1407928,526,21987
2021-05-28,trinidad_and_tobago,North America,1407928,633,22620
2021-05-29,trinidad_and_tobago,North America,1407928,381,23001
2021-05-30,trinidad_and_tobago,North America,1407928,637,23638
2021-05-31,trinidad_and_tobago,North America,1407928,271,23909
2021-06-01,trinidad_and_tobago,North America,1407928,405,24314
2021-06-02,trinidad_and_tobago,North America,1407928,412,24726
2021-06-03,trinidad_and_tobago,North America,1407928,546,25272
2021-06-04,trinidad_and_tobago,North America,1407928,529,25801
2021-06-05,trinidad_and_tobago,North America,1407928,391,26192
2021-06-06,trinidad_and_tobago,North America,1407928,218,26410
2021-06-07,trinidad_and_tobago,North America,1407928,389,26799
2021-06-08,trinidad_and_tobago,North America,1407928,280,27079
2021-06-09,trinidad_and_tobago,North America,1407928,454,27533
2021-06-10,trinidad_and_tobago,North America,1407928,273,27806
2021-06-11,trinidad_and_tobago,North America,1407928,300,28106
2021-06-12,trinidad_and_tobago,North America,1407928,316,28422
2021-06-13,trinidad_and_tobago,North America,1407928,301,28723
2021-06-14,trinidad_and_tobago,North America,1407928,259,28982
2021-06-15,trinidad_and_tobago,North America,1407928,327,29309
2021-06-16,trinidad_and_tobago,North America,1407928,297,29606
2021-06-17,trinidad_and_tobago,North America,1407928,350,29956
2021-06-18,trinidad_and_tobago,North America,1407928,227,30183
2021-06-19,trinidad_and_tobago,North America,1407928,330,30513
2021-06-20,trinidad_and_tobago,North America,1407928,106,30619
2021-06-21,trinidad_and_tobago,North America,1407928,148,30767
2021-06-22,trinidad_and_tobago,North America,1407928,215,30982
2021-06-23,trinidad_and_tobago,North America,1407928,225,31207
2021-06-24,trinidad_and_tobago,North America,1407928,222,31429
2021-06-25,trinidad_and_tobago,North America,1407928,346,31775
2021-06-26,trinidad_and_tobago,North America,1407928,294,32069
2021-06-27,trinidad_and_tobago,North America,1407928,129,32198
2021-06-28,trinidad_and_tobago,North America,1407928,145,32343
2021-06-29,trinidad_and_tobago,North America,1407928,185,32528
2021-06-30,trinidad_and_tobago,North America,1407928,265,32793
2021-07-01,trinidad_and_tobago,North America,1407928,236,33029
2021-07-02,trinidad_and_tobago,North America,1407928,124,33153
2021-07-03,trinidad_and_tobago,North America,1407928,160,33313
2021-07-04,trinidad_and_tobago,North America,1407928,115,33428
2021-07-05,trinidad_and_tobago,North America,1407928,127,33555
2021-07-06,trinidad_and_tobago,North America,1407928,250,33805
2021-07-07,trinidad_and_tobago,North America,1407928,115,33920
2021-07-08,trinidad_and_tobago,North America,1407928,321,34241
2021-07-09,trinidad_and_tobago,North America,1407928,161,34402
2021-07-10,trinidad_and_tobago,North America,1407928,175,34577
2021-07-11,trinidad_and_tobago,North America,1407928,188,34765
2021-07-12,trinidad_and_tobago,North America,1407928,57,34822
2021-07-13,trinidad_and_tobago,North America,1407928,224,35046
2021-07-14,trinidad_and_tobago,North America,1407928,190,35236
2021-07-15,trinidad_and_tobago,North America,1407928,192,35428
2021-07-16,trinidad_and_tobago,North America,1407928,251,35679
2021-07-17,trinidad_and_tobago,North America,1407928,235,35914
2021-07-18,trinidad_and_tobago,North America,1407928,103,36017
2021-07-19,trinidad_and_tobago,North America,1407928,181,36198
2021-07-20,trinidad_and_tobago,North America,1407928,156,36354
2021-07-21,trinidad_and_tobago,North America,1407928,272,36626
2021-07-22,trinidad_and_tobago,North America,1407928,258,36884
2021-07-23,trinidad_and_tobago,North America,1407928,181,37065
2021-07-24,trinidad_and_tobago,North America,1407928,300,37365
2021-07-25,trinidad_and_tobago,North America,1407928,189,37554
2021-07-26,trinidad_and_tobago,North America,1407928,109,37663
2021-07-27,trinidad_and_tobago,North America,1407928,108,37771
2021-07-28,trinidad_and_tobago,North America,1407928,243,38014
2021-07-29,trinidad_and_tobago,North America,1407928,233,38247
2021-07-30,trinidad_and_tobago,North America,1407928,310,38557
2021-07-31,trinidad_and_tobago,North America,1407928,254,38811
2021-08-01,trinidad_and_tobago,North America,1407928,119,38930
2021-08-02,trinidad_and_tobago,North America,1407928,109,39039
2021-08-03,trinidad_and_tobago,North America,1407928,123,39162
2021-08-04,trinidad_and_tobago,North America,1407928,183,39345
2021-08-05,trinidad_and_tobago,North America,1407928,232,39577
2021-08-06,trinidad_and_tobago,North America,1407928,258,39835
2021-08-07,trinidad_and_tobago,North America,1407928,269,40104
2021-08-08,trinidad_and_tobago,North America,1407928,129,40233
2021-08-09,trinidad_and_tobago,North America,1407928,128,40361
2021-08-10,trinidad_and_tobago,North America,1407928,213,40574
2021-08-11,trinidad_and_tobago,North America,1407928,315,40889
2021-08-12,trinidad_and_tobago,North America,1407928,318,41207
2021-08-13,trinidad_and_tobago,North America,1407928,321,41528
2021-08-14,trinidad_and_tobago,North America,1407928,148,41676
2021-08-15,trinidad_and_tobago,North America,1407928,190,41866
2021-08-16,trinidad_and_tobago,North America,1407928,89,41955
2021-08-17,trinidad_and_tobago,North America,1407928,278,42233
2021-08-18,trinidad_and_tobago,North America,1407928,194,42427
2021-08-19,trinidad_and_tobago,North America,1407928,155,42582
2021-08-20,trinidad_and_tobago,North America,1407928,257,42839
2021-08-21,trinidad_and_tobago,North America,1407928,123,42962
2021-08-22,trinidad_and_tobago,North America,1407928,71,43033
2021-08-23,trinidad_and_tobago,North America,1407928,112,43145
2021-08-24,trinidad_and_tobago,North America,1407928,199,43344
2021-08-25,trinidad_and_tobago,North America,1407928,194,43538
2021-08-26,trinidad_and_tobago,North America,1407928,212,43750
2021-08-27,trinidad_and_tobago,North America,1407928,249,43999
2021-08-28,trinidad_and_tobago,North America,1407928,297,44296
2021-08-29,trinidad_and_tobago,North America,1407928,185,44481
2021-08-30,trinidad_and_tobago,North America,1407928,125,44606
2021-08-31,trinidad_and_tobago,North America,1407928,241,44847
2021-09-01,trinidad_and_tobago,North America,1407928,110,44957
2021-09-02,trinidad_and_tobago,North America,1407928,104,45061
2021-09-03,trinidad_and_tobago,North America,1407928,239,45300
2021-09-04,trinidad_and_tobago,North America,1407928,187,45487
2021-09-05,trinidad_and_tobago,North America,1407928,227,45714
2021-09-06,trinidad_and_tobago,North America,1407928,110,45824
2021-09-07,trinidad_and_tobago,North America,1407928,189,46013
2021-09-08,trinidad_and_tobago,North America,1407928,270,46283
2021-09-09,trinidad_and_tobago,North America,1407928,270,46553
2021-09-10,trinidad_and_tobago,North America,1407928,182,46735
2021-09-11,trinidad_and_tobago,North America,1407928,260,46995
2021-09-12,trinidad_and_tobago,North America,1407928,135,47130
2021-09-13,trinidad_and_tobago,North America,1407928,78,47208
2021-09-14,trinidad_and_tobago,North America,1407928,155,47363
2021-09-15,trinidad_and_tobago,North America,1407928,290,47653
2021-09-16,trinidad_and_tobago,North America,1407928,272,47925
2021-09-17,trinidad_and_tobago,North America,1407928,218,48143
2021-09-18,trinidad_and_tobago,North America,1407928,257,48400
2021-09-19,trinidad_and_tobago,North America,1407928,123,48523
2021-09-20,trinidad_and_tobago,North America,1407928,106,48629
2021-09-21,trinidad_and_tobago,North America,1407928,197,48826
2021-09-22,trinidad_and_tobago,North America,1407928,285,49111
2021-09-23,trinidad_and_tobago,North America,1407928,331,49442
2021-09-24,trinidad_and_tobago,North America,1407928,246,49688
2021-09-25,trinidad_and_tobago,North America,1407928,134,49822
2021-09-26,trinidad_and_tobago,North America,1407928,127,49949
2021-09-27,trinidad_and_tobago,North America,1407928,106,50055
2021-09-28,trinidad_and_tobago,North America,1407928,174,50229
2021-09-29,trinidad_and_tobago,North America,1407928,230,50459
2021-09-30,trinidad_and_tobago,North America,1407928,250,50709
2021-10-01,trinidad_and_tobago,North America,1407928,194,50903
2021-10-02,trinidad_and_tobago,North America,1407928,181,51084
2021-10-03,trinidad_and_tobago,North America,1407928,159,51243
2021-10-04,trinidad_and_tobago,North America,1407928,144,51387
2021-10-05,trinidad_and_tobago,North America,1407928,218,51605
2021-10-06,trinidad_and_tobago,North America,1407928,208,51813
2021-10-07,trinidad_and_tobago,North America,1407928,266,52079
2021-10-08,trinidad_and_tobago,North America,1407928,184,52263
2021-10-09,trinidad_and_tobago,North America,1407928,217,52480
2021-10-10,trinidad_and_tobago,North America,1407928,248,52728
2021-10-11,trinidad_and_tobago,North America,1407928,119,52847
2021-10-12,trinidad_and_tobago,North America,1407928,152,52999
2021-10-13,trinidad_and_tobago,North America,1407928,217,53216
2021-10-14,trinidad_and_tobago,North America,1407928,176,53392
2021-10-15,trinidad_and_tobago,North America,1407928,297,53689
2021-10-16,trinidad_and_tobago,North America,1407928,198,53887
2021-10-17,trinidad_and_tobago,North America,1407928,227,54114
2021-10-18,trinidad_and_tobago,North America,1407928,153,54267
2021-10-19,trinidad_and_tobago,North America,1407928,138,54405
2021-10-20,trinidad_and_tobago,North America,1407928,218,54623
2021-10-21,trinidad_and_tobago,North America,1407928,258,54881
2021-10-22,trinidad_and_tobago,North America,1407928,322,55203
2021-10-23,trinidad_and_tobago,North America,1407928,234,55437
2021-10-24,trinidad_and_tobago,North America,1407928,244,55681
2021-10-25,trinidad_and_tobago,North America,1407928,117,55798
2021-10-26,trinidad_and_tobago,North America,1407928,215,56013
2021-10-27,trinidad_and_tobago,North America,1407928,147,56160
2021-10-28,trinidad_and_tobago,North America,1407928,386,56546
2021-10-29,trinidad_and_tobago,North America,1407928,285,56831
2021-10-30,trinidad_and_tobago,North America,1407928,290,57121
2021-10-31,trinidad_and_tobago,North America,1407928,208,57329
2021-11-01,trinidad_and_tobago,North America,1407928,90,57419
2021-11-02,trinidad_and_tobago,North America,1407928,294,57713
2021-11-03,trinidad_and_tobago,North America,1407928,393,58106
2021-11-04,trinidad_and_tobago,North America,1407928,335,58441
2021-11-05,trinidad_and_tobago,North America,1407928,140,58581
2021-11-06,trinidad_and_tobago,North America,1407928,394,58975
2021-11-07,trinidad_and_tobago,North America,1407928,329,59304
2021-11-08,trinidad_and_tobago,North America,1407928,354,59658
2021-11-09,trinidad_and_tobago,North America,1407928,305,59963
2021-11-10,trinidad_and_tobago,North America,1407928,512,60475
2021-11-11,trinidad_and_tobago,North America,1407928,509,60984
2021-11-12,trinidad_and_tobago,North America,1407928,535,61519
2021-11-13,trinidad_and_tobago,North America,1407928,403,61922
2021-11-14,trinidad_and_tobago,North America,1407928,345,62267
2021-11-15,trinidad_and_tobago,North America,1407928,403,62670
2021-11-16,trinidad_and_tobago,North America,1407928,414,63084
2021-11-17,trinidad_and_tobago,North America,1407928,781,63865
2021-11-18,trinidad_and_tobago,North America,1407928,537,64402
2021-11-19,trinidad_and_tobago,North America,1407928,491,64893
2021-11-20,trinidad_and_tobago,North America,1407928,592,65485
2021-11-21,trinidad_and_tobago,North America,1407928,404,65889
2021-11-22,trinidad_and_tobago,North America,1407928,404,66293
2021-11-23,trinidad_and_tobago,North America,1407928,682,66975
2021-11-24,trinidad_and_tobago,North America,1407928,689,67664
2021-11-25,trinidad_and_tobago,North America,1407928,624,68288
2021-11-26,trinidad_and_tobago,North America,1407928,720,69008
2021-11-27,trinidad_and_tobago,North America,1407928,672,69680
2021-11-28,trinidad_and_tobago,North America,1407928,456,70136
2021-11-29,trinidad_and_tobago,North America,1407928,462,70598
2021-11-30,trinidad_and_tobago,North America,1407928,763,71361
2021-12-01,trinidad_and_tobago,North America,1407928,658,72019
2021-12-02,trinidad_and_tobago,North America,1407928,756,72775
2021-12-03,trinidad_and_tobago,North America,1407928,984,73759
2021-12-04,trinidad_and_tobago,North America,1407928,774,74533
2021-12-05,trinidad_and_tobago,North America,1407928,601,75134
2021-12-06,trinidad_and_tobago,North America,1407928,801,75935
2021-12-07,trinidad_and_tobago,North America,1407928,666,76601
2021-12-08,trinidad_and_tobago,North America,1407928,881,77482
2021-12-09,trinidad_and_tobago,North America,1407928,857,78339
2021-12-10,trinidad_and_tobago,North America,1407928,898,79237
2021-12-11,trinidad_and_tobago,North America,1407928,812,80049
2021-12-12,trinidad_and_tobago,North America,1407928,558,80607
2021-12-13,trinidad_and_tobago,North America,1407928,464,81071
2021-12-14,trinidad_and_tobago,North America,1407928,786,81857
2021-12-15,trinidad_and_tobago,North America,1407928,706,82563
2021-12-16,trinidad_and_tobago,North America,1407928,567,83130
2021-12-17,trinidad_and_tobago,North America,1407928,707,83837
2021-12-18,trinidad_and_tobago,North America,1407928,956,84793
2021-12-19,trinidad_and_tobago,North America,1407928,629,85422
2021-12-20,trinidad_and_tobago,North America,1407928,451,85873
2021-12-21,trinidad_and_tobago,North America,1407928,723,86596
2021-12-22,trinidad_and_tobago,North America,1407928,456,87052
2021-12-23,trinidad_and_tobago,North America,1407928,928,87980
2021-12-24,trinidad_and_tobago,North America,1407928,964,88944
2021-12-25,trinidad_and_tobago,North America,1407928,420,89364
2021-12-26,trinidad_and_tobago,North America,1407928,465,89829
2021-12-27,trinidad_and_tobago,North America,1407928,175,90004
2021-12-28,trinidad_and_tobago,North America,1407928,360,90364
2021-12-29,trinidad_and_tobago,North America,1407928,465,90829
2021-12-30,trinidad_and_tobago,North America,1407928,491,91320
2021-12-31,trinidad_and_tobago,North America,1407928,579,91899
2022-01-01,trinidad_and_tobago,North America,1407928,302,92201
2022-01-02,trinidad_and_tobago,North America,1407928,458,92659
2022-01-03,trinidad_and_tobago,North America,1407928,338,92997
2022-01-04,trinidad_and_tobago,North America,1407928,637,93634
2022-01-05,trinidad_and_tobago,North America,1407928,579,94213
2022-01-06,trinidad_and_tobago,North America,1407928,883,95096
2022-01-07,trinidad_and_tobago,North America,1407928,974,96070
2022-01-08,trinidad_and_tobago,North America,1407928,485,96555
2022-01-09,trinidad_and_tobago,North America,1407928,397,96952
2022-01-10,trinidad_and_tobago,North America,1407928,402,97354
2022-01-11,trinidad_and_tobago,North America,1407928,543,97897
2022-01-12,trinidad_and_tobago,North America,1407928,577,98474
2022-01-13,trinidad_and_tobago,North America,1407928,453,98927
2022-01-14,trinidad_and_tobago,North America,1407928,853,99780
2022-01-15,trinidad_and_tobago,North America,1407928,810,100590
2022-01-16,trinidad_and_tobago,North America,1407928,404,100994
2022-01-17,trinidad_and_tobago,North America,1407928,382,101376
2020-04-06,turks_and_caicos_islands,North America,39692,3,8
2020-04-07,turks_and_caicos_islands,North America,39692,0,8
2020-04-08,turks_and_caicos_islands,North America,39692,0,8
2020-04-09,turks_and_caicos_islands,North America,39692,0,8
2020-04-10,turks_and_caicos_islands,North America,39692,0,8
2020-04-11,turks_and_caicos_islands,North America,39692,1,9
2020-04-12,turks_and_caicos_islands,North America,39692,0,9
2020-04-13,turks_and_caicos_islands,North America,39692,1,10
2020-04-14,turks_and_caicos_islands,North America,39692,0,10
2020-04-15,turks_and_caicos_islands,North America,39692,0,10
2020-04-16,turks_and_caicos_islands,North America,39692,1,11
2020-04-17,turks_and_caicos_islands,North America,39692,0,11
2020-04-18,turks_and_caicos_islands,North America,39692,0,11
2020-04-19,turks_and_caicos_islands,North America,39692,0,11
2020-04-20,turks_and_caicos_islands,North America,39692,0,11
2020-04-21,turks_and_caicos_islands,North America,39692,0,11
2020-04-22,turks_and_caicos_islands,North America,39692,0,11
2020-04-23,turks_and_caicos_islands,North America,39692,0,11
2020-04-24,turks_and_caicos_islands,North America,39692,0,11
2020-04-25,turks_and_caicos_islands,North America,39692,0,11
2020-04-26,turks_and_caicos_islands,North America,39692,0,11
2020-04-27,turks_and_caicos_islands,North America,39692,1,12
2020-04-28,turks_and_caicos_islands,North America,39692,0,12
2020-04-29,turks_and_caicos_islands,North America,39692,0,12
2020-04-30,turks_and_caicos_islands,North America,39692,0,12
2020-05-01,turks_and_caicos_islands,North America,39692,0,12
2020-05-02,turks_and_caicos_islands,North America,39692,0,12
2020-05-03,turks_and_caicos_islands,North America,39692,0,12
2020-05-04,turks_and_caicos_islands,North America,39692,0,12
2020-05-05,turks_and_caicos_islands,North America,39692,0,12
2020-05-06,turks_and_caicos_islands,North America,39692,0,12
2020-05-07,turks_and_caicos_islands,North America,39692,0,12
2020-05-08,turks_and_caicos_islands,North America,39692,0,12
2020-05-09,turks_and_caicos_islands,North America,39692,0,12
2020-05-10,turks_and_caicos_islands,North America,39692,0,12
2020-05-11,turks_and_caicos_islands,North America,39692,0,12
2020-05-12,turks_and_caicos_islands,North America,39692,0,12
2020-05-13,turks_and_caicos_islands,North America,39692,0,12
2020-05-14,turks_and_caicos_islands,North America,39692,0,12
2020-05-15,turks_and_caicos_islands,North America,39692,0,12
2020-05-16,turks_and_caicos_islands,North America,39692,0,12
2020-05-17,turks_and_caicos_islands,North America,39692,0,12
2020-05-18,turks_and_caicos_islands,North America,39692,0,12
2020-05-19,turks_and_caicos_islands,North America,39692,0,12
2020-05-20,turks_and_caicos_islands,North America,39692,0,12
2020-05-21,turks_and_caicos_islands,North America,39692,0,12
2020-05-22,turks_and_caicos_islands,North America,39692,0,12
2020-05-23,turks_and_caicos_islands,North America,39692,0,12
2020-05-24,turks_and_caicos_islands,North America,39692,0,12
2020-05-25,turks_and_caicos_islands,North America,39692,0,12
2020-05-26,turks_and_caicos_islands,North America,39692,0,12
2020-05-27,turks_and_caicos_islands,North America,39692,0,12
2020-05-28,turks_and_caicos_islands,North America,39692,0,12
2020-05-29,turks_and_caicos_islands,North America,39692,0,12
2020-05-30,turks_and_caicos_islands,North America,39692,0,12
2020-05-31,turks_and_caicos_islands,North America,39692,0,12
2020-06-01,turks_and_caicos_islands,North America,39692,0,12
2020-06-02,turks_and_caicos_islands,North America,39692,0,12
2020-06-03,turks_and_caicos_islands,North America,39692,0,12
2020-06-04,turks_and_caicos_islands,North America,39692,0,12
2020-06-05,turks_and_caicos_islands,North America,39692,0,12
2020-06-06,turks_and_caicos_islands,North America,39692,0,12
2020-06-07,turks_and_caicos_islands,North America,39692,0,12
2020-06-08,turks_and_caicos_islands,North America,39692,0,12
2020-06-09,turks_and_caicos_islands,North America,39692,0,12
2020-06-10,turks_and_caicos_islands,North America,39692,0,12
2020-06-11,turks_and_caicos_islands,North America,39692,0,12
2020-06-12,turks_and_caicos_islands,North America,39692,0,12
2020-06-13,turks_and_caicos_islands,North America,39692,0,12
2020-06-14,turks_and_caicos_islands,North America,39692,0,12
2020-06-15,turks_and_caicos_islands,North America,39692,0,12
2020-06-16,turks_and_caicos_islands,North America,39692,0,12
2020-06-17,turks_and_caicos_islands,North America,39692,0,12
2020-06-18,turks_and_caicos_islands,North America,39692,0,12
2020-06-19,turks_and_caicos_islands,North America,39692,0,12
2020-06-20,turks_and_caicos_islands,North America,39692,0,12
2020-06-21,turks_and_caicos_islands,North America,39692,2,14
2020-06-22,turks_and_caicos_islands,North America,39692,0,14
2020-06-23,turks_and_caicos_islands,North America,39692,0,14
2020-06-24,turks_and_caicos_islands,North America,39692,0,14
2020-06-25,turks_and_caicos_islands,North America,39692,1,15
2020-06-26,turks_and_caicos_islands,North America,39692,1,16
2020-06-27,turks_and_caicos_islands,North America,39692,0,16
2020-06-28,turks_and_caicos_islands,North America,39692,12,28
2020-06-29,turks_and_caicos_islands,North America,39692,13,41
2020-06-30,turks_and_caicos_islands,North America,39692,0,41
2020-07-01,turks_and_caicos_islands,North America,39692,1,42
2020-07-02,turks_and_caicos_islands,North America,39692,0,42
2020-07-03,turks_and_caicos_islands,North America,39692,2,44
2020-07-04,turks_and_caicos_islands,North America,39692,1,45
2020-07-05,turks_and_caicos_islands,North America,39692,2,47
2020-07-06,turks_and_caicos_islands,North America,39692,1,48
2020-07-07,turks_and_caicos_islands,North America,39692,1,49
2020-07-08,turks_and_caicos_islands,North America,39692,6,55
2020-07-09,turks_and_caicos_islands,North America,39692,0,55
2020-07-25,uganda,Africa,48429823,17,1334
2020-07-26,uganda,Africa,48429823,15,1349
2020-07-27,uganda,Africa,48429823,16,1365
2020-07-28,uganda,Africa,48429823,8,1373
2020-07-29,uganda,Africa,48429823,6,1379
2020-07-30,uganda,Africa,48429823,8,1387
2020-07-31,uganda,Africa,48429823,8,1395
2020-08-01,uganda,Africa,48429823,27,1422
2020-08-02,uganda,Africa,48429823,7,1429
2020-08-03,uganda,Africa,48429823,16,1445
2020-08-04,uganda,Africa,48429823,10,1455
2020-08-05,uganda,Africa,48429823,12,1467
2020-08-06,uganda,Africa,48429823,12,1479
2020-08-07,uganda,Africa,48429823,38,1517
2020-08-08,uganda,Africa,48429823,16,1533
2020-08-09,uganda,Africa,48429823,19,1552
2020-08-10,uganda,Africa,48429823,17,1569
2020-08-11,uganda,Africa,48429823,19,1588
2020-08-12,uganda,Africa,48429823,23,1611
2020-08-13,uganda,Africa,48429823,25,1636
2020-08-14,uganda,Africa,48429823,39,1675
2020-08-15,uganda,Africa,48429823,59,1734
2020-08-16,uganda,Africa,48429823,80,1814
2020-08-17,uganda,Africa,48429823,73,1887
2020-08-18,uganda,Africa,48429823,52,1939
2020-08-19,uganda,Africa,48429823,64,2003
2020-08-20,uganda,Africa,48429823,114,2117
2020-08-21,uganda,Africa,48429823,119,2236
2020-08-22,uganda,Africa,48429823,385,2621
2020-08-23,uganda,Africa,48429823,117,2738
2020-08-24,uganda,Africa,48429823,120,2858
2020-08-25,uganda,Africa,48429823,77,2935
2020-08-26,uganda,Africa,48429823,119,3054
2020-08-27,uganda,Africa,48429823,188,3242
2020-08-28,uganda,Africa,48429823,93,3335
2020-08-29,uganda,Africa,48429823,110,3445
2020-08-30,uganda,Africa,48429823,98,3543
2020-08-31,uganda,Africa,48429823,53,3596
2020-09-01,uganda,Africa,48429823,79,3675
2020-09-02,uganda,Africa,48429823,91,3766
2020-09-03,uganda,Africa,48429823,213,3979
2020-09-04,uganda,Africa,48429823,79,4058
2020-09-05,uganda,Africa,48429823,225,4283
2020-09-06,uganda,Africa,48429823,155,4438
2020-09-07,uganda,Africa,48429823,132,4570
2020-09-08,uganda,Africa,48429823,150,4720
2020-09-09,uganda,Africa,48429823,243,4963
2020-09-10,uganda,Africa,48429823,230,5193
2020-09-11,uganda,Africa,48429823,104,5297
2020-09-12,uganda,Africa,48429823,395,5692
2020-09-13,uganda,Africa,48429823,116,5808
2020-09-14,uganda,Africa,48429823,217,6025
2020-09-15,uganda,Africa,48429823,176,6201
2020-09-16,uganda,Africa,48429823,173,6374
2020-09-17,uganda,Africa,48429823,138,6512
2020-09-18,uganda,Africa,48429823,259,6771
2020-09-19,uganda,Africa,48429823,512,7283
2020-09-20,uganda,Africa,48429823,327,7610
2020-09-21,uganda,Africa,48429823,219,7829
2020-09-22,uganda,Africa,48429823,295,8124
2020-09-23,uganda,Africa,48429823,202,8326
2020-09-24,uganda,Africa,48429823,224,8550
2020-09-25,uganda,Africa,48429823,186,8736
2020-09-26,uganda,Africa,48429823,177,8913
2020-09-27,uganda,Africa,48429823,201,9114
2020-09-28,uganda,Africa,48429823,299,9413
2020-09-29,uganda,Africa,48429823,291,9704
2020-09-30,uganda,Africa,48429823,136,9840
2020-10-01,uganda,Africa,48429823,191,10031
2020-10-02,uganda,Africa,48429823,247,10278
2020-10-03,uganda,Africa,48429823,207,10485
2020-10-04,uganda,Africa,48429823,177,10662
2020-10-05,uganda,Africa,48429823,190,10852
2020-10-06,uganda,Africa,48429823,142,10994
2020-10-07,uganda,Africa,48429823,215,11209
2020-10-08,uganda,Africa,48429823,220,11429
2020-10-09,uganda,Africa,48429823,116,11545
2020-10-10,uganda,Africa,48429823,197,11742
2020-10-11,uganda,Africa,48429823,121,11863
2020-10-12,uganda,Africa,48429823,76,11939
2020-10-13,uganda,Africa,48429823,98,12037
2020-10-14,uganda,Africa,48429823,150,12187
2020-10-15,uganda,Africa,48429823,58,12245
2020-10-16,uganda,Africa,48429823,263,12508
2020-10-17,uganda,Africa,48429823,146,12654
2020-10-18,uganda,Africa,48429823,163,12817
2020-10-19,uganda,Africa,48429823,122,12939
2020-10-20,uganda,Africa,48429823,117,13056
2020-10-21,uganda,Africa,48429823,176,13232
2020-10-22,uganda,Africa,48429823,131,13363
2020-10-23,uganda,Africa,48429823,148,13511
2020-10-24,uganda,Africa,48429823,162,13673
2020-10-25,uganda,Africa,48429823,177,13850
2020-10-26,uganda,Africa,48429823,138,13988
2020-10-27,uganda,Africa,48429823,77,14065
2020-10-28,uganda,Africa,48429823,177,14242
2020-10-29,uganda,Africa,48429823,525,14767
2020-10-30,uganda,Africa,48429823,253,15020
2020-10-31,uganda,Africa,48429823,103,15123
2020-11-01,uganda,Africa,48429823,300,15423
2020-11-02,uganda,Africa,48429823,276,15699
2020-11-03,uganda,Africa,48429823,155,15854
2020-11-04,uganda,Africa,48429823,305,16159
2020-11-05,uganda,Africa,48429823,263,16422
2020-11-06,uganda,Africa,48429823,344,16766
2020-11-07,uganda,Africa,48429823,259,17025
2020-11-08,uganda,Africa,48429823,408,17433
2020-11-09,uganda,Africa,48429823,207,17640
2020-11-10,uganda,Africa,48429823,157,17797
2020-11-11,uganda,Africa,48429823,350,18147
2020-11-12,uganda,Africa,48429823,271,18418
2020-11-13,uganda,Africa,48429823,224,18642
2020-11-14,uganda,Africa,48429823,468,19110
2020-11-15,uganda,Africa,48429823,280,19390
2020-11-16,uganda,Africa,48429823,287,19677
2020-11-17,uganda,Africa,48429823,370,20047
2020-11-18,uganda,Africa,48429823,414,20461
2020-11-19,uganda,Africa,48429823,294,20755
2020-11-20,uganda,Africa,48429823,343,21098
2020-11-21,uganda,Africa,48429823,286,21384
2020-11-22,uganda,Africa,48429823,364,21748
2020-11-23,uganda,Africa,48429823,238,21986
2020-11-24,uganda,Africa,48429823,292,22278
2020-11-25,uganda,Africa,48429823,586,22864
2020-11-26,uganda,Africa,48429823,272,23136
2020-11-27,uganda,Africa,48429823,573,23709
2020-11-28,uganda,Africa,48429823,431,24140
2020-11-29,uganda,Africa,48429823,243,24383
2020-11-30,uganda,Africa,48429823,380,24763
2020-12-01,uganda,Africa,48429823,697,25460
2020-12-02,uganda,Africa,48429823,453,25913
2020-12-03,uganda,Africa,48429823,246,26159
2020-12-04,uganda,Africa,48429823,346,26505
2020-12-05,uganda,Africa,48429823,351,26856
2020-12-06,uganda,Africa,48429823,376,27232
2020-12-07,uganda,Africa,48429823,849,28081
2020-12-08,uganda,Africa,48429823,0,28081
2020-12-09,uganda,Africa,48429823,2250,30331
2020-12-10,uganda,Africa,48429823,812,31143
2020-12-11,uganda,Africa,48429823,773,31916
2020-12-12,uganda,Africa,48429823,850,32766
2020-12-13,uganda,Africa,48429823,558,33324
2020-12-14,uganda,Africa,48429823,283,33607
2020-12-15,uganda,Africa,48429823,487,34094
2020-12-16,uganda,Africa,48429823,684,34778
2020-12-17,uganda,Africa,48429823,760,35538
2020-12-18,uganda,Africa,48429823,859,36397
2020-12-19,uganda,Africa,48429823,764,37161
2020-12-20,uganda,Africa,48429823,587,37748
2020-12-21,uganda,Africa,48429823,238,37986
2020-12-22,uganda,Africa,48429823,637,38623
2020-12-23,uganda,Africa,48429823,592,39215
2020-12-24,uganda,Africa,48429823,623,39838
2020-12-25,uganda,Africa,48429823,540,40378
2020-12-26,uganda,Africa,48429823,246,40624
2020-12-27,uganda,Africa,48429823,300,40924
2020-12-28,uganda,Africa,48429823,196,41120
2020-12-29,uganda,Africa,48429823,373,41493
2020-12-30,uganda,Africa,48429823,479,41972
2020-12-31,uganda,Africa,48429823,652,42624
2021-01-01,uganda,Africa,48429823,357,42981
2021-01-02,uganda,Africa,48429823,243,43224
2021-01-03,uganda,Africa,48429823,254,43478
2021-01-04,uganda,Africa,48429823,155,43633
2021-01-05,uganda,Africa,48429823,432,44065
2021-01-06,uganda,Africa,48429823,357,44422
2021-01-07,uganda,Africa,48429823,450,44872
2021-01-08,uganda,Africa,48429823,269,45141
2021-01-09,uganda,Africa,48429823,312,45453
2021-01-10,uganda,Africa,48429823,228,45681
2021-01-11,uganda,Africa,48429823,80,45761
2021-01-12,uganda,Africa,48429823,169,45930
2021-01-13,uganda,Africa,48429823,166,46096
2021-01-14,uganda,Africa,48429823,0,46096
2021-01-15,uganda,Africa,48429823,0,46096
2021-01-16,uganda,Africa,48429823,0,46096
2021-01-17,uganda,Africa,48429823,0,46096
2021-01-18,uganda,Africa,48429823,0,46096
2021-01-19,uganda,Africa,48429823,543,46639
2021-01-20,uganda,Africa,48429823,114,46753
2021-01-21,uganda,Africa,48429823,215,46968
2021-01-22,uganda,Africa,48429823,156,47124
2021-01-23,uganda,Africa,48429823,132,47256
2021-01-24,uganda,Africa,48429823,127,47383
2021-01-25,uganda,Africa,48429823,47,47430
2021-01-26,uganda,Africa,48429823,88,47518
2021-01-27,uganda,Africa,48429823,64,47582
2021-01-28,uganda,Africa,48429823,133,47715
2021-01-29,uganda,Africa,48429823,80,47795
2021-01-30,uganda,Africa,48429823,52,47847
2021-01-31,uganda,Africa,48429823,56,47903
2021-02-01,uganda,Africa,48429823,33,47936
2021-02-02,uganda,Africa,48429823,54,47990
2021-02-03,uganda,Africa,48429823,41,48031
2021-02-04,uganda,Africa,48429823,61,48092
2021-02-05,uganda,Africa,48429823,65,48157
2021-02-06,uganda,Africa,48429823,39,48196
2021-02-07,uganda,Africa,48429823,33,48229
2021-02-08,uganda,Africa,48429823,15,48244
2021-02-09,uganda,Africa,48429823,28,48272
2021-02-10,uganda,Africa,48429823,34,48306
2021-02-11,uganda,Africa,48429823,38,48344
2021-02-12,uganda,Africa,48429823,45,48389
2021-02-13,uganda,Africa,48429823,48,48437
2021-02-14,uganda,Africa,48429823,0,48437
2021-02-15,uganda,Africa,48429823,44,48481
2021-02-16,uganda,Africa,48429823,10,48491
2021-02-17,uganda,Africa,48429823,47,48538
2021-02-18,uganda,Africa,48429823,63,48601
2021-02-19,uganda,Africa,48429823,17,48618
2021-02-20,uganda,Africa,48429823,38,48656
2021-02-21,uganda,Africa,48429823,17,48673
2021-02-22,uganda,Africa,48429823,10,48683
2021-02-23,uganda,Africa,48429823,27,48710
2021-02-24,uganda,Africa,48429823,22,48732
2021-02-25,uganda,Africa,48429823,47,48779
2021-02-26,uganda,Africa,48429823,27,48806
2021-02-27,uganda,Africa,48429823,16,48822
2021-02-28,uganda,Africa,48429823,27,48849
2021-03-01,uganda,Africa,48429823,12,48861
2021-03-02,uganda,Africa,48429823,34,48895
2021-03-03,uganda,Africa,48429823,16,48911
2021-03-04,uganda,Africa,48429823,22,48933
2021-03-05,uganda,Africa,48429823,31,48964
2021-03-06,uganda,Africa,48429823,0,48964
2021-03-07,uganda,Africa,48429823,15,48979
2021-03-08,uganda,Africa,48429823,18,48997
2021-03-09,uganda,Africa,48429823,13,49010
2021-03-10,uganda,Africa,48429823,36,49046
2021-03-11,uganda,Africa,48429823,18,49064
2021-03-12,uganda,Africa,48429823,11,49075
2021-03-13,uganda,Africa,48429823,29,49104
2021-03-14,uganda,Africa,48429823,16,49120
2021-03-15,uganda,Africa,48429823,12,49132
2021-03-16,uganda,Africa,48429823,2,49134
2021-03-17,uganda,Africa,48429823,17,49151
2021-03-18,uganda,Africa,48429823,22,49173
2021-03-19,uganda,Africa,48429823,31,49204
2021-03-20,uganda,Africa,48429823,0,49204
2021-03-21,uganda,Africa,48429823,24,49228
2021-03-22,uganda,Africa,48429823,19,49247
2021-03-23,uganda,Africa,48429823,39,49286
2021-03-24,uganda,Africa,48429823,1,49287
2021-03-25,uganda,Africa,48429823,17,49304
2021-03-26,uganda,Africa,48429823,21,49325
2021-03-27,uganda,Africa,48429823,19,49344
2021-03-28,uganda,Africa,48429823,33,49377
2021-03-29,uganda,Africa,48429823,31,49408
2021-03-30,uganda,Africa,48429823,23,49431
2021-03-31,uganda,Africa,48429823,34,49465
2021-04-01,uganda,Africa,48429823,27,49492
2021-04-02,uganda,Africa,48429823,42,49534
2021-04-03,uganda,Africa,48429823,46,49580
2021-04-04,uganda,Africa,48429823,0,49580
2021-04-05,uganda,Africa,48429823,65,49645
2021-04-06,uganda,Africa,48429823,8,49653
2021-04-07,uganda,Africa,48429823,28,49681
2021-04-08,uganda,Africa,48429823,19,49700
2021-04-09,uganda,Africa,48429823,29,49729
2021-04-10,uganda,Africa,48429823,33,49762
2021-04-11,uganda,Africa,48429823,33,49795
2021-04-12,uganda,Africa,48429823,41,49836
2021-04-13,uganda,Africa,48429823,36,49872
2021-04-14,uganda,Africa,48429823,40,49912
2021-04-15,uganda,Africa,48429823,31,49943
2021-04-16,uganda,Africa,48429823,57,50000
2021-04-17,uganda,Africa,48429823,36,50036
2021-04-18,uganda,Africa,48429823,46,50082
2021-04-19,uganda,Africa,48429823,22,50104
2021-04-20,uganda,Africa,48429823,31,50135
2021-04-21,uganda,Africa,48429823,64,50199
2021-04-22,uganda,Africa,48429823,65,50264
2021-04-23,uganda,Africa,48429823,56,50320
2021-04-24,uganda,Africa,48429823,0,50320
2021-04-25,uganda,Africa,48429823,97,50417
2021-04-26,uganda,Africa,48429823,73,50490
2021-04-27,uganda,Africa,48429823,27,50517
2021-04-28,uganda,Africa,48429823,35,50552
2021-04-29,uganda,Africa,48429823,38,50590
2021-04-30,uganda,Africa,48429823,84,50674
2021-05-01,uganda,Africa,48429823,47,50721
2021-05-02,uganda,Africa,48429823,0,50721
2021-05-03,uganda,Africa,48429823,82,50803
2021-05-04,uganda,Africa,48429823,71,50874
2021-05-05,uganda,Africa,48429823,85,50959
2021-05-06,uganda,Africa,48429823,61,51020
2021-05-07,uganda,Africa,48429823,87,51107
2021-05-08,uganda,Africa,48429823,102,51209
2021-05-09,uganda,Africa,48429823,57,51266
2021-05-10,uganda,Africa,48429823,35,51301
2021-05-11,uganda,Africa,48429823,52,51353
2021-05-12,uganda,Africa,48429823,73,51426
2021-05-13,uganda,Africa,48429823,110,51536
2021-05-14,uganda,Africa,48429823,116,51652
2021-05-15,uganda,Africa,48429823,0,51652
2021-05-16,uganda,Africa,48429823,127,51779
2021-05-17,uganda,Africa,48429823,97,51876
2021-05-18,uganda,Africa,48429823,86,51962
2021-05-19,uganda,Africa,48429823,199,52161
2021-05-20,uganda,Africa,48429823,156,52317
2021-05-21,uganda,Africa,48429823,178,52495
2021-05-22,uganda,Africa,48429823,166,52661
2021-05-23,uganda,Africa,48429823,275,52936
2021-05-24,uganda,Africa,48429823,224,53160
2021-05-25,uganda,Africa,48429823,188,53348
2021-05-26,uganda,Africa,48429823,251,53599
2021-05-27,uganda,Africa,48429823,379,53978
2021-05-28,uganda,Africa,48429823,771,54749
2021-05-29,uganda,Africa,48429823,847,55596
2021-05-30,uganda,Africa,48429823,838,56434
2021-05-31,uganda,Africa,48429823,634,57068
2021-06-01,uganda,Africa,48429823,743,57811
2021-06-02,uganda,Africa,48429823,1108,58919
2021-06-03,uganda,Africa,48429823,1311,60230
2021-06-04,uganda,Africa,48429823,1509,61739
2021-06-05,uganda,Africa,48429823,811,62550
2021-06-06,uganda,Africa,48429823,1524,64074
2021-06-07,uganda,Africa,48429823,1242,65316
2021-06-08,uganda,Africa,48429823,857,66173
2021-06-09,uganda,Africa,48429823,1019,67192
2021-06-10,uganda,Africa,48429823,1741,68933
2021-06-11,uganda,Africa,48429823,1896,70829
2021-06-12,uganda,Africa,48429823,2100,72929
2021-06-13,uganda,Africa,48429823,2090,75019
2021-06-14,uganda,Africa,48429823,1358,76377
2021-06-15,uganda,Africa,48429823,1721,78098
2020-02-20,uk,Europe,68550166,0,34
2020-02-21,uk,Europe,68550166,0,34
2020-02-22,uk,Europe,68550166,2,36
2020-02-23,uk,Europe,68550166,0,36
2020-02-24,uk,Europe,68550166,6,42
2020-02-25,uk,Europe,68550166,2,44
2020-02-26,uk,Europe,68550166,3,47
2020-02-27,uk,Europe,68550166,2,49
2020-02-28,uk,Europe,68550166,8,57
2020-02-29,uk,Europe,68550166,12,69
2020-03-01,uk,Europe,68550166,4,73
2020-03-02,uk,Europe,68550166,20,93
2020-03-03,uk,Europe,68550166,41,134
2020-03-04,uk,Europe,68550166,57,191
2020-03-05,uk,Europe,68550166,56,247
2020-03-06,uk,Europe,68550166,49,296
2020-03-07,uk,Europe,68550166,83,379
2020-03-08,uk,Europe,68550166,68,447
2020-03-09,uk,Europe,68550166,55,502
2020-03-10,uk,Europe,68550166,148,650
2020-03-11,uk,Europe,68550166,265,915
2020-03-12,uk,Europe,68550166,403,1318
2020-03-13,uk,Europe,68550166,484,1802
2020-03-14,uk,Europe,68550166,478,2280
2020-03-15,uk,Europe,68550166,352,2632
2020-03-16,uk,Europe,68550166,441,3073
2020-03-17,uk,Europe,68550166,602,3675
2020-03-18,uk,Europe,68550166,783,4458
2020-03-19,uk,Europe,68550166,981,5439
2020-03-20,uk,Europe,68550166,1042,6481
2020-03-21,uk,Europe,68550166,1252,7733
2020-03-22,uk,Europe,68550166,1181,8914
2020-03-23,uk,Europe,68550166,1363,10277
2020-03-24,uk,Europe,68550166,2290,12567
2020-03-25,uk,Europe,68550166,2354,14921
2020-03-26,uk,Europe,68550166,2666,17587
2020-03-27,uk,Europe,68550166,3039,20626
2020-03-28,uk,Europe,68550166,3154,23780
2020-03-29,uk,Europe,68550166,2774,26554
2020-03-30,uk,Europe,68550166,2818,29372
2020-03-31,uk,Europe,68550166,4195,33567
2020-04-01,uk,Europe,68550166,4463,38030
2020-04-02,uk,Europe,68550166,4891,42921
2020-04-03,uk,Europe,68550166,4824,47745
2020-04-04,uk,Europe,68550166,4852,52597
2020-04-05,uk,Europe,68550166,3976,56573
2020-04-06,uk,Europe,68550166,3556,60129
2020-04-07,uk,Europe,68550166,5273,65402
2020-04-08,uk,Europe,68550166,5477,70879
2020-04-09,uk,Europe,68550166,5146,76025
2020-04-10,uk,Europe,68550166,4875,80900
2020-04-11,uk,Europe,68550166,4327,85227
2020-04-12,uk,Europe,68550166,3585,88812
2020-04-13,uk,Europe,68550166,3507,92319
2020-04-14,uk,Europe,68550166,4203,96522
2020-04-15,uk,Europe,68550166,4335,100857
2020-04-16,uk,Europe,68550166,5070,105927
2020-04-17,uk,Europe,68550166,5292,111219
2020-04-18,uk,Europe,68550166,4977,116196
2020-04-19,uk,Europe,68550166,4743,120939
2020-04-20,uk,Europe,68550166,3881,124820
2020-04-21,uk,Europe,68550166,4441,129261
2020-04-22,uk,Europe,68550166,4795,134056
2020-04-23,uk,Europe,68550166,5517,139573
2020-04-24,uk,Europe,68550166,5167,144740
2020-04-25,uk,Europe,68550166,4961,149701
2020-04-26,uk,Europe,68550166,3757,153458
2020-04-27,uk,Europe,68550166,3476,156934
2020-04-28,uk,Europe,68550166,4739,161673
2020-04-29,uk,Europe,68550166,4720,166393
2020-04-30,uk,Europe,68550166,5433,171826
2020-05-01,uk,Europe,68550166,4961,176787
2020-05-02,uk,Europe,68550166,4766,181553
2020-05-03,uk,Europe,68550166,3258,184811
2020-05-04,uk,Europe,68550166,3002,187813
2020-05-05,uk,Europe,68550166,3398,191211
2020-05-06,uk,Europe,68550166,3686,194897
2020-05-07,uk,Europe,68550166,3832,198729
2020-05-08,uk,Europe,68550166,3787,202516
2020-05-09,uk,Europe,68550166,3064,205580
2020-05-10,uk,Europe,68550166,2170,207750
2020-05-11,uk,Europe,68550166,2337,210087
2020-05-12,uk,Europe,68550166,3612,213699
2020-05-13,uk,Europe,68550166,3410,217109
2020-05-14,uk,Europe,68550166,3330,220439
2020-05-15,uk,Europe,68550166,2630,223069
2020-05-16,uk,Europe,68550166,2530,225599
2020-05-17,uk,Europe,68550166,2082,227681
2020-05-18,uk,Europe,68550166,1837,229518
2020-05-19,uk,Europe,68550166,2581,232099
2020-05-20,uk,Europe,68550166,3063,235162
2020-05-21,uk,Europe,68550166,2719,237881
2020-05-22,uk,Europe,68550166,2567,240448
2020-05-23,uk,Europe,68550166,2057,242505
2020-05-24,uk,Europe,68550166,1532,244037
2020-05-25,uk,Europe,68550166,1373,245410
2020-05-26,uk,Europe,68550166,1625,247035
2020-05-27,uk,Europe,68550166,2070,249105
2020-05-28,uk,Europe,68550166,1825,250930
2020-05-29,uk,Europe,68550166,1757,252687
2020-05-30,uk,Europe,68550166,1531,254218
2020-05-31,uk,Europe,68550166,1132,255350
2020-06-01,uk,Europe,68550166,1080,256430
2020-06-02,uk,Europe,68550166,1438,257868
2020-06-03,uk,Europe,68550166,1492,259360
2020-06-04,uk,Europe,68550166,1369,260729
2020-06-05,uk,Europe,68550166,1249,261978
2020-06-06,uk,Europe,68550166,1123,263101
2020-06-07,uk,Europe,68550166,804,263905
2020-06-08,uk,Europe,68550166,722,264627
2020-06-09,uk,Europe,68550166,1099,265726
2020-06-10,uk,Europe,68550166,1165,266891
2020-06-11,uk,Europe,68550166,1196,268087
2020-06-12,uk,Europe,68550166,1013,269100
2020-06-13,uk,Europe,68550166,1053,270153
2020-06-14,uk,Europe,68550166,886,271039
2020-06-15,uk,Europe,68550166,826,271865
2020-06-16,uk,Europe,68550166,1045,272910
2020-06-17,uk,Europe,68550166,1103,274013
2020-06-18,uk,Europe,68550166,1017,275030
2020-06-19,uk,Europe,68550166,1022,276052
2020-06-20,uk,Europe,68550166,993,277045
2020-06-21,uk,Europe,68550166,683,277728
2020-06-22,uk,Europe,68550166,636,278364
2020-06-23,uk,Europe,68550166,899,279263
2020-06-24,uk,Europe,68550166,883,280146
2020-06-25,uk,Europe,68550166,777,280923
2020-06-26,uk,Europe,68550166,726,281649
2020-06-27,uk,Europe,68550166,666,282315
2020-06-28,uk,Europe,68550166,653,282968
2020-06-29,uk,Europe,68550166,449,283417
2020-06-30,uk,Europe,68550166,724,284141
2020-07-01,uk,Europe,68550166,623,284764
2020-07-02,uk,Europe,68550166,652,285416
2020-07-03,uk,Europe,68550166,606,286022
2020-07-04,uk,Europe,68550166,568,286590
2020-07-05,uk,Europe,68550166,399,286989
2020-07-06,uk,Europe,68550166,558,287547
2020-07-07,uk,Europe,68550166,714,288261
2020-07-08,uk,Europe,68550166,608,288869
2020-07-09,uk,Europe,68550166,713,289582
2020-07-10,uk,Europe,68550166,722,290304
2020-07-11,uk,Europe,68550166,568,290872
2020-07-12,uk,Europe,68550166,459,291331
2020-07-13,uk,Europe,68550166,366,291697
2020-07-14,uk,Europe,68550166,740,292437
2020-07-15,uk,Europe,68550166,705,293142
2020-07-16,uk,Europe,68550166,777,293919
2020-07-17,uk,Europe,68550166,712,294631
2020-07-18,uk,Europe,68550166,582,295213
2020-07-19,uk,Europe,68550166,505,295718
2020-07-20,uk,Europe,68550166,448,296166
2020-07-21,uk,Europe,68550166,830,296996
2020-07-22,uk,Europe,68550166,788,297784
2020-07-23,uk,Europe,68550166,816,298600
2020-07-24,uk,Europe,68550166,808,299408
2020-07-25,uk,Europe,68550166,774,300182
2020-07-26,uk,Europe,68550166,530,300712
2020-07-27,uk,Europe,68550166,563,301275
2020-07-28,uk,Europe,68550166,869,302144
2020-07-29,uk,Europe,68550166,856,303000
2020-07-30,uk,Europe,68550166,1062,304062
2020-07-31,uk,Europe,68550166,946,305008
2020-08-01,uk,Europe,68550166,697,305705
2020-08-02,uk,Europe,68550166,559,306264
2020-08-03,uk,Europe,68550166,564,306828
2020-08-04,uk,Europe,68550166,1060,307888
2020-08-05,uk,Europe,68550166,1065,308953
2020-08-06,uk,Europe,68550166,1092,310045
2020-08-07,uk,Europe,68550166,1105,311150
2020-08-08,uk,Europe,68550166,973,312123
2020-08-09,uk,Europe,68550166,710,312833
2020-08-10,uk,Europe,68550166,627,313460
2020-08-11,uk,Europe,68550166,1499,314959
2020-08-12,uk,Europe,68550166,1378,316337
2020-08-13,uk,Europe,68550166,1242,317579
2020-08-14,uk,Europe,68550166,1156,318735
2020-08-15,uk,Europe,68550166,1185,319920
2020-08-16,uk,Europe,68550166,714,320634
2020-08-17,uk,Europe,68550166,602,321236
2020-08-18,uk,Europe,68550166,1298,322534
2020-08-19,uk,Europe,68550166,1116,323650
2020-08-20,uk,Europe,68550166,1282,324932
2020-08-21,uk,Europe,68550166,1498,326430
2020-08-22,uk,Europe,68550166,1218,327648
2020-08-23,uk,Europe,68550166,842,328490
2020-08-24,uk,Europe,68550166,831,329321
2020-08-25,uk,Europe,68550166,1301,330622
2020-08-26,uk,Europe,68550166,1270,331892
2020-08-27,uk,Europe,68550166,1388,333280
2020-08-28,uk,Europe,68550166,1591,334871
2020-08-29,uk,Europe,68550166,1632,336503
2020-08-30,uk,Europe,68550166,1230,337733
2020-08-31,uk,Europe,68550166,1171,338904
2020-09-01,uk,Europe,68550166,1513,340417
2020-09-02,uk,Europe,68550166,2288,342705
2020-09-03,uk,Europe,68550166,3077,345782
2020-09-04,uk,Europe,68550166,3152,348934
2020-09-05,uk,Europe,68550166,3092,352026
2020-09-06,uk,Europe,68550166,2551,354577
2020-09-07,uk,Europe,68550166,2465,357042
2020-09-08,uk,Europe,68550166,3931,360973
2020-09-09,uk,Europe,68550166,3370,364343
2020-09-10,uk,Europe,68550166,3365,367708
2020-09-11,uk,Europe,68550166,3628,371336
2020-09-12,uk,Europe,68550166,3324,374660
2020-09-13,uk,Europe,68550166,2670,377330
2020-09-14,uk,Europe,68550166,2154,379484
2020-09-15,uk,Europe,68550166,3428,382912
2020-09-16,uk,Europe,68550166,3551,386463
2020-09-17,uk,Europe,68550166,4399,390862
2020-09-18,uk,Europe,68550166,4676,395538
2020-09-19,uk,Europe,68550166,4973,400511
2020-09-20,uk,Europe,68550166,4889,405400
2020-09-21,uk,Europe,68550166,5340,410740
2020-09-22,uk,Europe,68550166,5627,416367
2020-09-23,uk,Europe,68550166,6441,422808
2020-09-24,uk,Europe,68550166,7096,429904
2020-09-25,uk,Europe,68550166,7682,437586
2020-09-26,uk,Europe,68550166,7318,444904
2020-09-27,uk,Europe,68550166,6809,451713
2020-09-28,uk,Europe,68550166,7023,458736
2020-09-29,uk,Europe,68550166,9983,468719
2020-09-30,uk,Europe,68550166,10367,479086
2020-10-01,uk,Europe,68550166,12717,491803
2020-10-02,uk,Europe,68550166,13358,505161
2020-10-03,uk,Europe,68550166,13854,519015
2020-10-04,uk,Europe,68550166,11667,530682
2020-10-05,uk,Europe,68550166,11954,542636
2020-10-06,uk,Europe,68550166,16755,559391
2020-10-07,uk,Europe,68550166,17250,576641
2020-10-08,uk,Europe,68550166,18575,595216
2020-10-09,uk,Europe,68550166,18427,613643
2020-10-10,uk,Europe,68550166,15903,629546
2020-10-11,uk,Europe,68550166,12652,642198
2020-10-12,uk,Europe,68550166,12213,654411
2020-10-13,uk,Europe,68550166,19710,674121
2020-10-14,uk,Europe,68550166,19135,693256
2020-10-15,uk,Europe,68550166,19933,713189
2020-10-16,uk,Europe,68550166,18639,731828
2020-10-17,uk,Europe,68550166,17938,749766
2020-10-18,uk,Europe,68550166,14888,764654
2020-10-19,uk,Europe,68550166,14330,778984
2020-10-20,uk,Europe,68550166,25926,804910
2020-10-21,uk,Europe,68550166,25680,830590
2020-10-22,uk,Europe,68550166,25785,856375
2020-10-23,uk,Europe,68550166,23497,879872
2020-10-24,uk,Europe,68550166,21714,901586
2020-10-25,uk,Europe,68550166,16464,918050
2020-10-26,uk,Europe,68550166,15905,933955
2020-10-27,uk,Europe,68550166,26807,960762
2020-10-28,uk,Europe,68550166,24360,985122
2020-10-29,uk,Europe,68550166,23907,1009029
2020-10-30,uk,Europe,68550166,23649,1032678
2020-10-31,uk,Europe,68550166,22896,1055574
2020-11-01,uk,Europe,68550166,16702,1072276
2020-11-02,uk,Europe,68550166,16001,1088277
2020-11-03,uk,Europe,68550166,32003,1120280
2020-11-04,uk,Europe,68550166,25989,1146269
2020-11-05,uk,Europe,68550166,24055,1170324
2020-11-06,uk,Europe,68550166,24102,1194426
2020-11-07,uk,Europe,68550166,23714,1218140
2020-11-08,uk,Europe,68550166,18784,1236924
2020-11-09,uk,Europe,68550166,20253,1257177
2020-11-10,uk,Europe,68550166,31556,1288733
2020-11-11,uk,Europe,68550166,27828,1316561
2020-11-12,uk,Europe,68550166,27792,1344353
2020-11-13,uk,Europe,68550166,24876,1369229
2020-11-14,uk,Europe,68550166,24438,1393667
2020-11-15,uk,Europe,68550166,18258,1411925
2020-11-16,uk,Europe,68550166,16258,1428183
2020-11-17,uk,Europe,68550166,27006,1455189
2020-11-18,uk,Europe,68550166,23531,1478720
2020-11-19,uk,Europe,68550166,21118,1499838
2020-11-20,uk,Europe,68550166,18074,1517912
2020-11-21,uk,Europe,68550166,17134,1535046
2020-11-22,uk,Europe,68550166,12556,1547602
2020-11-23,uk,Europe,68550166,11913,1559515
2020-11-24,uk,Europe,68550166,19083,1578598
2020-11-25,uk,Europe,68550166,16704,1595302
2020-11-26,uk,Europe,68550166,16858,1612160
2020-11-27,uk,Europe,68550166,14817,1626977
2020-11-28,uk,Europe,68550166,14597,1641574
2020-11-29,uk,Europe,68550166,11105,1652679
2020-11-30,uk,Europe,68550166,10874,1663553
2020-12-01,uk,Europe,68550166,18265,1681818
2020-12-02,uk,Europe,68550166,16745,1698563
2020-12-03,uk,Europe,68550166,16748,1715311
2020-12-04,uk,Europe,68550166,15926,1731237
2020-12-05,uk,Europe,68550166,15866,1747103
2020-12-06,uk,Europe,68550166,12917,1760020
2020-12-07,uk,Europe,68550166,13765,1773785
2020-12-08,uk,Europe,68550166,21644,1795429
2020-12-09,uk,Europe,68550166,21097,1816526
2020-12-10,uk,Europe,68550166,21937,1838463
2020-12-11,uk,Europe,68550166,22927,1861390
2020-12-12,uk,Europe,68550166,24425,1885815
2020-12-13,uk,Europe,68550166,19592,1905407
2020-12-14,uk,Europe,68550166,22279,1927686
2020-12-15,uk,Europe,68550166,35221,1962907
2020-12-16,uk,Europe,68550166,34414,1997321
2020-12-17,uk,Europe,68550166,35438,2032759
2020-12-18,uk,Europe,68550166,34440,2067199
2020-12-19,uk,Europe,68550166,36417,2103616
2020-12-20,uk,Europe,68550166,25589,2129205
2020-12-21,uk,Europe,68550166,33064,2162269
2020-12-22,uk,Europe,68550166,48192,2210461
2020-12-23,uk,Europe,68550166,46475,2256936
2020-12-24,uk,Europe,68550166,42936,2299872
2020-12-25,uk,Europe,68550166,32391,2332263
2020-12-26,uk,Europe,68550166,14419,2346682
2020-12-27,uk,Europe,68550166,41109,2387791
2020-12-28,uk,Europe,68550166,48519,2436310
2020-12-29,uk,Europe,68550166,46407,2482717
2020-12-30,uk,Europe,68550166,83088,2565805
2020-12-31,uk,Europe,68550166,72161,2637966
2021-01-01,uk,Europe,68550166,53945,2691911
2021-01-02,uk,Europe,68550166,32482,2724393
2021-01-03,uk,Europe,68550166,61654,2786047
2021-01-04,uk,Europe,68550166,56332,2842379
2021-01-05,uk,Europe,68550166,77970,2920349
2021-01-06,uk,Europe,68550166,66635,2986984
2021-01-07,uk,Europe,68550166,58784,3045768
2021-01-08,uk,Europe,68550166,53187,3098955
2021-01-09,uk,Europe,68550166,48103,3147058
2021-01-10,uk,Europe,68550166,40035,3187093
2021-01-11,uk,Europe,68550166,37174,3224267
2021-01-12,uk,Europe,68550166,58591,3282858
2021-01-13,uk,Europe,68550166,50647,3333505
2021-01-14,uk,Europe,68550166,46506,3380011
2021-01-15,uk,Europe,68550166,43473,3423484
2021-01-16,uk,Europe,68550166,41450,3464934
2021-01-17,uk,Europe,68550166,31247,3496181
2021-01-18,uk,Europe,68550166,29592,3525773
2021-01-19,uk,Europe,68550166,45956,3571729
2021-01-20,uk,Europe,68550166,40526,3612255
2021-01-21,uk,Europe,68550166,35985,3648240
2021-01-22,uk,Europe,68550166,32501,3680741
2021-01-23,uk,Europe,68550166,30330,3711071
2021-01-24,uk,Europe,68550166,22344,3733415
2021-01-25,uk,Europe,68550166,17554,3750969
2021-01-26,uk,Europe,68550166,30736,3781705
2021-01-27,uk,Europe,68550166,27730,3809435
2021-01-28,uk,Europe,68550166,26303,3835738
2021-01-29,uk,Europe,68550166,24772,3860510
2021-01-30,uk,Europe,68550166,22433,3882943
2021-01-31,uk,Europe,68550166,17167,3900110
2021-02-01,uk,Europe,68550166,15783,3915893
2021-02-02,uk,Europe,68550166,22971,3938864
2021-02-03,uk,Europe,68550166,20268,3959132
2021-02-04,uk,Europe,68550166,19914,3979046
2021-02-05,uk,Europe,68550166,18492,3997538
2021-02-06,uk,Europe,68550166,16308,4013846
2021-02-07,uk,Europe,68550166,12320,4026166
2021-02-08,uk,Europe,68550166,11664,4037830
2021-02-09,uk,Europe,68550166,16193,4054023
2021-02-10,uk,Europe,68550166,14225,4068248
2021-02-11,uk,Europe,68550166,13899,4082147
2021-02-12,uk,Europe,68550166,13139,4095286
2021-02-13,uk,Europe,68550166,12573,4107859
2021-02-14,uk,Europe,68550166,9034,4116893
2021-02-15,uk,Europe,68550166,8994,4125887
2021-02-16,uk,Europe,68550166,14735,4140622
2021-02-17,uk,Europe,68550166,12941,4153563
2021-02-18,uk,Europe,68550166,11942,4165505
2021-02-19,uk,Europe,68550166,11794,4177299
2021-02-20,uk,Europe,68550166,10728,4188027
2021-02-21,uk,Europe,68550166,8312,4196339
2021-02-22,uk,Europe,68550166,8097,4204436
2021-02-23,uk,Europe,68550166,11655,4216091
2021-02-24,uk,Europe,68550166,9762,4225853
2021-02-25,uk,Europe,68550166,8845,4234698
2021-02-26,uk,Europe,68550166,8025,4242723
2021-02-27,uk,Europe,68550166,6783,4249506
2021-02-28,uk,Europe,68550166,4949,4254455
2021-03-01,uk,Europe,68550166,4873,4259328
2021-03-02,uk,Europe,68550166,7191,4266519
2021-03-03,uk,Europe,68550166,6919,4273438
2021-03-04,uk,Europe,68550166,6172,4279610
2021-03-05,uk,Europe,68550166,5937,4285547
2021-03-06,uk,Europe,68550166,5467,4291014
2021-03-07,uk,Europe,68550166,4628,4295642
2021-03-08,uk,Europe,68550166,4410,4300052
2021-03-09,uk,Europe,68550166,6890,4306942
2021-03-10,uk,Europe,68550166,6487,4313429
2021-03-11,uk,Europe,68550166,6251,4319680
2021-03-12,uk,Europe,68550166,5933,4325613
2021-03-13,uk,Europe,68550166,5716,4331329
2021-03-14,uk,Europe,68550166,4379,4335708
2021-03-15,uk,Europe,68550166,4425,4340133
2021-03-16,uk,Europe,68550166,6697,4346830
2021-03-17,uk,Europe,68550166,5849,4352679
2021-03-18,uk,Europe,68550166,5976,4358655
2021-03-19,uk,Europe,68550166,5623,4364278
2021-03-20,uk,Europe,68550166,5176,4369454
2021-03-21,uk,Europe,68550166,4246,4373700
2021-03-22,uk,Europe,68550166,5388,4379088
2021-03-23,uk,Europe,68550166,6458,4385546
2021-03-24,uk,Europe,68550166,5481,4391027
2021-03-25,uk,Europe,68550166,6222,4397249
2021-03-26,uk,Europe,68550166,5616,4402865
2021-03-27,uk,Europe,68550166,4567,4407432
2021-03-28,uk,Europe,68550166,3731,4411163
2021-03-29,uk,Europe,68550166,5029,4416192
2021-03-30,uk,Europe,68550166,4196,4420388
2021-03-31,uk,Europe,68550166,3779,4424167
2021-04-01,uk,Europe,68550166,3967,4428134
2021-04-02,uk,Europe,68550166,3674,4431808
2021-04-03,uk,Europe,68550166,2747,4434555
2021-04-04,uk,Europe,68550166,2506,4437061
2021-04-05,uk,Europe,68550166,2412,4439473
2021-04-06,uk,Europe,68550166,2744,4442217
2021-04-07,uk,Europe,68550166,3312,4445529
2021-04-08,uk,Europe,68550166,3253,4448782
2021-04-09,uk,Europe,68550166,3147,4451929
2021-04-10,uk,Europe,68550166,2952,4454881
2021-04-11,uk,Europe,68550166,2380,4457261
2021-04-12,uk,Europe,68550166,2376,4459637
2021-04-13,uk,Europe,68550166,2878,4462515
2021-04-14,uk,Europe,68550166,2495,4465010
2021-04-15,uk,Europe,68550166,2512,4467522
2021-04-16,uk,Europe,68550166,2344,4469866
2021-04-17,uk,Europe,68550166,2347,4472213
2021-04-18,uk,Europe,68550166,1721,4473934
2021-04-19,uk,Europe,68550166,2584,4476518
2021-04-20,uk,Europe,68550166,2738,4479256
2021-04-21,uk,Europe,68550166,2541,4481797
2021-04-22,uk,Europe,68550166,2709,4484506
2021-04-23,uk,Europe,68550166,2409,4486915
2021-04-24,uk,Europe,68550166,2020,4488935
2021-04-25,uk,Europe,68550166,1564,4490499
2021-04-26,uk,Europe,68550166,2119,4492618
2021-04-27,uk,Europe,68550166,2627,4495245
2021-04-28,uk,Europe,68550166,2177,4497422
2021-04-29,uk,Europe,68550166,2499,4499921
2021-04-30,uk,Europe,68550166,2230,4502151
2021-05-01,uk,Europe,68550166,1825,4503976
2021-05-02,uk,Europe,68550166,1431,4505407
2021-05-03,uk,Europe,68550166,1521,4506928
2021-05-04,uk,Europe,68550166,2084,4509012
2021-05-05,uk,Europe,68550166,2550,4511562
2021-05-06,uk,Europe,68550166,2568,4514130
2021-05-07,uk,Europe,68550166,2325,4516455
2021-05-08,uk,Europe,68550166,1981,4518436
2021-05-09,uk,Europe,68550166,1606,4520042
2021-05-10,uk,Europe,68550166,2307,4522349
2021-05-11,uk,Europe,68550166,2808,4525157
2021-05-12,uk,Europe,68550166,2328,4527485
2021-05-13,uk,Europe,68550166,2335,4529820
2021-05-14,uk,Europe,68550166,2182,4532002
2021-05-15,uk,Europe,68550166,1936,4533938
2021-05-16,uk,Europe,68550166,1626,4535564
2021-05-17,uk,Europe,68550166,1922,4537486
2021-05-18,uk,Europe,68550166,2858,4540344
2021-05-19,uk,Europe,68550166,2812,4543156
2021-05-20,uk,Europe,68550166,2812,4545968
2021-05-21,uk,Europe,68550166,2517,4548485
2021-05-22,uk,Europe,68550166,2365,4550850
2021-05-23,uk,Europe,68550166,2000,4552850
2021-05-24,uk,Europe,68550166,2326,4555176
2021-05-25,uk,Europe,68550166,3368,4558544
2021-05-26,uk,Europe,68550166,3427,4561971
2021-05-27,uk,Europe,68550166,3921,4565892
2021-05-28,uk,Europe,68550166,3747,4569639
2021-05-29,uk,Europe,68550166,3589,4573228
2021-05-30,uk,Europe,68550166,2999,4576227
2021-05-31,uk,Europe,68550166,3164,4579391
2021-06-01,uk,Europe,68550166,3897,4583288
2021-06-02,uk,Europe,68550166,5431,4588719
2021-06-03,uk,Europe,68550166,6168,4594887
2021-06-04,uk,Europe,68550166,6256,4601143
2021-06-05,uk,Europe,68550166,5860,4607003
2021-06-06,uk,Europe,68550166,4731,4611734
2021-06-07,uk,Europe,68550166,5533,4617267
2021-06-08,uk,Europe,68550166,7945,4625212
2021-06-09,uk,Europe,68550166,7896,4633108
2021-06-10,uk,Europe,68550166,8210,4641318
2021-06-11,uk,Europe,68550166,8042,4649360
2021-06-12,uk,Europe,68550166,7619,4656979
2021-06-13,uk,Europe,68550166,6284,4663263
2021-06-14,uk,Europe,68550166,7135,4670398
2021-06-15,uk,Europe,68550166,10362,4680760
2021-06-16,uk,Europe,68550166,10796,4691556
2021-06-17,uk,Europe,68550166,11051,4702607
2021-06-18,uk,Europe,68550166,11106,4713713
2021-06-19,uk,Europe,68550166,10320,4724033
2021-06-20,uk,Europe,68550166,8445,4732478
2021-06-21,uk,Europe,68550166,10087,4742565
2021-06-22,uk,Europe,68550166,16307,4758872
2021-06-23,uk,Europe,68550166,17403,4776275
2021-06-24,uk,Europe,68550166,18350,4794625
2021-06-25,uk,Europe,68550166,18712,4813337
2021-06-26,uk,Europe,68550166,18169,4831506
2021-06-27,uk,Europe,68550166,16300,4847806
2021-06-28,uk,Europe,68550166,18502,4866308
2021-06-29,uk,Europe,68550166,28418,4894726
2021-06-30,uk,Europe,68550166,28199,4922925
2021-07-01,uk,Europe,68550166,28922,4951847
2021-07-02,uk,Europe,68550166,28794,4980641
2021-07-03,uk,Europe,68550166,26340,5006981
2021-07-04,uk,Europe,68550166,24007,5030988
2021-07-05,uk,Europe,68550166,25155,5056143
2021-07-06,uk,Europe,68550166,34897,5091040
2021-07-07,uk,Europe,68550166,36040,5127080
2021-07-08,uk,Europe,68550166,38593,5165673
2021-07-09,uk,Europe,68550166,33999,5199672
2021-07-10,uk,Europe,68550166,32799,5232471
2021-07-11,uk,Europe,68550166,28373,5260844
2021-07-12,uk,Europe,68550166,30502,5291346
2021-07-13,uk,Europe,68550166,44505,5335851
2021-07-14,uk,Europe,68550166,47703,5383554
2021-07-15,uk,Europe,68550166,54909,5438463
2021-07-16,uk,Europe,68550166,61996,5500459
2021-07-17,uk,Europe,68550166,55262,5555721
2021-07-18,uk,Europe,68550166,38473,5594194
2021-07-19,uk,Europe,68550166,36180,5630374
2021-07-20,uk,Europe,68550166,47910,5678284
2021-07-21,uk,Europe,68550166,39869,5718153
2021-07-22,uk,Europe,68550166,35535,5753688
2021-07-23,uk,Europe,68550166,31274,5784962
2021-07-24,uk,Europe,68550166,27764,5812726
2021-07-25,uk,Europe,68550166,22848,5835574
2021-07-26,uk,Europe,68550166,22172,5857746
2021-07-27,uk,Europe,68550166,29977,5887723
2021-07-28,uk,Europe,68550166,29574,5917297
2021-07-29,uk,Europe,68550166,30235,5947532
2021-07-30,uk,Europe,68550166,28429,5975961
2021-07-31,uk,Europe,68550166,24745,6000706
2021-08-01,uk,Europe,68550166,20568,6021274
2021-08-02,uk,Europe,68550166,20899,6042173
2021-08-03,uk,Europe,68550166,29834,6072007
2021-08-04,uk,Europe,68550166,30445,6102452
2021-08-05,uk,Europe,68550166,32337,6134789
2021-08-06,uk,Europe,68550166,31660,6166449
2021-08-07,uk,Europe,68550166,28057,6194506
2021-08-08,uk,Europe,68550166,22566,6217072
2021-08-09,uk,Europe,68550166,22884,6239956
2021-08-10,uk,Europe,68550166,32157,6272113
2021-08-11,uk,Europe,68550166,31514,6303627
2021-08-12,uk,Europe,68550166,33346,6336973
2021-08-13,uk,Europe,68550166,31722,6368695
2021-08-14,uk,Europe,68550166,28968,6397663
2021-08-15,uk,Europe,68550166,25057,6422720
2021-08-16,uk,Europe,68550166,25321,6448041
2021-08-17,uk,Europe,68550166,36895,6484936
2021-08-18,uk,Europe,68550166,37909,6522845
2021-08-19,uk,Europe,68550166,38735,6561580
2021-08-20,uk,Europe,68550166,36483,6598063
2021-08-21,uk,Europe,68550166,32223,6630286
2021-08-22,uk,Europe,68550166,28515,6658801
2021-08-23,uk,Europe,68550166,28727,6687528
2021-08-24,uk,Europe,68550166,39710,6727238
2021-08-25,uk,Europe,68550166,37671,6764909
2021-08-26,uk,Europe,68550166,38768,6803677
2021-08-27,uk,Europe,68550166,37607,6841284
2021-08-28,uk,Europe,68550166,33734,6875018
2021-08-29,uk,Europe,68550166,27592,6902610
2021-08-30,uk,Europe,68550166,26131,6928741
2021-08-31,uk,Europe,68550166,34755,6963496
2021-09-01,uk,Europe,68550166,45204,7008700
2021-09-02,uk,Europe,68550166,43515,7052215
2021-09-03,uk,Europe,68550166,42310,7094525
2021-09-04,uk,Europe,68550166,38626,7133151
2021-09-05,uk,Europe,68550166,31803,7164954
2021-09-06,uk,Europe,68550166,31799,7196753
2021-09-07,uk,Europe,68550166,44915,7241668
2021-09-08,uk,Europe,68550166,38610,7280278
2021-09-09,uk,Europe,68550166,35839,7316117
2021-09-10,uk,Europe,68550166,33964,7350081
2021-09-11,uk,Europe,68550166,29175,7379256
2021-09-12,uk,Europe,68550166,23531,7402787
2021-09-13,uk,Europe,68550166,24053,7426840
2021-09-14,uk,Europe,68550166,34651,7461491
2021-09-15,uk,Europe,68550166,31417,7492908
2021-09-16,uk,Europe,68550166,30375,7523283
2021-09-17,uk,Europe,68550166,29548,7552831
2021-09-18,uk,Europe,68550166,29464,7582295
2021-09-19,uk,Europe,68550166,26639,7608934
2021-09-20,uk,Europe,68550166,31083,7640017
2021-09-21,uk,Europe,68550166,40756,7680773
2021-09-22,uk,Europe,68550166,38835,7719608
2021-09-23,uk,Europe,68550166,36749,7756357
2021-09-24,uk,Europe,68550166,35837,7792194
2021-09-25,uk,Europe,68550166,32096,7824290
2021-09-26,uk,Europe,68550166,28560,7852850
2021-09-27,uk,Europe,68550166,32064,7884914
2021-09-28,uk,Europe,68550166,41579,7926493
2021-09-29,uk,Europe,68550166,36540,7963033
2021-09-30,uk,Europe,68550166,34819,7997852
2021-10-01,uk,Europe,68550166,32587,8030439
2021-10-02,uk,Europe,68550166,29051,8059490
2021-10-03,uk,Europe,68550166,26309,8085799
2021-10-04,uk,Europe,68550166,32051,8117850
2021-10-05,uk,Europe,68550166,43727,8161577
2021-10-06,uk,Europe,68550166,39263,8200840
2021-10-07,uk,Europe,68550166,39255,8240095
2021-10-08,uk,Europe,68550166,38462,8278557
2021-10-09,uk,Europe,68550166,35597,8314154
2021-10-10,uk,Europe,68550166,32296,8346450
2021-10-11,uk,Europe,68550166,36406,8382856
2021-10-12,uk,Europe,68550166,50285,8433141
2021-10-13,uk,Europe,68550166,48299,8481440
2021-10-14,uk,Europe,68550166,47765,8529205
2021-10-15,uk,Europe,68550166,46413,8575618
2021-10-16,uk,Europe,68550166,43546,8619164
2021-10-17,uk,Europe,68550166,37872,8657036
2021-10-18,uk,Europe,68550166,43747,8700783
2021-10-19,uk,Europe,68550166,57728,8758511
2021-10-20,uk,Europe,68550166,52511,8811022
2021-10-21,uk,Europe,68550166,51650,8862672
2021-10-22,uk,Europe,68550166,45193,8907865
2021-10-23,uk,Europe,68550166,40658,8948523
2021-10-24,uk,Europe,68550166,35096,8983619
2021-10-25,uk,Europe,68550166,35757,9019376
2021-10-26,uk,Europe,68550166,47447,9066823
2021-10-27,uk,Europe,68550166,42109,9108932
2021-10-28,uk,Europe,68550166,43035,9151967
2021-10-29,uk,Europe,68550166,41375,9193342
2021-10-30,uk,Europe,68550166,40241,9233583
2021-10-31,uk,Europe,68550166,33556,9267139
2021-11-01,uk,Europe,68550166,34794,9301933
2021-11-02,uk,Europe,68550166,45102,9347035
2021-11-03,uk,Europe,68550166,38006,9385041
2021-11-04,uk,Europe,68550166,35972,9421013
2021-11-05,uk,Europe,68550166,33652,9454665
2021-11-06,uk,Europe,68550166,30313,9484978
2021-11-07,uk,Europe,68550166,27430,9512408
2021-11-08,uk,Europe,68550166,30584,9542992
2021-11-09,uk,Europe,68550166,44124,9587116
2021-11-10,uk,Europe,68550166,42242,9629358
2021-11-11,uk,Europe,68550166,42931,9672289
2021-11-12,uk,Europe,68550166,40986,9713275
2021-11-13,uk,Europe,68550166,37757,9751032
2021-11-14,uk,Europe,68550166,32879,9783911
2021-11-15,uk,Europe,68550166,35508,9819419
2021-11-16,uk,Europe,68550166,50946,9870365
2021-11-17,uk,Europe,68550166,46421,9916786
2021-11-18,uk,Europe,68550166,45887,9962673
2021-11-19,uk,Europe,68550166,44055,10006728
2021-11-20,uk,Europe,68550166,39588,10046316
2021-11-21,uk,Europe,68550166,35327,10081643
2021-11-22,uk,Europe,68550166,37245,10118888
2021-11-23,uk,Europe,68550166,50724,10169612
2021-11-24,uk,Europe,68550166,48185,10217797
2021-11-25,uk,Europe,68550166,46760,10264557
2021-11-26,uk,Europe,68550166,43413,10307970
2021-11-27,uk,Europe,68550166,39326,10347296
2021-11-28,uk,Europe,68550166,33290,10380586
2021-11-29,uk,Europe,68550166,39692,10420278
2021-11-30,uk,Europe,68550166,56289,10476567
2021-12-01,uk,Europe,68550166,55687,10532254
2021-12-02,uk,Europe,68550166,54813,10587067
2021-12-03,uk,Europe,68550166,50310,10637377
2021-12-04,uk,Europe,68550166,45660,10683037
2021-12-05,uk,Europe,68550166,38780,10721817
2021-12-06,uk,Europe,68550166,41014,10762831
2021-12-07,uk,Europe,68550166,59667,10822498
2021-12-08,uk,Europe,68550166,56230,10878728
2021-12-09,uk,Europe,68550166,58796,10937524
2021-12-10,uk,Europe,68550166,56978,10994502
2021-12-11,uk,Europe,68550166,52476,11046978
2021-12-12,uk,Europe,68550166,48590,11095568
2021-12-13,uk,Europe,68550166,53141,11148709
2021-12-14,uk,Europe,68550166,87158,11235867
2021-12-15,uk,Europe,68550166,102754,11338621
2021-12-16,uk,Europe,68550166,112672,11451293
2021-12-17,uk,Europe,68550166,106035,11557328
2020-03-29,uruguay,South America,3496151,0,304
2020-03-30,uruguay,South America,3496151,16,320
2020-03-31,uruguay,South America,3496151,18,338
2020-04-01,uruguay,South America,3496151,12,350
2020-04-02,uruguay,South America,3496151,0,350
2020-04-03,uruguay,South America,3496151,36,386
2020-04-04,uruguay,South America,3496151,14,400
2020-04-05,uruguay,South America,3496151,6,406
2020-04-06,uruguay,South America,3496151,9,415
2020-04-07,uruguay,South America,3496151,9,424
2020-04-08,uruguay,South America,3496151,32,456
2020-04-09,uruguay,South America,3496151,0,456
2020-04-10,uruguay,South America,3496151,17,473
2020-04-11,uruguay,South America,3496151,21,494
2020-04-12,uruguay,South America,3496151,18,512
2020-04-14,uruguay,South America,3496151,9,492
2020-04-15,uruguay,South America,3496151,1,493
2020-04-16,uruguay,South America,3496151,9,502
2020-04-17,uruguay,South America,3496151,0,502
2020-04-18,uruguay,South America,3496151,15,517
2020-04-19,uruguay,South America,3496151,0,517
2020-04-20,uruguay,South America,3496151,18,535
2020-04-21,uruguay,South America,3496151,8,543
2020-04-22,uruguay,South America,3496151,6,549
2020-04-23,uruguay,South America,3496151,0,549
2020-04-24,uruguay,South America,3496151,14,563
2020-04-25,uruguay,South America,3496151,0,563
2020-04-26,uruguay,South America,3496151,33,596
2020-04-27,uruguay,South America,3496151,10,606
2020-04-28,uruguay,South America,3496151,14,620
2020-04-29,uruguay,South America,3496151,5,625
2020-04-30,uruguay,South America,3496151,18,643
2020-05-01,uruguay,South America,3496151,5,648
2020-05-02,uruguay,South America,3496151,4,652
2020-05-03,uruguay,South America,3496151,3,655
2020-05-04,uruguay,South America,3496151,2,657
2020-02-20,usa,North America,334617623,0,15
2020-02-21,usa,North America,334617623,20,35
2020-02-22,usa,North America,334617623,0,35
2020-02-23,usa,North America,334617623,0,35
2020-02-24,usa,North America,334617623,18,53
2020-02-25,usa,North America,334617623,4,57
2020-02-26,usa,North America,334617623,3,60
2020-02-27,usa,North America,334617623,0,60
2020-02-28,usa,North America,334617623,3,63
2020-02-29,usa,North America,334617623,5,68
2020-03-01,usa,North America,334617623,7,75
2020-03-02,usa,North America,334617623,25,100
2020-03-03,usa,North America,334617623,24,124
2020-03-04,usa,North America,334617623,34,158
2020-03-05,usa,North America,334617623,63,221
2020-03-06,usa,North America,334617623,98,319
2020-03-07,usa,North America,334617623,116,435
2020-03-08,usa,North America,334617623,106,541
2020-03-09,usa,North America,334617623,163,704
2020-03-10,usa,North America,334617623,290,994
2020-03-11,usa,North America,334617623,307,1301
2020-03-12,usa,North America,334617623,1138,2439
2020-03-13,usa,North America,334617623,728,3167
2020-03-14,usa,North America,334617623,824,3991
2020-03-15,usa,North America,334617623,1039,5030
2020-03-16,usa,North America,334617623,1338,6368
2020-03-17,usa,North America,334617623,2471,8839
2020-03-18,usa,North America,334617623,3750,12589
2020-03-19,usa,North America,334617623,5322,17911
2020-03-20,usa,North America,334617623,6531,24442
2020-03-21,usa,North America,334617623,5856,30298
2020-03-22,usa,North America,334617623,10166,40464
2020-03-23,usa,North America,334617623,11649,52113
2020-03-24,usa,North America,334617623,12874,64987
2020-03-25,usa,North America,334617623,14882,79869
2020-03-26,usa,North America,334617623,18735,98604
2020-03-27,usa,North America,334617623,20307,118911
2020-03-28,usa,North America,334617623,20124,139035
2020-03-29,usa,North America,334617623,20776,159811
2020-03-30,usa,North America,334617623,24085,183896
2020-03-31,usa,North America,334617623,26759,210655
2020-04-01,usa,North America,334617623,27864,238519
2020-04-02,usa,North America,334617623,28959,267478
2020-04-03,usa,North America,334617623,33891,301369
2020-04-04,usa,North America,334617623,33481,334850
2020-04-05,usa,North America,334617623,26910,361760
2020-04-06,usa,North America,334617623,31645,393405
2020-04-07,usa,North America,334617623,34177,427582
2020-04-08,usa,North America,334617623,32954,460536
2020-04-09,usa,North America,334617623,34276,494812
2020-04-10,usa,North America,334617623,34274,529086
2020-04-11,usa,North America,334617623,30589,559675
2020-04-12,usa,North America,334617623,26280,585955
2020-04-13,usa,North America,334617623,27574,613529
2020-04-14,usa,North America,334617623,29793,643322
2020-04-15,usa,North America,334617623,32172,675494
2020-04-16,usa,North America,334617623,31074,706568
2020-04-17,usa,North America,334617623,33951,740519
2020-04-18,usa,North America,334617623,29579,770098
2020-04-19,usa,North America,334617623,26055,796153
2020-04-20,usa,North America,334617623,28613,824766
2020-04-21,usa,North America,334617623,27669,852435
2020-04-22,usa,North America,334617623,31954,884389
2020-04-23,usa,North America,334617623,34544,918933
2020-04-24,usa,North America,334617623,34882,953815
2020-04-25,usa,North America,334617623,35536,989351
2020-04-26,usa,North America,334617623,27458,1016809
2020-04-27,usa,North America,334617623,24419,1041228
2020-04-28,usa,North America,334617623,26967,1068195
2020-04-29,usa,North America,334617623,30351,1098546
2020-04-30,usa,North America,334617623,31563,1130109
2020-05-01,usa,North America,334617623,35448,1165557
2020-05-02,usa,North America,334617623,28867,1194424
2020-05-03,usa,North America,334617623,26216,1220640
2020-05-04,usa,North America,334617623,24778,1245418
2020-05-05,usa,North America,334617623,26019,1271437
2020-05-06,usa,North America,334617623,26061,1297498
2020-05-07,usa,North America,334617623,29922,1327420
2020-05-08,usa,North America,334617623,29204,1356624
2020-05-09,usa,North America,334617623,25440,1382064
2020-05-10,usa,North America,334617623,20489,1402553
2020-05-11,usa,North America,334617623,18651,1421204
2020-05-12,usa,North America,334617623,24575,1445779
2020-05-13,usa,North America,334617623,23304,1469083
2020-05-14,usa,North America,334617623,27213,1496296
2020-05-15,usa,North America,334617623,28238,1524534
2020-05-16,usa,North America,334617623,24179,1548713
2020-05-17,usa,North America,334617623,20550,1569263
2020-05-18,usa,North America,334617623,23040,1592303
2020-05-19,usa,North America,334617623,22633,1614936
2020-05-20,usa,North America,334617623,23566,1638502
2020-05-21,usa,North America,334617623,28069,1666571
2020-05-22,usa,North America,334617623,25656,1692227
2020-05-23,usa,North America,334617623,22481,1714708
2020-05-24,usa,North America,334617623,19486,1734194
2020-05-25,usa,North America,334617623,18620,1752814
2020-05-26,usa,North America,334617623,19041,1771855
2020-05-27,usa,North America,334617623,21361,1793216
2020-05-28,usa,North America,334617623,24334,1817550
2020-05-29,usa,North America,334617623,26342,1843892
2020-05-30,usa,North America,334617623,24250,1868142
2020-05-31,usa,North America,334617623,20900,1889042
2020-06-01,usa,North America,334617623,18330,1907372
2020-06-02,usa,North America,334617623,23665,1931037
2020-06-03,usa,North America,334617623,21756,1952793
2020-06-04,usa,North America,334617623,23397,1976190
2020-06-05,usa,North America,334617623,25621,2001811
2020-06-06,usa,North America,334617623,23345,2025156
2020-06-07,usa,North America,334617623,19577,2044733
2020-06-08,usa,North America,334617623,18672,2063405
2020-06-09,usa,North America,334617623,20092,2083497
2020-06-10,usa,North America,334617623,22529,2106026
2020-06-11,usa,North America,334617623,24272,2130298
2020-06-12,usa,North America,334617623,27198,2157496
2020-06-13,usa,North America,334617623,26008,2183504
2020-06-14,usa,North America,334617623,20010,2203514
2020-06-15,usa,North America,334617623,20531,2224045
2020-06-16,usa,North America,334617623,27805,2251850
2020-06-17,usa,North America,334617623,28314,2280164
2020-06-18,usa,North America,334617623,29905,2310069
2020-06-19,usa,North America,334617623,35528,2345597
2020-06-20,usa,North America,334617623,35439,2381036
2020-06-21,usa,North America,334617623,27733,2408769
2020-06-22,usa,North America,334617623,32257,2441026
2020-06-23,usa,North America,334617623,38008,2479034
2020-06-24,usa,North America,334617623,41105,2520139
2020-06-25,usa,North America,334617623,42463,2562602
2020-06-26,usa,North America,334617623,49001,2611603
2020-06-27,usa,North America,334617623,46973,2658576
2020-06-28,usa,North America,334617623,42048,2700624
2020-06-29,usa,North America,334617623,42863,2743487
2020-06-30,usa,North America,334617623,51408,2794895
2020-07-01,usa,North America,334617623,55053,2849948
2020-07-02,usa,North America,334617623,61092,2911040
2020-07-03,usa,North America,334617623,62147,2973187
2020-07-04,usa,North America,334617623,52932,3026119
2020-07-05,usa,North America,334617623,45790,3071909
2020-07-06,usa,North America,334617623,52394,3124303
2020-07-07,usa,North America,334617623,60546,3184849
2020-07-08,usa,North America,334617623,66251,3251100
2020-07-09,usa,North America,334617623,65541,3316641
2020-07-10,usa,North America,334617623,74618,3391259
2020-07-11,usa,North America,334617623,65650,3456909
2020-07-12,usa,North America,334617623,59977,3516886
2020-07-13,usa,North America,334617623,63889,3580775
2020-07-14,usa,North America,334617623,71070,3651845
2020-07-15,usa,North America,334617623,75558,3727403
2020-07-16,usa,North America,334617623,75833,3803236
2020-07-17,usa,North America,334617623,77597,3880833
2020-07-18,usa,North America,334617623,67481,3948314
2020-07-19,usa,North America,334617623,63641,4011955
2020-07-20,usa,North America,334617623,60669,4072624
2020-07-21,usa,North America,334617623,71726,4144350
2020-07-22,usa,North America,334617623,75074,4219424
2020-07-23,usa,North America,334617623,72062,4291486
2020-07-24,usa,North America,334617623,80162,4371648
2020-07-25,usa,North America,334617623,72746,4444394
2020-07-26,usa,North America,334617623,54812,4499206
2020-07-27,usa,North America,334617623,58762,4557968
2020-07-28,usa,North America,334617623,69869,4627837
2020-07-29,usa,North America,334617623,69402,4697239
2020-07-30,usa,North America,334617623,70229,4767468
2020-07-31,usa,North America,334617623,74062,4841530
2020-08-01,usa,North America,334617623,62201,4903731
2020-08-02,usa,North America,334617623,48569,4952300
2020-08-03,usa,North America,334617623,48080,5000380
2020-08-04,usa,North America,334617623,57578,5057958
2020-08-05,usa,North America,334617623,58059,5116017
2020-08-06,usa,North America,334617623,60158,5176175
2020-08-07,usa,North America,334617623,65055,5241230
2020-08-08,usa,North America,334617623,59598,5300828
2020-08-09,usa,North America,334617623,47629,5348457
2020-08-10,usa,North America,334617623,48283,5396740
2020-08-11,usa,North America,334617623,57745,5454485
2020-08-12,usa,North America,334617623,57505,5511990
2020-08-13,usa,North America,334617623,55514,5567504
2020-08-14,usa,North America,334617623,62811,5630315
2020-08-15,usa,North America,334617623,56488,5686803
2020-08-16,usa,North America,334617623,38681,5725484
2020-08-17,usa,North America,334617623,40138,5765622
2020-08-18,usa,North America,334617623,46777,5812399
2020-08-19,usa,North America,334617623,46888,5859287
2020-08-20,usa,North America,334617623,47318,5906605
2020-08-21,usa,North America,334617623,53529,5960134
2020-08-22,usa,North America,334617623,45615,6005749
2020-08-23,usa,North America,334617623,35910,6041659
2020-08-24,usa,North America,334617623,39091,6080750
2020-08-25,usa,North America,334617623,44176,6124926
2020-08-26,usa,North America,334617623,45592,6170518
2020-08-27,usa,North America,334617623,46705,6217223
2020-08-28,usa,North America,334617623,49795,6267018
2020-08-29,usa,North America,334617623,45280,6312298
2020-08-30,usa,North America,334617623,35214,6347512
2020-08-31,usa,North America,334617623,36290,6383802
2020-09-01,usa,North America,334617623,43958,6427760
2020-09-02,usa,North America,334617623,43351,6471111
2020-09-03,usa,North America,334617623,46553,6517664
2020-09-04,usa,North America,334617623,54539,6572203
2020-09-05,usa,North America,334617623,44182,6616385
2020-09-06,usa,North America,334617623,32609,6648994
2020-09-07,usa,North America,334617623,24964,6673958
2020-09-08,usa,North America,334617623,29231,6703189
2020-09-09,usa,North America,334617623,37268,6740457
2020-09-10,usa,North America,334617623,40578,6781035
2020-09-11,usa,North America,334617623,49128,6830163
2020-09-12,usa,North America,334617623,42941,6873104
2020-09-13,usa,North America,334617623,33413,6906517
2020-09-14,usa,North America,334617623,36171,6942688
2020-09-15,usa,North America,334617623,40295,6982983
2020-09-16,usa,North America,334617623,42103,7025086
2020-09-17,usa,North America,334617623,47946,7073032
2020-09-18,usa,North America,334617623,49909,7122941
2020-09-19,usa,North America,334617623,45060,7168001
2020-09-20,usa,North America,334617623,33624,7201625
2020-09-21,usa,North America,334617623,35024,7236649
2020-09-22,usa,North America,334617623,38587,7275236
2020-09-23,usa,North America,334617623,43581,7318817
2020-09-24,usa,North America,334617623,46968,7365785
2020-09-25,usa,North America,334617623,52289,7418074
2020-09-26,usa,North America,334617623,45710,7463784
2020-09-27,usa,North America,334617623,33099,7496883
2020-09-28,usa,North America,334617623,37227,7534110
2020-09-29,usa,North America,334617623,45211,7579321
2020-09-30,usa,North America,334617623,43756,7623077
2020-10-01,usa,North America,334617623,47660,7670737
2020-10-02,usa,North America,334617623,51882,7722619
2020-10-03,usa,North America,334617623,49324,7771943
2020-10-04,usa,North America,334617623,34391,7806334
2020-10-05,usa,North America,334617623,40405,7846739
2020-10-06,usa,North America,334617623,47669,7894408
2020-10-07,usa,North America,334617623,51312,7945720
2020-10-08,usa,North America,334617623,60603,8006323
2020-10-09,usa,North America,334617623,60818,8067141
2020-10-10,usa,North America,334617623,56790,8123931
2020-10-11,usa,North America,334617623,42956,8166887
2020-10-12,usa,North America,334617623,46820,8213707
2020-10-13,usa,North America,334617623,56535,8270242
2020-10-14,usa,North America,334617623,60253,8330495
2020-10-15,usa,North America,334617623,67547,8398042
2020-10-16,usa,North America,334617623,72073,8470115
2020-10-17,usa,North America,334617623,62697,8532812
2020-10-18,usa,North America,334617623,48618,8581430
2020-10-19,usa,North America,334617623,55368,8636798
2020-10-20,usa,North America,334617623,66637,8703435
2020-10-21,usa,North America,334617623,68578,8772013
2020-10-22,usa,North America,334617623,77676,8849689
2020-10-23,usa,North America,334617623,82198,8931887
2020-10-24,usa,North America,334617623,82280,9014167
2020-10-25,usa,North America,334617623,63046,9077213
2020-10-26,usa,North America,334617623,69517,9146730
2020-10-27,usa,North America,334617623,80809,9227539
2020-10-28,usa,North America,334617623,85569,9313108
2020-10-29,usa,North America,334617623,95123,9408231
2020-10-30,usa,North America,334617623,102909,9511140
2020-10-31,usa,North America,334617623,91958,9603098
2020-11-01,usa,North America,334617623,77933,9681031
2020-11-02,usa,North America,334617623,86479,9767510
2020-11-03,usa,North America,334617623,103361,9870871
2020-11-04,usa,North America,334617623,113925,9984796
2020-11-05,usa,North America,334617623,129457,10114253
2020-03-28,uzbekistan,Asia,34372515,16,104
2020-03-29,uzbekistan,Asia,34372515,40,144
2020-03-30,uzbekistan,Asia,34372515,5,149
2020-03-31,uzbekistan,Asia,34372515,23,172
2020-04-01,uzbekistan,Asia,34372515,9,181
2020-04-02,uzbekistan,Asia,34372515,24,205
2020-04-03,uzbekistan,Asia,34372515,22,227
2020-04-04,uzbekistan,Asia,34372515,39,266
2020-04-05,uzbekistan,Asia,34372515,76,342
2020-04-06,uzbekistan,Asia,34372515,115,457
2020-04-07,uzbekistan,Asia,34372515,63,520
2020-04-08,uzbekistan,Asia,34372515,25,545
2020-04-09,uzbekistan,Asia,34372515,37,582
2020-04-10,uzbekistan,Asia,34372515,42,624
2020-04-11,uzbekistan,Asia,34372515,143,767
2020-04-12,uzbekistan,Asia,34372515,98,865
2020-04-13,uzbekistan,Asia,34372515,133,998
2020-04-14,uzbekistan,Asia,34372515,167,1165
2020-04-15,uzbekistan,Asia,34372515,137,1302
2020-04-16,uzbekistan,Asia,34372515,47,1349
2020-04-17,uzbekistan,Asia,34372515,56,1405
2020-04-18,uzbekistan,Asia,34372515,85,1490
2020-04-19,uzbekistan,Asia,34372515,75,1565
2020-04-20,uzbekistan,Asia,34372515,62,1627
2020-04-21,uzbekistan,Asia,34372515,51,1678
2020-04-22,uzbekistan,Asia,34372515,38,1716
2020-04-23,uzbekistan,Asia,34372515,42,1758
2020-04-24,uzbekistan,Asia,34372515,46,1804
2020-04-25,uzbekistan,Asia,34372515,58,1862
2020-04-26,uzbekistan,Asia,34372515,7,1869
2020-04-27,uzbekistan,Asia,34372515,35,1904
2020-04-28,uzbekistan,Asia,34372515,35,1939
2020-04-29,uzbekistan,Asia,34372515,63,2002
2020-04-30,uzbekistan,Asia,34372515,37,2039
2020-05-01,uzbekistan,Asia,34372515,47,2086
2020-05-02,uzbekistan,Asia,34372515,32,2118
2020-05-03,uzbekistan,Asia,34372515,31,2149
2020-05-04,uzbekistan,Asia,34372515,40,2189
2020-05-05,uzbekistan,Asia,34372515,18,2207
2020-05-06,uzbekistan,Asia,34372515,26,2233
2020-05-07,uzbekistan,Asia,34372515,65,2298
2020-05-08,uzbekistan,Asia,34372515,27,2325
2020-05-09,uzbekistan,Asia,34372515,24,2349
2020-05-10,uzbekistan,Asia,34372515,69,2418
2020-05-11,uzbekistan,Asia,34372515,68,2486
2020-05-12,uzbekistan,Asia,34372515,33,2519
2020-05-13,uzbekistan,Asia,34372515,93,2612
2020-05-14,uzbekistan,Asia,34372515,33,2645
2020-05-15,uzbekistan,Asia,34372515,41,2686
2020-05-16,uzbekistan,Asia,34372515,52,2738
2020-05-17,uzbekistan,Asia,34372515,15,2753
2020-05-18,uzbekistan,Asia,34372515,38,2791
2020-05-19,uzbekistan,Asia,34372515,64,2855
2020-05-20,uzbekistan,Asia,34372515,84,2939
2020-05-21,uzbekistan,Asia,34372515,25,2964
2020-05-22,uzbekistan,Asia,34372515,64,3028
2020-05-23,uzbekistan,Asia,34372515,87,3115
2020-05-24,uzbekistan,Asia,34372515,49,3164
2020-05-25,uzbekistan,Asia,34372515,25,3189
2020-05-26,uzbekistan,Asia,34372515,101,3290
2020-05-27,uzbekistan,Asia,34372515,79,3369
2020-05-28,uzbekistan,Asia,34372515,75,3444
2020-05-29,uzbekistan,Asia,34372515,24,3468
2020-05-30,uzbekistan,Asia,34372515,78,3546
2020-05-31,uzbekistan,Asia,34372515,77,3623
2020-06-01,uzbekistan,Asia,34372515,79,3702
2020-06-02,uzbekistan,Asia,34372515,58,3760
2020-06-03,uzbekistan,Asia,34372515,83,3843
2020-06-04,uzbekistan,Asia,34372515,96,3939
2020-06-05,uzbekistan,Asia,34372515,68,4007
2020-06-06,uzbekistan,Asia,34372515,87,4094
2020-06-07,uzbekistan,Asia,34372515,237,4331
2020-06-08,uzbekistan,Asia,34372515,109,4440
2020-06-09,uzbekistan,Asia,34372515,80,4520
2020-06-10,uzbekistan,Asia,34372515,103,4623
2020-06-11,uzbekistan,Asia,34372515,118,4741
2020-06-12,uzbekistan,Asia,34372515,128,4869
2020-06-13,uzbekistan,Asia,34372515,97,4966
2020-06-14,uzbekistan,Asia,34372515,114,5080
2020-06-15,uzbekistan,Asia,34372515,183,5263
2020-06-16,uzbekistan,Asia,34372515,230,5493
2020-06-17,uzbekistan,Asia,34372515,189,5682
2020-06-18,uzbekistan,Asia,34372515,85,5767
2020-06-19,uzbekistan,Asia,34372515,179,5946
2020-06-20,uzbekistan,Asia,34372515,207,6153
2020-06-21,uzbekistan,Asia,34372515,162,6315
2020-06-22,uzbekistan,Asia,34372515,146,6461
2020-06-23,uzbekistan,Asia,34372515,201,6662
2020-06-24,uzbekistan,Asia,34372515,239,6901
2020-06-25,uzbekistan,Asia,34372515,276,7177
2020-06-26,uzbekistan,Asia,34372515,250,7427
2020-06-27,uzbekistan,Asia,34372515,255,7682
2020-06-28,uzbekistan,Asia,34372515,266,7948
2020-06-29,uzbekistan,Asia,34372515,274,8222
2020-06-30,uzbekistan,Asia,34372515,281,8503
2020-07-01,uzbekistan,Asia,34372515,278,8781
2020-07-02,uzbekistan,Asia,34372515,297,9078
2020-07-03,uzbekistan,Asia,34372515,318,9396
2020-07-04,uzbekistan,Asia,34372515,312,9708
2020-07-05,uzbekistan,Asia,34372515,312,10020
2020-07-06,uzbekistan,Asia,34372515,342,10362
2020-07-07,uzbekistan,Asia,34372515,308,10670
2020-07-08,uzbekistan,Asia,34372515,422,11092
2020-07-09,uzbekistan,Asia,34372515,472,11564
2020-07-10,uzbekistan,Asia,34372515,463,12027
2020-07-11,uzbekistan,Asia,34372515,486,12513
2020-07-12,uzbekistan,Asia,34372515,484,12997
2020-07-13,uzbekistan,Asia,34372515,594,13591
2020-07-14,uzbekistan,Asia,34372515,494,14085
2020-07-15,uzbekistan,Asia,34372515,496,14581
2020-07-16,uzbekistan,Asia,34372515,485,15066
2020-07-17,uzbekistan,Asia,34372515,541,15607
2020-07-18,uzbekistan,Asia,34372515,579,16186
2020-07-19,uzbekistan,Asia,34372515,421,16607
2020-07-20,uzbekistan,Asia,34372515,707,17314
2020-07-21,uzbekistan,Asia,34372515,567,17881
2020-07-22,uzbekistan,Asia,34372515,498,18379
2020-07-23,uzbekistan,Asia,34372515,489,18868
2020-07-24,uzbekistan,Asia,34372515,492,19360
2020-07-25,uzbekistan,Asia,34372515,592,19952
2020-07-26,uzbekistan,Asia,34372515,579,20531
2020-07-27,uzbekistan,Asia,34372515,678,21209
2020-07-28,uzbekistan,Asia,34372515,684,21893
2020-07-29,uzbekistan,Asia,34372515,692,22585
2020-07-30,uzbekistan,Asia,34372515,686,23271
2020-07-31,uzbekistan,Asia,34372515,738,24009
2020-08-01,uzbekistan,Asia,34372515,774,24783
2020-08-02,uzbekistan,Asia,34372515,553,25336
2020-08-03,uzbekistan,Asia,34372515,730,26066
2020-08-04,uzbekistan,Asia,34372515,981,27047
2020-08-05,uzbekistan,Asia,34372515,746,27793
2020-08-06,uzbekistan,Asia,34372515,522,28315
2020-08-07,uzbekistan,Asia,34372515,742,29057
2020-08-08,uzbekistan,Asia,34372515,595,29652
2020-08-09,uzbekistan,Asia,34372515,957,30609
2020-08-10,uzbekistan,Asia,34372515,695,31304
2020-08-11,uzbekistan,Asia,34372515,443,31747
2020-08-12,uzbekistan,Asia,34372515,718,32465
2020-08-13,uzbekistan,Asia,34372515,858,33323
2020-08-14,uzbekistan,Asia,34372515,498,33821
2020-08-15,uzbekistan,Asia,34372515,707,34528
2020-08-16,uzbekistan,Asia,34372515,801,35329
2020-08-17,uzbekistan,Asia,34372515,373,35702
2020-08-18,uzbekistan,Asia,34372515,650,36352
2020-08-19,uzbekistan,Asia,34372515,760,37112
2020-08-20,uzbekistan,Asia,34372515,435,37547
2020-08-21,uzbekistan,Asia,34372515,527,38074
2020-08-22,uzbekistan,Asia,34372515,338,38412
2020-08-23,uzbekistan,Asia,34372515,534,38946
2020-08-24,uzbekistan,Asia,34372515,402,39348
2020-08-25,uzbekistan,Asia,34372515,293,39641
2020-08-26,uzbekistan,Asia,34372515,323,39964
2020-08-27,uzbekistan,Asia,34372515,483,40447
2020-08-28,uzbekistan,Asia,34372515,376,40823
2020-08-29,uzbekistan,Asia,34372515,337,41160
2020-08-30,uzbekistan,Asia,34372515,264,41424
2020-08-31,uzbekistan,Asia,34372515,469,41893
2020-09-01,uzbekistan,Asia,34372515,234,42127
2020-09-02,uzbekistan,Asia,34372515,310,42437
2020-09-03,uzbekistan,Asia,34372515,251,42688
2020-09-04,uzbekistan,Asia,34372515,310,42998
2020-09-05,uzbekistan,Asia,34372515,295,43293
2020-09-06,uzbekistan,Asia,34372515,294,43587
2020-09-07,uzbekistan,Asia,34372515,306,43893
2020-09-08,uzbekistan,Asia,34372515,388,44281
2020-09-09,uzbekistan,Asia,34372515,649,44930
2020-09-10,uzbekistan,Asia,34372515,543,45473
2020-09-11,uzbekistan,Asia,34372515,687,46160
2020-09-12,uzbekistan,Asia,34372515,561,46721
2020-09-13,uzbekistan,Asia,34372515,566,47287
2020-09-14,uzbekistan,Asia,34372515,549,47836
2020-09-15,uzbekistan,Asia,34372515,593,48429
2020-09-16,uzbekistan,Asia,34372515,586,49015
2020-09-17,uzbekistan,Asia,34372515,612,49627
2020-09-18,uzbekistan,Asia,34372515,626,50253
2020-09-19,uzbekistan,Asia,34372515,739,50992
2020-09-20,uzbekistan,Asia,34372515,648,51640
2020-09-21,uzbekistan,Asia,34372515,430,52070
2020-09-22,uzbekistan,Asia,34372515,615,52685
2020-09-23,uzbekistan,Asia,34372515,590,53275
2020-09-24,uzbekistan,Asia,34372515,559,53834
2020-09-25,uzbekistan,Asia,34372515,558,54392
2020-09-26,uzbekistan,Asia,34372515,427,54819
2020-09-27,uzbekistan,Asia,34372515,501,55320
2020-09-28,uzbekistan,Asia,34372515,456,55776
2020-09-29,uzbekistan,Asia,34372515,578,56354
2020-09-30,uzbekistan,Asia,34372515,363,56717
2020-10-01,uzbekistan,Asia,34372515,473,57190
2020-10-02,uzbekistan,Asia,34372515,264,57454
2020-10-03,uzbekistan,Asia,34372515,784,58238
2020-10-04,uzbekistan,Asia,34372515,374,58612
2020-10-05,uzbekistan,Asia,34372515,334,58946
2020-10-06,uzbekistan,Asia,34372515,397,59343
2020-10-07,uzbekistan,Asia,34372515,236,59579
2020-10-08,uzbekistan,Asia,34372515,447,60026
2020-10-09,uzbekistan,Asia,34372515,316,60342
2020-10-10,uzbekistan,Asia,34372515,434,60776
2020-10-11,uzbekistan,Asia,34372515,322,61098
2020-10-12,uzbekistan,Asia,34372515,221,61319
2020-10-13,uzbekistan,Asia,34372515,323,61642
2020-10-14,uzbekistan,Asia,34372515,308,61950
2020-10-15,uzbekistan,Asia,34372515,328,62278
2020-10-16,uzbekistan,Asia,34372515,310,62588
2020-10-17,uzbekistan,Asia,34372515,221,62809
2020-10-18,uzbekistan,Asia,34372515,315,63124
2020-10-19,uzbekistan,Asia,34372515,399,63523
2020-10-20,uzbekistan,Asia,34372515,308,63831
2020-10-21,uzbekistan,Asia,34372515,179,64010
2020-10-22,uzbekistan,Asia,34372515,429,64439
2020-10-23,uzbekistan,Asia,34372515,285,64724
2020-10-24,uzbekistan,Asia,34372515,199,64923
2020-10-25,uzbekistan,Asia,34372515,384,65307
2020-10-26,uzbekistan,Asia,34372515,360,65667
2020-10-27,uzbekistan,Asia,34372515,214,65881
2020-10-28,uzbekistan,Asia,34372515,260,66141
2020-10-29,uzbekistan,Asia,34372515,251,66392
2020-10-30,uzbekistan,Asia,34372515,236,66628
2020-10-31,uzbekistan,Asia,34372515,304,66932
2020-11-01,uzbekistan,Asia,34372515,169,67101
2020-11-02,uzbekistan,Asia,34372515,153,67254
2020-11-03,uzbekistan,Asia,34372515,299,67553
2020-11-04,uzbekistan,Asia,34372515,226,67779
2020-11-05,uzbekistan,Asia,34372515,230,68009
2020-11-06,uzbekistan,Asia,34372515,130,68139
2020-11-07,uzbekistan,Asia,34372515,228,68367
2020-11-08,uzbekistan,Asia,34372515,363,68730
2020-11-09,uzbekistan,Asia,34372515,149,68879
2020-11-10,uzbekistan,Asia,34372515,148,69027
2020-11-11,uzbekistan,Asia,34372515,303,69330
2020-11-12,uzbekistan,Asia,34372515,230,69560
2020-11-13,uzbekistan,Asia,34372515,194,69754
2020-11-14,uzbekistan,Asia,34372515,233,69987
2020-11-15,uzbekistan,Asia,34372515,194,70181
2020-11-16,uzbekistan,Asia,34372515,118,70299
2020-11-17,uzbekistan,Asia,34372515,282,70581
2020-11-18,uzbekistan,Asia,34372515,200,70781
2020-11-19,uzbekistan,Asia,34372515,140,70921
2020-11-20,uzbekistan,Asia,34372515,287,71208
2020-11-21,uzbekistan,Asia,34372515,223,71431
2020-11-22,uzbekistan,Asia,34372515,186,71617
2020-11-23,uzbekistan,Asia,34372515,157,71774
2020-11-24,uzbekistan,Asia,34372515,211,71985
2020-11-25,uzbekistan,Asia,34372515,193,72178
2020-11-26,uzbekistan,Asia,34372515,164,72342
2020-11-27,uzbekistan,Asia,34372515,171,72513
2020-11-28,uzbekistan,Asia,34372515,205,72718
2020-11-29,uzbekistan,Asia,34372515,152,72870
2020-11-30,uzbekistan,Asia,34372515,171,73041
2020-12-01,uzbekistan,Asia,34372515,104,73145
2020-12-02,uzbekistan,Asia,34372515,190,73335
2020-12-03,uzbekistan,Asia,34372515,96,73431
2020-12-04,uzbekistan,Asia,34372515,161,73592
2020-12-05,uzbekistan,Asia,34372515,159,73751
2020-12-06,uzbekistan,Asia,34372515,153,73904
2020-12-07,uzbekistan,Asia,34372515,149,74053
2020-12-08,uzbekistan,Asia,34372515,153,74206
2020-12-09,uzbekistan,Asia,34372515,146,74352
2020-12-10,uzbekistan,Asia,34372515,146,74498
2020-12-11,uzbekistan,Asia,34372515,166,74664
2020-12-12,uzbekistan,Asia,34372515,147,74811
2020-12-13,uzbekistan,Asia,34372515,145,74956
2020-12-14,uzbekistan,Asia,34372515,138,75094
2020-12-15,uzbekistan,Asia,34372515,147,75241
2020-12-16,uzbekistan,Asia,34372515,155,75396
2020-12-17,uzbekistan,Asia,34372515,142,75538
2020-12-18,uzbekistan,Asia,34372515,137,75675
2020-12-19,uzbekistan,Asia,34372515,131,75806
2020-12-20,uzbekistan,Asia,34372515,127,75933
2020-12-21,uzbekistan,Asia,34372515,115,76048
2020-12-22,uzbekistan,Asia,34372515,132,76180
2020-12-23,uzbekistan,Asia,34372515,135,76315
2020-12-24,uzbekistan,Asia,34372515,141,76456
2020-12-25,uzbekistan,Asia,34372515,112,76568
2020-12-26,uzbekistan,Asia,34372515,98,76666
2020-12-27,uzbekistan,Asia,34372515,85,76751
2020-12-28,uzbekistan,Asia,34372515,81,76832
2020-12-29,uzbekistan,Asia,34372515,75,76907
2020-12-30,uzbekistan,Asia,34372515,78,76985
2020-12-31,uzbekistan,Asia,34372515,75,77060
2021-01-01,uzbekistan,Asia,34372515,66,77126
2021-01-02,uzbekistan,Asia,34372515,56,77182
2021-01-03,uzbekistan,Asia,34372515,49,77231
2021-01-04,uzbekistan,Asia,34372515,27,77258
2021-01-05,uzbekistan,Asia,34372515,37,77295
2021-01-06,uzbekistan,Asia,34372515,55,77350
2021-01-07,uzbekistan,Asia,34372515,62,77412
2021-01-08,uzbekistan,Asia,34372515,73,77485
2021-01-09,uzbekistan,Asia,34372515,45,77530
2021-01-10,uzbekistan,Asia,34372515,42,77572
2021-01-11,uzbekistan,Asia,34372515,39,77611
2021-01-12,uzbekistan,Asia,34372515,52,77663
2021-01-13,uzbekistan,Asia,34372515,53,77716
2021-01-14,uzbekistan,Asia,34372515,61,77777
2021-01-15,uzbekistan,Asia,34372515,68,77845
2021-01-16,uzbekistan,Asia,34372515,59,77904
2021-01-17,uzbekistan,Asia,34372515,64,77968
2021-01-18,uzbekistan,Asia,34372515,68,78036
2021-01-19,uzbekistan,Asia,34372515,55,78091
2021-01-20,uzbekistan,Asia,34372515,72,78163
2021-01-21,uzbekistan,Asia,34372515,56,78219
2021-01-22,uzbekistan,Asia,34372515,53,78272
2021-01-23,uzbekistan,Asia,34372515,45,78317
2021-01-24,uzbekistan,Asia,34372515,58,78375
2021-01-25,uzbekistan,Asia,34372515,54,78429
2021-01-26,uzbekistan,Asia,34372515,42,78471
2021-01-27,uzbekistan,Asia,34372515,39,78510
2021-01-28,uzbekistan,Asia,34372515,46,78556
2021-01-29,uzbekistan,Asia,34372515,46,78602
2021-01-30,uzbekistan,Asia,34372515,70,78672
2021-01-31,uzbekistan,Asia,34372515,39,78711
2021-02-01,uzbekistan,Asia,34372515,44,78755
2021-02-02,uzbekistan,Asia,34372515,46,78801
2021-02-03,uzbekistan,Asia,34372515,58,78859
2021-02-04,uzbekistan,Asia,34372515,57,78916
2021-02-05,uzbekistan,Asia,34372515,73,78989
2021-02-06,uzbekistan,Asia,34372515,56,79045
2021-02-07,uzbekistan,Asia,34372515,53,79098
2021-02-08,uzbekistan,Asia,34372515,64,79162
2021-02-09,uzbekistan,Asia,34372515,42,79204
2021-02-10,uzbekistan,Asia,34372515,33,79237
2021-02-11,uzbekistan,Asia,34372515,66,79303
2021-02-12,uzbekistan,Asia,34372515,37,79340
2021-02-13,uzbekistan,Asia,34372515,41,79381
2021-02-14,uzbekistan,Asia,34372515,35,79416
2021-02-15,uzbekistan,Asia,34372515,26,79442
2021-02-16,uzbekistan,Asia,34372515,19,79461
2021-02-17,uzbekistan,Asia,34372515,36,79497
2021-02-18,uzbekistan,Asia,34372515,51,79548
2021-02-19,uzbekistan,Asia,34372515,50,79598
2021-02-20,uzbekistan,Asia,34372515,34,79632
2021-02-21,uzbekistan,Asia,34372515,22,79654
2021-02-22,uzbekistan,Asia,34372515,27,79681
2021-02-23,uzbekistan,Asia,34372515,36,79717
2021-02-24,uzbekistan,Asia,34372515,32,79749
2021-02-25,uzbekistan,Asia,34372515,24,79773
2021-02-26,uzbekistan,Asia,34372515,31,79804
2021-02-27,uzbekistan,Asia,34372515,32,79836
2021-02-28,uzbekistan,Asia,34372515,50,79886
2021-03-01,uzbekistan,Asia,34372515,40,79926
2021-03-02,uzbekistan,Asia,34372515,35,79961
2021-03-03,uzbekistan,Asia,34372515,45,80006
2021-03-04,uzbekistan,Asia,34372515,29,80035
2021-03-05,uzbekistan,Asia,34372515,46,80081
2021-03-06,uzbekistan,Asia,34372515,44,80125
2021-03-07,uzbekistan,Asia,34372515,51,80176
2021-03-08,uzbekistan,Asia,34372515,43,80219
2021-03-09,uzbekistan,Asia,34372515,28,80247
2021-03-10,uzbekistan,Asia,34372515,21,80268
2021-03-11,uzbekistan,Asia,34372515,79,80347
2021-03-12,uzbekistan,Asia,34372515,45,80392
2021-03-13,uzbekistan,Asia,34372515,89,80481
2021-03-14,uzbekistan,Asia,34372515,86,80567
2021-03-15,uzbekistan,Asia,34372515,111,80678
2021-03-16,uzbekistan,Asia,34372515,65,80743
2021-03-17,uzbekistan,Asia,34372515,115,80858
2021-03-18,uzbekistan,Asia,34372515,113,80971
2021-03-19,uzbekistan,Asia,34372515,124,81095
2021-03-20,uzbekistan,Asia,34372515,126,81221
2021-03-21,uzbekistan,Asia,34372515,118,81339
2021-03-22,uzbekistan,Asia,34372515,107,81446
2021-03-23,uzbekistan,Asia,34372515,113,81559
2021-03-24,uzbekistan,Asia,34372515,119,81678
2021-03-25,uzbekistan,Asia,34372515,138,81816
2021-03-26,uzbekistan,Asia,34372515,144,81960
2021-03-27,uzbekistan,Asia,34372515,186,82146
2021-03-28,uzbekistan,Asia,34372515,194,82340
2021-03-29,uzbekistan,Asia,34372515,196,82536
2021-03-30,uzbekistan,Asia,34372515,146,82682
2021-03-31,uzbekistan,Asia,34372515,187,82869
2021-04-01,uzbekistan,Asia,34372515,181,83050
2021-04-02,uzbekistan,Asia,34372515,189,83239
2021-04-03,uzbekistan,Asia,34372515,196,83435
2021-04-04,uzbekistan,Asia,34372515,188,83623
2021-04-05,uzbekistan,Asia,34372515,179,83802
2021-04-06,uzbekistan,Asia,34372515,133,83935
2021-04-07,uzbekistan,Asia,34372515,192,84127
2021-04-08,uzbekistan,Asia,34372515,195,84322
2021-04-09,uzbekistan,Asia,34372515,207,84529
2021-04-10,uzbekistan,Asia,34372515,195,84724
2021-04-11,uzbekistan,Asia,34372515,198,84922
2021-04-12,uzbekistan,Asia,34372515,192,85114
2021-04-13,uzbekistan,Asia,34372515,177,85291
2021-04-14,uzbekistan,Asia,34372515,212,85503
2021-04-15,uzbekistan,Asia,34372515,227,85730
2021-04-16,uzbekistan,Asia,34372515,292,86022
2021-04-17,uzbekistan,Asia,34372515,316,86338
2021-04-18,uzbekistan,Asia,34372515,342,86680
2021-04-19,uzbekistan,Asia,34372515,302,86982
2021-04-20,uzbekistan,Asia,34372515,243,87225
2021-04-21,uzbekistan,Asia,34372515,326,87551
2021-04-22,uzbekistan,Asia,34372515,384,87935
2021-04-23,uzbekistan,Asia,34372515,345,88280
2021-04-24,uzbekistan,Asia,34372515,399,88679
2021-04-25,uzbekistan,Asia,34372515,348,89027
2021-04-26,uzbekistan,Asia,34372515,328,89355
2021-04-27,uzbekistan,Asia,34372515,275,89630
2021-04-28,uzbekistan,Asia,34372515,378,90008
2021-04-29,uzbekistan,Asia,34372515,398,90406
2021-04-30,uzbekistan,Asia,34372515,402,90808
2021-05-01,uzbekistan,Asia,34372515,442,91250
2021-05-02,uzbekistan,Asia,34372515,393,91643
2021-05-03,uzbekistan,Asia,34372515,363,92006
2021-05-04,uzbekistan,Asia,34372515,314,92320
2021-05-05,uzbekistan,Asia,34372515,404,92724
2021-05-06,uzbekistan,Asia,34372515,452,93176
2021-05-07,uzbekistan,Asia,34372515,421,93597
2021-05-08,uzbekistan,Asia,34372515,381,93978
2021-05-09,uzbekistan,Asia,34372515,419,94397
2021-05-10,uzbekistan,Asia,34372515,362,94759
2021-05-11,uzbekistan,Asia,34372515,313,95072
2021-05-12,uzbekistan,Asia,34372515,395,95467
2021-05-13,uzbekistan,Asia,34372515,359,95826
2021-05-14,uzbekistan,Asia,34372515,291,96117
2021-05-15,uzbekistan,Asia,34372515,251,96368
2021-05-16,uzbekistan,Asia,34372515,302,96670
2021-05-17,uzbekistan,Asia,34372515,223,96893
2021-05-18,uzbekistan,Asia,34372515,175,97068
2021-05-19,uzbekistan,Asia,34372515,212,97280
2021-05-20,uzbekistan,Asia,34372515,263,97543
2021-05-21,uzbekistan,Asia,34372515,313,97856
2021-05-22,uzbekistan,Asia,34372515,308,98164
2021-05-23,uzbekistan,Asia,34372515,287,98451
2021-05-24,uzbekistan,Asia,34372515,206,98657
2021-05-25,uzbekistan,Asia,34372515,192,98849
2021-05-26,uzbekistan,Asia,34372515,215,99064
2021-05-27,uzbekistan,Asia,34372515,280,99344
2021-05-28,uzbekistan,Asia,34372515,236,99580
2021-05-29,uzbekistan,Asia,34372515,264,99844
2021-05-30,uzbekistan,Asia,34372515,280,100124
2021-05-31,uzbekistan,Asia,34372515,211,100335
2021-06-01,uzbekistan,Asia,34372515,160,100495
2021-06-02,uzbekistan,Asia,34372515,231,100726
2021-06-03,uzbekistan,Asia,34372515,271,100997
2021-06-04,uzbekistan,Asia,34372515,201,101198
2021-06-05,uzbekistan,Asia,34372515,238,101436
2021-06-06,uzbekistan,Asia,34372515,286,101722
2021-06-07,uzbekistan,Asia,34372515,242,101964
2021-06-08,uzbekistan,Asia,34372515,199,102163
2021-06-09,uzbekistan,Asia,34372515,199,102362
2021-06-10,uzbekistan,Asia,34372515,243,102605
2021-06-11,uzbekistan,Asia,34372515,287,102892
2021-06-12,uzbekistan,Asia,34372515,314,103206
2021-06-13,uzbekistan,Asia,34372515,304,103510
2021-06-14,uzbekistan,Asia,34372515,303,103813
2021-06-15,uzbekistan,Asia,34372515,300,104113
2020-03-27,venezuela,South America,28285909,6,113
2020-03-28,venezuela,South America,28285909,6,119
2020-03-29,venezuela,South America,28285909,0,119
2020-03-30,venezuela,South America,28285909,16,135
2020-03-31,venezuela,South America,28285909,0,135
2020-04-01,venezuela,South America,28285909,9,144
2020-04-02,venezuela,South America,28285909,2,146
2020-04-03,venezuela,South America,28285909,7,153
2020-04-04,venezuela,South America,28285909,2,155
2020-04-05,venezuela,South America,28285909,4,159
2020-04-06,venezuela,South America,28285909,6,165
2020-04-07,venezuela,South America,28285909,1,166
2020-04-08,venezuela,South America,28285909,1,167
2020-04-09,venezuela,South America,28285909,4,171
2020-04-10,venezuela,South America,28285909,4,175
2020-04-11,venezuela,South America,28285909,0,175
2020-04-12,venezuela,South America,28285909,6,181
2020-04-13,venezuela,South America,28285909,8,189
2020-04-14,venezuela,South America,28285909,0,189
2020-04-15,venezuela,South America,28285909,8,197
2020-04-16,venezuela,South America,28285909,7,204
2020-04-17,venezuela,South America,28285909,0,204
2020-04-18,venezuela,South America,28285909,23,227
2020-04-19,venezuela,South America,28285909,29,256
2020-04-20,venezuela,South America,28285909,29,285
2020-04-21,venezuela,South America,28285909,3,288
2020-04-22,venezuela,South America,28285909,10,298
2020-04-23,venezuela,South America,28285909,0,298
2020-04-24,venezuela,South America,28285909,20,318
2020-04-25,venezuela,South America,28285909,5,323
2020-04-26,venezuela,South America,28285909,2,325
2020-04-27,venezuela,South America,28285909,4,329
2020-04-28,venezuela,South America,28285909,0,329
2020-04-29,venezuela,South America,28285909,2,331
2020-04-30,venezuela,South America,28285909,2,333
2020-05-01,venezuela,South America,28285909,2,335
2020-05-02,venezuela,South America,28285909,10,345
2020-05-03,venezuela,South America,28285909,12,357
2020-05-04,venezuela,South America,28285909,0,357
2020-05-05,venezuela,South America,28285909,4,361
2020-05-06,venezuela,South America,28285909,18,379
2020-05-07,venezuela,South America,28285909,2,381
2020-05-08,venezuela,South America,28285909,7,388
2020-05-09,venezuela,South America,28285909,14,402
2020-05-10,venezuela,South America,28285909,12,414
2020-05-11,venezuela,South America,28285909,8,422
2020-05-12,venezuela,South America,28285909,1,423
2020-05-13,venezuela,South America,28285909,17,440
2020-05-14,venezuela,South America,28285909,15,455
2020-05-15,venezuela,South America,28285909,4,459
2020-05-16,venezuela,South America,28285909,45,504
2020-05-17,venezuela,South America,28285909,37,541
2020-05-18,venezuela,South America,28285909,77,618
2020-05-19,venezuela,South America,28285909,0,618
2020-05-20,venezuela,South America,28285909,206,824
2020-05-21,venezuela,South America,28285909,58,882
2020-05-22,venezuela,South America,28285909,62,944
2020-05-23,venezuela,South America,28285909,66,1010
2020-05-24,venezuela,South America,28285909,111,1121
2020-05-25,venezuela,South America,28285909,56,1177
2020-05-26,venezuela,South America,28285909,34,1211
2020-05-27,venezuela,South America,28285909,34,1245
2020-05-28,venezuela,South America,28285909,80,1325
2020-05-29,venezuela,South America,28285909,45,1370
2020-05-30,venezuela,South America,28285909,89,1459
2020-05-31,venezuela,South America,28285909,51,1510
2020-06-01,venezuela,South America,28285909,152,1662
2020-06-02,venezuela,South America,28285909,157,1819
2020-06-03,venezuela,South America,28285909,133,1952
2020-06-04,venezuela,South America,28285909,135,2087
2020-06-05,venezuela,South America,28285909,58,2145
2020-06-06,venezuela,South America,28285909,171,2316
2020-06-07,venezuela,South America,28285909,61,2377
2020-06-08,venezuela,South America,28285909,96,2473
2020-06-09,venezuela,South America,28285909,159,2632
2020-06-10,venezuela,South America,28285909,106,2738
2020-06-11,venezuela,South America,28285909,76,2814
2020-06-12,venezuela,South America,28285909,65,2879
2020-06-13,venezuela,South America,28285909,25,2904
2020-06-14,venezuela,South America,28285909,0,2904
2020-06-15,venezuela,South America,28285909,158,3062
2020-06-16,venezuela,South America,28285909,88,3150
2020-06-17,venezuela,South America,28285909,236,3386
2020-06-18,venezuela,South America,28285909,97,3483
2020-06-19,venezuela,South America,28285909,108,3591
2020-06-20,venezuela,South America,28285909,198,3789
2020-06-21,venezuela,South America,28285909,128,3917
2020-06-22,venezuela,South America,28285909,131,4048
2020-06-23,venezuela,South America,28285909,139,4187
2020-06-24,venezuela,South America,28285909,179,4366
2020-06-25,venezuela,South America,28285909,197,4563
2020-06-26,venezuela,South America,28285909,216,4779
2020-06-27,venezuela,South America,28285909,351,5130
2020-06-28,venezuela,South America,28285909,167,5297
2020-06-29,venezuela,South America,28285909,233,5530
2020-06-30,venezuela,South America,28285909,302,5832
2020-07-01,venezuela,South America,28285909,230,6062
2020-07-02,venezuela,South America,28285909,211,6273
2020-07-03,venezuela,South America,28285909,264,6537
2020-07-04,venezuela,South America,28285909,213,6750
2020-07-05,venezuela,South America,28285909,419,7169
2020-07-06,venezuela,South America,28285909,242,7411
2020-07-07,venezuela,South America,28285909,282,7693
2020-07-08,venezuela,South America,28285909,315,8008
2020-07-09,venezuela,South America,28285909,364,8372
2020-07-10,venezuela,South America,28285909,431,8803
2020-07-11,venezuela,South America,28285909,375,9178
2020-07-12,venezuela,South America,28285909,287,9465
2020-07-13,venezuela,South America,28285909,242,9707
2020-07-14,venezuela,South America,28285909,303,10010
2020-07-15,venezuela,South America,28285909,418,10428
2020-07-16,venezuela,South America,28285909,426,10854
2020-07-17,venezuela,South America,28285909,337,11191
2020-07-18,venezuela,South America,28285909,292,11483
2020-07-19,venezuela,South America,28285909,408,11891
2020-07-20,venezuela,South America,28285909,443,12334
2020-07-21,venezuela,South America,28285909,440,12774
2020-07-22,venezuela,South America,28285909,390,13164
2020-07-23,venezuela,South America,28285909,449,13613
2020-07-24,venezuela,South America,28285909,650,14263
2020-07-25,venezuela,South America,28285909,666,14929
2020-07-26,venezuela,South America,28285909,534,15463
2020-07-27,venezuela,South America,28285909,525,15988
2020-07-28,venezuela,South America,28285909,583,16571
2020-07-29,venezuela,South America,28285909,587,17158
2020-07-30,venezuela,South America,28285909,701,17859
2020-07-31,venezuela,South America,28285909,715,18574
2020-08-01,venezuela,South America,28285909,869,19443
2020-08-02,venezuela,South America,28285909,763,20206
2020-08-03,venezuela,South America,28285909,548,20754
2020-08-04,venezuela,South America,28285909,684,21438
2020-08-05,venezuela,South America,28285909,861,22299
2020-08-06,venezuela,South America,28285909,981,23280
2020-08-07,venezuela,South America,28285909,886,24166
2020-08-08,venezuela,South America,28285909,795,24961
2020-08-09,venezuela,South America,28285909,844,25805
2020-08-10,venezuela,South America,28285909,995,26800
2020-08-11,venezuela,South America,28285909,1138,27938
2020-08-12,venezuela,South America,28285909,1150,29088
2020-08-13,venezuela,South America,28285909,1281,30369
2020-08-14,venezuela,South America,28285909,1012,31381
2020-08-15,venezuela,South America,28285909,1226,32607
2020-08-16,venezuela,South America,28285909,1148,33755
2020-08-17,venezuela,South America,28285909,1047,34802
2020-08-18,venezuela,South America,28285909,895,35697
2020-08-19,venezuela,South America,28285909,1171,36868
2020-08-20,venezuela,South America,28285909,699,37567
2020-08-21,venezuela,South America,28285909,652,38219
2020-08-22,venezuela,South America,28285909,738,38957
2020-08-23,venezuela,South America,28285909,607,39564
2020-08-24,venezuela,South America,28285909,774,40338
2020-08-25,venezuela,South America,28285909,820,41158
2020-08-26,venezuela,South America,28285909,807,41965
2020-08-27,venezuela,South America,28285909,933,42898
2020-08-28,venezuela,South America,28285909,981,43879
2020-08-29,venezuela,South America,28285909,1067,44946
2020-08-30,venezuela,South America,28285909,922,45868
2020-08-31,venezuela,South America,28285909,860,46728
2020-09-01,venezuela,South America,28285909,1028,47756
2020-09-02,venezuela,South America,28285909,1127,48883
2020-09-03,venezuela,South America,28285909,994,49877
2020-09-04,venezuela,South America,28285909,1096,50973
2020-09-05,venezuela,South America,28285909,1192,52165
2020-09-06,venezuela,South America,28285909,1124,53289
2020-09-07,venezuela,South America,28285909,1061,54350
2020-09-08,venezuela,South America,28285909,1213,55563
2020-09-09,venezuela,South America,28285909,1188,56751
2020-09-10,venezuela,South America,28285909,1072,57823
2020-09-11,venezuela,South America,28285909,840,58663
2020-09-12,venezuela,South America,28285909,967,59630
2020-09-13,venezuela,South America,28285909,910,60540
2020-09-14,venezuela,South America,28285909,1029,61569
2020-09-15,venezuela,South America,28285909,1086,62655
2020-09-16,venezuela,South America,28285909,761,63416
2020-09-17,venezuela,South America,28285909,868,64284
2020-09-18,venezuela,South America,28285909,890,65174
2020-09-19,venezuela,South America,28285909,775,65949
2020-09-20,venezuela,South America,28285909,707,66656
2020-09-21,venezuela,South America,28285909,787,67443
2020-09-22,venezuela,South America,28285909,1010,68453
2020-09-23,venezuela,South America,28285909,986,69439
2020-09-24,venezuela,South America,28285909,967,70406
2020-09-25,venezuela,South America,28285909,867,71273
2020-09-26,venezuela,South America,28285909,667,71940
2020-09-27,venezuela,South America,28285909,751,72691
2020-09-28,venezuela,South America,28285909,837,73528
2020-09-29,venezuela,South America,28285909,835,74363
2020-09-30,venezuela,South America,28285909,759,75122
2020-10-01,venezuela,South America,28285909,907,76029
2020-10-02,venezuela,South America,28285909,791,76820
2020-10-03,venezuela,South America,28285909,826,77646
2020-10-04,venezuela,South America,28285909,788,78434
2020-10-05,venezuela,South America,28285909,683,79117
2020-10-06,venezuela,South America,28285909,679,79796
2020-10-07,venezuela,South America,28285909,608,80404
2020-10-08,venezuela,South America,28285909,615,81019
2020-10-09,venezuela,South America,28285909,677,81696
2020-10-10,venezuela,South America,28285909,757,82453
2020-10-11,venezuela,South America,28285909,684,83137
2020-10-12,venezuela,South America,28285909,619,83756
2020-10-13,venezuela,South America,28285909,635,84391
2020-10-14,venezuela,South America,28285909,614,85005
2020-10-15,venezuela,South America,28285909,464,85469
2020-10-16,venezuela,South America,28285909,289,85758
2020-10-17,venezuela,South America,28285909,531,86289
2020-10-18,venezuela,South America,28285909,347,86636
2020-10-19,venezuela,South America,28285909,525,87161
2020-10-20,venezuela,South America,28285909,483,87644
2020-10-21,venezuela,South America,28285909,391,88035
2020-10-22,venezuela,South America,28285909,381,88416
2020-10-23,venezuela,South America,28285909,302,88718
2020-10-24,venezuela,South America,28285909,424,89142
2020-10-25,venezuela,South America,28285909,423,89565
2020-10-26,venezuela,South America,28285909,482,90047
2020-10-27,venezuela,South America,28285909,353,90400
2020-10-28,venezuela,South America,28285909,476,90876
2020-10-29,venezuela,South America,28285909,404,91280
2020-10-30,venezuela,South America,28285909,309,91589
2020-10-31,venezuela,South America,28285909,424,92013
2020-11-01,venezuela,South America,28285909,312,92325
2020-11-02,venezuela,South America,28285909,380,92705
2020-11-03,venezuela,South America,28285909,395,93100
2020-11-04,venezuela,South America,28285909,380,93480
2020-11-05,venezuela,South America,28285909,441,93921
2020-11-06,venezuela,South America,28285909,384,94305
2020-11-07,venezuela,South America,28285909,393,94698
2020-11-08,venezuela,South America,28285909,185,94883
2020-11-09,venezuela,South America,28285909,266,95149
2020-11-10,venezuela,South America,28285909,296,95445
2020-11-11,venezuela,South America,28285909,305,95750
2020-11-12,venezuela,South America,28285909,390,96140
2020-11-13,venezuela,South America,28285909,301,96441
2020-11-14,venezuela,South America,28285909,492,96933
2020-11-15,venezuela,South America,28285909,419,97352
2020-11-16,venezuela,South America,28285909,387,97739
2020-11-17,venezuela,South America,28285909,311,98050
2020-11-18,venezuela,South America,28285909,300,98350
2020-11-19,venezuela,South America,28285909,315,98665
2020-11-20,venezuela,South America,28285909,352,99017
2020-11-21,venezuela,South America,28285909,418,99435
2020-11-22,venezuela,South America,28285909,400,99835
2020-11-23,venezuela,South America,28285909,308,100143
2020-11-24,venezuela,South America,28285909,355,100498
2020-11-25,venezuela,South America,28285909,319,100817
2020-11-26,venezuela,South America,28285909,398,101215
2020-11-27,venezuela,South America,28285909,309,101524
2020-11-28,venezuela,South America,28285909,236,101760
2020-11-29,venezuela,South America,28285909,280,102040
2020-11-30,venezuela,South America,28285909,354,102394
2020-12-01,venezuela,South America,28285909,227,102621
2020-12-02,venezuela,South America,28285909,446,103067
2020-12-03,venezuela,South America,28285909,481,103548
2020-12-04,venezuela,South America,28285909,329,103877
2020-12-05,venezuela,South America,28285909,300,104177
2020-12-06,venezuela,South America,28285909,265,104442
2020-12-07,venezuela,South America,28285909,462,104904
2020-12-08,venezuela,South America,28285909,480,105384
2020-12-09,venezuela,South America,28285909,468,105852
2020-12-10,venezuela,South America,28285909,428,106280
2020-12-11,venezuela,South America,28285909,435,106715
2020-12-12,venezuela,South America,28285909,462,107177
2020-12-13,venezuela,South America,28285909,609,107786
2020-12-14,venezuela,South America,28285909,339,108125
2020-12-15,venezuela,South America,28285909,355,108480
2020-12-16,venezuela,South America,28285909,237,108717
2020-12-17,venezuela,South America,28285909,364,109081
2020-12-18,venezuela,South America,28285909,314,109395
2020-12-19,venezuela,South America,28285909,386,109781
2020-12-20,venezuela,South America,28285909,294,110075
2020-12-21,venezuela,South America,28285909,438,110513
2020-12-22,venezuela,South America,28285909,315,110828
2020-12-23,venezuela,South America,28285909,196,111024
2020-12-24,venezuela,South America,28285909,221,111245
2020-12-25,venezuela,South America,28285909,358,111603
2020-12-26,venezuela,South America,28285909,348,111951
2020-12-27,venezuela,South America,28285909,365,112316
2020-12-28,venezuela,South America,28285909,320,112636
2020-12-29,venezuela,South America,28285909,225,112861
2020-02-20,viet_nam,Asia,98969721,0,16
2020-02-21,viet_nam,Asia,98969721,0,16
2020-02-22,viet_nam,Asia,98969721,0,16
2020-02-23,viet_nam,Asia,98969721,0,16
2020-02-24,viet_nam,Asia,98969721,0,16
2020-02-25,viet_nam,Asia,98969721,0,16
2020-02-26,viet_nam,Asia,98969721,0,16
2020-02-27,viet_nam,Asia,98969721,0,16
2020-02-28,viet_nam,Asia,98969721,0,16
2020-02-29,viet_nam,Asia,98969721,0,16
2020-03-01,viet_nam,Asia,98969721,0,16
2020-03-02,viet_nam,Asia,98969721,0,16
2020-03-03,viet_nam,Asia,98969721,0,16
2020-03-04,viet_nam,Asia,98969721,0,16
2020-03-05,viet_nam,Asia,98969721,0,16
2020-03-06,viet_nam,Asia,98969721,1,17
2020-03-07,viet_nam,Asia,98969721,3,20
2020-03-08,viet_nam,Asia,98969721,11,31
2020-03-09,viet_nam,Asia,98969721,1,32
2020-03-10,viet_nam,Asia,98969721,3,35
2020-03-11,viet_nam,Asia,98969721,5,40
2020-03-12,viet_nam,Asia,98969721,5,45
2020-03-13,viet_nam,Asia,98969721,0,45
2020-03-14,viet_nam,Asia,98969721,9,54
2020-03-15,viet_nam,Asia,98969721,4,58
2020-03-16,viet_nam,Asia,98969721,4,62
2020-03-17,viet_nam,Asia,98969721,5,67
2020-03-18,viet_nam,Asia,98969721,11,78
2020-03-19,viet_nam,Asia,98969721,9,87
2020-03-20,viet_nam,Asia,98969721,6,93
2020-03-21,viet_nam,Asia,98969721,3,96
2020-03-22,viet_nam,Asia,98969721,22,118
2020-03-23,viet_nam,Asia,98969721,11,129
2020-03-24,viet_nam,Asia,98969721,12,141
2020-03-25,viet_nam,Asia,98969721,16,157
2020-03-26,viet_nam,Asia,98969721,5,162
2020-03-27,viet_nam,Asia,98969721,11,173
2020-03-28,viet_nam,Asia,98969721,12,185
2020-03-29,viet_nam,Asia,98969721,24,209
2020-03-30,viet_nam,Asia,98969721,11,220
2020-03-31,viet_nam,Asia,98969721,8,228
2020-04-01,viet_nam,Asia,98969721,6,234
2020-04-02,viet_nam,Asia,98969721,17,251
2020-04-03,viet_nam,Asia,98969721,6,257
2020-04-04,viet_nam,Asia,98969721,1,258
2020-04-05,viet_nam,Asia,98969721,1,259
2020-04-06,viet_nam,Asia,98969721,4,263
2020-04-07,viet_nam,Asia,98969721,6,269
2020-04-08,viet_nam,Asia,98969721,0,269
2020-04-09,viet_nam,Asia,98969721,4,273
2020-04-10,viet_nam,Asia,98969721,2,275
2020-04-11,viet_nam,Asia,98969721,1,276
2020-04-12,viet_nam,Asia,98969721,4,280
2020-04-13,viet_nam,Asia,98969721,3,283
2020-04-14,viet_nam,Asia,98969721,1,284
2020-04-15,viet_nam,Asia,98969721,2,286
2020-04-16,viet_nam,Asia,98969721,0,286
2020-04-17,viet_nam,Asia,98969721,0,286
2020-04-18,viet_nam,Asia,98969721,0,286
2020-04-19,viet_nam,Asia,98969721,0,286
2020-04-20,viet_nam,Asia,98969721,0,286
2020-04-21,viet_nam,Asia,98969721,0,286
2020-04-22,viet_nam,Asia,98969721,0,286
2020-04-23,viet_nam,Asia,98969721,0,286
2020-04-24,viet_nam,Asia,98969721,2,288
2020-04-25,viet_nam,Asia,98969721,0,288
2020-04-26,viet_nam,Asia,98969721,0,288
2020-04-27,viet_nam,Asia,98969721,0,288
2020-04-28,viet_nam,Asia,98969721,0,288
2020-04-29,viet_nam,Asia,98969721,0,288
2020-04-30,viet_nam,Asia,98969721,0,288
2020-05-01,viet_nam,Asia,98969721,0,288
2020-05-02,viet_nam,Asia,98969721,0,288
2020-05-03,viet_nam,Asia,98969721,1,289
2020-05-04,viet_nam,Asia,98969721,0,289
2020-05-05,viet_nam,Asia,98969721,0,289
2020-05-06,viet_nam,Asia,98969721,0,289
2020-05-07,viet_nam,Asia,98969721,19,308
2020-05-08,viet_nam,Asia,98969721,0,308
2020-05-09,viet_nam,Asia,98969721,0,308
2020-05-10,viet_nam,Asia,98969721,0,308
2020-05-11,viet_nam,Asia,98969721,0,308
2020-05-12,viet_nam,Asia,98969721,0,308
2020-05-13,viet_nam,Asia,98969721,0,308
2020-05-14,viet_nam,Asia,98969721,30,338
2020-05-15,viet_nam,Asia,98969721,2,340
2020-05-16,viet_nam,Asia,98969721,4,344
2020-05-17,viet_nam,Asia,98969721,2,346
2020-05-18,viet_nam,Asia,98969721,4,350
2020-05-19,viet_nam,Asia,98969721,0,350
2020-05-20,viet_nam,Asia,98969721,0,350
2020-05-21,viet_nam,Asia,98969721,0,350
2020-05-22,viet_nam,Asia,98969721,0,350
2020-05-23,viet_nam,Asia,98969721,0,350
2020-05-24,viet_nam,Asia,98969721,1,351
2020-05-25,viet_nam,Asia,98969721,1,352
2020-05-26,viet_nam,Asia,98969721,1,353
2020-05-27,viet_nam,Asia,98969721,0,353
2020-05-28,viet_nam,Asia,98969721,0,353
2020-05-29,viet_nam,Asia,98969721,0,353
2020-05-30,viet_nam,Asia,98969721,1,354
2020-05-31,viet_nam,Asia,98969721,0,354
2020-06-01,viet_nam,Asia,98969721,0,354
2020-06-02,viet_nam,Asia,98969721,0,354
2020-06-03,viet_nam,Asia,98969721,0,354
2020-06-04,viet_nam,Asia,98969721,0,354
2020-06-05,viet_nam,Asia,98969721,0,354
2020-06-06,viet_nam,Asia,98969721,1,355
2020-06-07,viet_nam,Asia,98969721,0,355
2020-06-08,viet_nam,Asia,98969721,3,358
2020-06-09,viet_nam,Asia,98969721,0,358
2020-06-10,viet_nam,Asia,98969721,0,358
2020-06-11,viet_nam,Asia,98969721,0,358
2020-06-12,viet_nam,Asia,98969721,1,359
2020-06-13,viet_nam,Asia,98969721,1,360
2020-06-14,viet_nam,Asia,98969721,0,360
2020-06-15,viet_nam,Asia,98969721,0,360
2020-06-16,viet_nam,Asia,98969721,0,360
2020-06-17,viet_nam,Asia,98969721,1,361
2020-06-18,viet_nam,Asia,98969721,7,368
2020-06-19,viet_nam,Asia,98969721,7,375
2020-06-20,viet_nam,Asia,98969721,0,375
2020-06-21,viet_nam,Asia,98969721,0,375
2020-06-22,viet_nam,Asia,98969721,0,375
2020-06-23,viet_nam,Asia,98969721,0,375
2020-06-24,viet_nam,Asia,98969721,3,378
2020-06-25,viet_nam,Asia,98969721,0,378
2020-06-26,viet_nam,Asia,98969721,1,379
2020-06-27,viet_nam,Asia,98969721,2,381
2020-06-28,viet_nam,Asia,98969721,0,381
2020-06-29,viet_nam,Asia,98969721,0,381
2020-06-30,viet_nam,Asia,98969721,0,381
2020-07-01,viet_nam,Asia,98969721,0,381
2020-07-02,viet_nam,Asia,98969721,0,381
2020-07-03,viet_nam,Asia,98969721,0,381
2020-07-04,viet_nam,Asia,98969721,0,381
2020-07-05,viet_nam,Asia,98969721,0,381
2020-07-06,viet_nam,Asia,98969721,16,397
2020-07-07,viet_nam,Asia,98969721,0,397
2020-07-08,viet_nam,Asia,98969721,0,397
2020-07-09,viet_nam,Asia,98969721,0,397
2020-07-10,viet_nam,Asia,98969721,0,397
2020-07-11,viet_nam,Asia,98969721,1,398
2020-07-12,viet_nam,Asia,98969721,2,400
2020-07-13,viet_nam,Asia,98969721,0,400
2020-07-14,viet_nam,Asia,98969721,1,401
2020-07-15,viet_nam,Asia,98969721,8,409
2020-07-16,viet_nam,Asia,98969721,0,409
2020-07-17,viet_nam,Asia,98969721,1,410
2020-07-18,viet_nam,Asia,98969721,0,410
2020-07-19,viet_nam,Asia,98969721,1,411
2020-07-20,viet_nam,Asia,98969721,1,412
2020-07-21,viet_nam,Asia,98969721,19,431
2020-07-22,viet_nam,Asia,98969721,7,438
2020-07-23,viet_nam,Asia,98969721,4,442
2020-07-24,viet_nam,Asia,98969721,1,443
2020-07-25,viet_nam,Asia,98969721,4,447
2020-07-26,viet_nam,Asia,98969721,3,450
2020-07-27,viet_nam,Asia,98969721,12,462
2020-07-28,viet_nam,Asia,98969721,17,479
2020-07-29,viet_nam,Asia,98969721,15,494
2020-07-30,viet_nam,Asia,98969721,70,564
2020-07-31,viet_nam,Asia,98969721,50,614
2020-08-01,viet_nam,Asia,98969721,63,677
2020-08-02,viet_nam,Asia,98969721,39,716
2020-08-03,viet_nam,Asia,98969721,43,759
2020-08-04,viet_nam,Asia,98969721,24,783
2020-08-05,viet_nam,Asia,98969721,65,848
2020-08-06,viet_nam,Asia,98969721,39,887
2020-08-07,viet_nam,Asia,98969721,60,947
2020-08-08,viet_nam,Asia,98969721,29,976
2020-08-09,viet_nam,Asia,98969721,38,1014
2020-08-10,viet_nam,Asia,98969721,6,1020
2020-08-11,viet_nam,Asia,98969721,22,1042
2020-08-12,viet_nam,Asia,98969721,19,1061
2020-08-13,viet_nam,Asia,98969721,37,1098
2020-08-14,viet_nam,Asia,98969721,22,1120
2020-08-15,viet_nam,Asia,98969721,25,1145
2020-08-16,viet_nam,Asia,98969721,12,1157
2020-08-17,viet_nam,Asia,98969721,25,1182
2020-08-18,viet_nam,Asia,98969721,6,1188
2020-08-19,viet_nam,Asia,98969721,5,1193
2020-08-20,viet_nam,Asia,98969721,15,1208
2020-08-21,viet_nam,Asia,98969721,2,1210
2020-08-22,viet_nam,Asia,98969721,5,1215
2020-08-23,viet_nam,Asia,98969721,2,1217
2020-08-24,viet_nam,Asia,98969721,6,1223
2020-08-25,viet_nam,Asia,98969721,7,1230
2020-08-26,viet_nam,Asia,98969721,5,1235
2020-08-27,viet_nam,Asia,98969721,2,1237
2020-08-28,viet_nam,Asia,98969721,2,1239
2020-08-29,viet_nam,Asia,98969721,2,1241
2020-08-30,viet_nam,Asia,98969721,0,1241
2020-08-31,viet_nam,Asia,98969721,4,1245
2020-09-01,viet_nam,Asia,98969721,0,1245
2020-09-02,viet_nam,Asia,98969721,2,1247
2020-09-03,viet_nam,Asia,98969721,0,1247
2020-09-04,viet_nam,Asia,98969721,3,1250
2020-09-05,viet_nam,Asia,98969721,0,1250
2020-09-06,viet_nam,Asia,98969721,0,1250
2020-09-07,viet_nam,Asia,98969721,0,1250
2020-09-08,viet_nam,Asia,98969721,5,1255
2020-09-09,viet_nam,Asia,98969721,5,1260
2020-09-10,viet_nam,Asia,98969721,0,1260
2020-09-11,viet_nam,Asia,98969721,1,1261
2020-09-12,viet_nam,Asia,98969721,0,1261
2020-09-13,viet_nam,Asia,98969721,3,1264
2020-09-14,viet_nam,Asia,98969721,0,1264
2020-09-15,viet_nam,Asia,98969721,0,1264
2020-09-16,viet_nam,Asia,98969721,0,1264
2020-09-17,viet_nam,Asia,98969721,3,1267
2020-09-18,viet_nam,Asia,98969721,2,1269
2020-09-19,viet_nam,Asia,98969721,0,1269
2020-09-20,viet_nam,Asia,98969721,0,1269
2020-09-21,viet_nam,Asia,98969721,0,1269
2020-09-22,viet_nam,Asia,98969721,0,1269
2020-09-23,viet_nam,Asia,98969721,1,1270
2020-09-24,viet_nam,Asia,98969721,0,1270
2020-09-25,viet_nam,Asia,98969721,0,1270
2020-09-26,viet_nam,Asia,98969721,0,1270
2020-09-27,viet_nam,Asia,98969721,5,1275
2020-09-28,viet_nam,Asia,98969721,3,1278
2020-09-29,viet_nam,Asia,98969721,19,1297
2020-09-30,viet_nam,Asia,98969721,0,1297
2020-10-01,viet_nam,Asia,98969721,1,1298
2020-10-02,viet_nam,Asia,98969721,1,1299
2020-10-03,viet_nam,Asia,98969721,0,1299
2020-10-04,viet_nam,Asia,98969721,0,1299
2020-10-05,viet_nam,Asia,98969721,1,1300
2020-10-06,viet_nam,Asia,98969721,1,1301
2020-10-07,viet_nam,Asia,98969721,1,1302
2020-10-08,viet_nam,Asia,98969721,1,1303
2020-10-09,viet_nam,Asia,98969721,5,1308
2020-10-10,viet_nam,Asia,98969721,2,1310
2020-10-11,viet_nam,Asia,98969721,2,1312
2020-10-12,viet_nam,Asia,98969721,1,1313
2020-10-13,viet_nam,Asia,98969721,3,1316
2020-10-14,viet_nam,Asia,98969721,9,1325
2020-10-15,viet_nam,Asia,98969721,2,1327
2020-10-16,viet_nam,Asia,98969721,0,1327
2020-10-17,viet_nam,Asia,98969721,2,1329
2020-10-18,viet_nam,Asia,98969721,8,1337
2020-10-19,viet_nam,Asia,98969721,6,1343
2020-10-20,viet_nam,Asia,98969721,1,1344
2020-10-21,viet_nam,Asia,98969721,3,1347
2020-10-22,viet_nam,Asia,98969721,4,1351
2020-10-23,viet_nam,Asia,98969721,0,1351
2020-10-24,viet_nam,Asia,98969721,13,1364
2020-10-25,viet_nam,Asia,98969721,8,1372
2020-10-26,viet_nam,Asia,98969721,1,1373
2020-10-27,viet_nam,Asia,98969721,3,1376
2020-10-28,viet_nam,Asia,98969721,1,1377
2020-10-29,viet_nam,Asia,98969721,4,1381
2020-10-30,viet_nam,Asia,98969721,0,1381
2020-10-31,viet_nam,Asia,98969721,3,1384
2020-11-01,viet_nam,Asia,98969721,0,1384
2020-11-02,viet_nam,Asia,98969721,13,1397
2020-11-03,viet_nam,Asia,98969721,11,1408
2020-11-04,viet_nam,Asia,98969721,1,1409
2020-11-05,viet_nam,Asia,98969721,4,1413
2020-11-06,viet_nam,Asia,98969721,5,1418
2020-11-07,viet_nam,Asia,98969721,1,1419
2020-11-08,viet_nam,Asia,98969721,0,1419
2020-11-09,viet_nam,Asia,98969721,2,1421
2020-11-10,viet_nam,Asia,98969721,12,1433
2020-11-11,viet_nam,Asia,98969721,32,1465
2020-11-12,viet_nam,Asia,98969721,1,1466
2020-11-13,viet_nam,Asia,98969721,3,1469
2020-11-14,viet_nam,Asia,98969721,0,1469
2020-11-15,viet_nam,Asia,98969721,31,1500
2020-11-16,viet_nam,Asia,98969721,2,1502
2020-11-17,viet_nam,Asia,98969721,5,1507
2020-11-18,viet_nam,Asia,98969721,13,1520
2020-11-19,viet_nam,Asia,98969721,4,1524
2020-11-20,viet_nam,Asia,98969721,1,1525
2020-11-21,viet_nam,Asia,98969721,1,1526
2020-11-22,viet_nam,Asia,98969721,1,1527
2020-11-23,viet_nam,Asia,98969721,5,1532
2020-11-24,viet_nam,Asia,98969721,4,1536
2020-11-25,viet_nam,Asia,98969721,5,1541
2020-11-26,viet_nam,Asia,98969721,11,1552
2020-11-27,viet_nam,Asia,98969721,8,1560
2020-11-28,viet_nam,Asia,98969721,2,1562
2020-11-29,viet_nam,Asia,98969721,2,1564
2020-11-30,viet_nam,Asia,98969721,4,1568
2020-12-01,viet_nam,Asia,98969721,4,1572
2020-12-02,viet_nam,Asia,98969721,7,1579
2020-12-03,viet_nam,Asia,98969721,3,1582
2020-12-04,viet_nam,Asia,98969721,0,1582
2020-12-05,viet_nam,Asia,98969721,4,1586
2020-12-06,viet_nam,Asia,98969721,1,1587
2020-12-07,viet_nam,Asia,98969721,1,1588
2020-12-08,viet_nam,Asia,98969721,11,1599
2020-12-09,viet_nam,Asia,98969721,4,1603
2020-12-10,viet_nam,Asia,98969721,4,1607
2020-12-11,viet_nam,Asia,98969721,6,1613
2020-12-12,viet_nam,Asia,98969721,4,1617
2020-12-13,viet_nam,Asia,98969721,2,1619
2020-12-14,viet_nam,Asia,98969721,5,1624
2020-12-15,viet_nam,Asia,98969721,3,1627
2020-12-16,viet_nam,Asia,98969721,0,1627
2020-12-17,viet_nam,Asia,98969721,2,1629
2020-12-18,viet_nam,Asia,98969721,3,1632
2020-12-19,viet_nam,Asia,98969721,1,1633
2020-12-20,viet_nam,Asia,98969721,2,1635
2020-12-21,viet_nam,Asia,98969721,1,1636
2020-12-22,viet_nam,Asia,98969721,6,1642
2020-12-23,viet_nam,Asia,98969721,1,1643
2020-12-24,viet_nam,Asia,98969721,12,1655
2020-12-25,viet_nam,Asia,98969721,7,1662
2020-12-26,viet_nam,Asia,98969721,1,1663
2020-12-27,viet_nam,Asia,98969721,1,1664
2020-12-28,viet_nam,Asia,98969721,11,1675
2020-12-29,viet_nam,Asia,98969721,3,1678
2020-12-30,viet_nam,Asia,98969721,2,1680
2020-12-31,viet_nam,Asia,98969721,9,1689
2021-01-01,viet_nam,Asia,98969721,9,1698
2021-01-02,viet_nam,Asia,98969721,8,1706
2021-01-03,viet_nam,Asia,98969721,13,1719
2021-01-04,viet_nam,Asia,98969721,3,1722
2021-01-05,viet_nam,Asia,98969721,7,1729
2021-01-06,viet_nam,Asia,98969721,1,1730
2021-01-07,viet_nam,Asia,98969721,4,1734
2021-01-08,viet_nam,Asia,98969721,3,1737
2021-01-09,viet_nam,Asia,98969721,1,1738
2021-01-10,viet_nam,Asia,98969721,1,1739
2021-01-11,viet_nam,Asia,98969721,1,1740
2021-01-12,viet_nam,Asia,98969721,5,1745
2021-01-13,viet_nam,Asia,98969721,1,1746
2021-01-14,viet_nam,Asia,98969721,11,1757
2021-01-15,viet_nam,Asia,98969721,5,1762
2021-01-16,viet_nam,Asia,98969721,1,1763
2021-01-17,viet_nam,Asia,98969721,0,1763
2021-01-18,viet_nam,Asia,98969721,2,1765
2021-01-19,viet_nam,Asia,98969721,1,1766
2021-01-20,viet_nam,Asia,98969721,4,1770
2021-01-21,viet_nam,Asia,98969721,2,1772
2021-01-22,viet_nam,Asia,98969721,2,1774
2021-01-23,viet_nam,Asia,98969721,0,1774
2021-01-24,viet_nam,Asia,98969721,0,1774
2021-01-25,viet_nam,Asia,98969721,1,1775
2021-01-26,viet_nam,Asia,98969721,2,1777
2021-01-27,viet_nam,Asia,98969721,0,1777
2021-01-28,viet_nam,Asia,98969721,140,1917
2021-01-29,viet_nam,Asia,98969721,93,2010
2021-01-30,viet_nam,Asia,98969721,92,2102
2021-01-31,viet_nam,Asia,98969721,70,2172
2021-02-01,viet_nam,Asia,98969721,45,2217
2021-02-02,viet_nam,Asia,98969721,43,2260
2021-02-03,viet_nam,Asia,98969721,38,2298
2021-02-04,viet_nam,Asia,98969721,66,2364
2021-02-05,viet_nam,Asia,98969721,22,2386
2021-02-06,viet_nam,Asia,98969721,5,2391
2021-02-07,viet_nam,Asia,98969721,24,2415
2021-02-08,viet_nam,Asia,98969721,69,2484
2021-02-09,viet_nam,Asia,98969721,16,2500
2021-02-10,viet_nam,Asia,98969721,35,2535
2021-02-11,viet_nam,Asia,98969721,69,2604
2021-02-12,viet_nam,Asia,98969721,2,2606
2021-02-13,viet_nam,Asia,98969721,74,2680
2021-02-14,viet_nam,Asia,98969721,45,2725
2021-02-15,viet_nam,Asia,98969721,59,2784
2021-02-16,viet_nam,Asia,98969721,60,2844
2021-02-17,viet_nam,Asia,98969721,20,2864
2021-02-18,viet_nam,Asia,98969721,20,2884
2021-02-19,viet_nam,Asia,98969721,17,2901
2021-02-20,viet_nam,Asia,98969721,6,2907
2021-02-21,viet_nam,Asia,98969721,17,2924
2021-02-22,viet_nam,Asia,98969721,9,2933
2021-02-23,viet_nam,Asia,98969721,9,2942
2021-02-24,viet_nam,Asia,98969721,12,2954
2021-02-25,viet_nam,Asia,98969721,8,2962
2021-02-26,viet_nam,Asia,98969721,6,2968
2021-02-27,viet_nam,Asia,98969721,6,2974
2021-02-28,viet_nam,Asia,98969721,18,2992
2021-03-01,viet_nam,Asia,98969721,0,2992
2021-03-02,viet_nam,Asia,98969721,30,3022
2021-03-03,viet_nam,Asia,98969721,11,3033
2021-03-04,viet_nam,Asia,98969721,6,3039
2021-03-05,viet_nam,Asia,98969721,6,3045
2021-03-06,viet_nam,Asia,98969721,7,3052
2021-03-07,viet_nam,Asia,98969721,12,3064
2021-03-08,viet_nam,Asia,98969721,13,3077
2021-03-09,viet_nam,Asia,98969721,2,3079
2021-03-10,viet_nam,Asia,98969721,3,3082
2021-03-11,viet_nam,Asia,98969721,4,3086
2021-03-12,viet_nam,Asia,98969721,19,3105
2021-03-13,viet_nam,Asia,98969721,3,3108
2021-03-14,viet_nam,Asia,98969721,1,3109
2021-03-15,viet_nam,Asia,98969721,3,3112
2021-03-16,viet_nam,Asia,98969721,3,3115
2021-03-17,viet_nam,Asia,98969721,7,3122
2021-03-18,viet_nam,Asia,98969721,3,3125
2021-03-19,viet_nam,Asia,98969721,1,3126
2021-03-20,viet_nam,Asia,98969721,1,3127
2021-03-21,viet_nam,Asia,98969721,0,3127
2021-03-22,viet_nam,Asia,98969721,3,3130
2021-03-23,viet_nam,Asia,98969721,0,3130
2021-03-24,viet_nam,Asia,98969721,1,3131
2021-03-25,viet_nam,Asia,98969721,3,3134
2021-03-26,viet_nam,Asia,98969721,7,3141
2021-03-27,viet_nam,Asia,98969721,0,3141
2021-03-28,viet_nam,Asia,98969721,5,3146
2021-03-29,viet_nam,Asia,98969721,3,3149
2021-03-30,viet_nam,Asia,98969721,0,3149
2021-03-31,viet_nam,Asia,98969721,9,3158
2021-04-01,viet_nam,Asia,98969721,16,3174
2021-04-02,viet_nam,Asia,98969721,3,3177
2021-04-03,viet_nam,Asia,98969721,6,3183
2021-04-04,viet_nam,Asia,98969721,5,3188
2021-04-05,viet_nam,Asia,98969721,6,3194
2021-04-06,viet_nam,Asia,98969721,12,3206
2021-04-07,viet_nam,Asia,98969721,12,3218
2021-04-08,viet_nam,Asia,98969721,9,3227
2021-04-09,viet_nam,Asia,98969721,17,3244
2021-04-10,viet_nam,Asia,98969721,9,3253
2021-04-11,viet_nam,Asia,98969721,1,3254
2021-04-12,viet_nam,Asia,98969721,13,3267
2021-04-13,viet_nam,Asia,98969721,9,3276
2021-04-14,viet_nam,Asia,98969721,22,3298
2021-04-15,viet_nam,Asia,98969721,31,3329
2021-04-16,viet_nam,Asia,98969721,16,3345
2021-04-17,viet_nam,Asia,98969721,9,3354
2021-04-18,viet_nam,Asia,98969721,3,3357
2021-04-19,viet_nam,Asia,98969721,7,3364
2021-04-20,viet_nam,Asia,98969721,9,3373
2021-04-21,viet_nam,Asia,98969721,6,3379
2021-04-22,viet_nam,Asia,98969721,11,3390
2021-04-23,viet_nam,Asia,98969721,16,3406
2021-04-24,viet_nam,Asia,98969721,3,3409
2021-04-25,viet_nam,Asia,98969721,11,3420
2021-04-26,viet_nam,Asia,98969721,9,3429
2021-04-27,viet_nam,Asia,98969721,5,3434
2021-04-28,viet_nam,Asia,98969721,8,3442
2021-04-29,viet_nam,Asia,98969721,65,3507
2021-04-30,viet_nam,Asia,98969721,20,3527
2021-05-01,viet_nam,Asia,98969721,16,3543
2021-05-02,viet_nam,Asia,98969721,24,3567
2021-05-03,viet_nam,Asia,98969721,22,3589
2021-05-04,viet_nam,Asia,98969721,17,3606
2021-05-05,viet_nam,Asia,98969721,32,3638
2021-05-06,viet_nam,Asia,98969721,102,3740
2021-05-07,viet_nam,Asia,98969721,67,3807
2021-05-08,viet_nam,Asia,98969721,143,3950
2021-05-09,viet_nam,Asia,98969721,160,4110
2021-05-10,viet_nam,Asia,98969721,205,4315
2021-05-11,viet_nam,Asia,98969721,117,4432
2021-05-12,viet_nam,Asia,98969721,128,4560
2021-05-13,viet_nam,Asia,98969721,129,4689
2021-05-14,viet_nam,Asia,98969721,167,4856
2021-05-15,viet_nam,Asia,98969721,264,5120
2021-05-16,viet_nam,Asia,98969721,300,5420
2021-05-17,viet_nam,Asia,98969721,288,5708
2021-05-18,viet_nam,Asia,98969721,239,5947
2021-05-19,viet_nam,Asia,98969721,276,6223
2021-05-20,viet_nam,Asia,98969721,189,6412
2021-05-21,viet_nam,Asia,98969721,210,6622
2021-05-22,viet_nam,Asia,98969721,228,6850
2021-05-23,viet_nam,Asia,98969721,209,7059
2021-05-24,viet_nam,Asia,98969721,296,7355
2021-05-25,viet_nam,Asia,98969721,575,7930
2021-05-26,viet_nam,Asia,98969721,491,8421
2021-05-27,viet_nam,Asia,98969721,361,8782
2021-05-28,viet_nam,Asia,98969721,392,9174
2021-05-29,viet_nam,Asia,98969721,446,9620
2021-05-30,viet_nam,Asia,98969721,388,10008
2021-05-31,viet_nam,Asia,98969721,337,10345
2021-06-01,viet_nam,Asia,98969721,388,10733
2021-06-02,viet_nam,Asia,98969721,374,11107
2021-06-03,viet_nam,Asia,98969721,386,11493
2021-06-04,viet_nam,Asia,98969721,354,11847
2021-06-05,viet_nam,Asia,98969721,392,12239
2021-06-06,viet_nam,Asia,98969721,324,12563
2021-06-07,viet_nam,Asia,98969721,368,12931
2021-06-08,viet_nam,Asia,98969721,270,13201
2021-06-09,viet_nam,Asia,98969721,638,13839
2021-06-10,viet_nam,Asia,98969721,347,14186
2021-06-11,viet_nam,Asia,98969721,309,14495
2021-06-12,viet_nam,Asia,98969721,406,14901
2021-06-13,viet_nam,Asia,98969721,462,15363
2021-06-14,viet_nam,Asia,98969721,427,15790
2021-06-15,viet_nam,Asia,98969721,632,16422
2021-06-16,viet_nam,Asia,98969721,662,17084
2021-06-17,viet_nam,Asia,98969721,806,17890
2021-06-18,viet_nam,Asia,98969721,411,18301
2021-06-19,viet_nam,Asia,98969721,757,19058
2021-06-20,viet_nam,Asia,98969721,488,19546
2021-06-21,viet_nam,Asia,98969721,427,19973
2021-06-22,viet_nam,Asia,98969721,377,20350
2021-06-23,viet_nam,Asia,98969721,348,20698
2021-06-24,viet_nam,Asia,98969721,445,21143
2021-06-25,viet_nam,Asia,98969721,1356,22499
2021-06-26,viet_nam,Asia,98969721,270,22769
2021-06-27,viet_nam,Asia,98969721,574,23343
2021-06-28,viet_nam,Asia,98969721,628,23971
2021-06-29,viet_nam,Asia,98969721,580,24551
2021-06-30,viet_nam,Asia,98969721,702,25253
2021-07-01,viet_nam,Asia,98969721,1119,26372
2021-07-02,viet_nam,Asia,98969721,851,27223
2020-05-01,yemen,Asia,31049015,1,7
2020-05-02,yemen,Asia,31049015,3,10
2020-05-03,yemen,Asia,31049015,0,10
2020-05-04,yemen,Asia,31049015,2,12
2020-05-05,yemen,Asia,31049015,10,22
2020-05-06,yemen,Asia,31049015,3,25
2020-05-07,yemen,Asia,31049015,0,25
2020-05-08,yemen,Asia,31049015,9,34
2020-05-09,yemen,Asia,31049015,0,34
2020-05-10,yemen,Asia,31049015,18,52
2020-05-11,yemen,Asia,31049015,5,57
2020-05-12,yemen,Asia,31049015,9,66
2020-05-13,yemen,Asia,31049015,5,71
2020-05-14,yemen,Asia,31049015,16,87
2020-05-15,yemen,Asia,31049015,22,109
2020-05-16,yemen,Asia,31049015,17,126
2020-05-17,yemen,Asia,31049015,6,132
2020-05-18,yemen,Asia,31049015,2,134
2020-05-19,yemen,Asia,31049015,38,172
2020-05-20,yemen,Asia,31049015,18,190
2020-05-21,yemen,Asia,31049015,13,203
2020-05-22,yemen,Asia,31049015,12,215
2020-05-23,yemen,Asia,31049015,3,218
2020-05-24,yemen,Asia,31049015,10,228
2020-05-25,yemen,Asia,31049015,11,239
2020-05-26,yemen,Asia,31049015,17,256
2020-05-27,yemen,Asia,31049015,7,263
2020-05-28,yemen,Asia,31049015,23,286
2020-05-29,yemen,Asia,31049015,5,291
2020-05-30,yemen,Asia,31049015,28,319
2020-05-31,yemen,Asia,31049015,13,332
2020-06-01,yemen,Asia,31049015,32,364
2020-06-02,yemen,Asia,31049015,46,410
2020-06-03,yemen,Asia,31049015,21,431
2020-06-04,yemen,Asia,31049015,35,466
2020-06-05,yemen,Asia,31049015,17,483
2020-06-06,yemen,Asia,31049015,13,496
2020-06-07,yemen,Asia,31049015,2,498
2020-06-08,yemen,Asia,31049015,12,510
2020-06-09,yemen,Asia,31049015,29,539
2020-06-10,yemen,Asia,31049015,37,576
2020-06-11,yemen,Asia,31049015,32,608
2020-06-12,yemen,Asia,31049015,41,649
2020-06-13,yemen,Asia,31049015,75,724
2020-06-14,yemen,Asia,31049015,24,748
2020-06-15,yemen,Asia,31049015,119,867
2020-06-16,yemen,Asia,31049015,41,908
2020-06-17,yemen,Asia,31049015,18,926
2020-06-18,yemen,Asia,31049015,7,933
2020-06-19,yemen,Asia,31049015,10,943
2020-06-20,yemen,Asia,31049015,3,946
2020-06-21,yemen,Asia,31049015,20,966
2020-06-22,yemen,Asia,31049015,27,993
2020-06-23,yemen,Asia,31049015,26,1019
2020-06-24,yemen,Asia,31049015,24,1043
2020-06-25,yemen,Asia,31049015,62,1105
2020-06-26,yemen,Asia,31049015,13,1118
2020-06-27,yemen,Asia,31049015,15,1133
2020-06-28,yemen,Asia,31049015,16,1149
2020-06-29,yemen,Asia,31049015,10,1159
2020-06-30,yemen,Asia,31049015,31,1190
2020-07-01,yemen,Asia,31049015,33,1223
2020-07-02,yemen,Asia,31049015,32,1255
2020-07-03,yemen,Asia,31049015,20,1275
2020-07-04,yemen,Asia,31049015,8,1283
2020-07-05,yemen,Asia,31049015,18,1301
2020-07-06,yemen,Asia,31049015,20,1321
2020-07-07,yemen,Asia,31049015,13,1334
2020-07-08,yemen,Asia,31049015,22,1356
2020-07-09,yemen,Asia,31049015,39,1395
2020-07-10,yemen,Asia,31049015,25,1420
2020-07-11,yemen,Asia,31049015,9,1429
2020-07-12,yemen,Asia,31049015,78,1507
2020-07-13,yemen,Asia,31049015,34,1541
2020-07-14,yemen,Asia,31049015,19,1560
2020-07-15,yemen,Asia,31049015,10,1570
2020-07-16,yemen,Asia,31049015,27,1597
2020-07-17,yemen,Asia,31049015,25,1622
2020-07-18,yemen,Asia,31049015,5,1627
2020-07-19,yemen,Asia,31049015,26,1653
2020-07-20,yemen,Asia,31049015,13,1666
2020-07-21,yemen,Asia,31049015,10,1676
2020-07-22,yemen,Asia,31049015,11,1687
2020-07-23,yemen,Asia,31049015,15,1702
2020-07-24,yemen,Asia,31049015,21,1723
2020-07-25,yemen,Asia,31049015,0,1723
2020-07-26,yemen,Asia,31049015,7,1730
2020-07-27,yemen,Asia,31049015,10,1740
2020-07-28,yemen,Asia,31049015,12,1752
2020-07-29,yemen,Asia,31049015,8,1760
2020-07-30,yemen,Asia,31049015,16,1776
2020-07-31,yemen,Asia,31049015,2,1778
2020-08-01,yemen,Asia,31049015,2,1780
2020-08-02,yemen,Asia,31049015,4,1784
2020-08-03,yemen,Asia,31049015,0,1784
2020-08-04,yemen,Asia,31049015,27,1811
2020-08-05,yemen,Asia,31049015,3,1814
2020-08-06,yemen,Asia,31049015,5,1819
2020-08-07,yemen,Asia,31049015,29,1848
2020-08-08,yemen,Asia,31049015,1,1849
2020-08-09,yemen,Asia,31049015,7,1856
2020-08-10,yemen,Asia,31049015,28,1884
2020-08-11,yemen,Asia,31049015,0,1884
2020-08-12,yemen,Asia,31049015,10,1894
2020-08-13,yemen,Asia,31049015,6,1900
2020-08-14,yemen,Asia,31049015,11,1911
2020-08-15,yemen,Asia,31049015,0,1911
2020-08-16,yemen,Asia,31049015,11,1922
2020-08-17,yemen,Asia,31049015,13,1935
2020-08-18,yemen,Asia,31049015,7,1942
2020-08-19,yemen,Asia,31049015,3,1945
2020-08-20,yemen,Asia,31049015,7,1952
2020-08-21,yemen,Asia,31049015,7,1959
2020-08-22,yemen,Asia,31049015,1,1960
2020-08-23,yemen,Asia,31049015,4,1964
2020-08-24,yemen,Asia,31049015,5,1969
2020-08-25,yemen,Asia,31049015,8,1977
2020-08-26,yemen,Asia,31049015,6,1983
2020-08-27,yemen,Asia,31049015,3,1986
2020-08-28,yemen,Asia,31049015,10,1996
2020-08-29,yemen,Asia,31049015,3,1999
2020-08-30,yemen,Asia,31049015,7,2006
2020-08-31,yemen,Asia,31049015,5,2011
2020-09-01,yemen,Asia,31049015,4,2015
2020-09-02,yemen,Asia,31049015,15,2030
2020-09-03,yemen,Asia,31049015,3,2033
2020-09-04,yemen,Asia,31049015,4,2037
2020-09-05,yemen,Asia,31049015,0,2037
2020-09-06,yemen,Asia,31049015,4,2041
2020-09-07,yemen,Asia,31049015,2,2043
2020-09-08,yemen,Asia,31049015,5,2048
2020-09-09,yemen,Asia,31049015,5,2053
2020-09-10,yemen,Asia,31049015,4,2057
2020-09-11,yemen,Asia,31049015,4,2061
2020-09-12,yemen,Asia,31049015,2,2063
2020-09-13,yemen,Asia,31049015,2,2065
2020-09-14,yemen,Asia,31049015,2,2067
2020-09-15,yemen,Asia,31049015,3,2070
2020-09-16,yemen,Asia,31049015,3,2073
2020-09-17,yemen,Asia,31049015,3,2076
2020-09-18,yemen,Asia,31049015,2,2078
2020-09-19,yemen,Asia,31049015,2,2080
2020-09-20,yemen,Asia,31049015,0,2080
2020-09-21,yemen,Asia,31049015,2,2082
2020-09-22,yemen,Asia,31049015,0,2082
2020-09-23,yemen,Asia,31049015,1,2083
2020-09-24,yemen,Asia,31049015,0,2083
2020-09-25,yemen,Asia,31049015,0,2083
2020-09-26,yemen,Asia,31049015,1,2084
2020-09-27,yemen,Asia,31049015,0,2084
2020-09-28,yemen,Asia,31049015,1,2085
2020-09-29,yemen,Asia,31049015,0,2085
2020-09-30,yemen,Asia,31049015,3,2088
2020-10-01,yemen,Asia,31049015,5,2093
2020-10-02,yemen,Asia,31049015,1,2094
2020-10-03,yemen,Asia,31049015,1,2095
2020-10-04,yemen,Asia,31049015,0,2095
2020-10-05,yemen,Asia,31049015,0,2095
2020-10-06,yemen,Asia,31049015,6,2101
2020-10-07,yemen,Asia,31049015,2,2103
2020-10-08,yemen,Asia,31049015,1,2104
2020-10-09,yemen,Asia,31049015,1,2105
2020-10-10,yemen,Asia,31049015,0,2105
2020-10-11,yemen,Asia,31049015,1,2106
2020-10-12,yemen,Asia,31049015,0,2106
2020-10-13,yemen,Asia,31049015,1,2107
2020-10-14,yemen,Asia,31049015,0,2107
2020-10-15,yemen,Asia,31049015,0,2107
2020-10-16,yemen,Asia,31049015,2,2109
2020-10-17,yemen,Asia,31049015,0,2109
2020-10-18,yemen,Asia,31049015,1,2110
2020-10-19,yemen,Asia,31049015,0,2110
2020-10-20,yemen,Asia,31049015,1,2111
2020-10-21,yemen,Asia,31049015,0,2111
2020-10-22,yemen,Asia,31049015,0,2111
2020-10-23,yemen,Asia,31049015,3,2114
2020-10-24,yemen,Asia,31049015,0,2114
2020-10-25,yemen,Asia,31049015,0,2114
2020-10-26,yemen,Asia,31049015,0,2114
2020-10-27,yemen,Asia,31049015,0,2114
2020-10-28,yemen,Asia,31049015,1,2115
2020-10-29,yemen,Asia,31049015,1,2116
2020-10-30,yemen,Asia,31049015,0,2116
2020-10-31,yemen,Asia,31049015,1,2117
2020-11-01,yemen,Asia,31049015,0,2117
2020-11-02,yemen,Asia,31049015,0,2117
2020-11-03,yemen,Asia,31049015,0,2117
2020-11-04,yemen,Asia,31049015,0,2117
2020-11-05,yemen,Asia,31049015,0,2117
2020-11-06,yemen,Asia,31049015,4,2121
2020-11-07,yemen,Asia,31049015,1,2122
2020-11-08,yemen,Asia,31049015,0,2122
2020-11-09,yemen,Asia,31049015,0,2122
2020-11-10,yemen,Asia,31049015,0,2122
2020-11-11,yemen,Asia,31049015,0,2122
2020-11-12,yemen,Asia,31049015,0,2122
2020-11-13,yemen,Asia,31049015,0,2122
2020-11-14,yemen,Asia,31049015,0,2122
2020-11-15,yemen,Asia,31049015,0,2122
2020-11-16,yemen,Asia,31049015,0,2122
2020-11-17,yemen,Asia,31049015,0,2122
2020-11-18,yemen,Asia,31049015,0,2122
2020-11-19,yemen,Asia,31049015,0,2122
2020-11-20,yemen,Asia,31049015,1,2123
2020-11-21,yemen,Asia,31049015,0,2123
2020-11-22,yemen,Asia,31049015,0,2123
2020-11-23,yemen,Asia,31049015,3,2126
2020-11-24,yemen,Asia,31049015,1,2127
2020-11-25,yemen,Asia,31049015,0,2127
2020-11-26,yemen,Asia,31049015,0,2127
2020-11-27,yemen,Asia,31049015,1,2128
2020-11-28,yemen,Asia,31049015,0,2128
2020-11-29,yemen,Asia,31049015,3,2131
2020-11-30,yemen,Asia,31049015,0,2131
2020-12-01,yemen,Asia,31049015,0,2131
2020-12-02,yemen,Asia,31049015,0,2131
2020-12-03,yemen,Asia,31049015,0,2131
2020-12-04,yemen,Asia,31049015,0,2131
2020-12-05,yemen,Asia,31049015,0,2131
2020-12-06,yemen,Asia,31049015,1,2132
2020-12-07,yemen,Asia,31049015,0,2132
2020-12-08,yemen,Asia,31049015,0,2132
2020-12-09,yemen,Asia,31049015,1,2133
2020-12-10,yemen,Asia,31049015,2,2135
2020-12-11,yemen,Asia,31049015,1,2136
2020-12-12,yemen,Asia,31049015,1,2137
2020-12-13,yemen,Asia,31049015,0,2137
2020-12-14,yemen,Asia,31049015,1,2138
2020-12-15,yemen,Asia,31049015,1,2139
2020-12-16,yemen,Asia,31049015,0,2139
2020-12-17,yemen,Asia,31049015,2,2141
2020-12-18,yemen,Asia,31049015,0,2141
2020-12-19,yemen,Asia,31049015,0,2141
2020-12-20,yemen,Asia,31049015,0,2141
2020-12-21,yemen,Asia,31049015,0,2141
2020-12-22,yemen,Asia,31049015,0,2141
2020-12-23,yemen,Asia,31049015,0,2141
2020-12-24,yemen,Asia,31049015,5,2146
2020-12-25,yemen,Asia,31049015,0,2146
2020-12-26,yemen,Asia,31049015,0,2146
2020-12-27,yemen,Asia,31049015,2,2148
2020-12-28,yemen,Asia,31049015,2,2150
2020-12-29,yemen,Asia,31049015,0,2150
2020-12-30,yemen,Asia,31049015,1,2151
2020-12-31,yemen,Asia,31049015,2,2153
2021-01-01,yemen,Asia,31049015,2,2155
2021-01-02,yemen,Asia,31049015,0,2155
2021-01-03,yemen,Asia,31049015,0,2155
2021-01-04,yemen,Asia,31049015,0,2155
2021-01-05,yemen,Asia,31049015,0,2155
2021-01-06,yemen,Asia,31049015,1,2156
2021-01-07,yemen,Asia,31049015,2,2158
2021-01-08,yemen,Asia,31049015,0,2158
2021-01-09,yemen,Asia,31049015,0,2158
2021-01-10,yemen,Asia,31049015,0,2158
2021-01-11,yemen,Asia,31049015,1,2159
2021-01-12,yemen,Asia,31049015,2,2161
2021-01-13,yemen,Asia,31049015,2,2163
2021-01-14,yemen,Asia,31049015,1,2164
2021-01-15,yemen,Asia,31049015,1,2165
2021-01-16,yemen,Asia,31049015,1,2166
2021-01-17,yemen,Asia,31049015,0,2166
2021-01-18,yemen,Asia,31049015,1,2167
2021-01-19,yemen,Asia,31049015,2,2169
2020-04-03,zambia,Africa,19342381,0,39
2020-04-04,zambia,Africa,19342381,0,39
2020-04-05,zambia,Africa,19342381,0,39
2020-04-06,zambia,Africa,19342381,0,39
2020-04-07,zambia,Africa,19342381,0,39
2020-04-08,zambia,Africa,19342381,0,39
2020-04-09,zambia,Africa,19342381,0,39
2020-04-10,zambia,Africa,19342381,1,40
2020-04-11,zambia,Africa,19342381,0,40
2020-04-12,zambia,Africa,19342381,3,43
2020-04-13,zambia,Africa,19342381,2,45
2020-04-14,zambia,Africa,19342381,0,45
2020-04-15,zambia,Africa,19342381,3,48
2020-04-16,zambia,Africa,19342381,0,48
2020-04-17,zambia,Africa,19342381,4,52
2020-04-18,zambia,Africa,19342381,5,57
2020-04-19,zambia,Africa,19342381,4,61
2020-04-20,zambia,Africa,19342381,4,65
2020-04-21,zambia,Africa,19342381,5,70
2020-04-22,zambia,Africa,19342381,4,74
2020-04-23,zambia,Africa,19342381,2,76
2020-04-24,zambia,Africa,19342381,8,84
2020-04-25,zambia,Africa,19342381,0,84
2020-04-26,zambia,Africa,19342381,4,88
2020-04-27,zambia,Africa,19342381,1,89
2020-04-28,zambia,Africa,19342381,6,95
2020-04-29,zambia,Africa,19342381,2,97
2020-04-30,zambia,Africa,19342381,9,106
2020-05-01,zambia,Africa,19342381,3,109
2020-05-02,zambia,Africa,19342381,10,119
2020-05-03,zambia,Africa,19342381,5,124
2020-05-04,zambia,Africa,19342381,13,137
2020-05-05,zambia,Africa,19342381,1,138
2020-05-06,zambia,Africa,19342381,8,146
2020-05-07,zambia,Africa,19342381,7,153
2020-05-08,zambia,Africa,19342381,14,167
2020-05-09,zambia,Africa,19342381,85,252
2020-05-10,zambia,Africa,19342381,15,267
2020-05-11,zambia,Africa,19342381,0,267
2020-05-12,zambia,Africa,19342381,174,441
2020-05-13,zambia,Africa,19342381,5,446
2020-05-14,zambia,Africa,19342381,208,654
2020-05-15,zambia,Africa,19342381,0,654
2020-05-16,zambia,Africa,19342381,25,679
2020-05-17,zambia,Africa,19342381,74,753
2020-05-18,zambia,Africa,19342381,8,761
2020-05-19,zambia,Africa,19342381,11,772
2020-05-20,zambia,Africa,19342381,60,832
2020-05-21,zambia,Africa,19342381,34,866
2020-05-22,zambia,Africa,19342381,54,920
2020-05-23,zambia,Africa,19342381,0,920
2020-05-24,zambia,Africa,19342381,0,920
2020-05-25,zambia,Africa,19342381,0,920
2020-05-26,zambia,Africa,19342381,0,920
2020-05-27,zambia,Africa,19342381,137,1057
2020-05-28,zambia,Africa,19342381,0,1057
2020-05-29,zambia,Africa,19342381,0,1057
2020-05-30,zambia,Africa,19342381,0,1057
2020-05-31,zambia,Africa,19342381,0,1057
2020-06-01,zambia,Africa,19342381,32,1089
2020-06-02,zambia,Africa,19342381,0,1089
2020-06-03,zambia,Africa,19342381,0,1089
2020-06-04,zambia,Africa,19342381,0,1089
2020-06-05,zambia,Africa,19342381,0,1089
2020-06-06,zambia,Africa,19342381,0,1089
2020-06-07,zambia,Africa,19342381,0,1089
2020-06-08,zambia,Africa,19342381,111,1200
2020-06-09,zambia,Africa,19342381,0,1200
2020-06-10,zambia,Africa,19342381,0,1200
2020-06-11,zambia,Africa,19342381,0,1200
2020-06-12,zambia,Africa,19342381,121,1321
2020-06-13,zambia,Africa,19342381,36,1357
2020-06-14,zambia,Africa,19342381,1,1358
2020-06-15,zambia,Africa,19342381,24,1382
2020-06-16,zambia,Africa,19342381,23,1405
2020-06-17,zambia,Africa,19342381,7,1412
2020-06-18,zambia,Africa,19342381,4,1416
2020-06-19,zambia,Africa,19342381,14,1430
2020-06-20,zambia,Africa,19342381,0,1430
2020-06-21,zambia,Africa,19342381,0,1430
2020-06-22,zambia,Africa,19342381,0,1430
2020-06-23,zambia,Africa,19342381,47,1477
2020-06-24,zambia,Africa,19342381,12,1489
2020-06-25,zambia,Africa,19342381,8,1497
2020-06-26,zambia,Africa,19342381,34,1531
2020-06-27,zambia,Africa,19342381,0,1531
2020-06-28,zambia,Africa,19342381,26,1557
2020-06-29,zambia,Africa,19342381,11,1568
2020-06-30,zambia,Africa,19342381,26,1594
2020-07-01,zambia,Africa,19342381,38,1632
2020-07-02,zambia,Africa,19342381,0,1632
2020-07-03,zambia,Africa,19342381,0,1632
2020-07-04,zambia,Africa,19342381,0,1632
2020-07-05,zambia,Africa,19342381,0,1632
2020-07-06,zambia,Africa,19342381,0,1632
2020-07-07,zambia,Africa,19342381,263,1895
2020-07-08,zambia,Africa,19342381,42,1937
2020-07-09,zambia,Africa,19342381,69,2006
2020-07-10,zambia,Africa,19342381,29,2035
2020-07-11,zambia,Africa,19342381,99,2134
2020-07-12,zambia,Africa,19342381,71,2205
2020-07-13,zambia,Africa,19342381,78,2283
2020-07-14,zambia,Africa,19342381,80,2363
2020-07-15,zambia,Africa,19342381,138,2501
2020-07-16,zambia,Africa,19342381,119,2620
2020-07-17,zambia,Africa,19342381,190,2810
2020-07-18,zambia,Africa,19342381,170,2980
2020-07-19,zambia,Africa,19342381,168,3148
2020-07-20,zambia,Africa,19342381,178,3326
2020-07-21,zambia,Africa,19342381,60,3386
2020-07-22,zambia,Africa,19342381,197,3583
2020-07-23,zambia,Africa,19342381,206,3789
2020-07-24,zambia,Africa,19342381,67,3856
2020-07-25,zambia,Africa,19342381,472,4328
2020-07-26,zambia,Africa,19342381,153,4481
2020-07-27,zambia,Africa,19342381,71,4552
2020-07-28,zambia,Africa,19342381,450,5002
2020-07-29,zambia,Africa,19342381,247,5249
2020-07-30,zambia,Africa,19342381,306,5555
2020-07-31,zambia,Africa,19342381,408,5963
2020-08-01,zambia,Africa,19342381,265,6228
2020-08-02,zambia,Africa,19342381,119,6347
2020-08-03,zambia,Africa,19342381,233,6580
2020-08-04,zambia,Africa,19342381,213,6793
2020-08-05,zambia,Africa,19342381,229,7022
2020-08-06,zambia,Africa,19342381,142,7164
2020-08-07,zambia,Africa,19342381,322,7486
2020-08-08,zambia,Africa,19342381,417,7903
2020-08-09,zambia,Africa,19342381,182,8085
2020-08-10,zambia,Africa,19342381,125,8210
2020-08-11,zambia,Africa,19342381,65,8275
2020-08-12,zambia,Africa,19342381,226,8501
2020-08-13,zambia,Africa,19342381,162,8663
2020-08-14,zambia,Africa,19342381,358,9021
2020-08-15,zambia,Africa,19342381,165,9186
2020-08-16,zambia,Africa,19342381,157,9343
2020-08-17,zambia,Africa,19342381,496,9839
2020-08-18,zambia,Africa,19342381,142,9981
2020-08-19,zambia,Africa,19342381,237,10218
2020-08-20,zambia,Africa,19342381,154,10372
2020-08-21,zambia,Africa,19342381,255,10627
2020-08-22,zambia,Africa,19342381,204,10831
2020-08-23,zambia,Africa,19342381,251,11082
2020-08-24,zambia,Africa,19342381,66,11148
2020-08-25,zambia,Africa,19342381,137,11285
2020-08-26,zambia,Africa,19342381,91,11376
2020-08-27,zambia,Africa,19342381,225,11601
2020-08-28,zambia,Africa,19342381,178,11779
2020-08-29,zambia,Africa,19342381,123,11902
2020-08-30,zambia,Africa,19342381,123,12025
2020-08-31,zambia,Africa,19342381,72,12097
2020-09-01,zambia,Africa,19342381,284,12381
2020-09-02,zambia,Africa,19342381,34,12415
2020-09-03,zambia,Africa,19342381,108,12523
2020-09-04,zambia,Africa,19342381,116,12639
2020-09-05,zambia,Africa,19342381,70,12709
2020-09-06,zambia,Africa,19342381,67,12776
2020-09-07,zambia,Africa,19342381,60,12836
2020-09-08,zambia,Africa,19342381,116,12952
2020-09-09,zambia,Africa,19342381,160,13112
2020-09-10,zambia,Africa,19342381,102,13214
2020-09-11,zambia,Africa,19342381,109,13323
2020-09-12,zambia,Africa,19342381,143,13466
2020-09-13,zambia,Africa,19342381,73,13539
2020-09-14,zambia,Africa,19342381,181,13720
2020-09-15,zambia,Africa,19342381,99,13819
2020-09-16,zambia,Africa,19342381,68,13887
2020-09-17,zambia,Africa,19342381,41,13928
2020-09-18,zambia,Africa,19342381,94,14022
2020-09-19,zambia,Africa,19342381,48,14070
2020-09-20,zambia,Africa,19342381,61,14131
2020-09-21,zambia,Africa,19342381,44,14175
2020-09-22,zambia,Africa,19342381,214,14389
2020-09-23,zambia,Africa,19342381,54,14443
2020-09-24,zambia,Africa,19342381,48,14491
2020-09-25,zambia,Africa,19342381,24,14515
2020-09-26,zambia,Africa,19342381,97,14612
2020-09-27,zambia,Africa,19342381,29,14641
2020-09-28,zambia,Africa,19342381,19,14660
2020-09-29,zambia,Africa,19342381,55,14715
2020-09-30,zambia,Africa,19342381,44,14759
2020-10-01,zambia,Africa,19342381,43,14802
2020-10-02,zambia,Africa,19342381,28,14830
2020-10-03,zambia,Africa,19342381,144,14974
2020-10-04,zambia,Africa,19342381,78,15052
2020-10-05,zambia,Africa,19342381,37,15089
2020-10-06,zambia,Africa,19342381,81,15170
2020-10-07,zambia,Africa,19342381,54,15224
2020-10-08,zambia,Africa,19342381,77,15301
2020-10-09,zambia,Africa,19342381,38,15339
2020-10-10,zambia,Africa,19342381,76,15415
2020-10-11,zambia,Africa,19342381,43,15458
2020-10-12,zambia,Africa,19342381,91,15549
2020-10-13,zambia,Africa,19342381,38,15587
2020-10-14,zambia,Africa,19342381,29,15616
2020-10-15,zambia,Africa,19342381,43,15659
2020-10-16,zambia,Africa,19342381,53,15712
2020-10-17,zambia,Africa,19342381,77,15789
2020-10-18,zambia,Africa,19342381,64,15853
2020-10-19,zambia,Africa,19342381,44,15897
2020-10-20,zambia,Africa,19342381,85,15982
2020-10-21,zambia,Africa,19342381,18,16000
2020-10-22,zambia,Africa,19342381,35,16035
2020-10-23,zambia,Africa,19342381,60,16095
2020-10-24,zambia,Africa,19342381,22,16117
2020-10-25,zambia,Africa,19342381,20,16137
2020-10-26,zambia,Africa,19342381,63,16200
2020-10-27,zambia,Africa,19342381,43,16243
2020-10-28,zambia,Africa,19342381,42,16285
2020-10-29,zambia,Africa,19342381,40,16325
2020-10-30,zambia,Africa,19342381,90,16415
2020-10-31,zambia,Africa,19342381,17,16432
2020-11-01,zambia,Africa,19342381,48,16480
2020-11-02,zambia,Africa,19342381,63,16543
2020-11-03,zambia,Africa,19342381,118,16661
2020-11-04,zambia,Africa,19342381,37,16698
2020-11-05,zambia,Africa,19342381,72,16770
2020-11-06,zambia,Africa,19342381,49,16819
2020-11-07,zambia,Africa,19342381,89,16908
2020-11-08,zambia,Africa,19342381,46,16954
2020-11-09,zambia,Africa,19342381,17,16971
2020-11-10,zambia,Africa,19342381,26,16997
2020-11-11,zambia,Africa,19342381,39,17036
2020-11-12,zambia,Africa,19342381,20,17056
2020-11-13,zambia,Africa,19342381,37,17093
2020-11-14,zambia,Africa,19342381,4,17097
2020-11-15,zambia,Africa,19342381,26,17123
2020-11-16,zambia,Africa,19342381,64,17187
2020-11-17,zambia,Africa,19342381,56,17243
2020-11-18,zambia,Africa,19342381,37,17280
2020-11-19,zambia,Africa,19342381,70,17350
2020-11-20,zambia,Africa,19342381,23,17373
2020-11-21,zambia,Africa,19342381,21,17394
2020-11-22,zambia,Africa,19342381,30,17424
2020-11-23,zambia,Africa,19342381,30,17454
2020-11-24,zambia,Africa,19342381,12,17466
2020-11-25,zambia,Africa,19342381,69,17535
2020-11-26,zambia,Africa,19342381,18,17553
2020-11-27,zambia,Africa,19342381,16,17569
2020-11-28,zambia,Africa,19342381,20,17589
2020-11-29,zambia,Africa,19342381,19,17608
2020-11-30,zambia,Africa,19342381,39,17647
2020-12-01,zambia,Africa,19342381,18,17665
2020-12-02,zambia,Africa,19342381,35,17700
2020-12-03,zambia,Africa,19342381,30,17730
2020-12-04,zambia,Africa,19342381,127,17857
2020-12-05,zambia,Africa,19342381,41,17898
2020-12-06,zambia,Africa,19342381,18,17916
2020-12-07,zambia,Africa,19342381,15,17931
2020-12-08,zambia,Africa,19342381,32,17963
2020-12-09,zambia,Africa,19342381,99,18062
2020-12-10,zambia,Africa,19342381,29,18091
2020-12-11,zambia,Africa,19342381,70,18161
2020-12-12,zambia,Africa,19342381,56,18217
2020-12-13,zambia,Africa,19342381,57,18274
2020-12-14,zambia,Africa,19342381,48,18322
2020-12-15,zambia,Africa,19342381,106,18428
2020-12-16,zambia,Africa,19342381,28,18456
2020-12-17,zambia,Africa,19342381,48,18504
2020-12-18,zambia,Africa,19342381,71,18575
2020-12-19,zambia,Africa,19342381,45,18620
2020-12-20,zambia,Africa,19342381,96,18716
2020-12-21,zambia,Africa,19342381,52,18768
2020-12-22,zambia,Africa,19342381,113,18881
2020-12-23,zambia,Africa,19342381,241,19122
2020-12-24,zambia,Africa,19342381,112,19234
2020-12-25,zambia,Africa,19342381,337,19571
2020-12-26,zambia,Africa,19342381,100,19671
2020-12-27,zambia,Africa,19342381,163,19834
2020-12-28,zambia,Africa,19342381,109,19943
2020-12-29,zambia,Africa,19342381,234,20177
2020-12-30,zambia,Africa,19342381,285,20462
2020-12-31,zambia,Africa,19342381,263,20725
2021-01-01,zambia,Africa,19342381,272,20997
2021-01-02,zambia,Africa,19342381,233,21230
2021-01-03,zambia,Africa,19342381,352,21582
2021-01-04,zambia,Africa,19342381,411,21993
2021-01-05,zambia,Africa,19342381,652,22645
2021-01-06,zambia,Africa,19342381,850,23495
2021-01-07,zambia,Africa,19342381,802,24297
2021-01-08,zambia,Africa,19342381,1029,25326
2021-01-09,zambia,Africa,19342381,1241,26567
2021-01-10,zambia,Africa,19342381,1161,27728
2021-01-11,zambia,Africa,19342381,868,28596
2021-01-12,zambia,Africa,19342381,1161,29757
2021-01-13,zambia,Africa,19342381,1343,31100
2021-01-14,zambia,Africa,19342381,1700,32800
2021-01-15,zambia,Africa,19342381,1478,34278
2021-01-16,zambia,Africa,19342381,1796,36074
2021-01-17,zambia,Africa,19342381,1531,37605
2021-01-18,zambia,Africa,19342381,602,38207
2021-01-19,zambia,Africa,19342381,1308,39515
2021-01-20,zambia,Africa,19342381,1434,40949
2021-01-21,zambia,Africa,19342381,1264,42213
2021-01-22,zambia,Africa,19342381,1120,43333
2021-01-23,zambia,Africa,19342381,1259,44592
2021-01-24,zambia,Africa,19342381,745,45337
2021-01-25,zambia,Africa,19342381,809,46146
2021-01-26,zambia,Africa,19342381,1476,47622
2021-01-27,zambia,Africa,19342381,1289,48911
2021-01-28,zambia,Africa,19342381,1408,50319
2021-01-29,zambia,Africa,19342381,1305,51624
2021-01-30,zambia,Africa,19342381,1728,53352
2021-01-31,zambia,Africa,19342381,865,54217
2021-02-01,zambia,Africa,19342381,825,55042
2021-02-02,zambia,Africa,19342381,1191,56233
2021-02-03,zambia,Africa,19342381,1256,57489
2021-02-04,zambia,Africa,19342381,1514,59003
2021-02-05,zambia,Africa,19342381,1424,60427
2021-02-06,zambia,Africa,19342381,1000,61427
2021-02-07,zambia,Africa,19342381,1206,62633
2021-02-08,zambia,Africa,19342381,940,63573
2021-02-09,zambia,Africa,19342381,1037,64610
2021-02-10,zambia,Africa,19342381,963,65573
2021-02-11,zambia,Africa,19342381,1025,66598
2021-02-12,zambia,Africa,19342381,1083,67681
2021-02-13,zambia,Africa,19342381,773,68454
2021-02-14,zambia,Africa,19342381,983,69437
2021-02-15,zambia,Africa,19342381,811,70248
2021-02-16,zambia,Africa,19342381,575,70823
2021-02-17,zambia,Africa,19342381,854,71677
2021-02-18,zambia,Africa,19342381,790,72467
2021-02-19,zambia,Africa,19342381,736,73203
2021-02-20,zambia,Africa,19342381,691,73894
2021-02-21,zambia,Africa,19342381,609,74503
2021-02-22,zambia,Africa,19342381,524,75027
2021-02-23,zambia,Africa,19342381,555,75582
2021-02-24,zambia,Africa,19342381,902,76484
2021-02-25,zambia,Africa,19342381,687,77171
2021-02-26,zambia,Africa,19342381,468,77639
2021-02-27,zambia,Africa,19342381,563,78202
2021-02-28,zambia,Africa,19342381,332,78534
2021-03-01,zambia,Africa,19342381,468,79002
2021-03-02,zambia,Africa,19342381,555,79557
2021-03-03,zambia,Africa,19342381,533,80090
2021-03-04,zambia,Africa,19342381,597,80687
2021-03-05,zambia,Africa,19342381,654,81341
2021-03-06,zambia,Africa,19342381,670,82011
2021-03-07,zambia,Africa,19342381,410,82421
2021-03-08,zambia,Africa,19342381,234,82655
2021-03-09,zambia,Africa,19342381,242,82897
2021-03-10,zambia,Africa,19342381,436,83333
2021-03-11,zambia,Africa,19342381,580,83913
2021-03-12,zambia,Africa,19342381,327,84240
2021-03-13,zambia,Africa,19342381,234,84474
2021-03-14,zambia,Africa,19342381,323,84797
2021-03-15,zambia,Africa,19342381,153,84950
2021-03-16,zambia,Africa,19342381,290,85240
2021-03-17,zambia,Africa,19342381,262,85502
2021-03-18,zambia,Africa,19342381,387,85889
2021-03-19,zambia,Africa,19342381,170,86059
2021-03-20,zambia,Africa,19342381,214,86273
2021-03-21,zambia,Africa,19342381,176,86449
2021-03-22,zambia,Africa,19342381,86,86535
2021-03-23,zambia,Africa,19342381,244,86779
2021-03-24,zambia,Africa,19342381,214,86993
2021-03-25,zambia,Africa,19342381,325,87318
2021-03-26,zambia,Africa,19342381,121,87439
2021-03-27,zambia,Africa,19342381,288,87727
2021-03-28,zambia,Africa,19342381,145,87872
2021-03-29,zambia,Africa,19342381,140,88012
2021-03-30,zambia,Africa,19342381,187,88199
2021-03-31,zambia,Africa,19342381,219,88418
2021-04-01,zambia,Africa,19342381,131,88549
2021-04-02,zambia,Africa,19342381,181,88730
2021-04-03,zambia,Africa,19342381,70,88800
2021-04-04,zambia,Africa,19342381,130,88930
2021-04-05,zambia,Africa,19342381,79,89009
2021-04-06,zambia,Africa,19342381,62,89071
2021-04-07,zambia,Africa,19342381,315,89386
2021-04-08,zambia,Africa,19342381,206,89592
2021-04-09,zambia,Africa,19342381,191,89783
2021-04-10,zambia,Africa,19342381,135,89918
2021-04-11,zambia,Africa,19342381,111,90029
2021-04-12,zambia,Africa,19342381,35,90064
2021-04-13,zambia,Africa,19342381,154,90218
2021-04-14,zambia,Africa,19342381,171,90389
2021-04-15,zambia,Africa,19342381,143,90532
2021-04-16,zambia,Africa,19342381,218,90750
2021-04-17,zambia,Africa,19342381,94,90844
2021-04-18,zambia,Africa,19342381,74,90918
2021-04-19,zambia,Africa,19342381,24,90942
2021-04-20,zambia,Africa,19342381,100,91042
2021-04-21,zambia,Africa,19342381,77,91119
2021-04-22,zambia,Africa,19342381,70,91189
2021-04-23,zambia,Africa,19342381,62,91251
2021-04-24,zambia,Africa,19342381,66,91317
2021-04-25,zambia,Africa,19342381,41,91358
2021-04-26,zambia,Africa,19342381,20,91378
2021-04-27,zambia,Africa,19342381,40,91418
2021-04-28,zambia,Africa,19342381,66,91484
2021-04-29,zambia,Africa,19342381,49,91533
2021-04-30,zambia,Africa,19342381,53,91586
2021-05-01,zambia,Africa,19342381,84,91670
2021-05-02,zambia,Africa,19342381,23,91693
2021-05-03,zambia,Africa,19342381,29,91722
2021-05-04,zambia,Africa,19342381,82,91804
2021-05-05,zambia,Africa,19342381,45,91849
2021-05-06,zambia,Africa,19342381,97,91946
2021-05-07,zambia,Africa,19342381,58,92004
2021-05-08,zambia,Africa,19342381,53,92057
2021-05-09,zambia,Africa,19342381,35,92092
2021-05-10,zambia,Africa,19342381,20,92112
2021-05-11,zambia,Africa,19342381,40,92152
2021-05-12,zambia,Africa,19342381,59,92211
2021-05-13,zambia,Africa,19342381,51,92262
2021-05-14,zambia,Africa,19342381,94,92356
2021-05-15,zambia,Africa,19342381,53,92409
2021-05-16,zambia,Africa,19342381,27,92436
2021-05-17,zambia,Africa,19342381,24,92460
2021-05-18,zambia,Africa,19342381,60,92520
2021-05-19,zambia,Africa,19342381,110,92630
2021-05-20,zambia,Africa,19342381,124,92754
2021-05-21,zambia,Africa,19342381,166,92920
2021-05-22,zambia,Africa,19342381,186,93106
2021-05-23,zambia,Africa,19342381,95,93201
2021-05-24,zambia,Africa,19342381,78,93279
2021-05-25,zambia,Africa,19342381,149,93428
2021-05-26,zambia,Africa,19342381,199,93627
2021-05-27,zambia,Africa,19342381,320,93947
2021-05-28,zambia,Africa,19342381,483,94430
2021-05-29,zambia,Africa,19342381,321,94751
2021-05-30,zambia,Africa,19342381,299,95050
2021-05-31,zambia,Africa,19342381,213,95263
2021-06-01,zambia,Africa,19342381,558,95821
2021-06-02,zambia,Africa,19342381,742,96563
2021-06-03,zambia,Africa,19342381,825,97388
2021-06-04,zambia,Africa,19342381,988,98376
2021-06-05,zambia,Africa,19342381,1164,99540
2021-06-06,zambia,Africa,19342381,738,100278
2021-06-07,zambia,Africa,19342381,487,100765
2021-06-08,zambia,Africa,19342381,1231,101996
2021-06-09,zambia,Africa,19342381,1767,103763
2021-06-10,zambia,Africa,19342381,2146,105909
2021-06-11,zambia,Africa,19342381,2065,107974
2021-06-12,zambia,Africa,19342381,2358,110332
2021-06-13,zambia,Africa,19342381,1414,111746
2021-06-14,zambia,Africa,19342381,1388,113134
2021-06-15,zambia,Africa,19342381,2690,115824
2021-06-16,zambia,Africa,19342381,3026,118850
2021-06-17,zambia,Africa,19342381,3394,122244
2021-06-18,zambia,Africa,19342381,2913,125157
2021-06-19,zambia,Africa,19342381,1816,126973
2021-06-20,zambia,Africa,19342381,2060,129033
2021-06-21,zambia,Africa,19342381,1598,130631
2021-06-22,zambia,Africa,19342381,3028,133659
2021-06-23,zambia,Africa,19342381,3367,137026
2021-06-24,zambia,Africa,19342381,3594,140620
2021-06-25,zambia,Africa,19342381,2595,143215
2021-06-26,zambia,Africa,19342381,2816,146031
2021-06-27,zambia,Africa,19342381,2537,148568
2021-06-28,zambia,Africa,19342381,1093,149661
2021-06-29,zambia,Africa,19342381,2395,152056
2021-06-30,zambia,Africa,19342381,2892,154948
2021-07-01,zambia,Africa,19342381,2884,157832
2021-07-02,zambia,Africa,19342381,2781,160613
2021-07-03,zambia,Africa,19342381,1874,162487
2021-07-04,zambia,Africa,19342381,1795,164282
2021-07-05,zambia,Africa,19342381,1231,165513
2021-07-06,zambia,Africa,19342381,1619,167132
2021-07-07,zambia,Africa,19342381,1871,169003
2021-07-08,zambia,Africa,19342381,1453,170456
2021-07-09,zambia,Africa,19342381,1949,172405
2021-07-10,zambia,Africa,19342381,2384,174789
2021-07-11,zambia,Africa,19342381,940,175729
2021-07-12,zambia,Africa,19342381,1013,176742
2021-07-13,zambia,Africa,19342381,2006,178748
2021-07-14,zambia,Africa,19342381,1801,180549
2021-07-15,zambia,Africa,19342381,1580,182129
2021-07-16,zambia,Africa,19342381,1215,183344
2021-07-17,zambia,Africa,19342381,1328,184672
2021-07-18,zambia,Africa,19342381,977,185649
2021-07-19,zambia,Africa,19342381,630,186279
2021-07-20,zambia,Africa,19342381,1323,187602
2021-07-21,zambia,Africa,19342381,971,188573
2021-07-22,zambia,Africa,19342381,1158,189731
2021-07-23,zambia,Africa,19342381,884,190615
2021-07-24,zambia,Africa,19342381,912,191527
2021-07-25,zambia,Africa,19342381,544,192071
2021-07-26,zambia,Africa,19342381,245,192316
2021-07-27,zambia,Africa,19342381,640,192956
2021-07-28,zambia,Africa,19342381,476,193432
2021-07-29,zambia,Africa,19342381,708,194140
2021-07-30,zambia,Africa,19342381,956,195096
2021-07-31,zambia,Africa,19342381,720,195816
2021-08-01,zambia,Africa,19342381,477,196293
2021-08-02,zambia,Africa,19342381,197,196490
2021-08-03,zambia,Africa,19342381,633,197123
2021-08-04,zambia,Africa,19342381,668,197791
2021-08-05,zambia,Africa,19342381,664,198455
2021-08-06,zambia,Africa,19342381,680,199135
2021-08-07,zambia,Africa,19342381,527,199662
2021-08-08,zambia,Africa,19342381,387,200049
2021-08-09,zambia,Africa,19342381,152,200201
2021-08-10,zambia,Africa,19342381,629,200830
2021-08-11,zambia,Africa,19342381,512,201342
2021-08-12,zambia,Africa,19342381,428,201770
2021-08-13,zambia,Africa,19342381,97,201867
2021-08-14,zambia,Africa,19342381,211,202078
2021-08-15,zambia,Africa,19342381,183,202261
2021-08-16,zambia,Africa,19342381,168,202429
2021-08-17,zambia,Africa,19342381,358,202787
2021-08-18,zambia,Africa,19342381,382,203169
2021-08-19,zambia,Africa,19342381,384,203553
2021-08-20,zambia,Africa,19342381,425,203978
2021-08-21,zambia,Africa,19342381,359,204337
2021-08-22,zambia,Africa,19342381,212,204549
2021-08-23,zambia,Africa,19342381,102,204651
2021-08-24,zambia,Africa,19342381,326,204977
2021-08-25,zambia,Africa,19342381,130,205107
2021-08-26,zambia,Africa,19342381,208,205315
2021-08-27,zambia,Africa,19342381,389,205704
2021-08-28,zambia,Africa,19342381,189,205893
2021-08-29,zambia,Africa,19342381,158,206051
2021-08-30,zambia,Africa,19342381,94,206145
2021-08-31,zambia,Africa,19342381,182,206327
2021-09-01,zambia,Africa,19342381,195,206522
2021-09-02,zambia,Africa,19342381,183,206705
2021-09-03,zambia,Africa,19342381,179,206884
2021-09-04,zambia,Africa,19342381,144,207028
2020-03-24,zimbabwe,Africa,15265849,0,3
2020-03-25,zimbabwe,Africa,15265849,0,3
2020-03-26,zimbabwe,Africa,15265849,0,3
2020-03-27,zimbabwe,Africa,15265849,2,5
2020-03-28,zimbabwe,Africa,15265849,2,7
2020-03-29,zimbabwe,Africa,15265849,0,7
2020-03-30,zimbabwe,Africa,15265849,0,7
2020-03-31,zimbabwe,Africa,15265849,1,8
2020-04-01,zimbabwe,Africa,15265849,0,8
2020-04-02,zimbabwe,Africa,15265849,1,9
2020-04-03,zimbabwe,Africa,15265849,0,9
2020-04-04,zimbabwe,Africa,15265849,0,9
2020-04-05,zimbabwe,Africa,15265849,0,9
2020-04-06,zimbabwe,Africa,15265849,1,10
2020-04-07,zimbabwe,Africa,15265849,1,11
2020-04-08,zimbabwe,Africa,15265849,0,11
2020-04-09,zimbabwe,Africa,15265849,0,11
2020-04-10,zimbabwe,Africa,15265849,2,13
2020-04-11,zimbabwe,Africa,15265849,1,14
2020-04-12,zimbabwe,Africa,15265849,0,14
2020-04-13,zimbabwe,Africa,15265849,3,17
2020-04-14,zimbabwe,Africa,15265849,0,17
2020-04-15,zimbabwe,Africa,15265849,6,23
2020-04-16,zimbabwe,Africa,15265849,0,23
2020-04-17,zimbabwe,Africa,15265849,1,24
2020-04-18,zimbabwe,Africa,15265849,1,25
2020-04-19,zimbabwe,Africa,15265849,0,25
2020-04-20,zimbabwe,Africa,15265849,0,25
2020-04-21,zimbabwe,Africa,15265849,3,28
2020-04-22,zimbabwe,Africa,15265849,0,28
2020-04-23,zimbabwe,Africa,15265849,0,28
2020-04-24,zimbabwe,Africa,15265849,1,29
2020-04-25,zimbabwe,Africa,15265849,2,31
2020-04-26,zimbabwe,Africa,15265849,0,31
2020-04-27,zimbabwe,Africa,15265849,0,31
2020-04-28,zimbabwe,Africa,15265849,1,32
2020-04-29,zimbabwe,Africa,15265849,0,32
2020-04-30,zimbabwe,Africa,15265849,2,34
2020-05-01,zimbabwe,Africa,15265849,0,34
2020-05-02,zimbabwe,Africa,15265849,0,34
2020-05-03,zimbabwe,Africa,15265849,0,34
2020-05-04,zimbabwe,Africa,15265849,0,34
2020-05-05,zimbabwe,Africa,15265849,0,34
2020-05-06,zimbabwe,Africa,15265849,0,34
2020-05-07,zimbabwe,Africa,15265849,0,34
2020-05-08,zimbabwe,Africa,15265849,0,34
2020-05-09,zimbabwe,Africa,15265849,1,35
2020-05-10,zimbabwe,Africa,15265849,1,36
2020-05-11,zimbabwe,Africa,15265849,0,36
2020-05-12,zimbabwe,Africa,15265849,0,36
2020-05-13,zimbabwe,Africa,15265849,1,37
2020-05-14,zimbabwe,Africa,15265849,0,37
2020-05-15,zimbabwe,Africa,15265849,5,42
2020-05-16,zimbabwe,Africa,15265849,0,42
2020-05-17,zimbabwe,Africa,15265849,2,44
2020-05-18,zimbabwe,Africa,15265849,2,46
2020-05-19,zimbabwe,Africa,15265849,0,46
2020-05-20,zimbabwe,Africa,15265849,2,48
2020-05-21,zimbabwe,Africa,15265849,3,51
2020-05-22,zimbabwe,Africa,15265849,0,51
2020-05-23,zimbabwe,Africa,15265849,5,56
2020-05-24,zimbabwe,Africa,15265849,0,56
2020-05-25,zimbabwe,Africa,15265849,0,56
2020-05-26,zimbabwe,Africa,15265849,0,56
2020-05-27,zimbabwe,Africa,15265849,76,132
2020-05-28,zimbabwe,Africa,15265849,17,149
2020-05-29,zimbabwe,Africa,15265849,0,149
2020-05-30,zimbabwe,Africa,15265849,25,174
2020-05-31,zimbabwe,Africa,15265849,4,178
2020-06-01,zimbabwe,Africa,15265849,25,203
2020-06-02,zimbabwe,Africa,15265849,3,206
2020-06-03,zimbabwe,Africa,15265849,16,222
2020-06-04,zimbabwe,Africa,15265849,15,237
2020-06-05,zimbabwe,Africa,15265849,28,265
2020-06-06,zimbabwe,Africa,15265849,14,279
2020-06-07,zimbabwe,Africa,15265849,3,282
2020-06-08,zimbabwe,Africa,15265849,5,287
2020-06-09,zimbabwe,Africa,15265849,27,314
2020-06-10,zimbabwe,Africa,15265849,6,320
2020-06-11,zimbabwe,Africa,15265849,12,332
2020-06-12,zimbabwe,Africa,15265849,11,343
2020-06-13,zimbabwe,Africa,15265849,13,356
2020-06-14,zimbabwe,Africa,15265849,27,383
2020-06-15,zimbabwe,Africa,15265849,4,387
2020-06-16,zimbabwe,Africa,15265849,4,391
2020-06-17,zimbabwe,Africa,15265849,10,401
2020-06-18,zimbabwe,Africa,15265849,62,463
2020-06-19,zimbabwe,Africa,15265849,16,479
2020-06-20,zimbabwe,Africa,15265849,0,479
2020-06-21,zimbabwe,Africa,15265849,10,489
2020-06-22,zimbabwe,Africa,15265849,23,512
2020-06-23,zimbabwe,Africa,15265849,13,525
2020-06-24,zimbabwe,Africa,15265849,5,530
2020-06-25,zimbabwe,Africa,15265849,21,551
2020-06-26,zimbabwe,Africa,15265849,10,561
2020-06-27,zimbabwe,Africa,15265849,6,567
2020-06-28,zimbabwe,Africa,15265849,0,567
2020-06-29,zimbabwe,Africa,15265849,7,574
2020-06-30,zimbabwe,Africa,15265849,17,591
2020-07-01,zimbabwe,Africa,15265849,14,605
2020-07-02,zimbabwe,Africa,15265849,12,617
2020-07-03,zimbabwe,Africa,15265849,8,625
2020-07-04,zimbabwe,Africa,15265849,73,698
2020-07-05,zimbabwe,Africa,15265849,18,716
2020-07-06,zimbabwe,Africa,15265849,18,734
2020-07-07,zimbabwe,Africa,15265849,53,787
2020-07-08,zimbabwe,Africa,15265849,98,885
2020-07-09,zimbabwe,Africa,15265849,41,926
2020-07-10,zimbabwe,Africa,15265849,16,942
2020-07-11,zimbabwe,Africa,15265849,40,982
2020-07-12,zimbabwe,Africa,15265849,3,985
2020-07-13,zimbabwe,Africa,15265849,49,1034
2020-07-14,zimbabwe,Africa,15265849,30,1064
2020-07-15,zimbabwe,Africa,15265849,25,1089
2020-07-16,zimbabwe,Africa,15265849,273,1362
2020-07-17,zimbabwe,Africa,15265849,58,1420
2020-07-18,zimbabwe,Africa,15265849,58,1478
2020-07-19,zimbabwe,Africa,15265849,133,1611
2020-07-20,zimbabwe,Africa,15265849,102,1713
2020-07-21,zimbabwe,Africa,15265849,107,1820
2020-07-22,zimbabwe,Africa,15265849,214,2034
2020-07-23,zimbabwe,Africa,15265849,90,2124
2020-07-24,zimbabwe,Africa,15265849,172,2296
2020-07-25,zimbabwe,Africa,15265849,138,2434
2020-07-26,zimbabwe,Africa,15265849,78,2512
2020-07-27,zimbabwe,Africa,15265849,192,2704
2020-07-28,zimbabwe,Africa,15265849,113,2817
2020-07-29,zimbabwe,Africa,15265849,62,2879
2020-07-30,zimbabwe,Africa,15265849,213,3092
2020-07-31,zimbabwe,Africa,15265849,77,3169
2020-08-01,zimbabwe,Africa,15265849,490,3659
2020-08-02,zimbabwe,Africa,15265849,262,3921
2020-08-03,zimbabwe,Africa,15265849,154,4075
2020-08-04,zimbabwe,Africa,15265849,146,4221
2020-08-05,zimbabwe,Africa,15265849,0,4221
2020-08-06,zimbabwe,Africa,15265849,118,4339
2020-08-07,zimbabwe,Africa,15265849,112,4451
2020-08-08,zimbabwe,Africa,15265849,124,4575
2020-08-09,zimbabwe,Africa,15265849,74,4649
2020-08-10,zimbabwe,Africa,15265849,99,4748
2020-08-11,zimbabwe,Africa,15265849,70,4818
2020-08-12,zimbabwe,Africa,15265849,75,4893
2020-08-13,zimbabwe,Africa,15265849,97,4990
2020-08-14,zimbabwe,Africa,15265849,82,5072
2020-08-15,zimbabwe,Africa,15265849,104,5176
2020-08-16,zimbabwe,Africa,15265849,85,5261
2020-08-17,zimbabwe,Africa,15265849,47,5308
2020-08-18,zimbabwe,Africa,15265849,70,5378
2020-08-19,zimbabwe,Africa,15265849,265,5643
2020-08-20,zimbabwe,Africa,15265849,102,5745
2020-08-21,zimbabwe,Africa,15265849,70,5815
2020-08-22,zimbabwe,Africa,15265849,78,5893
2020-08-23,zimbabwe,Africa,15265849,37,5930
2020-08-24,zimbabwe,Africa,15265849,140,6070
2020-08-25,zimbabwe,Africa,15265849,126,6196
2020-08-26,zimbabwe,Africa,15265849,55,6251
2020-08-27,zimbabwe,Africa,15265849,41,6292
2020-08-28,zimbabwe,Africa,15265849,96,6388
2020-08-29,zimbabwe,Africa,15265849,18,6406
2020-08-30,zimbabwe,Africa,15265849,6,6412
2020-08-31,zimbabwe,Africa,15265849,85,6497
2020-09-01,zimbabwe,Africa,15265849,62,6559
2020-09-02,zimbabwe,Africa,15265849,79,6638
2020-09-03,zimbabwe,Africa,15265849,40,6678
2020-09-04,zimbabwe,Africa,15265849,159,6837
2020-09-05,zimbabwe,Africa,15265849,0,6837
2020-09-06,zimbabwe,Africa,15265849,0,6837
2020-09-07,zimbabwe,Africa,15265849,461,7298
2020-09-08,zimbabwe,Africa,15265849,90,7388
2020-09-09,zimbabwe,Africa,15265849,41,7429
2020-09-10,zimbabwe,Africa,15265849,24,7453
2020-09-11,zimbabwe,Africa,15265849,26,7479
2020-09-12,zimbabwe,Africa,15265849,29,7508
2020-09-13,zimbabwe,Africa,15265849,18,7526
2020-09-14,zimbabwe,Africa,15265849,5,7531
2020-09-15,zimbabwe,Africa,15265849,45,7576
2020-09-16,zimbabwe,Africa,15265849,22,7598
2020-09-17,zimbabwe,Africa,15265849,35,7633
2020-09-18,zimbabwe,Africa,15265849,14,7647
2020-09-19,zimbabwe,Africa,15265849,25,7672
2020-09-20,zimbabwe,Africa,15265849,11,7683
2020-09-21,zimbabwe,Africa,15265849,23,7706
2020-09-22,zimbabwe,Africa,15265849,5,7711
2020-09-23,zimbabwe,Africa,15265849,14,7725
2020-09-24,zimbabwe,Africa,15265849,27,7752
2020-09-25,zimbabwe,Africa,15265849,35,7787
2020-09-26,zimbabwe,Africa,15265849,16,7803
2020-09-27,zimbabwe,Africa,15265849,9,7812
2020-09-28,zimbabwe,Africa,15265849,4,7816
2020-09-29,zimbabwe,Africa,15265849,21,7837
2020-09-30,zimbabwe,Africa,15265849,1,7838
2020-10-01,zimbabwe,Africa,15265849,12,7850
2020-10-02,zimbabwe,Africa,15265849,8,7858
2020-10-03,zimbabwe,Africa,15265849,27,7885
2020-10-04,zimbabwe,Africa,15265849,3,7888
2020-10-05,zimbabwe,Africa,15265849,10,7898
2020-10-06,zimbabwe,Africa,15265849,17,7915
2020-10-07,zimbabwe,Africa,15265849,4,7919
2020-10-08,zimbabwe,Africa,15265849,32,7951
2020-10-09,zimbabwe,Africa,15265849,43,7994
2020-10-10,zimbabwe,Africa,15265849,16,8010
2020-10-11,zimbabwe,Africa,15265849,1,8011
2020-10-12,zimbabwe,Africa,15265849,10,8021
2020-10-13,zimbabwe,Africa,15265849,15,8036
2020-10-14,zimbabwe,Africa,15265849,19,8055
2020-10-15,zimbabwe,Africa,15265849,20,8075
2020-10-16,zimbabwe,Africa,15265849,24,8099
2020-10-17,zimbabwe,Africa,15265849,11,8110
2020-10-18,zimbabwe,Africa,15265849,37,8147
2020-10-19,zimbabwe,Africa,15265849,12,8159
2020-10-20,zimbabwe,Africa,15265849,28,8187
2020-10-21,zimbabwe,Africa,15265849,28,8215
2020-10-22,zimbabwe,Africa,15265849,27,8242
2020-10-23,zimbabwe,Africa,15265849,15,8257
2020-10-24,zimbabwe,Africa,15265849,12,8269
2020-10-25,zimbabwe,Africa,15265849,7,8276
2020-10-26,zimbabwe,Africa,15265849,27,8303
2020-10-27,zimbabwe,Africa,15265849,12,8315
2020-10-28,zimbabwe,Africa,15265849,5,8320
2020-10-29,zimbabwe,Africa,15265849,29,8349
2020-10-30,zimbabwe,Africa,15265849,13,8362
2020-10-31,zimbabwe,Africa,15265849,5,8367
2020-11-01,zimbabwe,Africa,15265849,7,8374
2020-11-02,zimbabwe,Africa,15265849,15,8389
2020-11-03,zimbabwe,Africa,15265849,21,8410
2020-11-04,zimbabwe,Africa,15265849,17,8427
2020-11-05,zimbabwe,Africa,15265849,17,8444
2020-11-06,zimbabwe,Africa,15265849,27,8471
2020-11-07,zimbabwe,Africa,15265849,27,8498
2020-11-08,zimbabwe,Africa,15265849,33,8531
2020-11-09,zimbabwe,Africa,15265849,30,8561
2020-11-10,zimbabwe,Africa,15265849,49,8610
2020-11-11,zimbabwe,Africa,15265849,57,8667
2020-11-12,zimbabwe,Africa,15265849,29,8696
2020-11-13,zimbabwe,Africa,15265849,69,8765
2020-11-14,zimbabwe,Africa,15265849,21,8786
2020-11-15,zimbabwe,Africa,15265849,43,8829
2020-11-16,zimbabwe,Africa,15265849,68,8897
2020-11-17,zimbabwe,Africa,15265849,48,8945
2020-11-18,zimbabwe,Africa,15265849,36,8981
2020-11-19,zimbabwe,Africa,15265849,65,9046
2020-11-20,zimbabwe,Africa,15265849,74,9120
2020-11-21,zimbabwe,Africa,15265849,52,9172
2020-11-22,zimbabwe,Africa,15265849,48,9220
2020-11-23,zimbabwe,Africa,15265849,88,9308
2020-11-24,zimbabwe,Africa,15265849,90,9398
2020-11-25,zimbabwe,Africa,15265849,110,9508
2020-11-26,zimbabwe,Africa,15265849,115,9623
2020-11-27,zimbabwe,Africa,15265849,91,9714
2020-11-28,zimbabwe,Africa,15265849,108,9822
2020-11-29,zimbabwe,Africa,15265849,128,9950
2020-11-30,zimbabwe,Africa,15265849,84,10034
2020-12-01,zimbabwe,Africa,15265849,95,10129
2020-12-02,zimbabwe,Africa,15265849,114,10243
2020-12-03,zimbabwe,Africa,15265849,181,10424
2020-12-04,zimbabwe,Africa,15265849,123,10547
2020-12-05,zimbabwe,Africa,15265849,70,10617
2020-12-06,zimbabwe,Africa,15265849,101,10718
2020-12-07,zimbabwe,Africa,15265849,121,10839
2020-12-08,zimbabwe,Africa,15265849,73,10912
2020-12-09,zimbabwe,Africa,15265849,95,11007
2020-12-10,zimbabwe,Africa,15265849,74,11081
2020-12-11,zimbabwe,Africa,15265849,81,11162
2020-12-12,zimbabwe,Africa,15265849,57,11219
2020-12-13,zimbabwe,Africa,15265849,27,11246
2020-12-14,zimbabwe,Africa,15265849,112,11358
2020-12-15,zimbabwe,Africa,15265849,164,11522
2020-12-16,zimbabwe,Africa,15265849,227,11749
2020-12-17,zimbabwe,Africa,15265849,117,11866
2020-12-18,zimbabwe,Africa,15265849,181,12047
2020-12-19,zimbabwe,Africa,15265849,104,12151
2020-12-20,zimbabwe,Africa,15265849,174,12325
2020-12-21,zimbabwe,Africa,15265849,97,12422
2020-12-22,zimbabwe,Africa,15265849,122,12544
2020-12-23,zimbabwe,Africa,15265849,112,12656
2020-12-24,zimbabwe,Africa,15265849,130,12786
2020-12-25,zimbabwe,Africa,15265849,94,12880
2020-12-26,zimbabwe,Africa,15265849,83,12963
2020-12-27,zimbabwe,Africa,15265849,114,13077
2020-12-28,zimbabwe,Africa,15265849,71,13148
2020-12-29,zimbabwe,Africa,15265849,177,13325
2020-12-30,zimbabwe,Africa,15265849,300,13625
2020-12-31,zimbabwe,Africa,15265849,242,13867
2021-01-01,zimbabwe,Africa,15265849,217,14084
2021-01-02,zimbabwe,Africa,15265849,407,14491
2021-01-03,zimbabwe,Africa,15265849,774,15265
2021-01-04,zimbabwe,Africa,15265849,564,15829
2021-01-05,zimbabwe,Africa,15265849,1365,17194
2021-01-06,zimbabwe,Africa,15265849,610,17804
2021-01-07,zimbabwe,Africa,15265849,871,18675
2021-01-08,zimbabwe,Africa,15265849,985,19660
2021-01-09,zimbabwe,Africa,15265849,839,20499
2021-01-10,zimbabwe,Africa,15265849,978,21477
2021-01-11,zimbabwe,Africa,15265849,820,22297
2021-01-12,zimbabwe,Africa,15265849,942,23239
2021-01-13,zimbabwe,Africa,15265849,1017,24256
2021-01-14,zimbabwe,Africa,15265849,1112,25368
2021-01-15,zimbabwe,Africa,15265849,741,26109
2021-01-16,zimbabwe,Africa,15265849,772,26881
2021-01-17,zimbabwe,Africa,15265849,322,27203
2021-01-18,zimbabwe,Africa,15265849,689,27892
2021-01-19,zimbabwe,Africa,15265849,783,28675
2021-01-20,zimbabwe,Africa,15265849,733,29408
2021-01-21,zimbabwe,Africa,15265849,639,30047
2021-01-22,zimbabwe,Africa,15265849,476,30523
2021-01-23,zimbabwe,Africa,15265849,484,31007
2021-01-24,zimbabwe,Africa,15265849,313,31320
2021-01-25,zimbabwe,Africa,15265849,326,31646
2021-01-26,zimbabwe,Africa,15265849,358,32004
2021-01-27,zimbabwe,Africa,15265849,300,32304
2021-01-28,zimbabwe,Africa,15265849,342,32646
2021-01-29,zimbabwe,Africa,15265849,306,32952
2021-01-30,zimbabwe,Africa,15265849,321,33273
2021-01-31,zimbabwe,Africa,15265849,115,33388
2021-02-01,zimbabwe,Africa,15265849,160,33548
2021-02-02,zimbabwe,Africa,15265849,266,33814
2021-02-03,zimbabwe,Africa,15265849,150,33964
2021-02-04,zimbabwe,Africa,15265849,207,34171
2021-02-05,zimbabwe,Africa,15265849,160,34331
2021-02-06,zimbabwe,Africa,15265849,156,34487
2021-02-07,zimbabwe,Africa,15265849,65,34552
2021-02-08,zimbabwe,Africa,15265849,106,34658
2021-02-09,zimbabwe,Africa,15265849,123,34781
2021-02-10,zimbabwe,Africa,15265849,83,34864
2021-02-11,zimbabwe,Africa,15265849,85,34949
2021-02-12,zimbabwe,Africa,15265849,96,35045
2021-02-13,zimbabwe,Africa,15265849,59,35104
2021-02-14,zimbabwe,Africa,15265849,68,35172
2021-02-15,zimbabwe,Africa,15265849,50,35222
2021-02-16,zimbabwe,Africa,15265849,93,35315
2021-02-17,zimbabwe,Africa,15265849,108,35423
2021-02-18,zimbabwe,Africa,15265849,120,35543
2021-02-19,zimbabwe,Africa,15265849,167,35710
2021-02-20,zimbabwe,Africa,15265849,58,35768
2021-02-21,zimbabwe,Africa,15265849,28,35796
2021-02-22,zimbabwe,Africa,15265849,66,35862
2021-02-23,zimbabwe,Africa,15265849,48,35910
2021-02-24,zimbabwe,Africa,15265849,50,35960
2021-02-25,zimbabwe,Africa,15265849,34,35994
2021-02-26,zimbabwe,Africa,15265849,50,36044
2021-02-27,zimbabwe,Africa,15265849,14,36058
2021-02-28,zimbabwe,Africa,15265849,31,36089
2021-03-01,zimbabwe,Africa,15265849,26,36115
2021-03-02,zimbabwe,Africa,15265849,33,36148
2021-03-03,zimbabwe,Africa,15265849,31,36179
2021-03-04,zimbabwe,Africa,15265849,44,36223
2021-03-05,zimbabwe,Africa,15265849,25,36248
2021-03-06,zimbabwe,Africa,15265849,12,36260
2021-03-07,zimbabwe,Africa,15265849,11,36271
2021-03-08,zimbabwe,Africa,15265849,18,36289
2021-03-09,zimbabwe,Africa,15265849,32,36321
2021-03-10,zimbabwe,Africa,15265849,20,36341
2021-03-11,zimbabwe,Africa,15265849,36,36377
2021-03-12,zimbabwe,Africa,15265849,46,36423
2021-03-13,zimbabwe,Africa,15265849,48,36471
2021-03-14,zimbabwe,Africa,15265849,13,36484
2021-03-15,zimbabwe,Africa,15265849,20,36504
2021-03-16,zimbabwe,Africa,15265849,31,36535
2021-03-17,zimbabwe,Africa,15265849,17,36552
2021-03-18,zimbabwe,Africa,15265849,59,36611
2021-03-19,zimbabwe,Africa,15265849,41,36652
2021-03-20,zimbabwe,Africa,15265849,10,36662
2021-03-21,zimbabwe,Africa,15265849,3,36665
2021-03-22,zimbabwe,Africa,15265849,19,36684
2021-03-23,zimbabwe,Africa,15265849,33,36717
2021-03-24,zimbabwe,Africa,15265849,32,36749
2021-03-25,zimbabwe,Africa,15265849,29,36778
2021-03-26,zimbabwe,Africa,15265849,27,36805
2021-03-27,zimbabwe,Africa,15265849,13,36818
2021-03-28,zimbabwe,Africa,15265849,4,36822
2021-03-29,zimbabwe,Africa,15265849,17,36839
2021-03-30,zimbabwe,Africa,15265849,0,36839
2021-03-31,zimbabwe,Africa,15265849,43,36882
2021-04-01,zimbabwe,Africa,15265849,14,36896
2021-04-02,zimbabwe,Africa,15265849,7,36903
2021-04-03,zimbabwe,Africa,15265849,8,36911
2021-04-04,zimbabwe,Africa,15265849,12,36923
2021-04-05,zimbabwe,Africa,15265849,11,36934
2021-04-06,zimbabwe,Africa,15265849,32,36966
2021-04-07,zimbabwe,Africa,15265849,18,36984
2021-04-08,zimbabwe,Africa,15265849,68,37052
2021-04-09,zimbabwe,Africa,15265849,95,37147
2021-04-10,zimbabwe,Africa,15265849,126,37273
2021-04-11,zimbabwe,Africa,15265849,15,37288
2021-04-12,zimbabwe,Africa,15265849,19,37307
2021-04-13,zimbabwe,Africa,15265849,23,37330
2021-04-14,zimbabwe,Africa,15265849,39,37369
2021-04-15,zimbabwe,Africa,15265849,53,37422
2021-04-16,zimbabwe,Africa,15265849,112,37534
2021-04-17,zimbabwe,Africa,15265849,165,37699
2021-04-18,zimbabwe,Africa,15265849,52,37751
2021-04-19,zimbabwe,Africa,15265849,108,37859
2021-04-20,zimbabwe,Africa,15265849,16,37875
2021-04-21,zimbabwe,Africa,15265849,105,37980
2021-04-22,zimbabwe,Africa,15265849,38,38018
2021-04-23,zimbabwe,Africa,15265849,27,38045
2021-04-24,zimbabwe,Africa,15265849,19,38064
2021-04-25,zimbabwe,Africa,15265849,22,38086
2021-04-26,zimbabwe,Africa,15265849,16,38102
2021-04-27,zimbabwe,Africa,15265849,62,38164
2021-04-28,zimbabwe,Africa,15265849,27,38191
2021-04-29,zimbabwe,Africa,15265849,44,38235
2021-04-30,zimbabwe,Africa,15265849,22,38257
2021-05-01,zimbabwe,Africa,15265849,3,38260
2021-05-02,zimbabwe,Africa,15265849,21,38281
2021-05-03,zimbabwe,Africa,15265849,12,38293
2021-05-04,zimbabwe,Africa,15265849,34,38327
2021-05-05,zimbabwe,Africa,15265849,30,38357
2021-05-06,zimbabwe,Africa,15265849,41,38398
2021-05-07,zimbabwe,Africa,15265849,5,38403
2021-05-08,zimbabwe,Africa,15265849,11,38414
2021-05-09,zimbabwe,Africa,15265849,5,38419
2021-05-10,zimbabwe,Africa,15265849,14,38433
2021-05-11,zimbabwe,Africa,15265849,15,38448
2021-05-12,zimbabwe,Africa,15265849,18,38466
2021-05-13,zimbabwe,Africa,15265849,25,38491
2021-05-14,zimbabwe,Africa,15265849,44,38535
2021-05-15,zimbabwe,Africa,15265849,19,38554
2021-05-16,zimbabwe,Africa,15265849,6,38560
2021-05-17,zimbabwe,Africa,15265849,12,38572
2021-05-18,zimbabwe,Africa,15265849,23,38595
2021-05-19,zimbabwe,Africa,15265849,17,38612
2021-05-20,zimbabwe,Africa,15265849,23,38635
2021-05-21,zimbabwe,Africa,15265849,29,38664
2021-05-22,zimbabwe,Africa,15265849,15,38679
2021-05-23,zimbabwe,Africa,15265849,3,38682
2021-05-24,zimbabwe,Africa,15265849,14,38696
2021-05-25,zimbabwe,Africa,15265849,10,38706
2021-05-26,zimbabwe,Africa,15265849,113,38819
2021-05-27,zimbabwe,Africa,15265849,35,38854
2021-05-28,zimbabwe,Africa,15265849,64,38918
2021-05-29,zimbabwe,Africa,15265849,15,38933
2021-05-30,zimbabwe,Africa,15265849,11,38944
2021-05-31,zimbabwe,Africa,15265849,17,38961
2021-06-01,zimbabwe,Africa,15265849,37,38998
2021-06-02,zimbabwe,Africa,15265849,33,39031
2021-06-03,zimbabwe,Africa,15265849,61,39092
2021-06-04,zimbabwe,Africa,15265849,52,39144
2021-06-05,zimbabwe,Africa,15265849,24,39168
2021-06-06,zimbabwe,Africa,15265849,21,39189
2021-06-07,zimbabwe,Africa,15265849,49,39238
2021-06-08,zimbabwe,Africa,15265849,83,39321
2021-06-09,zimbabwe,Africa,15265849,111,39432
2021-06-10,zimbabwe,Africa,15265849,64,39496
2021-06-11,zimbabwe,Africa,15265849,192,39688
2021-06-12,zimbabwe,Africa,15265849,164,39852
2021-06-13,zimbabwe,Africa,15265849,107,39959
2021-06-14,zimbabwe,Africa,15265849,118,40077
2021-06-15,zimbabwe,Africa,15265849,241,40318
2021-06-16,zimbabwe,Africa,15265849,238,40556
2021-06-17,zimbabwe,Africa,15265849,371,40927
2021-06-18,zimbabwe,Africa,15265849,408,41335
2021-06-19,zimbabwe,Africa,15265849,293,41628
2021-06-20,zimbabwe,Africa,15265849,151,41779
2021-06-21,zimbabwe,Africa,15265849,416,42195
2021-06-22,zimbabwe,Africa,15265849,519,42714
2021-06-23,zimbabwe,Africa,15265849,766,43480
2021-06-24,zimbabwe,Africa,15265849,826,44306
2021-06-25,zimbabwe,Africa,15265849,911,45217
2021-06-26,zimbabwe,Africa,15265849,801,46018
2021-06-27,zimbabwe,Africa,15265849,424,46442
2021-06-28,zimbabwe,Africa,15265849,842,47284
2021-06-29,zimbabwe,Africa,15265849,1249,48533
2021-06-30,zimbabwe,Africa,15265849,1331,49864
2021-07-01,zimbabwe,Africa,15265849,1357,51221
2021-07-02,zimbabwe,Africa,15265849,1442,52663
2021-07-03,zimbabwe,Africa,15265849,1002,53665
2021-07-04,zimbabwe,Africa,15265849,809,54474
2021-07-05,zimbabwe,Africa,15265849,1540,56014
2021-07-06,zimbabwe,Africa,15265849,1949,57963
2021-07-07,zimbabwe,Africa,15265849,2264,60227
2021-07-08,zimbabwe,Africa,15265849,2156,62383
2021-07-09,zimbabwe,Africa,15265849,2683,65066
2021-07-10,zimbabwe,Africa,15265849,1787,66853
2021-07-11,zimbabwe,Africa,15265849,912,67765
2021-07-12,zimbabwe,Africa,15265849,2661,70426
2021-07-13,zimbabwe,Africa,15265849,2845,73271
2021-07-14,zimbabwe,Africa,15265849,3110,76381
2021-07-15,zimbabwe,Africa,15265849,2491,78872
2021-07-16,zimbabwe,Africa,15265849,2296,81168
2021-07-17,zimbabwe,Africa,15265849,1445,82613
2021-07-18,zimbabwe,Africa,15265849,1006,83619
2021-07-19,zimbabwe,Africa,15265849,2113,85732
2021-07-20,zimbabwe,Africa,15265849,2683,88415
2021-07-21,zimbabwe,Africa,15265849,2705,91120
2021-07-22,zimbabwe,Africa,15265849,2301,93421
2021-07-23,zimbabwe,Africa,15265849,2265,95686
2021-07-24,zimbabwe,Africa,15265849,1591,97277
2021-07-25,zimbabwe,Africa,15265849,617,97894
2021-07-26,zimbabwe,Africa,15265849,2050,99944
2021-07-27,zimbabwe,Africa,15265849,1767,101711
2021-07-28,zimbabwe,Africa,15265849,1856,103567
2021-07-29,zimbabwe,Africa,15265849,2089,105656
2021-07-30,zimbabwe,Africa,15265849,1834,107490
2021-07-31,zimbabwe,Africa,15265849,1370,108860
2021-08-01,zimbabwe,Africa,15265849,686,109546
2021-08-02,zimbabwe,Africa,15265849,1309,110855
2021-08-03,zimbabwe,Africa,15265849,1580,112435
2021-08-04,zimbabwe,Africa,15265849,1091,113526
2021-08-05,zimbabwe,Africa,15265849,963,114489
2021-08-06,zimbabwe,Africa,15265849,956,115445
2021-08-07,zimbabwe,Africa,15265849,445,115890
2021-08-08,zimbabwe,Africa,15265849,437,116327
2021-08-09,zimbabwe,Africa,15265849,526,116853
2021-08-10,zimbabwe,Africa,15265849,405,117258
2021-08-11,zimbabwe,Africa,15265849,696,117954
2021-08-12,zimbabwe,Africa,15265849,800,118754
2021-08-13,zimbabwe,Africa,15265849,754,119508
2021-08-14,zimbabwe,Africa,15265849,345,119853
2021-08-15,zimbabwe,Africa,15265849,235,120088
2021-08-16,zimbabwe,Africa,15265849,0,120088
2021-08-17,zimbabwe,Africa,15265849,958,121046
2021-08-18,zimbabwe,Africa,15265849,452,121498
2021-08-19,zimbabwe,Africa,15265849,404,121902
2021-08-20,zimbabwe,Africa,15265849,386,122288
2021-08-21,zimbabwe,Africa,15265849,199,122487
2021-08-22,zimbabwe,Africa,15265849,165,122652
2021-08-23,zimbabwe,Africa,15265849,349,123001
2021-08-24,zimbabwe,Africa,15265849,319,123320
2021-08-25,zimbabwe,Africa,15265849,391,123711
2021-08-26,zimbabwe,Africa,15265849,275,123986
2021-08-27,zimbabwe,Africa,15265849,250,124236
2021-08-28,zimbabwe,Africa,15265849,131,124367
2021-08-29,zimbabwe,Africa,15265849,70,124437
2021-08-30,zimbabwe,Africa,15265849,144,124581
2021-08-31,zimbabwe,Africa,15265849,192,124773
2021-09-01,zimbabwe,Africa,15265849,187,124960
2021-09-02,zimbabwe,Africa,15265849,158,125118
2021-09-03,zimbabwe,Africa,15265849,213,125331
2021-09-04,zimbabwe,Africa,15265849,94,125425
2021-09-05,zimbabwe,Africa,15265849,125,125550
2021-09-06,zimbabwe,Africa,15265849,121,125671
2021-09-07,zimbabwe,Africa,15265849,125,125796
2021-09-08,zimbabwe,Africa,15265849,135,125931
2021-09-09,zimbabwe,Africa,15265849,125,126056
2021-09-10,zimbabwe,Africa,15265849,107,126163
2021-09-11,zimbabwe,Africa,15265849,57,126220
2021-09-12,zimbabwe,Africa,15265849,49,126269
2021-09-13,zimbabwe,Africa,15265849,130,126399
2021-09-14,zimbabwe,Africa,15265849,418,126817
2021-09-15,zimbabwe,Africa,15265849,266,127083
2021-09-16,zimbabwe,Africa,15265849,285,127368
2021-09-17,zimbabwe,Africa,15265849,264,127632
2021-09-18,zimbabwe,Africa,15265849,107,127739
2021-09-19,zimbabwe,Africa,15265849,199,127938
2021-09-20,zimbabwe,Africa,15265849,248,128186
2021-09-21,zimbabwe,Africa,15265849,278,128464
2021-09-22,zimbabwe,Africa,15265849,340,128804
2021-09-23,zimbabwe,Africa,15265849,330,129134
2021-09-24,zimbabwe,Africa,15265849,226,129360
2021-09-25,zimbabwe,Africa,15265849,145,129505
2021-09-26,zimbabwe,Africa,15265849,120,129625
2021-09-27,zimbabwe,Africa,15265849,294,129919
2021-09-28,zimbabwe,Africa,15265849,353,130272
2021-09-29,zimbabwe,Africa,15265849,213,130485
2021-09-30,zimbabwe,Africa,15265849,335,130820
2021-10-01,zimbabwe,Africa,15265849,208,131028
2021-10-02,zimbabwe,Africa,15265849,66,131094
2021-10-03,zimbabwe,Africa,15265849,35,131129
2021-10-04,zimbabwe,Africa,15265849,0,131129
2021-10-05,zimbabwe,Africa,15265849,76,131205
2021-10-06,zimbabwe,Africa,15265849,229,131434
2021-10-07,zimbabwe,Africa,15265849,89,131523
2021-10-08,zimbabwe,Africa,15265849,182,131705
2021-10-09,zimbabwe,Africa,15265849,57,131762
2021-10-10,zimbabwe,Africa,15265849,34,131796
2021-10-11,zimbabwe,Africa,15265849,79,131875
2021-10-12,zimbabwe,Africa,15265849,141,132016
2021-10-13,zimbabwe,Africa,15265849,92,132108
2021-10-14,zimbabwe,Africa,15265849,143,132251
2021-10-15,zimbabwe,Africa,15265849,34,132285
2021-10-16,zimbabwe,Africa,15265849,48,132333
2021-10-17,zimbabwe,Africa,15265849,35,132368
2021-10-18,zimbabwe,Africa,15265849,0,132368
2021-10-19,zimbabwe,Africa,15265849,37,132405
2021-10-20,zimbabwe,Africa,15265849,32,132437
2021-10-21,zimbabwe,Africa,15265849,103,132540
2021-10-22,zimbabwe,Africa,15265849,48,132588
2021-10-23,zimbabwe,Africa,15265849,37,132625
2021-10-24,zimbabwe,Africa,15265849,26,132651
2021-10-25,zimbabwe,Africa,15265849,37,132688
2021-10-26,zimbabwe,Africa,15265849,36,132724
2021-10-27,zimbabwe,Africa,15265849,84,132808
2021-10-28,zimbabwe,Africa,15265849,72,132880
2021-10-29,zimbabwe,Africa,15265849,46,132926
2021-10-30,zimbabwe,Africa,15265849,0,132926
2021-10-31,zimbabwe,Africa,15265849,51,132977
2021-11-01,zimbabwe,Africa,15265849,30,133007
2021-11-02,zimbabwe,Africa,15265849,40,133047
2021-11-03,zimbabwe,Africa,15265849,44,133091
2021-11-04,zimbabwe,Africa,15265849,21,133112
2021-11-05,zimbabwe,Africa,15265849,34,133146
2021-11-06,zimbabwe,Africa,15265849,22,133168
2021-11-07,zimbabwe,Africa,15265849,19,133187
2021-11-08,zimbabwe,Africa,15265849,18,133205
2021-11-09,zimbabwe,Africa,15265849,37,133242
2021-11-10,zimbabwe,Africa,15265849,60,133302
2021-11-11,zimbabwe,Africa,15265849,27,133329
2021-11-12,zimbabwe,Africa,15265849,64,133393
2021-11-13,zimbabwe,Africa,15265849,35,133428
2021-11-14,zimbabwe,Africa,15265849,0,133428
2021-11-15,zimbabwe,Africa,15265849,10,133438
2021-11-16,zimbabwe,Africa,15265849,67,133505
2021-11-17,zimbabwe,Africa,15265849,52,133557
2021-11-18,zimbabwe,Africa,15265849,36,133593
2021-11-19,zimbabwe,Africa,15265849,22,133615
2021-11-20,zimbabwe,Africa,15265849,23,133638
2021-11-21,zimbabwe,Africa,15265849,9,133647
2021-11-22,zimbabwe,Africa,15265849,27,133674
2021-11-23,zimbabwe,Africa,15265849,33,133707
2021-11-24,zimbabwe,Africa,15265849,40,133747
2021-11-25,zimbabwe,Africa,15265849,27,133774
2021-11-26,zimbabwe,Africa,15265849,62,133836
2021-11-27,zimbabwe,Africa,15265849,115,133951
2021-11-28,zimbabwe,Africa,15265849,40,133991
2021-11-29,zimbabwe,Africa,15265849,235,134226
2021-11-30,zimbabwe,Africa,15265849,399,134625
2021-12-01,zimbabwe,Africa,15265849,712,135337
2021-12-02,zimbabwe,Africa,15265849,1042,136379
2021-12-03,zimbabwe,Africa,15265849,1062,137441
2021-12-04,zimbabwe,Africa,15265849,1082,138523
2021-12-05,zimbabwe,Africa,15265849,523,139046
2021-12-06,zimbabwe,Africa,15265849,2555,141601
2021-12-07,zimbabwe,Africa,15265849,4031,145632
2021-12-08,zimbabwe,Africa,15265849,4996,150628
2021-12-09,zimbabwe,Africa,15265849,5189,155817
2021-12-10,zimbabwe,Africa,15265849,6181,161998
2021-12-11,zimbabwe,Africa,15265849,3004,165002
2021-12-12,zimbabwe,Africa,15265849,2138,167140
2021-12-13,zimbabwe,Africa,15265849,4872,172012
2021-12-14,zimbabwe,Africa,15265849,5678,177690
2021-12-15,zimbabwe,Africa,15265849,4367,182057
2021-12-16,zimbabwe,Africa,15265849,4247,186304
2021-12-17,zimbabwe,Africa,15265849,3263,189567
2021-12-18,zimbabwe,Africa,15265849,2106,191673
2021-12-19,zimbabwe,Africa,15265849,1123,192796
2021-12-20,zimbabwe,Africa,15265849,2283,195079
2021-12-21,zimbabwe,Africa,15265849,2689,197768
2021-12-22,zimbabwe,Africa,15265849,1636,199404
2021-12-23,zimbabwe,Africa,15265849,1940,201344
2021-12-24,zimbabwe,Africa,15265849,1392,202736
2021-12-25,zimbabwe,Africa,15265849,1010,203746
2021-12-26,zimbabwe,Africa,15265849,605,204351
2021-12-27,zimbabwe,Africa,15265849,1098,205449
2021-12-28,zimbabwe,Africa,15265849,2099,207548
2021-12-29,zimbabwe,Africa,15265849,2107,209655
2021-12-30,zimbabwe,Africa,15265849,2073,211728
2021-12-31,zimbabwe,Africa,15265849,1530,213258
2022-01-01,zimbabwe,Africa,15265849,956,214214
2022-01-02,zimbabwe,Africa,15265849,664,214878
2022-01-03,zimbabwe,Africa,15265849,1209,216087
2022-01-04,zimbabwe,Africa,15265849,1591,217678
2022-01-05,zimbabwe,Africa,15265849,1379,219057
2022-01-06,zimbabwe,Africa,15265849,1121,220178
2022-01-07,zimbabwe,Africa,15265849,1104,221282
2022-01-08,zimbabwe,Africa,15265849,636,221918
2022-01-09,zimbabwe,Africa,15265849,373,222291
2022-01-10,zimbabwe,Africa,15265849,709,223000
2022-01-11,zimbabwe,Africa,15265849,765,223765
2022-01-12,zimbabwe,Africa,15265849,668,224433
2022-01-13,zimbabwe,Africa,15265849,651,225084
2022-01-14,zimbabwe,Africa,15265849,553,225637
2022-01-15,zimbabwe,Africa,15265849,297,225934
2022-01-16,zimbabwe,Africa,15265849,144,226078
2022-01-17,zimbabwe,Africa,15265849,382,226460
2022-01-18,zimbabwe,Africa,15265849,427,226887
2022-01-19,zimbabwe,Africa,15265849,665,227552
2022-01-20,zimbabwe,Africa,15265849,143,227695
2022-01-21,zimbabwe,Africa,15265849,266,227961
2022-01-22,zimbabwe,Africa,15265849,218,228179
2022-01-23,zimbabwe,Africa,15265849,75,228254
2022-01-24,zimbabwe,Africa,15265849,287,228541
2022-01-25,zimbabwe,Africa,15265849,235,228776
2022-01-26,zimbabwe,Africa,15265849,167,228943
2022-01-27,zimbabwe,Africa,15265849,153,229096
2022-01-28,zimbabwe,Africa,15265849,237,229333
2022-01-29,zimbabwe,Africa,15265849,82,229415
2022-01-30,zimbabwe,Africa,15265849,45,229460
2022-01-31,zimbabwe,Africa,15265849,206,229666
2022-02-01,zimbabwe,Africa,15265849,185,229851
2022-02-02,zimbabwe,Africa,15265849,161,230012
2022-02-03,zimbabwe,Africa,15265849,158,230170
2022-02-04,zimbabwe,Africa,15265849,165,230335
2022-02-05,zimbabwe,Africa,15265849,67,230402
2022-02-06,zimbabwe,Africa,15265849,50,230452
2022-02-07,zimbabwe,Africa,15265849,151,230603
2022-02-08,zimbabwe,Africa,15265849,137,230740
2022-02-09,zimbabwe,Africa,15265849,140,230880
2022-02-10,zimbabwe,Africa,15265849,160,231040
2022-02-11,zimbabwe,Africa,15265849,174,231214
2022-02-12,zimbabwe,Africa,15265849,85,231299
2022-02-13,zimbabwe,Africa,15265849,82,231381
2022-02-14,zimbabwe,Africa,15265849,222,231603
2022-02-15,zimbabwe,Africa,15265849,260,231863
2022-02-16,zimbabwe,Africa,15265849,350,232213
2022-02-17,zimbabwe,Africa,15265849,385,232598
2022-02-18,zimbabwe,Africa,15265849,432,233030
2022-02-19,zimbabwe,Africa,15265849,194,233224
2022-02-20,zimbabwe,Africa,15265849,128,233352
2022-02-21,zimbabwe,Africa,15265849,219,233571
2022-02-22,zimbabwe,Africa,15265849,409,233980
2022-02-23,zimbabwe,Africa,15265849,609,234589
2022-02-24,zimbabwe,Africa,15265849,378,234967
2022-02-25,zimbabwe,Africa,15265849,500,235467
2022-02-26,zimbabwe,Africa,15265849,336,235803
2022-02-27,zimbabwe,Africa,15265849,172,235975
2022-02-28,zimbabwe,Africa,15265849,405,236380
2022-03-01,zimbabwe,Africa,15265849,491,236871
2022-03-02,zimbabwe,Africa,15265849,632,237503
2022-03-03,zimbabwe,Africa,15265849,603,238106
2022-03-04,zimbabwe,Africa,15265849,633,238739
2022-03-05,zimbabwe,Africa,15265849,280,239019
2022-03-06,zimbabwe,Africa,15265849,190,239209
2022-03-07,zimbabwe,Africa,15265849,501,239710
2022-03-08,zimbabwe,Africa,15265849,633,240343
2022-03-09,zimbabwe,Africa,15265849,706,241049
2022-03-10,zimbabwe,Africa,15265849,499,241548
2022-03-11,zimbabwe,Africa,15265849,521,242069
2022-03-12,zimbabwe,Africa,15265849,288,242357
2022-03-13,zimbabwe,Africa,15265849,158,242515
2022-03-14,zimbabwe,Africa,15265849,394,242909
2022-03-15,zimbabwe,Africa,15265849,456,243365
2022-03-16,zimbabwe,Africa,15265849,285,243650
2022-03-17,zimbabwe,Africa,15265849,362,244012
2022-03-18,zimbabwe,Africa,15265849,306,244318
2022-03-19,zimbabwe,Africa,15265849,134,244452
2022-03-20,zimbabwe,Africa,15265849,67,244519
2022-03-21,zimbabwe,Africa,15265849,166,244685
2022-03-22,zimbabwe,Africa,15265849,273,244958
2022-03-23,zimbabwe,Africa,15265849,236,245194
2022-03-24,zimbabwe,Africa,15265849,273,245467
2022-03-25,zimbabwe,Africa,15265849,178,245645
2022-03-26,zimbabwe,Africa,15265849,122,245767
2022-03-27,zimbabwe,Africa,15265849,53,245820
2022-03-28,zimbabwe,Africa,15265849,107,245927
2022-03-29,zimbabwe,Africa,15265849,115,246042
2022-03-30,zimbabwe,Africa,15265849,140,246182
2022-03-31,zimbabwe,Africa,15265849,104,246286
2022-04-01,zimbabwe,Africa,15265849,128,246414
2022-04-02,zimbabwe,Africa,15265849,67,246481
2022-04-03,zimbabwe,Africa,15265849,44,246525
2022-04-04,zimbabwe,Africa,15265849,87,246612
2022-04-05,zimbabwe,Africa,15265849,132,246744
2022-04-06,zimbabwe,Africa,15265849,59,246803
2022-04-07,zimbabwe,Africa,15265849,67,246870
2022-04-08,zimbabwe,Africa,15265849,55,246925
2022-04-09,zimbabwe,Africa,15265849,33,246958
2022-04-10,zimbabwe,Africa,15265849,15,246973
2022-04-11,zimbabwe,Africa,15265849,37,247010
2022-04-12,zimbabwe,Africa,15265849,84,247094
2022-04-13,zimbabwe,Africa,15265849,66,247160
2022-04-14,zimbabwe,Africa,15265849,48,247208
2022-04-15,zimbabwe,Africa,15265849,29,247237
2022-04-16,zimbabwe,Africa,15265849,24,247261
2022-04-17,zimbabwe,Africa,15265849,17,247278
2022-04-18,zimbabwe,Africa,15265849,19,247297
2022-04-19,zimbabwe,Africa,15265849,0,247297
2022-04-20,zimbabwe,Africa,15265849,39,247336
2022-04-21,zimbabwe,Africa,15265849,47,247383
2022-04-22,zimbabwe,Africa,15265849,105,247488
2022-04-23,zimbabwe,Africa,15265849,36,247524
2022-04-24,zimbabwe,Africa,15265849,30,247554
2022-04-25,zimbabwe,Africa,15265849,44,247598
2022-04-26,zimbabwe,Africa,15265849,69,247667
2022-04-27,zimbabwe,Africa,15265849,62,247729
2022-04-28,zimbabwe,Africa,15265849,55,247784
2022-04-29,zimbabwe,Africa,15265849,58,247842
2022-04-30,zimbabwe,Africa,15265849,33,247875
2022-05-01,zimbabwe,Africa,15265849,36,247911
2022-05-02,zimbabwe,Africa,15265849,24,247935
2022-05-03,zimbabwe,Africa,15265849,55,247990
2022-05-04,zimbabwe,Africa,15265849,60,248050
2022-05-05,zimbabwe,Africa,15265849,100,248150
2022-05-06,zimbabwe,Africa,15265849,64,248214
2022-05-07,zimbabwe,Africa,15265849,55,248269
2022-05-08,zimbabwe,Africa,15265849,83,248352
2022-05-09,zimbabwe,Africa,15265849,184,248536
2022-05-10,zimbabwe,Africa,15265849,106,248642
2022-05-11,zimbabwe,Africa,15265849,136,248778
2022-05-12,zimbabwe,Africa,15265849,165,248943
2022-05-13,zimbabwe,Africa,15265849,188,249131
2022-05-14,zimbabwe,Africa,15265849,75,249206
